Chromosome,Start,End,ID,Name,Range
chr1,9899,10239,SRX5716454,SOX3,340
chr1,9923,10228,SRX5075182,SMARCA2,305
chr1,9990,10437,SRX20140894,INTS13,447
chr1,10000,10254,SRX5020214,SMARCA2,254
chr1,10001,10206,SRX5075174,SMARCA4,205
chr1,10002,10295,SRX5716460,Epitope tags,293
chr1,10003,10428,SRX20140880,CPSF3L,425
chr1,10004,10200,SRX5075176,SMARCA4,196
chr1,10004,10399,SRX20140860,SOX2,395
chr1,10005,10270,SRX20140892,SOX2,265
chr1,10011,10438,SRX20140879,CPSF3L,427
chr1,10011,10456,SRX20140862,SOX2,445
chr1,10013,10243,SRX5716468,SMARCA2,230
chr1,10018,10436,SRX20140882,CPSF3L,418
chr1,10019,10358,SRX20140870,INTS10,339
chr1,10020,10419,SRX20140891,SOX2,399
chr1,10022,10079,SRX5075180,SMARCA2,57
chr1,10024,10407,SRX20140861,SOX2,383
chr1,10026,10303,SRX5075168,SMARCA4,277
chr1,10027,10217,SRX5716451,SOX2,190
chr1,10028,10408,SRX20140881,CPSF3L,380
chr1,10030,10334,SRX20140869,INTS10,304
chr1,10034,10447,SRX20140895,INTS13,413
chr1,10035,10424,SRX20140897,INTS13,389
chr1,10036,10438,SRX20140868,INTS10,402
chr1,10042,10345,SRX20140896,INTS13,303
chr1,10045,10309,SRX20140867,INTS10,264
chr1,10056,10312,SRX20140890,SOX2,256
chr1,11084,11533,SRX16500062,CTCF,449
chr1,11085,11640,SRX16500060,CTCF,555
chr1,11093,11652,SRX16500061,CTCF,559
chr1,11097,11642,SRX16500059,CTCF,545
chr1,11149,11536,SRX4174629,CTCF,387
chr1,11178,11476,SRX5075174,SMARCA4,298
chr1,11201,11488,SRX5075168,SMARCA4,287
chr1,19887,20555,SRX20140869,INTS10,668
chr1,19970,20290,SRX5075170,SMARCA4,320
chr1,20007,20496,SRX5075176,SMARCA4,489
chr1,20038,20406,SRX20140897,INTS13,368
chr1,25925,26135,SRX4174629,CTCF,210
chr1,28887,29659,SRX20140895,INTS13,772
chr1,29027,29338,SRX5075169,SMARCA4,311
chr1,29039,29517,SRX20140869,INTS10,478
chr1,29097,29309,SRX5716469,SMARCA4,212
chr1,29103,29385,SRX5075170,SMARCA4,282
chr1,29111,29528,SRX5716470,SMARCA4,417
chr1,29123,29598,SRX20140868,INTS10,475
chr1,29140,29322,SRX5075176,SMARCA4,182
chr1,29183,29565,SRX5075168,SMARCA4,382
chr1,29189,29763,SRX5075174,SMARCA4,574
chr1,29249,29630,SRX5075175,SMARCA4,381
chr1,56204,56377,SRX5075174,SMARCA4,173
chr1,91249,91592,SRX16500059,CTCF,343
chr1,91256,91562,SRX16500060,CTCF,306
chr1,91270,91584,SRX16500062,CTCF,314
chr1,91272,91554,SRX4174629,CTCF,282
chr1,91292,91539,SRX16500061,CTCF,247
chr1,180748,180995,SRX20140894,INTS13,247
chr1,181444,182110,SRX16500060,CTCF,666
chr1,181491,182090,SRX16500061,CTCF,599
chr1,181497,182124,SRX16500059,CTCF,627
chr1,181502,182079,SRX16500062,CTCF,577
chr1,181588,181973,SRX20140895,INTS13,385
chr1,181608,181985,SRX5075174,SMARCA4,377
chr1,181622,182059,SRX5075168,SMARCA4,437
chr1,181635,181932,SRX20140894,INTS13,297
chr1,181649,182086,SRX4174629,CTCF,437
chr1,190369,190793,SRX20140897,INTS13,424
chr1,190514,191022,SRX20140869,INTS10,508
chr1,190601,190986,SRX5075176,SMARCA4,385
chr1,190607,190932,SRX5075170,SMARCA4,325
chr1,196413,196688,SRX16500061,CTCF,275
chr1,196445,196787,SRX16500060,CTCF,342
chr1,196446,196776,SRX16500062,CTCF,330
chr1,196448,196781,SRX16500059,CTCF,333
chr1,196471,196746,SRX4174629,CTCF,275
chr1,199043,199230,SRX5075176,SMARCA4,187
chr1,199069,199353,SRX5075169,SMARCA4,284
chr1,199247,199757,SRX20140897,INTS13,510
chr1,199307,200101,SRX5075175,SMARCA4,794
chr1,199317,200177,SRX20140869,INTS10,860
chr1,199477,200417,SRX20140895,INTS13,940
chr1,199622,200154,SRX5716470,SMARCA4,532
chr1,199623,200088,SRX20140870,INTS10,465
chr1,199628,200148,SRX5075170,SMARCA4,520
chr1,199632,200218,SRX20140868,INTS10,586
chr1,199642,199838,SRX5075169,SMARCA4,196
chr1,199704,200088,SRX5075168,SMARCA4,384
chr1,199714,199949,SRX5716469,SMARCA4,235
chr1,199717,200103,SRX5075174,SMARCA4,386
chr1,199731,200079,SRX20140894,INTS13,348
chr1,199732,200101,SRX5075176,SMARCA4,369
chr1,199766,200155,SRX20140867,INTS10,389
chr1,199797,200105,SRX5716464,SMARCA4,308
chr1,199800,200116,SRX20140879,CPSF3L,316
chr1,199817,200134,SRX20140897,INTS13,317
chr1,199899,200152,SRX5075169,SMARCA4,253
chr1,267719,268314,SRX16500059,CTCF,595
chr1,267798,268251,SRX16500060,CTCF,453
chr1,267798,268254,SRX16500061,CTCF,456
chr1,267799,268245,SRX16500062,CTCF,446
chr1,267831,268283,SRX4174629,CTCF,452
chr1,267859,268156,SRX5075168,SMARCA4,297
chr1,267865,268119,SRX5075176,SMARCA4,254
chr1,267866,268189,SRX5075174,SMARCA4,323
chr1,267908,268195,SRX5716470,SMARCA4,287
chr1,267913,268146,SRX5075170,SMARCA4,233
chr1,267961,268183,SRX5716464,SMARCA4,222
chr1,352520,352775,SRX5054308,FOSL2,255
chr1,357092,357578,SRX16500059,CTCF,486
chr1,357137,357590,SRX16500062,CTCF,453
chr1,357147,357673,SRX16500060,CTCF,526
chr1,357224,357608,SRX16500061,CTCF,384
chr1,357244,357482,SRX5075168,SMARCA4,238
chr1,357254,357686,SRX4174629,CTCF,432
chr1,357267,357556,SRX5075174,SMARCA4,289
chr1,376925,377134,SRX5075169,SMARCA4,209
chr1,381044,381797,SRX16500059,CTCF,753
chr1,381075,381804,SRX16500060,CTCF,729
chr1,381091,381792,SRX16500062,CTCF,701
chr1,381095,381790,SRX16500061,CTCF,695
chr1,381147,381778,SRX4174629,CTCF,631
chr1,410774,410954,SRX5075169,SMARCA4,180
chr1,410807,410989,SRX5075170,SMARCA4,182
chr1,430088,430437,SRX16500060,CTCF,349
chr1,430220,430465,SRX16500061,CTCF,245
chr1,435472,435815,SRX16500062,CTCF,343
chr1,435502,435969,SRX16500059,CTCF,467
chr1,435512,435918,SRX16500060,CTCF,406
chr1,435581,435963,SRX16500061,CTCF,382
chr1,449576,450051,SRX16500060,CTCF,475
chr1,449579,450082,SRX16500062,CTCF,503
chr1,449579,450097,SRX16500059,CTCF,518
chr1,449628,450060,SRX16500061,CTCF,432
chr1,449629,449972,SRX4174629,CTCF,343
chr1,585981,586483,SRX16500060,CTCF,502
chr1,585992,586445,SRX16500059,CTCF,453
chr1,585996,586410,SRX16500061,CTCF,414
chr1,585997,586390,SRX16500062,CTCF,393
chr1,586052,586345,SRX4174629,CTCF,293
chr1,586055,586340,SRX5075174,SMARCA4,285
chr1,586057,586324,SRX5075168,SMARCA4,267
chr1,586070,586331,SRX5075170,SMARCA4,261
chr1,586091,586308,SRX5716464,SMARCA4,217
chr1,586103,586288,SRX5075176,SMARCA4,185
chr1,586134,586338,SRX5716463,SMARCA4,204
chr1,586136,586316,SRX5075169,SMARCA4,180
chr1,609250,610849,SRX16500060,CTCF,1599
chr1,609250,610880,SRX16500059,CTCF,1630
chr1,609291,610857,SRX16500061,CTCF,1566
chr1,609294,610888,SRX16500062,CTCF,1594
chr1,629127,629177,SRX5075180,SMARCA2,50
chr1,629136,630043,SRX5716455,SOX3,907
chr1,629151,629439,SRX4174629,CTCF,288
chr1,629165,629994,SRX5716452,SOX2,829
chr1,629205,630000,SRX20140897,INTS13,795
chr1,629221,630034,SRX20140895,INTS13,813
chr1,629222,629980,SRX5716451,SOX2,758
chr1,629223,629995,SRX5716453,SOX2,772
chr1,629227,629983,SRX5020211,SMARCA2,756
chr1,629229,629970,SRX20140881,CPSF3L,741
chr1,629232,629466,SRX5716454,SOX3,234
chr1,629250,629452,SRX5075176,SMARCA4,202
chr1,629250,629974,SRX5075181,SMARCA2,724
chr1,629253,629976,SRX5716468,SMARCA2,723
chr1,629257,629981,SRX5075182,SMARCA2,724
chr1,629264,629956,SRX5054307,FOSL2,692
chr1,629268,630021,SRX20140869,INTS10,753
chr1,629280,629997,SRX20140879,CPSF3L,717
chr1,629287,630008,SRX20140894,INTS13,721
chr1,629290,629955,SRX20140896,INTS13,665
chr1,629309,629433,SRX5075180,SMARCA2,124
chr1,629311,629990,SRX20140868,INTS10,679
chr1,629382,629882,SRX20140890,SOX2,500
chr1,629385,629955,SRX20140862,SOX2,570
chr1,629497,629978,SRX5716456,SOX3,481
chr1,629498,629937,SRX20140892,SOX2,439
chr1,629504,629860,SRX4174629,CTCF,356
chr1,629519,629976,SRX5020214,SMARCA2,457
chr1,629523,629967,SRX5716454,SOX3,444
chr1,629532,629988,SRX16500059,CTCF,456
chr1,629534,629585,SRX5075180,SMARCA2,51
chr1,629539,629834,SRX20140867,INTS10,295
chr1,629542,629984,SRX5075176,SMARCA4,442
chr1,629648,629960,SRX16500061,CTCF,312
chr1,629663,629989,SRX5075180,SMARCA2,326
chr1,629666,629901,SRX5716469,SMARCA4,235
chr1,629666,629984,SRX16500060,CTCF,318
chr1,629670,629958,SRX20140861,SOX2,288
chr1,629675,629970,SRX16500062,CTCF,295
chr1,629715,629942,SRX5075175,SMARCA4,227
chr1,630767,630991,SRX5020211,SMARCA2,224
chr1,630769,631321,SRX5716468,SMARCA2,552
chr1,630773,631316,SRX5075182,SMARCA2,543
chr1,630778,631341,SRX5716453,SOX2,563
chr1,630780,631333,SRX20140897,INTS13,553
chr1,630782,631303,SRX5075181,SMARCA2,521
chr1,630785,631317,SRX5054307,FOSL2,532
chr1,630785,631342,SRX5716454,SOX3,557
chr1,630785,631348,SRX5716451,SOX2,563
chr1,630788,631354,SRX5716455,SOX3,566
chr1,630793,631353,SRX5716452,SOX2,560
chr1,630795,631260,SRX20140892,SOX2,465
chr1,630796,631334,SRX20140895,INTS13,538
chr1,630798,631322,SRX20140869,INTS10,524
chr1,630807,631289,SRX20140868,INTS10,482
chr1,630811,631284,SRX20140896,INTS13,473
chr1,630823,630928,SRX5075180,SMARCA2,105
chr1,630827,631276,SRX5020214,SMARCA2,449
chr1,630837,631299,SRX5716456,SOX3,462
chr1,630842,631269,SRX20140879,CPSF3L,427
chr1,630847,631300,SRX20140881,CPSF3L,453
chr1,630851,631275,SRX20140862,SOX2,424
chr1,630856,631358,SRX4174629,CTCF,502
chr1,630866,631293,SRX20140894,INTS13,427
chr1,630876,631279,SRX20140880,CPSF3L,403
chr1,630951,631184,SRX5716463,SMARCA4,233
chr1,631048,631155,SRX5075180,SMARCA2,107
chr1,631055,631338,SRX5020211,SMARCA2,283
chr1,631232,631345,SRX5075180,SMARCA2,113
chr1,631875,632299,SRX5075181,SMARCA2,424
chr1,631879,632309,SRX5716451,SOX2,430
chr1,631879,632313,SRX5075182,SMARCA2,434
chr1,631881,632458,SRX5716452,SOX2,577
chr1,631881,632633,SRX5716455,SOX3,752
chr1,631882,632468,SRX5716453,SOX2,586
chr1,631885,632370,SRX5020214,SMARCA2,485
chr1,631890,632295,SRX5716454,SOX3,405
chr1,631893,632299,SRX5020211,SMARCA2,406
chr1,631897,632061,SRX5075180,SMARCA2,164
chr1,631902,632235,SRX5716468,SMARCA2,333
chr1,631904,632274,SRX4174629,CTCF,370
chr1,631911,632856,SRX20140895,INTS13,945
chr1,631914,632223,SRX16500060,CTCF,309
chr1,631914,632828,SRX20140897,INTS13,914
chr1,631924,632812,SRX20140869,INTS10,888
chr1,631929,632260,SRX20140879,CPSF3L,331
chr1,631933,632245,SRX16500062,CTCF,312
chr1,631944,632265,SRX5716456,SOX3,321
chr1,631949,632613,SRX20140881,CPSF3L,664
chr1,631952,632241,SRX16500059,CTCF,289
chr1,631952,632624,SRX20140896,INTS13,672
chr1,631954,632280,SRX5075176,SMARCA4,326
chr1,631956,632253,SRX16500061,CTCF,297
chr1,631957,632252,SRX20140868,INTS10,295
chr1,631968,632276,SRX20140894,INTS13,308
chr1,631985,632261,SRX20140862,SOX2,276
chr1,631999,632273,SRX5054307,FOSL2,274
chr1,632031,632266,SRX5075170,SMARCA4,235
chr1,632147,632278,SRX5075180,SMARCA2,131
chr1,632176,632244,SRX1424894,POU3F2,68
chr1,632510,632780,SRX20140894,INTS13,270
chr1,632520,632794,SRX5716453,SOX2,274
chr1,632526,632650,SRX5075180,SMARCA2,124
chr1,632527,632815,SRX5716452,SOX2,288
chr1,632529,632785,SRX5020211,SMARCA2,256
chr1,632538,632780,SRX20140879,CPSF3L,242
chr1,633320,633624,SRX16500059,CTCF,304
chr1,633321,633543,SRX16500060,CTCF,222
chr1,633333,633600,SRX16500062,CTCF,267
chr1,633379,633602,SRX16500061,CTCF,223
chr1,633407,633502,SRX5075180,SMARCA2,95
chr1,633792,634779,SRX20140897,INTS13,987
chr1,633797,634778,SRX20140895,INTS13,981
chr1,633834,634204,SRX16500059,CTCF,370
chr1,633857,634206,SRX16500060,CTCF,349
chr1,633858,634195,SRX16500062,CTCF,337
chr1,633873,634196,SRX5716451,SOX2,323
chr1,633876,634228,SRX20140879,CPSF3L,352
chr1,633880,634200,SRX16500061,CTCF,320
chr1,633882,634197,SRX5075182,SMARCA2,315
chr1,633890,634204,SRX5020214,SMARCA2,314
chr1,633891,634228,SRX5020211,SMARCA2,337
chr1,633893,634451,SRX20140869,INTS10,558
chr1,633894,634181,SRX5054307,FOSL2,287
chr1,633894,634219,SRX5716454,SOX3,325
chr1,633895,634217,SRX5716468,SMARCA2,322
chr1,633897,634196,SRX20140862,SOX2,299
chr1,633897,634392,SRX20140894,INTS13,495
chr1,633902,634212,SRX4174629,CTCF,310
chr1,633902,634394,SRX20140881,CPSF3L,492
chr1,633903,634289,SRX5716452,SOX2,386
chr1,633903,634311,SRX5716455,SOX3,408
chr1,633907,634116,SRX5075170,SMARCA4,209
chr1,633908,634289,SRX5716453,SOX2,381
chr1,633909,634187,SRX5075181,SMARCA2,278
chr1,633911,634191,SRX5716456,SOX3,280
chr1,633912,634185,SRX5075176,SMARCA4,273
chr1,633917,634284,SRX20140868,INTS10,367
chr1,633918,634771,SRX20140896,INTS13,853
chr1,633923,634071,SRX5075180,SMARCA2,148
chr1,633937,634194,SRX20140892,SOX2,257
chr1,633998,634176,SRX5075174,SMARCA4,178
chr1,634000,634051,SRX5020208,SMARCA2,51
chr1,634838,634891,SRX5075180,SMARCA2,53
chr1,646505,646755,SRX5075168,SMARCA4,250
chr1,665932,666159,SRX16500060,CTCF,227
chr1,670506,670872,SRX16500059,CTCF,366
chr1,670541,670893,SRX16500060,CTCF,352
chr1,670551,670837,SRX16500062,CTCF,286
chr1,670570,670813,SRX16500061,CTCF,243
chr1,684554,685003,SRX16500062,CTCF,449
chr1,684568,685032,SRX16500059,CTCF,464
chr1,684568,685036,SRX16500060,CTCF,468
chr1,684571,685058,SRX16500061,CTCF,487
chr1,684596,684885,SRX4174629,CTCF,289
chr1,684655,684839,SRX5075174,SMARCA4,184
chr1,684683,684852,SRX5075170,SMARCA4,169
chr1,763763,763962,SRX5075176,SMARCA4,199
chr1,778347,779166,SRX16500060,CTCF,819
chr1,778377,779207,SRX20140895,INTS13,830
chr1,778386,779072,SRX16500062,CTCF,686
chr1,778403,778961,SRX16500059,CTCF,558
chr1,778404,778667,SRX20140881,CPSF3L,263
chr1,778418,779209,SRX20140868,INTS10,791
chr1,778425,779098,SRX20140867,INTS10,673
chr1,778441,779060,SRX5716463,SMARCA4,619
chr1,778445,778625,SRX5075176,SMARCA4,180
chr1,778452,778982,SRX16500061,CTCF,530
chr1,778466,778900,SRX20140869,INTS10,434
chr1,778488,779111,SRX20140897,INTS13,623
chr1,778489,779150,SRX5075168,SMARCA4,661
chr1,778548,779069,SRX5075174,SMARCA4,521
chr1,778550,779029,SRX5075170,SMARCA4,479
chr1,778574,778876,SRX5716469,SMARCA4,302
chr1,778613,779097,SRX4174629,CTCF,484
chr1,778644,778857,SRX5054307,FOSL2,213
chr1,778694,779087,SRX5075176,SMARCA4,393
chr1,778720,778910,SRX5716451,SOX2,190
chr1,778776,779025,SRX5716464,SMARCA4,249
chr1,778838,779075,SRX5075175,SMARCA4,237
chr1,789917,789959,SRX1424893,POU3F2,42
chr1,790922,790966,SRX1424893,POU3F2,44
chr1,790925,790966,SRX1424894,POU3F2,41
chr1,790926,790966,SRX1424891,POU3F2,40
chr1,791554,791600,SRX1424893,POU3F2,46
chr1,791556,791596,SRX1424891,POU3F2,40
chr1,791557,791599,SRX1424894,POU3F2,42
chr1,810928,811264,SRX5075170,SMARCA4,336
chr1,810929,811291,SRX5075176,SMARCA4,362
chr1,810956,811168,SRX5716469,SMARCA4,212
chr1,810974,811187,SRX5075175,SMARCA4,213
chr1,810999,811202,SRX5075169,SMARCA4,203
chr1,811009,811205,SRX5075174,SMARCA4,196
chr1,827139,827969,SRX20140895,INTS13,830
chr1,827305,827584,SRX20140869,INTS10,279
chr1,827382,827748,SRX5075168,SMARCA4,366
chr1,827395,827890,SRX5075170,SMARCA4,495
chr1,827400,827741,SRX5075174,SMARCA4,341
chr1,827419,827986,SRX5075176,SMARCA4,567
chr1,827564,827820,SRX5716470,SMARCA4,256
chr1,827574,827941,SRX5075175,SMARCA4,367
chr1,827601,827815,SRX20140867,INTS10,214
chr1,857889,858206,SRX16500062,CTCF,317
chr1,857904,858283,SRX16500059,CTCF,379
chr1,857937,858223,SRX16500060,CTCF,286
chr1,857957,858228,SRX16500061,CTCF,271
chr1,858030,858244,SRX4174629,CTCF,214
chr1,869657,870218,SRX16500059,CTCF,561
chr1,869671,870144,SRX16500062,CTCF,473
chr1,869684,870196,SRX16500061,CTCF,512
chr1,869694,870170,SRX16500060,CTCF,476
chr1,869733,870107,SRX5075168,SMARCA4,374
chr1,869770,870086,SRX5075176,SMARCA4,316
chr1,869777,870012,SRX5716463,SMARCA4,235
chr1,869783,870118,SRX5075174,SMARCA4,335
chr1,869806,870124,SRX5075170,SMARCA4,318
chr1,869827,870084,SRX5716470,SMARCA4,257
chr1,869830,870112,SRX5716464,SMARCA4,282
chr1,869832,870021,SRX5075169,SMARCA4,189
chr1,904428,904979,SRX16500060,CTCF,551
chr1,904467,905010,SRX20140895,INTS13,543
chr1,904470,904937,SRX5075169,SMARCA4,467
chr1,904474,904952,SRX5716470,SMARCA4,478
chr1,904522,904966,SRX5075168,SMARCA4,444
chr1,904523,904970,SRX16500061,CTCF,447
chr1,904528,904968,SRX16500062,CTCF,440
chr1,904530,904996,SRX20140868,INTS10,466
chr1,904532,904988,SRX16500059,CTCF,456
chr1,904580,904949,SRX5075170,SMARCA4,369
chr1,904585,904931,SRX5075176,SMARCA4,346
chr1,904594,904977,SRX5075174,SMARCA4,383
chr1,904603,904932,SRX5716463,SMARCA4,329
chr1,904608,904936,SRX5075175,SMARCA4,328
chr1,904630,904853,SRX5716464,SMARCA4,223
chr1,904656,904876,SRX20140867,INTS10,220
chr1,904693,904948,SRX20140897,INTS13,255
chr1,904725,904956,SRX5716469,SMARCA4,231
chr1,904770,904999,SRX4174629,CTCF,229
chr1,920955,921321,SRX16500059,CTCF,366
chr1,920969,921333,SRX16500062,CTCF,364
chr1,920969,921418,SRX16500060,CTCF,449
chr1,920996,921301,SRX5075170,SMARCA4,305
chr1,921003,921371,SRX16500061,CTCF,368
chr1,921015,921265,SRX5716470,SMARCA4,250
chr1,921023,921268,SRX5075175,SMARCA4,245
chr1,921039,921266,SRX5075169,SMARCA4,227
chr1,921056,921262,SRX5075176,SMARCA4,206
chr1,921069,921395,SRX5075174,SMARCA4,326
chr1,921072,921373,SRX5075168,SMARCA4,301
chr1,923708,923970,SRX5075168,SMARCA4,262
chr1,923742,923977,SRX5075170,SMARCA4,235
chr1,923757,923993,SRX5075174,SMARCA4,236
chr1,923870,924045,SRX5075176,SMARCA4,175
chr1,940170,940493,SRX5716470,SMARCA4,323
chr1,940203,940531,SRX5716469,SMARCA4,328
chr1,940248,940481,SRX5075176,SMARCA4,233
chr1,940257,940488,SRX5075175,SMARCA4,231
chr1,940258,940551,SRX5075170,SMARCA4,293
chr1,940262,940453,SRX5075169,SMARCA4,191
chr1,941746,941969,SRX20140867,INTS10,223
chr1,941790,941974,SRX5075170,SMARCA4,184
chr1,941863,942075,SRX5075168,SMARCA4,212
chr1,951373,951679,SRX16500060,CTCF,306
chr1,951420,951729,SRX16500061,CTCF,309
chr1,951435,951790,SRX16500062,CTCF,355
chr1,951445,951758,SRX16500059,CTCF,313
chr1,959151,959417,SRX20140895,INTS13,266
chr1,959179,959426,SRX5075170,SMARCA4,247
chr1,959306,959498,SRX5075174,SMARCA4,192
chr1,960480,960697,SRX5075168,SMARCA4,217
chr1,966832,967085,SRX5716469,SMARCA4,253
chr1,966854,967125,SRX5075170,SMARCA4,271
chr1,966874,967185,SRX5075176,SMARCA4,311
chr1,966889,967099,SRX5054309,FOSL2,210
chr1,966974,967185,SRX5716470,SMARCA4,211
chr1,975950,976479,SRX16500060,CTCF,529
chr1,975958,976492,SRX16500061,CTCF,534
chr1,975974,976484,SRX16500062,CTCF,510
chr1,975977,976502,SRX16500059,CTCF,525
chr1,976050,976299,SRX5075174,SMARCA4,249
chr1,976112,976281,SRX5075170,SMARCA4,169
chr1,984068,984570,SRX16500062,CTCF,502
chr1,984088,984589,SRX16500061,CTCF,501
chr1,984095,984615,SRX16500060,CTCF,520
chr1,984095,984632,SRX16500059,CTCF,537
chr1,984172,984465,SRX5716470,SMARCA4,293
chr1,984181,984559,SRX4174629,CTCF,378
chr1,984207,984427,SRX5075168,SMARCA4,220
chr1,984230,984516,SRX5075174,SMARCA4,286
chr1,984237,984467,SRX5075175,SMARCA4,230
chr1,999717,1001067,SRX20140895,INTS13,1350
chr1,999773,1000395,SRX20140879,CPSF3L,622
chr1,999778,1000431,SRX20140881,CPSF3L,653
chr1,999791,1000861,SRX20140867,INTS10,1070
chr1,999827,1000806,SRX20140868,INTS10,979
chr1,999830,1000471,SRX20140896,INTS13,641
chr1,999843,1000544,SRX20140897,INTS13,701
chr1,999845,1000294,SRX20140880,CPSF3L,449
chr1,999944,1000867,SRX20140869,INTS10,923
chr1,999967,1000380,SRX5075176,SMARCA4,413
chr1,999984,1000347,SRX20140870,INTS10,363
chr1,1000006,1000403,SRX20140894,INTS13,397
chr1,1000009,1000290,SRX20140882,CPSF3L,281
chr1,1000042,1000408,SRX5716470,SMARCA4,366
chr1,1000079,1000401,SRX5075170,SMARCA4,322
chr1,1000090,1000464,SRX5075168,SMARCA4,374
chr1,1000118,1000373,SRX5075174,SMARCA4,255
chr1,1000218,1000411,SRX5075175,SMARCA4,193
chr1,1001755,1002283,SRX16500059,CTCF,528
chr1,1001799,1002327,SRX16500060,CTCF,528
chr1,1001800,1002246,SRX16500061,CTCF,446
chr1,1001805,1002241,SRX16500062,CTCF,436
chr1,1001817,1002100,SRX5075174,SMARCA4,283
chr1,1001870,1002099,SRX5075168,SMARCA4,229
chr1,1001890,1002109,SRX5075169,SMARCA4,219
chr1,1001892,1002104,SRX5075170,SMARCA4,212
chr1,1001906,1002121,SRX5075176,SMARCA4,215
chr1,1001996,1002251,SRX4174629,CTCF,255
chr1,1013084,1013497,SRX5075169,SMARCA4,413
chr1,1013172,1013572,SRX5075175,SMARCA4,400
chr1,1013193,1013405,SRX5716468,SMARCA2,212
chr1,1013193,1013614,SRX5716470,SMARCA4,421
chr1,1013202,1013711,SRX5075176,SMARCA4,509
chr1,1013214,1013653,SRX5075170,SMARCA4,439
chr1,1013222,1013744,SRX5716469,SMARCA4,522
chr1,1013252,1013588,SRX5075174,SMARCA4,336
chr1,1013273,1013488,SRX5716467,SMARCA2,215
chr1,1013310,1013571,SRX5075168,SMARCA4,261
chr1,1016236,1016280,SRX1424892,POU3F2,44
chr1,1016236,1016282,SRX1424891,POU3F2,46
chr1,1016236,1016282,SRX1424894,POU3F2,46
chr1,1016236,1016283,SRX1424893,POU3F2,47
chr1,1019131,1019439,SRX5054309,FOSL2,308
chr1,1019192,1019568,SRX16500059,CTCF,376
chr1,1019215,1019487,SRX16500060,CTCF,272
chr1,1019225,1019478,SRX16500061,CTCF,253
chr1,1019241,1020116,SRX5075168,SMARCA4,875
chr1,1019303,1019934,SRX5075170,SMARCA4,631
chr1,1019308,1019595,SRX5716463,SMARCA4,287
chr1,1019317,1020096,SRX5075174,SMARCA4,779
chr1,1019355,1019884,SRX5075176,SMARCA4,529
chr1,1019380,1019639,SRX5054307,FOSL2,259
chr1,1019521,1019955,SRX5716470,SMARCA4,434
chr1,1019553,1019974,SRX20140868,INTS10,421
chr1,1019554,1019953,SRX20140867,INTS10,399
chr1,1019554,1020395,SRX20140895,INTS13,841
chr1,1019637,1019921,SRX5075169,SMARCA4,284
chr1,1019644,1019867,SRX5075175,SMARCA4,223
chr1,1021128,1021394,SRX5075176,SMARCA4,266
chr1,1021225,1021396,SRX5075170,SMARCA4,171
chr1,1032840,1033301,SRX16500062,CTCF,461
chr1,1032877,1033359,SRX16500059,CTCF,482
chr1,1032890,1033330,SRX16500061,CTCF,440
chr1,1032896,1033334,SRX16500060,CTCF,438
chr1,1032911,1033270,SRX4174629,CTCF,359
chr1,1032973,1033294,SRX20140895,INTS13,321
chr1,1032977,1033390,SRX5075174,SMARCA4,413
chr1,1033023,1033377,SRX5075168,SMARCA4,354
chr1,1033116,1033379,SRX5716463,SMARCA4,263
chr1,1040636,1040867,SRX5716470,SMARCA4,231
chr1,1040652,1040918,SRX5075169,SMARCA4,266
chr1,1040659,1040919,SRX5716469,SMARCA4,260
chr1,1040669,1040941,SRX5075170,SMARCA4,272
chr1,1040704,1040927,SRX5075174,SMARCA4,223
chr1,1040710,1040923,SRX5075168,SMARCA4,213
chr1,1040710,1040928,SRX5075176,SMARCA4,218
chr1,1059244,1059569,SRX16500062,CTCF,325
chr1,1059244,1059574,SRX16500059,CTCF,330
chr1,1059251,1059597,SRX16500061,CTCF,346
chr1,1059255,1059583,SRX16500060,CTCF,328
chr1,1059382,1059705,SRX20140895,INTS13,323
chr1,1059413,1059696,SRX5075168,SMARCA4,283
chr1,1059419,1059782,SRX5075174,SMARCA4,363
chr1,1059525,1059789,SRX5054307,FOSL2,264
chr1,1063730,1064221,SRX16500062,CTCF,491
chr1,1063751,1064202,SRX16500060,CTCF,451
chr1,1063760,1064190,SRX16500059,CTCF,430
chr1,1063777,1064202,SRX16500061,CTCF,425
chr1,1064075,1064531,SRX5075170,SMARCA4,456
chr1,1064089,1064549,SRX5075169,SMARCA4,460
chr1,1064092,1064517,SRX5075176,SMARCA4,425
chr1,1064162,1064467,SRX5716467,SMARCA2,305
chr1,1064174,1064506,SRX5054309,FOSL2,332
chr1,1064196,1064530,SRX5075175,SMARCA4,334
chr1,1064197,1064504,SRX5054308,FOSL2,307
chr1,1064202,1064497,SRX5716470,SMARCA4,295
chr1,1064213,1064528,SRX5716469,SMARCA4,315
chr1,1064271,1064493,SRX5075174,SMARCA4,222
chr1,1069243,1069597,SRX5075168,SMARCA4,354
chr1,1069255,1069611,SRX5075174,SMARCA4,356
chr1,1069271,1069602,SRX20140895,INTS13,331
chr1,1079326,1079771,SRX20140869,INTS10,445
chr1,1079430,1079800,SRX5716470,SMARCA4,370
chr1,1079431,1079763,SRX20140895,INTS13,332
chr1,1079456,1079929,SRX20140897,INTS13,473
chr1,1079488,1080000,SRX5075169,SMARCA4,512
chr1,1079495,1079967,SRX5075170,SMARCA4,472
chr1,1079499,1079808,SRX5075176,SMARCA4,309
chr1,1079509,1079793,SRX5075175,SMARCA4,284
chr1,1079568,1079754,SRX5075168,SMARCA4,186
chr1,1079596,1079769,SRX5075174,SMARCA4,173
chr1,1080035,1080537,SRX20140895,INTS13,502
chr1,1080465,1080634,SRX5075170,SMARCA4,169
chr1,1080478,1080670,SRX5075176,SMARCA4,192
chr1,1115865,1116764,SRX20140895,INTS13,899
chr1,1115938,1116637,SRX5075174,SMARCA4,699
chr1,1116001,1116473,SRX20140879,CPSF3L,472
chr1,1116078,1116542,SRX5716464,SMARCA4,464
chr1,1116078,1116633,SRX5075168,SMARCA4,555
chr1,1116092,1116485,SRX5716456,SOX3,393
chr1,1116093,1116461,SRX20140869,INTS10,368
chr1,1116122,1116477,SRX5716451,SOX2,355
chr1,1116144,1116457,SRX5054307,FOSL2,313
chr1,1116174,1116514,SRX20140868,INTS10,340
chr1,1116190,1116419,SRX5716454,SOX3,229
chr1,1116190,1116555,SRX5716463,SMARCA4,365
chr1,1116197,1116595,SRX5075170,SMARCA4,398
chr1,1116296,1116724,SRX5075176,SMARCA4,428
chr1,1116346,1116828,SRX5075175,SMARCA4,482
chr1,1116384,1116600,SRX5075169,SMARCA4,216
chr1,1121984,1122573,SRX16500062,CTCF,589
chr1,1121994,1122494,SRX16500060,CTCF,500
chr1,1122009,1122498,SRX16500059,CTCF,489
chr1,1122054,1122520,SRX16500061,CTCF,466
chr1,1122114,1122386,SRX5075174,SMARCA4,272
chr1,1122207,1122445,SRX5075169,SMARCA4,238
chr1,1122212,1122446,SRX5075168,SMARCA4,234
chr1,1122232,1122412,SRX5075170,SMARCA4,180
chr1,1122240,1122455,SRX5075175,SMARCA4,215
chr1,1123417,1124328,SRX20140895,INTS13,911
chr1,1133397,1133622,SRX5075170,SMARCA4,225
chr1,1157810,1158371,SRX20140868,INTS10,561
chr1,1157958,1158486,SRX20140895,INTS13,528
chr1,1200965,1201171,SRX5075176,SMARCA4,206
chr1,1201316,1201673,SRX5075170,SMARCA4,357
chr1,1201345,1201665,SRX5075175,SMARCA4,320
chr1,1201377,1201737,SRX5075176,SMARCA4,360
chr1,1201381,1201733,SRX5075169,SMARCA4,352
chr1,1201402,1201707,SRX5054309,FOSL2,305
chr1,1201445,1201701,SRX5054308,FOSL2,256
chr1,1201449,1201661,SRX5716469,SMARCA4,212
chr1,1201452,1201667,SRX5716467,SMARCA2,215
chr1,1208024,1208316,SRX5054309,FOSL2,292
chr1,1208034,1208279,SRX5054308,FOSL2,245
chr1,1231524,1231818,SRX20140869,INTS10,294
chr1,1231673,1232441,SRX20140867,INTS10,768
chr1,1231688,1232312,SRX20140895,INTS13,624
chr1,1231689,1232168,SRX20140868,INTS10,479
chr1,1231708,1232213,SRX20140897,INTS13,505
chr1,1231731,1232007,SRX20140881,CPSF3L,276
chr1,1231788,1232119,SRX5075168,SMARCA4,331
chr1,1231825,1232248,SRX20140896,INTS13,423
chr1,1250053,1250549,SRX16500061,CTCF,496
chr1,1250084,1250520,SRX4174629,CTCF,436
chr1,1250087,1250575,SRX16500060,CTCF,488
chr1,1250175,1250559,SRX16500062,CTCF,384
chr1,1250175,1250611,SRX16500059,CTCF,436
chr1,1250192,1250479,SRX5075168,SMARCA4,287
chr1,1250209,1250415,SRX5075176,SMARCA4,206
chr1,1250211,1250522,SRX5075174,SMARCA4,311
chr1,1250233,1250439,SRX5075175,SMARCA4,206
chr1,1264806,1265169,SRX5075176,SMARCA4,363
chr1,1264808,1265299,SRX5075170,SMARCA4,491
chr1,1264815,1265252,SRX5075169,SMARCA4,437
chr1,1264837,1265185,SRX5716469,SMARCA4,348
chr1,1264837,1265252,SRX5075175,SMARCA4,415
chr1,1264849,1265171,SRX5054308,FOSL2,322
chr1,1264854,1265158,SRX5054309,FOSL2,304
chr1,1264854,1265310,SRX5716470,SMARCA4,456
chr1,1264901,1265116,SRX5716467,SMARCA2,215
chr1,1264927,1265212,SRX5716468,SMARCA2,285
chr1,1264945,1265298,SRX20140869,INTS10,353
chr1,1265061,1265297,SRX16500059,CTCF,236
chr1,1273610,1274311,SRX20140895,INTS13,701
chr1,1273640,1273816,SRX5075176,SMARCA4,176
chr1,1273686,1274189,SRX20140867,INTS10,503
chr1,1273729,1274241,SRX5075174,SMARCA4,512
chr1,1273777,1274294,SRX5075170,SMARCA4,517
chr1,1273830,1274202,SRX5075168,SMARCA4,372
chr1,1273868,1274266,SRX5075176,SMARCA4,398
chr1,1273952,1274159,SRX5075169,SMARCA4,207
chr1,1273970,1274292,SRX20140868,INTS10,322
chr1,1274040,1274255,SRX5075175,SMARCA4,215
chr1,1290225,1290497,SRX16500059,CTCF,272
chr1,1290276,1290543,SRX16500062,CTCF,267
chr1,1291797,1292258,SRX16500059,CTCF,461
chr1,1291808,1292270,SRX16500060,CTCF,462
chr1,1291827,1292233,SRX16500061,CTCF,406
chr1,1291868,1292281,SRX16500062,CTCF,413
chr1,1300042,1300404,SRX16500061,CTCF,362
chr1,1300096,1300371,SRX16500060,CTCF,275
chr1,1300097,1300327,SRX16500062,CTCF,230
chr1,1302093,1302328,SRX16500059,CTCF,235
chr1,1304688,1305092,SRX20140895,INTS13,404
chr1,1305600,1305880,SRX5054308,FOSL2,280
chr1,1305624,1305813,SRX5054309,FOSL2,189
chr1,1305670,1305884,SRX5075176,SMARCA4,214
chr1,1307772,1308066,SRX20140867,INTS10,294
chr1,1308060,1308396,SRX20140868,INTS10,336
chr1,1308101,1308530,SRX20140895,INTS13,429
chr1,1308309,1308488,SRX5075168,SMARCA4,179
chr1,1308453,1308768,SRX5075174,SMARCA4,315
chr1,1318158,1318640,SRX5075170,SMARCA4,482
chr1,1318195,1318577,SRX5075175,SMARCA4,382
chr1,1318231,1318612,SRX5075169,SMARCA4,381
chr1,1318237,1318614,SRX5075176,SMARCA4,377
chr1,1318240,1318689,SRX5716470,SMARCA4,449
chr1,1318245,1318562,SRX5054308,FOSL2,317
chr1,1318254,1318535,SRX5054309,FOSL2,281
chr1,1318259,1318632,SRX5716469,SMARCA4,373
chr1,1318268,1318513,SRX5020211,SMARCA2,245
chr1,1318270,1318573,SRX5716467,SMARCA2,303
chr1,1324466,1324672,SRX5716464,SMARCA4,206
chr1,1324492,1324703,SRX5075174,SMARCA4,211
chr1,1324529,1324965,SRX20140895,INTS13,436
chr1,1324552,1324914,SRX5075168,SMARCA4,362
chr1,1324666,1324861,SRX5054307,FOSL2,195
chr1,1349565,1349900,SRX20140895,INTS13,335
chr1,1349613,1349897,SRX5075170,SMARCA4,284
chr1,1349621,1349901,SRX5075176,SMARCA4,280
chr1,1349671,1350015,SRX16500060,CTCF,344
chr1,1349726,1350031,SRX16500061,CTCF,305
chr1,1349728,1350072,SRX16500059,CTCF,344
chr1,1349734,1350040,SRX16500062,CTCF,306
chr1,1359726,1360025,SRX5075176,SMARCA4,299
chr1,1359768,1359988,SRX5075170,SMARCA4,220
chr1,1360024,1360381,SRX20140895,INTS13,357
chr1,1360555,1360956,SRX5075175,SMARCA4,401
chr1,1360565,1360998,SRX5075176,SMARCA4,433
chr1,1360575,1360864,SRX5716470,SMARCA4,289
chr1,1360608,1360897,SRX5075170,SMARCA4,289
chr1,1360610,1360955,SRX5075169,SMARCA4,345
chr1,1360618,1360892,SRX5054309,FOSL2,274
chr1,1360618,1360960,SRX5020211,SMARCA2,342
chr1,1360619,1360881,SRX5054308,FOSL2,262
chr1,1360622,1360829,SRX5020214,SMARCA2,207
chr1,1360623,1361013,SRX5716469,SMARCA4,390
chr1,1360644,1360828,SRX5075168,SMARCA4,184
chr1,1360653,1360882,SRX5075181,SMARCA2,229
chr1,1360660,1360901,SRX5716467,SMARCA2,241
chr1,1372012,1372443,SRX16500059,CTCF,431
chr1,1372013,1372254,SRX5075170,SMARCA4,241
chr1,1372015,1372398,SRX16500060,CTCF,383
chr1,1372034,1372430,SRX16500062,CTCF,396
chr1,1372051,1372480,SRX16500061,CTCF,429
chr1,1374976,1375701,SRX20140895,INTS13,725
chr1,1375013,1375553,SRX5075168,SMARCA4,540
chr1,1375053,1375604,SRX20140868,INTS10,551
chr1,1375089,1375533,SRX20140867,INTS10,444
chr1,1375097,1375439,SRX20140897,INTS13,342
chr1,1375098,1375580,SRX5075170,SMARCA4,482
chr1,1375108,1375446,SRX20140879,CPSF3L,338
chr1,1375114,1375783,SRX20140869,INTS10,669
chr1,1375125,1375386,SRX20140881,CPSF3L,261
chr1,1375166,1375416,SRX20140894,INTS13,250
chr1,1375166,1375429,SRX5716463,SMARCA4,263
chr1,1375177,1375644,SRX5075174,SMARCA4,467
chr1,1375186,1375442,SRX5716454,SOX3,256
chr1,1375201,1375386,SRX5075169,SMARCA4,185
chr1,1375218,1375603,SRX5075176,SMARCA4,385
chr1,1375245,1375537,SRX5716469,SMARCA4,292
chr1,1375266,1375551,SRX5716456,SOX3,285
chr1,1375270,1375528,SRX5716451,SOX2,258
chr1,1375359,1375590,SRX5054309,FOSL2,231
chr1,1399058,1399717,SRX20140895,INTS13,659
chr1,1399121,1399499,SRX20140897,INTS13,378
chr1,1399135,1399663,SRX20140879,CPSF3L,528
chr1,1399150,1399610,SRX20140867,INTS10,460
chr1,1399207,1399721,SRX16500061,CTCF,514
chr1,1399212,1399591,SRX20140868,INTS10,379
chr1,1399226,1399780,SRX16500059,CTCF,554
chr1,1399275,1399794,SRX16500062,CTCF,519
chr1,1399296,1399807,SRX16500060,CTCF,511
chr1,1399320,1399532,SRX5054307,FOSL2,212
chr1,1399344,1399679,SRX5075168,SMARCA4,335
chr1,1399353,1399672,SRX20140869,INTS10,319
chr1,1399366,1399716,SRX5075174,SMARCA4,350
chr1,1401995,1402264,SRX16500060,CTCF,269
chr1,1402017,1402312,SRX16500059,CTCF,295
chr1,1402035,1402270,SRX16500061,CTCF,235
chr1,1407014,1407600,SRX20140895,INTS13,586
chr1,1407084,1407497,SRX5075168,SMARCA4,413
chr1,1407112,1407457,SRX20140867,INTS10,345
chr1,1407121,1407516,SRX20140869,INTS10,395
chr1,1407121,1407546,SRX5075170,SMARCA4,425
chr1,1407130,1407497,SRX5075176,SMARCA4,367
chr1,1407152,1407413,SRX20140897,INTS13,261
chr1,1407165,1407484,SRX20140868,INTS10,319
chr1,1407174,1407526,SRX5075174,SMARCA4,352
chr1,1422778,1422980,SRX5054309,FOSL2,202
chr1,1430347,1430734,SRX5075170,SMARCA4,387
chr1,1430410,1430759,SRX5075176,SMARCA4,349
chr1,1433029,1433692,SRX20140895,INTS13,663
chr1,1433043,1433631,SRX20140868,INTS10,588
chr1,1433070,1433399,SRX20140879,CPSF3L,329
chr1,1433079,1433435,SRX5075174,SMARCA4,356
chr1,1433843,1434125,SRX5075170,SMARCA4,282
chr1,1433856,1434152,SRX5075169,SMARCA4,296
chr1,1433888,1434164,SRX5054309,FOSL2,276
chr1,1433908,1434100,SRX5075176,SMARCA4,192
chr1,1433930,1434119,SRX5054308,FOSL2,189
chr1,1435503,1435751,SRX5075176,SMARCA4,248
chr1,1435566,1435870,SRX5075174,SMARCA4,304
chr1,1435617,1435818,SRX5075168,SMARCA4,201
chr1,1435627,1435818,SRX5075175,SMARCA4,191
chr1,1440907,1441288,SRX16500059,CTCF,381
chr1,1440909,1441281,SRX16500060,CTCF,372
chr1,1440937,1441237,SRX16500062,CTCF,300
chr1,1440940,1441268,SRX16500061,CTCF,328
chr1,1471291,1471638,SRX5075170,SMARCA4,347
chr1,1471347,1471973,SRX5075168,SMARCA4,626
chr1,1471430,1471892,SRX20140869,INTS10,462
chr1,1471485,1471986,SRX5075174,SMARCA4,501
chr1,1471494,1471876,SRX5716463,SMARCA4,382
chr1,1471510,1471939,SRX20140895,INTS13,429
chr1,1471838,1472025,SRX5075175,SMARCA4,187
chr1,1504804,1505800,SRX16500060,CTCF,996
chr1,1504814,1505300,SRX16500062,CTCF,486
chr1,1504827,1505855,SRX16500061,CTCF,1028
chr1,1504835,1505870,SRX16500059,CTCF,1035
chr1,1504871,1505139,SRX5075176,SMARCA4,268
chr1,1504890,1505176,SRX4174629,CTCF,286
chr1,1504893,1505230,SRX5075168,SMARCA4,337
chr1,1504894,1505171,SRX5075174,SMARCA4,277
chr1,1504923,1505188,SRX5075170,SMARCA4,265
chr1,1504951,1505166,SRX5075169,SMARCA4,215
chr1,1504959,1505180,SRX5075175,SMARCA4,221
chr1,1505100,1505719,SRX20140895,INTS13,619
chr1,1505364,1505800,SRX4174629,CTCF,436
chr1,1505427,1505638,SRX5716470,SMARCA4,211
chr1,1505427,1505872,SRX16500062,CTCF,445
chr1,1505439,1505759,SRX5075176,SMARCA4,320
chr1,1505448,1505723,SRX5075169,SMARCA4,275
chr1,1505507,1505793,SRX5075168,SMARCA4,286
chr1,1505549,1505766,SRX5075174,SMARCA4,217
chr1,1510917,1511242,SRX16500059,CTCF,325
chr1,1510986,1511207,SRX16500060,CTCF,221
chr1,1511526,1512120,SRX20140879,CPSF3L,594
chr1,1511530,1512056,SRX20140867,INTS10,526
chr1,1511534,1512291,SRX20140895,INTS13,757
chr1,1511634,1511986,SRX5075170,SMARCA4,352
chr1,1511649,1512137,SRX20140868,INTS10,488
chr1,1511714,1512234,SRX5075174,SMARCA4,520
chr1,1511732,1512062,SRX20140869,INTS10,330
chr1,1511814,1512048,SRX5716464,SMARCA4,234
chr1,1511825,1512102,SRX20140897,INTS13,277
chr1,1511835,1512225,SRX5075176,SMARCA4,390
chr1,1511858,1512224,SRX20140881,CPSF3L,366
chr1,1511884,1512172,SRX5054307,FOSL2,288
chr1,1511922,1512126,SRX5716463,SMARCA4,204
chr1,1512105,1512351,SRX5075168,SMARCA4,246
chr1,1540606,1540801,SRX5075176,SMARCA4,195
chr1,1551028,1551440,SRX16500060,CTCF,412
chr1,1551102,1551398,SRX16500062,CTCF,296
chr1,1551132,1551393,SRX16500059,CTCF,261
chr1,1551144,1551374,SRX16500061,CTCF,230
chr1,1554883,1555298,SRX5075174,SMARCA4,415
chr1,1554884,1555152,SRX5054308,FOSL2,268
chr1,1554900,1555127,SRX5054309,FOSL2,227
chr1,1554927,1555178,SRX5075168,SMARCA4,251
chr1,1554941,1555140,SRX5054307,FOSL2,199
chr1,1554996,1555372,SRX20140895,INTS13,376
chr1,1555016,1555222,SRX5716463,SMARCA4,206
chr1,1573857,1574260,SRX16500062,CTCF,403
chr1,1573864,1574245,SRX16500061,CTCF,381
chr1,1573888,1574100,SRX4174629,CTCF,212
chr1,1573901,1574439,SRX16500060,CTCF,538
chr1,1574004,1574251,SRX16500059,CTCF,247
chr1,1574213,1575161,SRX20140895,INTS13,948
chr1,1574242,1575081,SRX20140868,INTS10,839
chr1,1574243,1575163,SRX20140869,INTS10,920
chr1,1574356,1575004,SRX20140897,INTS13,648
chr1,1574471,1574936,SRX20140896,INTS13,465
chr1,1574474,1575113,SRX20140867,INTS10,639
chr1,1574668,1575062,SRX20140870,INTS10,394
chr1,1574711,1574886,SRX5075176,SMARCA4,175
chr1,1574716,1574953,SRX5075168,SMARCA4,237
chr1,1574745,1575032,SRX20140881,CPSF3L,287
chr1,1597673,1597977,SRX16500060,CTCF,304
chr1,1597742,1598005,SRX16500059,CTCF,263
chr1,1597753,1598028,SRX16500061,CTCF,275
chr1,1599511,1599737,SRX5075174,SMARCA4,226
chr1,1599530,1599759,SRX5075168,SMARCA4,229
chr1,1599593,1599771,SRX5075176,SMARCA4,178
chr1,1615071,1615660,SRX5075168,SMARCA4,589
chr1,1615159,1615575,SRX5075174,SMARCA4,416
chr1,1615218,1615466,SRX5716464,SMARCA4,248
chr1,1615255,1615837,SRX20140868,INTS10,582
chr1,1615306,1615925,SRX20140867,INTS10,619
chr1,1615344,1616118,SRX20140895,INTS13,774
chr1,1615347,1615775,SRX20140869,INTS10,428
chr1,1615394,1615783,SRX20140896,INTS13,389
chr1,1615399,1615776,SRX20140897,INTS13,377
chr1,1615455,1615755,SRX20140879,CPSF3L,300
chr1,1615468,1615760,SRX5716469,SMARCA4,292
chr1,1615471,1615719,SRX5075169,SMARCA4,248
chr1,1615491,1615804,SRX20140881,CPSF3L,313
chr1,1615542,1616043,SRX5075176,SMARCA4,501
chr1,1615549,1615768,SRX5716463,SMARCA4,219
chr1,1615653,1616086,SRX5075174,SMARCA4,433
chr1,1615742,1616030,SRX5075168,SMARCA4,288
chr1,1615891,1616076,SRX5075170,SMARCA4,185
chr1,1622281,1622561,SRX5054309,FOSL2,280
chr1,1622317,1622524,SRX5075170,SMARCA4,207
chr1,1631820,1632329,SRX5075176,SMARCA4,509
chr1,1631941,1632266,SRX5075170,SMARCA4,325
chr1,1644822,1645321,SRX16500059,CTCF,499
chr1,1644835,1645395,SRX16500060,CTCF,560
chr1,1644841,1645290,SRX16500061,CTCF,449
chr1,1644900,1645313,SRX16500062,CTCF,413
chr1,1658761,1659452,SRX20140869,INTS10,691
chr1,1658791,1659402,SRX20140868,INTS10,611
chr1,1658926,1659538,SRX20140895,INTS13,612
chr1,1658930,1659459,SRX20140867,INTS10,529
chr1,1658962,1659475,SRX20140897,INTS13,513
chr1,1659056,1659662,SRX16500060,CTCF,606
chr1,1659059,1659596,SRX5075168,SMARCA4,537
chr1,1659065,1659428,SRX5075176,SMARCA4,363
chr1,1659094,1659573,SRX5716463,SMARCA4,479
chr1,1659118,1659687,SRX16500062,CTCF,569
chr1,1659132,1659599,SRX16500061,CTCF,467
chr1,1659133,1659537,SRX5075174,SMARCA4,404
chr1,1659138,1659630,SRX16500059,CTCF,492
chr1,1659242,1659447,SRX5716464,SMARCA4,205
chr1,1659243,1659449,SRX5075169,SMARCA4,206
chr1,1659264,1659438,SRX5075170,SMARCA4,174
chr1,1659290,1659565,SRX4174629,CTCF,275
chr1,1659298,1659527,SRX5716470,SMARCA4,229
chr1,1662470,1662660,SRX5054309,FOSL2,190
chr1,1662470,1662669,SRX5075176,SMARCA4,199
chr1,1662475,1662691,SRX5075170,SMARCA4,216
chr1,1662488,1662668,SRX5075169,SMARCA4,180
chr1,1665655,1666083,SRX16500061,CTCF,428
chr1,1665672,1666085,SRX16500059,CTCF,413
chr1,1665680,1666035,SRX16500062,CTCF,355
chr1,1665731,1666101,SRX16500060,CTCF,370
chr1,1665745,1665942,SRX5075174,SMARCA4,197
chr1,1686185,1686705,SRX5716469,SMARCA4,520
chr1,1686190,1686741,SRX5075169,SMARCA4,551
chr1,1686208,1686662,SRX5054308,FOSL2,454
chr1,1686230,1686648,SRX5075170,SMARCA4,418
chr1,1686235,1686666,SRX5054309,FOSL2,431
chr1,1686241,1686712,SRX5716470,SMARCA4,471
chr1,1686243,1686632,SRX5075176,SMARCA4,389
chr1,1686261,1686638,SRX5075175,SMARCA4,377
chr1,1686347,1686647,SRX5716467,SMARCA2,300
chr1,1692289,1693815,SRX20140895,INTS13,1526
chr1,1692326,1693639,SRX20140868,INTS10,1313
chr1,1692374,1693523,SRX20140897,INTS13,1149
chr1,1692385,1693610,SRX20140867,INTS10,1225
chr1,1692433,1692724,SRX5075170,SMARCA4,291
chr1,1692452,1693673,SRX5075174,SMARCA4,1221
chr1,1692471,1693149,SRX20140869,INTS10,678
chr1,1692580,1693677,SRX5075168,SMARCA4,1097
chr1,1692643,1693050,SRX20140881,CPSF3L,407
chr1,1692759,1693008,SRX20140879,CPSF3L,249
chr1,1692799,1693562,SRX16500059,CTCF,763
chr1,1692857,1693071,SRX5716463,SMARCA4,214
chr1,1692875,1693576,SRX16500061,CTCF,701
chr1,1692917,1693574,SRX16500060,CTCF,657
chr1,1693000,1693600,SRX16500062,CTCF,600
chr1,1693113,1693611,SRX5075170,SMARCA4,498
chr1,1693127,1693450,SRX5716463,SMARCA4,323
chr1,1693137,1693317,SRX5075169,SMARCA4,180
chr1,1693137,1693638,SRX5075176,SMARCA4,501
chr1,1693146,1693653,SRX5075175,SMARCA4,507
chr1,1693177,1693688,SRX5716470,SMARCA4,511
chr1,1693178,1693548,SRX5716464,SMARCA4,370
chr1,1693180,1693479,SRX5716451,SOX2,299
chr1,1693192,1693438,SRX5020214,SMARCA2,246
chr1,1693203,1693467,SRX5716469,SMARCA4,264
chr1,1693203,1693620,SRX20140869,INTS10,417
chr1,1693218,1693797,SRX20140879,CPSF3L,579
chr1,1693236,1693419,SRX5054309,FOSL2,183
chr1,1693333,1693759,SRX20140881,CPSF3L,426
chr1,1693525,1693705,SRX5075169,SMARCA4,180
chr1,1700568,1700896,SRX5716470,SMARCA4,328
chr1,1700680,1700895,SRX5075175,SMARCA4,215
chr1,1700698,1700889,SRX5075170,SMARCA4,191
chr1,1712002,1712420,SRX16500060,CTCF,418
chr1,1712011,1712430,SRX16500059,CTCF,419
chr1,1712060,1712396,SRX16500061,CTCF,336
chr1,1712079,1712405,SRX16500062,CTCF,326
chr1,1724187,1724864,SRX20140895,INTS13,677
chr1,1724203,1724899,SRX20140869,INTS10,696
chr1,1724242,1724779,SRX20140867,INTS10,537
chr1,1724260,1724728,SRX20140868,INTS10,468
chr1,1724326,1724880,SRX5075174,SMARCA4,554
chr1,1724340,1724597,SRX5716451,SOX2,257
chr1,1724350,1724881,SRX5075168,SMARCA4,531
chr1,1724368,1724789,SRX5075176,SMARCA4,421
chr1,1724390,1724800,SRX20140897,INTS13,410
chr1,1724413,1724841,SRX5716463,SMARCA4,428
chr1,1724420,1725021,SRX16500059,CTCF,601
chr1,1724432,1724801,SRX20140879,CPSF3L,369
chr1,1724435,1724976,SRX16500060,CTCF,541
chr1,1724452,1724931,SRX16500061,CTCF,479
chr1,1724465,1724958,SRX16500062,CTCF,493
chr1,1724484,1724870,SRX5716470,SMARCA4,386
chr1,1724505,1724777,SRX5075169,SMARCA4,272
chr1,1724508,1724750,SRX5716469,SMARCA4,242
chr1,1724513,1724779,SRX20140881,CPSF3L,266
chr1,1724552,1724780,SRX5716464,SMARCA4,228
chr1,1724561,1724748,SRX5075175,SMARCA4,187
chr1,1724561,1724819,SRX5075170,SMARCA4,258
chr1,1724592,1724887,SRX4174629,CTCF,295
chr1,1728323,1728628,SRX5075170,SMARCA4,305
chr1,1728362,1728633,SRX5054309,FOSL2,271
chr1,1728372,1728597,SRX5075176,SMARCA4,225
chr1,1728389,1728583,SRX5075169,SMARCA4,194
chr1,1728423,1728635,SRX5716469,SMARCA4,212
chr1,1741114,1741297,SRX5054309,FOSL2,183
chr1,1741146,1741326,SRX5054308,FOSL2,180
chr1,1745632,1747092,SRX20140895,INTS13,1460
chr1,1745716,1746889,SRX20140867,INTS10,1173
chr1,1745722,1745974,SRX20140897,INTS13,252
chr1,1745738,1746992,SRX20140868,INTS10,1254
chr1,1746000,1746958,SRX20140869,INTS10,958
chr1,1746022,1747079,SRX20140879,CPSF3L,1057
chr1,1746106,1746976,SRX20140897,INTS13,870
chr1,1746124,1747044,SRX20140881,CPSF3L,920
chr1,1746139,1746934,SRX5075168,SMARCA4,795
chr1,1746145,1746430,SRX20140896,INTS13,285
chr1,1746158,1746970,SRX5075174,SMARCA4,812
chr1,1746181,1746386,SRX5716464,SMARCA4,205
chr1,1746221,1746847,SRX16500060,CTCF,626
chr1,1746238,1746820,SRX16500061,CTCF,582
chr1,1746273,1746961,SRX5075170,SMARCA4,688
chr1,1746275,1746852,SRX16500062,CTCF,577
chr1,1746363,1746680,SRX5716453,SOX2,317
chr1,1746371,1746902,SRX16500059,CTCF,531
chr1,1746441,1746674,SRX5716463,SMARCA4,233
chr1,1746444,1746933,SRX5075176,SMARCA4,489
chr1,1746460,1746795,SRX5716464,SMARCA4,335
chr1,1746464,1746693,SRX5716451,SOX2,229
chr1,1746483,1746691,SRX5075169,SMARCA4,208
chr1,1746489,1746734,SRX5716470,SMARCA4,245
chr1,1746499,1746847,SRX5075175,SMARCA4,348
chr1,1746508,1746709,SRX5020211,SMARCA2,201
chr1,1778232,1778927,SRX20140895,INTS13,695
chr1,1778861,1779241,SRX16500059,CTCF,380
chr1,1778884,1779209,SRX16500060,CTCF,325
chr1,1779039,1779329,SRX16500062,CTCF,290
chr1,1827243,1827487,SRX5075168,SMARCA4,244
chr1,1858807,1858989,SRX5075170,SMARCA4,182
chr1,1858818,1859001,SRX5075176,SMARCA4,183
chr1,1860145,1860368,SRX5075176,SMARCA4,223
chr1,1889884,1890333,SRX20140895,INTS13,449
chr1,1890080,1890405,SRX20140868,INTS10,325
chr1,1890893,1891268,SRX20140895,INTS13,375
chr1,1890920,1891232,SRX20140867,INTS10,312
chr1,1891034,1891283,SRX5075176,SMARCA4,249
chr1,1891036,1891324,SRX5075174,SMARCA4,288
chr1,1891051,1891334,SRX5075169,SMARCA4,283
chr1,1891062,1891270,SRX5075170,SMARCA4,208
chr1,1891082,1891350,SRX5075168,SMARCA4,268
chr1,1906165,1906585,SRX16500062,CTCF,420
chr1,1906191,1906619,SRX16500060,CTCF,428
chr1,1906204,1906610,SRX16500061,CTCF,406
chr1,1906212,1906553,SRX16500059,CTCF,341
chr1,1906232,1906494,SRX5075168,SMARCA4,262
chr1,1906239,1906517,SRX5075174,SMARCA4,278
chr1,1906243,1906447,SRX5075169,SMARCA4,204
chr1,1906255,1906566,SRX4174629,CTCF,311
chr1,1906262,1906484,SRX5075170,SMARCA4,222
chr1,1908719,1909289,SRX5716470,SMARCA4,570
chr1,1908784,1909249,SRX5075175,SMARCA4,465
chr1,1908792,1909566,SRX20140895,INTS13,774
chr1,1908799,1909193,SRX5716469,SMARCA4,394
chr1,1908825,1909499,SRX5075169,SMARCA4,674
chr1,1908839,1909208,SRX20140868,INTS10,369
chr1,1908841,1909321,SRX5075176,SMARCA4,480
chr1,1908848,1909456,SRX5075174,SMARCA4,608
chr1,1908875,1909452,SRX5075170,SMARCA4,577
chr1,1908891,1909458,SRX20140897,INTS13,567
chr1,1908894,1909399,SRX16500059,CTCF,505
chr1,1908907,1909306,SRX16500060,CTCF,399
chr1,1908944,1909317,SRX16500062,CTCF,373
chr1,1908946,1909474,SRX5075168,SMARCA4,528
chr1,1908964,1909191,SRX20140867,INTS10,227
chr1,1908971,1909315,SRX16500061,CTCF,344
chr1,1909159,1909368,SRX5054307,FOSL2,209
chr1,1918887,1919740,SRX20140895,INTS13,853
chr1,1919009,1919396,SRX20140867,INTS10,387
chr1,1919027,1919340,SRX20140881,CPSF3L,313
chr1,1919034,1919339,SRX20140879,CPSF3L,305
chr1,1919080,1919351,SRX5075169,SMARCA4,271
chr1,1919080,1919400,SRX20140868,INTS10,320
chr1,1919107,1919772,SRX5075168,SMARCA4,665
chr1,1919121,1919773,SRX5075170,SMARCA4,652
chr1,1919133,1919821,SRX5075174,SMARCA4,688
chr1,1919213,1919750,SRX5716463,SMARCA4,537
chr1,1919224,1919701,SRX5054307,FOSL2,477
chr1,1919259,1919723,SRX5716451,SOX2,464
chr1,1919259,1919819,SRX5075176,SMARCA4,560
chr1,1919312,1919658,SRX5716454,SOX3,346
chr1,1919337,1919547,SRX5054309,FOSL2,210
chr1,1919364,1919782,SRX5716464,SMARCA4,418
chr1,1919398,1919613,SRX5054308,FOSL2,215
chr1,1943875,1944510,SRX16500059,CTCF,635
chr1,1943906,1944426,SRX16500061,CTCF,520
chr1,1943930,1944463,SRX16500060,CTCF,533
chr1,1943960,1944437,SRX16500062,CTCF,477
chr1,1944039,1944374,SRX5075174,SMARCA4,335
chr1,1944044,1944289,SRX4174629,CTCF,245
chr1,1944082,1944313,SRX5716464,SMARCA4,231
chr1,1944090,1944416,SRX5075168,SMARCA4,326
chr1,1954789,1955122,SRX16500060,CTCF,333
chr1,1954818,1955166,SRX16500061,CTCF,348
chr1,1954860,1955095,SRX16500059,CTCF,235
chr1,1959841,1960344,SRX5075174,SMARCA4,503
chr1,1959874,1960209,SRX5075176,SMARCA4,335
chr1,1959984,1960447,SRX16500060,CTCF,463
chr1,1960004,1960427,SRX16500062,CTCF,423
chr1,1960004,1960518,SRX16500061,CTCF,514
chr1,1960007,1960485,SRX16500059,CTCF,478
chr1,1960063,1960426,SRX4174629,CTCF,363
chr1,1960075,1960287,SRX5716469,SMARCA4,212
chr1,1960086,1960388,SRX5075168,SMARCA4,302
chr1,1994548,1994950,SRX5075168,SMARCA4,402
chr1,2003584,2004024,SRX5075174,SMARCA4,440
chr1,2003615,2004162,SRX20140895,INTS13,547
chr1,2003627,2004066,SRX5075168,SMARCA4,439
chr1,2003630,2003895,SRX5716463,SMARCA4,265
chr1,2003742,2003947,SRX5716464,SMARCA4,205
chr1,2019506,2019756,SRX5075169,SMARCA4,250
chr1,2019542,2019764,SRX5075175,SMARCA4,222
chr1,2044709,2045210,SRX16500060,CTCF,501
chr1,2044730,2045212,SRX16500059,CTCF,482
chr1,2044758,2045201,SRX16500061,CTCF,443
chr1,2044788,2045203,SRX16500062,CTCF,415
chr1,2044805,2045072,SRX5716470,SMARCA4,267
chr1,2044806,2045049,SRX5716464,SMARCA4,243
chr1,2044811,2045101,SRX5075168,SMARCA4,290
chr1,2044822,2045144,SRX5075174,SMARCA4,322
chr1,2044825,2045132,SRX5075170,SMARCA4,307
chr1,2044834,2045117,SRX5075176,SMARCA4,283
chr1,2044843,2045095,SRX5075175,SMARCA4,252
chr1,2044856,2045153,SRX5075169,SMARCA4,297
chr1,2046499,2046767,SRX16500061,CTCF,268
chr1,2046505,2046808,SRX16500060,CTCF,303
chr1,2046514,2046779,SRX16500062,CTCF,265
chr1,2046526,2046838,SRX16500059,CTCF,312
chr1,2049480,2049704,SRX16500062,CTCF,224
chr1,2073469,2073826,SRX5075174,SMARCA4,357
chr1,2073470,2074116,SRX20140895,INTS13,646
chr1,2073472,2073879,SRX5075168,SMARCA4,407
chr1,2073568,2074035,SRX20140868,INTS10,467
chr1,2091592,2091909,SRX16500061,CTCF,317
chr1,2091657,2092006,SRX16500059,CTCF,349
chr1,2091666,2091982,SRX16500060,CTCF,316
chr1,2091674,2091922,SRX16500062,CTCF,248
chr1,2108599,2109011,SRX16500062,CTCF,412
chr1,2108609,2109043,SRX16500060,CTCF,434
chr1,2108614,2108965,SRX16500061,CTCF,351
chr1,2108650,2108927,SRX5075174,SMARCA4,277
chr1,2108661,2109083,SRX16500059,CTCF,422
chr1,2115962,2116416,SRX5075168,SMARCA4,454
chr1,2115967,2116421,SRX5075174,SMARCA4,454
chr1,2128361,2128612,SRX5075174,SMARCA4,251
chr1,2128397,2128584,SRX5075168,SMARCA4,187
chr1,2132248,2132559,SRX16500059,CTCF,311
chr1,2132253,2132541,SRX16500061,CTCF,288
chr1,2132276,2132617,SRX16500060,CTCF,341
chr1,2132322,2132568,SRX16500062,CTCF,246
chr1,2133106,2133436,SRX5075176,SMARCA4,330
chr1,2133146,2133400,SRX5075170,SMARCA4,254
chr1,2133149,2133409,SRX5075168,SMARCA4,260
chr1,2133196,2133401,SRX5075174,SMARCA4,205
chr1,2133215,2133506,SRX5054307,FOSL2,291
chr1,2135363,2135828,SRX20140895,INTS13,465
chr1,2135400,2135677,SRX5716464,SMARCA4,277
chr1,2135413,2135852,SRX5075174,SMARCA4,439
chr1,2135445,2135761,SRX20140867,INTS10,316
chr1,2135447,2135867,SRX5075168,SMARCA4,420
chr1,2135489,2135880,SRX5716463,SMARCA4,391
chr1,2135493,2135776,SRX20140868,INTS10,283
chr1,2135509,2135869,SRX5075170,SMARCA4,360
chr1,2135519,2135770,SRX5716468,SMARCA2,251
chr1,2135519,2135901,SRX5716470,SMARCA4,382
chr1,2135557,2135818,SRX5075176,SMARCA4,261
chr1,2135565,2135850,SRX5716469,SMARCA4,285
chr1,2135583,2135877,SRX5716467,SMARCA2,294
chr1,2139744,2140268,SRX4174629,CTCF,524
chr1,2139773,2140338,SRX16500059,CTCF,565
chr1,2139788,2140346,SRX16500061,CTCF,558
chr1,2139794,2140297,SRX16500060,CTCF,503
chr1,2139810,2140272,SRX16500062,CTCF,462
chr1,2140040,2140326,SRX5075176,SMARCA4,286
chr1,2140060,2140292,SRX5075170,SMARCA4,232
chr1,2140080,2140360,SRX5075175,SMARCA4,280
chr1,2140080,2140389,SRX5054309,FOSL2,309
chr1,2140097,2140357,SRX5075169,SMARCA4,260
chr1,2140098,2140325,SRX5716470,SMARCA4,227
chr1,2140104,2140335,SRX5054308,FOSL2,231
chr1,2140117,2140346,SRX5716469,SMARCA4,229
chr1,2174169,2174724,SRX16500059,CTCF,555
chr1,2174205,2174818,SRX16500061,CTCF,613
chr1,2174220,2174917,SRX16500062,CTCF,697
chr1,2174239,2174776,SRX16500060,CTCF,537
chr1,2174288,2174612,SRX5075174,SMARCA4,324
chr1,2174309,2174510,SRX5075168,SMARCA4,201
chr1,2174325,2174671,SRX4174629,CTCF,346
chr1,2174340,2174558,SRX5716470,SMARCA4,218
chr1,2189384,2189869,SRX5075168,SMARCA4,485
chr1,2189410,2189850,SRX5075174,SMARCA4,440
chr1,2189532,2189773,SRX5075170,SMARCA4,241
chr1,2189555,2190028,SRX20140895,INTS13,473
chr1,2189557,2189833,SRX5075176,SMARCA4,276
chr1,2194580,2195317,SRX20140895,INTS13,737
chr1,2194907,2195464,SRX5075174,SMARCA4,557
chr1,2194948,2195429,SRX5075176,SMARCA4,481
chr1,2194999,2195502,SRX5075170,SMARCA4,503
chr1,2195011,2195602,SRX16500060,CTCF,591
chr1,2195018,2195596,SRX16500059,CTCF,578
chr1,2195047,2195353,SRX5716470,SMARCA4,306
chr1,2195064,2195454,SRX5075169,SMARCA4,390
chr1,2195071,2195509,SRX4174629,CTCF,438
chr1,2195111,2195570,SRX16500062,CTCF,459
chr1,2195125,2195413,SRX5075175,SMARCA4,288
chr1,2195132,2195569,SRX16500061,CTCF,437
chr1,2195215,2195435,SRX5075168,SMARCA4,220
chr1,2204636,2204872,SRX5075174,SMARCA4,236
chr1,2205262,2205541,SRX5075168,SMARCA4,279
chr1,2205299,2205476,SRX5075174,SMARCA4,177
chr1,2208295,2208505,SRX5075175,SMARCA4,210
chr1,2208295,2208545,SRX5075169,SMARCA4,250
chr1,2208325,2208558,SRX5075170,SMARCA4,233
chr1,2208381,2208573,SRX5075176,SMARCA4,192
chr1,2212341,2213002,SRX5075169,SMARCA4,661
chr1,2212342,2212959,SRX5075170,SMARCA4,617
chr1,2212366,2212961,SRX5075168,SMARCA4,595
chr1,2212380,2213029,SRX5716469,SMARCA4,649
chr1,2212386,2212779,SRX5020211,SMARCA2,393
chr1,2212388,2213020,SRX5075174,SMARCA4,632
chr1,2212396,2213082,SRX5716470,SMARCA4,686
chr1,2212409,2213090,SRX5075176,SMARCA4,681
chr1,2212423,2212985,SRX5075175,SMARCA4,562
chr1,2212446,2212764,SRX5716467,SMARCA2,318
chr1,2212520,2212704,SRX5054309,FOSL2,184
chr1,2212549,2212789,SRX5716464,SMARCA4,240
chr1,2212576,2213123,SRX20140895,INTS13,547
chr1,2212655,2213112,SRX20140869,INTS10,457
chr1,2212663,2213000,SRX20140897,INTS13,337
chr1,2212691,2212961,SRX20140879,CPSF3L,270
chr1,2212726,2213081,SRX20140868,INTS10,355
chr1,2227414,2227914,SRX5075168,SMARCA4,500
chr1,2227445,2227750,SRX5716470,SMARCA4,305
chr1,2227462,2227800,SRX5075169,SMARCA4,338
chr1,2227466,2227700,SRX16500060,CTCF,234
chr1,2227470,2227875,SRX5075176,SMARCA4,405
chr1,2227483,2227938,SRX5075174,SMARCA4,455
chr1,2227502,2227882,SRX5075170,SMARCA4,380
chr1,2227510,2227711,SRX5075175,SMARCA4,201
chr1,2227588,2227918,SRX5716463,SMARCA4,330
chr1,2227673,2227947,SRX5716454,SOX3,274
chr1,2227675,2227919,SRX5716464,SMARCA4,244
chr1,2227841,2228150,SRX20140867,INTS10,309
chr1,2246154,2246329,SRX5075176,SMARCA4,175
chr1,2246177,2246573,SRX5075169,SMARCA4,396
chr1,2246210,2246642,SRX5075175,SMARCA4,432
chr1,2246347,2246574,SRX5716470,SMARCA4,227
chr1,2246427,2246644,SRX5075170,SMARCA4,217
chr1,2246431,2246730,SRX5075176,SMARCA4,299
chr1,2248093,2248666,SRX20140868,INTS10,573
chr1,2248101,2248705,SRX20140895,INTS13,604
chr1,2248150,2248716,SRX5075174,SMARCA4,566
chr1,2248271,2248637,SRX20140867,INTS10,366
chr1,2248288,2248800,SRX5075168,SMARCA4,512
chr1,2248291,2248551,SRX5716451,SOX2,260
chr1,2248308,2248612,SRX5716464,SMARCA4,304
chr1,2248327,2248614,SRX5716454,SOX3,287
chr1,2248347,2248551,SRX5716463,SMARCA4,204
chr1,2248360,2248620,SRX20140860,SOX2,260
chr1,2248380,2248635,SRX20140879,CPSF3L,255
chr1,2270293,2270769,SRX20140895,INTS13,476
chr1,2270340,2270610,SRX20140868,INTS10,270
chr1,2270358,2270551,SRX5075174,SMARCA4,193
chr1,2270440,2270681,SRX20140867,INTS10,241
chr1,2270939,2272271,SRX20140895,INTS13,1332
chr1,2271265,2271726,SRX5075168,SMARCA4,461
chr1,2271329,2271698,SRX5075174,SMARCA4,369
chr1,2271340,2272212,SRX20140868,INTS10,872
chr1,2271419,2271825,SRX5716463,SMARCA4,406
chr1,2271543,2271782,SRX20140867,INTS10,239
chr1,2271809,2272352,SRX5075168,SMARCA4,543
chr1,2271923,2272266,SRX5075174,SMARCA4,343
chr1,2279197,2279788,SRX5075174,SMARCA4,591
chr1,2279227,2279692,SRX5716470,SMARCA4,465
chr1,2279233,2279756,SRX5075170,SMARCA4,523
chr1,2279236,2279721,SRX5075176,SMARCA4,485
chr1,2279249,2279717,SRX5716467,SMARCA2,468
chr1,2279259,2279712,SRX5075175,SMARCA4,453
chr1,2279285,2279599,SRX5716463,SMARCA4,314
chr1,2279295,2279796,SRX5075169,SMARCA4,501
chr1,2279305,2279629,SRX5716468,SMARCA2,324
chr1,2279306,2279709,SRX5716469,SMARCA4,403
chr1,2279317,2279730,SRX5075168,SMARCA4,413
chr1,2279318,2279597,SRX5020211,SMARCA2,279
chr1,2279364,2279612,SRX5020214,SMARCA2,248
chr1,2279376,2279577,SRX5075182,SMARCA2,201
chr1,2279393,2279598,SRX5716464,SMARCA4,205
chr1,2280282,2280322,SRX1424894,POU3F2,40
chr1,2280282,2280323,SRX1424891,POU3F2,41
chr1,2290669,2291122,SRX5075176,SMARCA4,453
chr1,2290715,2291029,SRX5716470,SMARCA4,314
chr1,2290725,2291061,SRX5075169,SMARCA4,336
chr1,2290761,2291109,SRX5075170,SMARCA4,348
chr1,2290767,2290999,SRX5054308,FOSL2,232
chr1,2290770,2290975,SRX5054309,FOSL2,205
chr1,2290791,2291125,SRX5716469,SMARCA4,334
chr1,2290848,2291078,SRX5075175,SMARCA4,230
chr1,2311521,2311770,SRX16500061,CTCF,249
chr1,2311527,2311810,SRX16500059,CTCF,283
chr1,2311567,2311807,SRX16500062,CTCF,240
chr1,2314350,2314562,SRX5075168,SMARCA4,212
chr1,2314364,2314680,SRX5075174,SMARCA4,316
chr1,2314409,2314591,SRX5075170,SMARCA4,182
chr1,2314476,2314656,SRX5075169,SMARCA4,180
chr1,2314819,2315329,SRX5075170,SMARCA4,510
chr1,2314922,2315355,SRX5075176,SMARCA4,433
chr1,2315010,2315583,SRX16500059,CTCF,573
chr1,2315040,2315579,SRX16500060,CTCF,539
chr1,2315066,2315544,SRX16500061,CTCF,478
chr1,2315073,2315419,SRX5075168,SMARCA4,346
chr1,2315079,2315535,SRX16500062,CTCF,456
chr1,2321987,2322762,SRX5075169,SMARCA4,775
chr1,2322008,2322569,SRX5716463,SMARCA4,561
chr1,2322011,2322618,SRX5075170,SMARCA4,607
chr1,2322014,2322814,SRX5716469,SMARCA4,800
chr1,2322019,2322666,SRX5075175,SMARCA4,647
chr1,2322024,2322557,SRX5075174,SMARCA4,533
chr1,2322025,2322690,SRX5716470,SMARCA4,665
chr1,2322032,2322601,SRX5075176,SMARCA4,569
chr1,2322059,2322436,SRX5020211,SMARCA2,377
chr1,2322075,2322550,SRX5716468,SMARCA2,475
chr1,2322078,2322628,SRX5716467,SMARCA2,550
chr1,2322090,2322570,SRX5075181,SMARCA2,480
chr1,2322098,2322517,SRX20140869,INTS10,419
chr1,2322141,2322594,SRX5716464,SMARCA4,453
chr1,2322142,2322620,SRX5075168,SMARCA4,478
chr1,2322157,2322405,SRX5054309,FOSL2,248
chr1,2322187,2322552,SRX20140895,INTS13,365
chr1,2322208,2322478,SRX5075182,SMARCA2,270
chr1,2322215,2322556,SRX20140897,INTS13,341
chr1,2322240,2322524,SRX20140868,INTS10,284
chr1,2330728,2331134,SRX5075175,SMARCA4,406
chr1,2330754,2331109,SRX5075168,SMARCA4,355
chr1,2330780,2331169,SRX5075176,SMARCA4,389
chr1,2330791,2331230,SRX5075174,SMARCA4,439
chr1,2330792,2331010,SRX5716469,SMARCA4,218
chr1,2330855,2331170,SRX5075170,SMARCA4,315
chr1,2381682,2382192,SRX16500060,CTCF,510
chr1,2381708,2382236,SRX16500061,CTCF,528
chr1,2381715,2381926,SRX5716470,SMARCA4,211
chr1,2381719,2381998,SRX5075176,SMARCA4,279
chr1,2381724,2382110,SRX4174629,CTCF,386
chr1,2381725,2381997,SRX5075170,SMARCA4,272
chr1,2381728,2382198,SRX16500059,CTCF,470
chr1,2381744,2382170,SRX16500062,CTCF,426
chr1,2381772,2382027,SRX5075168,SMARCA4,255
chr1,2381790,2382020,SRX5075174,SMARCA4,230
chr1,2382507,2382939,SRX16500062,CTCF,432
chr1,2382575,2382949,SRX16500060,CTCF,374
chr1,2382601,2382965,SRX16500059,CTCF,364
chr1,2382650,2382963,SRX16500061,CTCF,313
chr1,2391058,2391337,SRX20140868,INTS10,279
chr1,2391170,2391888,SRX20140895,INTS13,718
chr1,2391222,2391825,SRX20140869,INTS10,603
chr1,2391296,2391837,SRX20140867,INTS10,541
chr1,2391309,2391611,SRX5716470,SMARCA4,302
chr1,2391310,2391727,SRX20140897,INTS13,417
chr1,2391399,2392036,SRX5075174,SMARCA4,637
chr1,2391461,2391972,SRX5075170,SMARCA4,511
chr1,2391474,2392014,SRX5075168,SMARCA4,540
chr1,2391505,2391765,SRX5716463,SMARCA4,260
chr1,2391508,2391875,SRX20140868,INTS10,367
chr1,2391531,2391832,SRX5716464,SMARCA4,301
chr1,2391539,2391946,SRX5075176,SMARCA4,407
chr1,2391573,2391782,SRX5716454,SOX3,209
chr1,2391611,2391870,SRX5054307,FOSL2,259
chr1,2405855,2406039,SRX5075169,SMARCA4,184
chr1,2412306,2412742,SRX20140867,INTS10,436
chr1,2412350,2412931,SRX5075174,SMARCA4,581
chr1,2412369,2413046,SRX20140895,INTS13,677
chr1,2412373,2412897,SRX5075168,SMARCA4,524
chr1,2412449,2412921,SRX5075170,SMARCA4,472
chr1,2412457,2412829,SRX20140868,INTS10,372
chr1,2412496,2412843,SRX5716464,SMARCA4,347
chr1,2412498,2412815,SRX20140869,INTS10,317
chr1,2412511,2412849,SRX5075176,SMARCA4,338
chr1,2412538,2412748,SRX5054307,FOSL2,210
chr1,2412606,2412844,SRX5716470,SMARCA4,238
chr1,2412743,2412961,SRX5075169,SMARCA4,218
chr1,2414252,2414807,SRX16500059,CTCF,555
chr1,2414261,2414823,SRX16500061,CTCF,562
chr1,2414281,2414780,SRX16500062,CTCF,499
chr1,2414285,2414765,SRX16500060,CTCF,480
chr1,2414347,2414763,SRX4174629,CTCF,416
chr1,2430110,2430347,SRX16500059,CTCF,237
chr1,2430110,2430348,SRX16500060,CTCF,238
chr1,2432383,2432711,SRX5075168,SMARCA4,328
chr1,2446333,2446665,SRX5075174,SMARCA4,332
chr1,2446444,2446797,SRX5075168,SMARCA4,353
chr1,2446452,2446736,SRX20140895,INTS13,284
chr1,2451732,2452081,SRX5075175,SMARCA4,349
chr1,2451763,2451978,SRX5075170,SMARCA4,215
chr1,2451763,2451996,SRX5075169,SMARCA4,233
chr1,2451787,2451982,SRX5054309,FOSL2,195
chr1,2467351,2467538,SRX5075168,SMARCA4,187
chr1,2474050,2474427,SRX20140895,INTS13,377
chr1,2526561,2527109,SRX20140895,INTS13,548
chr1,2526660,2526871,SRX5075168,SMARCA4,211
chr1,2526673,2526934,SRX20140868,INTS10,261
chr1,2529965,2530635,SRX20140895,INTS13,670
chr1,2530048,2530500,SRX20140879,CPSF3L,452
chr1,2530090,2530673,SRX20140868,INTS10,583
chr1,2530096,2530463,SRX20140867,INTS10,367
chr1,2530156,2530498,SRX20140880,CPSF3L,342
chr1,2530271,2530683,SRX5075168,SMARCA4,412
chr1,2530281,2530519,SRX5716451,SOX2,238
chr1,2530295,2530667,SRX5075174,SMARCA4,372
chr1,2532603,2533071,SRX20140895,INTS13,468
chr1,2532624,2533090,SRX20140868,INTS10,466
chr1,2532754,2533008,SRX20140880,CPSF3L,254
chr1,2539266,2539607,SRX16500059,CTCF,341
chr1,2539346,2539609,SRX16500061,CTCF,263
chr1,2539376,2539698,SRX16500062,CTCF,322
chr1,2540601,2541165,SRX20140895,INTS13,564
chr1,2540664,2541211,SRX20140868,INTS10,547
chr1,2540732,2541110,SRX20140880,CPSF3L,378
chr1,2540771,2541106,SRX20140867,INTS10,335
chr1,2540790,2541088,SRX20140879,CPSF3L,298
chr1,2540828,2541191,SRX5075174,SMARCA4,363
chr1,2543689,2544075,SRX20140868,INTS10,386
chr1,2543707,2544054,SRX20140895,INTS13,347
chr1,2545998,2546759,SRX20140895,INTS13,761
chr1,2546283,2546485,SRX5075174,SMARCA4,202
chr1,2546306,2546657,SRX20140868,INTS10,351
chr1,2546322,2546597,SRX20140867,INTS10,275
chr1,2546324,2546753,SRX20140879,CPSF3L,429
chr1,2547891,2548482,SRX16500059,CTCF,591
chr1,2547911,2548467,SRX16500060,CTCF,556
chr1,2547942,2548449,SRX16500062,CTCF,507
chr1,2547949,2548405,SRX16500061,CTCF,456
chr1,2548138,2548352,SRX4174629,CTCF,214
chr1,2556442,2556659,SRX5075176,SMARCA4,217
chr1,2566244,2566453,SRX5075168,SMARCA4,209
chr1,2586099,2586627,SRX20140895,INTS13,528
chr1,2586210,2586424,SRX20140867,INTS10,214
chr1,2586239,2586509,SRX20140868,INTS10,270
chr1,2586249,2586716,SRX5075170,SMARCA4,467
chr1,2586287,2586741,SRX5075168,SMARCA4,454
chr1,2586289,2586896,SRX5075174,SMARCA4,607
chr1,2586384,2586874,SRX5075176,SMARCA4,490
chr1,2586385,2586721,SRX5716464,SMARCA4,336
chr1,2586396,2586800,SRX5054307,FOSL2,404
chr1,2586411,2586705,SRX5716470,SMARCA4,294
chr1,2586441,2586768,SRX5054308,FOSL2,327
chr1,2586596,2586779,SRX5054309,FOSL2,183
chr1,2642586,2642794,SRX5075170,SMARCA4,208
chr1,2642594,2642866,SRX5075169,SMARCA4,272
chr1,2642741,2643327,SRX20140895,INTS13,586
chr1,2642885,2643282,SRX5075175,SMARCA4,397
chr1,2642950,2643141,SRX5075169,SMARCA4,191
chr1,2643004,2643363,SRX5075176,SMARCA4,359
chr1,2643007,2643483,SRX5075174,SMARCA4,476
chr1,2643033,2643488,SRX5075168,SMARCA4,455
chr1,2643146,2643426,SRX5075170,SMARCA4,280
chr1,2653815,2654081,SRX20140869,INTS10,266
chr1,2653887,2654259,SRX9989505,GFP,372
chr1,2653915,2654216,SRX9989504,GFP,301
chr1,2697401,2697850,SRX9989504,GFP,449
chr1,2697483,2697828,SRX9989505,GFP,345
chr1,2701842,2702337,SRX16500060,CTCF,495
chr1,2701929,2702329,SRX16500062,CTCF,400
chr1,2701943,2702331,SRX16500059,CTCF,388
chr1,2701949,2702291,SRX16500061,CTCF,342
chr1,2756775,2757030,SRX9989504,GFP,255
chr1,2763145,2763436,SRX16500062,CTCF,291
chr1,2765083,2765322,SRX16500061,CTCF,239
chr1,2772323,2772580,SRX16500059,CTCF,257
chr1,2774107,2774330,SRX16500060,CTCF,223
chr1,2786565,2787007,SRX16500061,CTCF,442
chr1,2786572,2787069,SRX16500059,CTCF,497
chr1,2786589,2787019,SRX16500060,CTCF,430
chr1,2786616,2787000,SRX16500062,CTCF,384
chr1,2789111,2789535,SRX20140895,INTS13,424
chr1,2801609,2801990,SRX16500059,CTCF,381
chr1,2801610,2801948,SRX16500060,CTCF,338
chr1,2801659,2801927,SRX16500062,CTCF,268
chr1,2801671,2801985,SRX16500061,CTCF,314
chr1,2821942,2822372,SRX16500060,CTCF,430
chr1,2821968,2822452,SRX16500059,CTCF,484
chr1,2821984,2822422,SRX16500061,CTCF,438
chr1,2821987,2822398,SRX16500062,CTCF,411
chr1,2875815,2876310,SRX16500059,CTCF,495
chr1,2875861,2876284,SRX16500060,CTCF,423
chr1,2875897,2876256,SRX16500062,CTCF,359
chr1,2875983,2876285,SRX16500061,CTCF,302
chr1,2922023,2922434,SRX16500059,CTCF,411
chr1,2922033,2922359,SRX16500061,CTCF,326
chr1,2922052,2922425,SRX16500060,CTCF,373
chr1,2922070,2922388,SRX16500062,CTCF,318
chr1,2975870,2976053,SRX5054309,FOSL2,183
chr1,3011940,3012196,SRX20140895,INTS13,256
chr1,3012396,3012917,SRX16500060,CTCF,521
chr1,3012397,3012902,SRX16500059,CTCF,505
chr1,3012413,3012897,SRX16500061,CTCF,484
chr1,3012443,3012882,SRX16500062,CTCF,439
chr1,3024009,3024275,SRX16500061,CTCF,266
chr1,3056413,3056668,SRX16500061,CTCF,255
chr1,3066148,3066530,SRX16500059,CTCF,382
chr1,3066153,3066517,SRX16500061,CTCF,364
chr1,3066163,3066518,SRX16500062,CTCF,355
chr1,3066179,3066550,SRX16500060,CTCF,371
chr1,3069615,3069996,SRX16500059,CTCF,381
chr1,3069633,3069994,SRX16500060,CTCF,361
chr1,3069636,3069960,SRX5075169,SMARCA4,324
chr1,3069649,3069966,SRX16500062,CTCF,317
chr1,3069660,3069927,SRX16500061,CTCF,267
chr1,3069701,3069971,SRX5075176,SMARCA4,270
chr1,3069733,3069920,SRX5075175,SMARCA4,187
chr1,3105460,3105975,SRX5075174,SMARCA4,515
chr1,3105463,3105908,SRX5075168,SMARCA4,445
chr1,3105488,3105959,SRX20140895,INTS13,471
chr1,3105495,3105934,SRX5716470,SMARCA4,439
chr1,3105532,3105782,SRX5075175,SMARCA4,250
chr1,3105533,3105887,SRX5716469,SMARCA4,354
chr1,3105542,3105741,SRX5716451,SOX2,199
chr1,3105545,3105895,SRX5075169,SMARCA4,350
chr1,3105549,3105890,SRX5716463,SMARCA4,341
chr1,3105552,3105863,SRX5075170,SMARCA4,311
chr1,3105561,3105927,SRX20140868,INTS10,366
chr1,3105562,3105905,SRX5716464,SMARCA4,343
chr1,3105580,3105849,SRX20140867,INTS10,269
chr1,3105582,3105891,SRX5075176,SMARCA4,309
chr1,3105583,3105811,SRX5716468,SMARCA2,228
chr1,3109471,3109650,SRX5075170,SMARCA4,179
chr1,3111766,3111939,SRX5075174,SMARCA4,173
chr1,3119831,3120066,SRX16500059,CTCF,235
chr1,3170527,3170824,SRX5075176,SMARCA4,297
chr1,3170561,3170813,SRX5075169,SMARCA4,252
chr1,3186366,3186893,SRX5075174,SMARCA4,527
chr1,3186421,3186795,SRX5075168,SMARCA4,374
chr1,3186635,3186834,SRX5075170,SMARCA4,199
chr1,3186639,3186938,SRX5716470,SMARCA4,299
chr1,3204668,3205139,SRX20140895,INTS13,471
chr1,3204789,3205050,SRX20140868,INTS10,261
chr1,3215633,3216204,SRX5075168,SMARCA4,571
chr1,3215641,3216229,SRX5075174,SMARCA4,588
chr1,3215687,3215882,SRX5075176,SMARCA4,195
chr1,3215688,3216004,SRX5716463,SMARCA4,316
chr1,3215708,3215922,SRX5075170,SMARCA4,214
chr1,3215714,3216106,SRX5716464,SMARCA4,392
chr1,3215743,3216034,SRX5716451,SOX2,291
chr1,3215768,3215973,SRX5716454,SOX3,205
chr1,3219183,3219585,SRX5075169,SMARCA4,402
chr1,3219191,3219558,SRX5075176,SMARCA4,367
chr1,3219227,3219649,SRX5716470,SMARCA4,422
chr1,3219235,3219590,SRX5075175,SMARCA4,355
chr1,3219254,3219629,SRX5716469,SMARCA4,375
chr1,3219271,3219620,SRX5075170,SMARCA4,349
chr1,3219290,3219504,SRX5716468,SMARCA2,214
chr1,3219291,3219499,SRX5054309,FOSL2,208
chr1,3219300,3219473,SRX5075174,SMARCA4,173
chr1,3219300,3219549,SRX5716467,SMARCA2,249
chr1,3227152,3227664,SRX20140895,INTS13,512
chr1,3249489,3250105,SRX20140895,INTS13,616
chr1,3249530,3250005,SRX20140868,INTS10,475
chr1,3249546,3250068,SRX5075174,SMARCA4,522
chr1,3249579,3250192,SRX5075168,SMARCA4,613
chr1,3249616,3249952,SRX5716454,SOX3,336
chr1,3249657,3249959,SRX5716451,SOX2,302
chr1,3249657,3250016,SRX5716463,SMARCA4,359
chr1,3249672,3250001,SRX20140879,CPSF3L,329
chr1,3249689,3250010,SRX5716464,SMARCA4,321
chr1,3249699,3249986,SRX20140867,INTS10,287
chr1,3249755,3249957,SRX5075170,SMARCA4,202
chr1,3276065,3276292,SRX5075175,SMARCA4,227
chr1,3276126,3276306,SRX5075169,SMARCA4,180
chr1,3276162,3276437,SRX5075176,SMARCA4,275
chr1,3283862,3284360,SRX16500062,CTCF,498
chr1,3283894,3284385,SRX16500059,CTCF,491
chr1,3283925,3284327,SRX16500061,CTCF,402
chr1,3283949,3284371,SRX16500060,CTCF,422
chr1,3306545,3307235,SRX5054309,FOSL2,690
chr1,3306571,3306872,SRX5020211,SMARCA2,301
chr1,3306591,3306773,SRX5075170,SMARCA4,182
chr1,3306591,3306855,SRX5020214,SMARCA2,264
chr1,3306598,3307159,SRX5054308,FOSL2,561
chr1,3306619,3307228,SRX5075169,SMARCA4,609
chr1,3306681,3306906,SRX5075175,SMARCA4,225
chr1,3312915,3313476,SRX5075169,SMARCA4,561
chr1,3312935,3313183,SRX5716459,Epitope tags,248
chr1,3313001,3313894,SRX5716469,SMARCA4,893
chr1,3313005,3313434,SRX5716467,SMARCA2,429
chr1,3313018,3313949,SRX5075170,SMARCA4,931
chr1,3313040,3313860,SRX5075176,SMARCA4,820
chr1,3313042,3313562,SRX5716470,SMARCA4,520
chr1,3313052,3313462,SRX5075174,SMARCA4,410
chr1,3313055,3313506,SRX5054308,FOSL2,451
chr1,3313064,3313812,SRX5075175,SMARCA4,748
chr1,3313067,3313507,SRX5054309,FOSL2,440
chr1,3313078,3313328,SRX5075181,SMARCA2,250
chr1,3313085,3313442,SRX5075168,SMARCA4,357
chr1,3313128,3313442,SRX5020211,SMARCA2,314
chr1,3313168,3313447,SRX5054307,FOSL2,279
chr1,3313220,3313478,SRX20140897,INTS13,258
chr1,3313542,3313844,SRX5075169,SMARCA4,302
chr1,3313690,3313901,SRX5716470,SMARCA4,211
chr1,3319844,3320335,SRX16500061,CTCF,491
chr1,3319870,3320370,SRX16500059,CTCF,500
chr1,3319910,3320393,SRX16500060,CTCF,483
chr1,3319944,3320419,SRX16500062,CTCF,475
chr1,3322209,3322424,SRX5716467,SMARCA2,215
chr1,3322246,3322454,SRX5075170,SMARCA4,208
chr1,3323486,3323765,SRX20140895,INTS13,279
chr1,3349726,3350074,SRX16500062,CTCF,348
chr1,3349726,3350075,SRX16500059,CTCF,349
chr1,3349735,3350007,SRX16500060,CTCF,272
chr1,3349750,3350083,SRX16500061,CTCF,333
chr1,3352286,3352943,SRX5075168,SMARCA4,657
chr1,3352303,3352746,SRX20140881,CPSF3L,443
chr1,3352335,3352856,SRX5075170,SMARCA4,521
chr1,3352339,3352768,SRX5075175,SMARCA4,429
chr1,3352340,3353055,SRX20140895,INTS13,715
chr1,3352367,3352900,SRX5716470,SMARCA4,533
chr1,3352376,3352941,SRX5716464,SMARCA4,565
chr1,3352378,3352640,SRX20140867,INTS10,262
chr1,3352384,3352707,SRX20140869,INTS10,323
chr1,3352385,3352766,SRX5075181,SMARCA2,381
chr1,3352387,3352817,SRX5075176,SMARCA4,430
chr1,3352394,3352750,SRX20140879,CPSF3L,356
chr1,3352398,3352844,SRX20140868,INTS10,446
chr1,3352399,3352774,SRX5075169,SMARCA4,375
chr1,3352403,3352718,SRX5020211,SMARCA2,315
chr1,3352408,3352779,SRX5716469,SMARCA4,371
chr1,3352409,3352782,SRX5054309,FOSL2,373
chr1,3352428,3352740,SRX20140897,INTS13,312
chr1,3352447,3352953,SRX5075174,SMARCA4,506
chr1,3352456,3352702,SRX5054308,FOSL2,246
chr1,3352463,3352726,SRX5716467,SMARCA2,263
chr1,3352469,3352902,SRX5716463,SMARCA4,433
chr1,3352471,3352785,SRX5716468,SMARCA2,314
chr1,3352486,3352711,SRX5020214,SMARCA2,225
chr1,3352504,3352730,SRX5075182,SMARCA2,226
chr1,3369324,3370173,SRX5075169,SMARCA4,849
chr1,3369549,3370172,SRX5075176,SMARCA4,623
chr1,3369569,3370131,SRX5075170,SMARCA4,562
chr1,3369643,3370014,SRX5716468,SMARCA2,371
chr1,3369647,3370113,SRX5716467,SMARCA2,466
chr1,3369685,3370165,SRX5716469,SMARCA4,480
chr1,3369761,3370194,SRX5054309,FOSL2,433
chr1,3369775,3370117,SRX5716470,SMARCA4,342
chr1,3369785,3370133,SRX5054308,FOSL2,348
chr1,3369786,3370149,SRX5075175,SMARCA4,363
chr1,3393377,3394057,SRX20140895,INTS13,680
chr1,3393651,3393935,SRX20140868,INTS10,284
chr1,3393655,3393918,SRX5075168,SMARCA4,263
chr1,3402087,3402527,SRX5075176,SMARCA4,440
chr1,3402192,3402613,SRX5075169,SMARCA4,421
chr1,3402206,3402525,SRX5075175,SMARCA4,319
chr1,3402209,3402519,SRX5075170,SMARCA4,310
chr1,3402223,3402461,SRX5716470,SMARCA4,238
chr1,3402301,3402484,SRX5054309,FOSL2,183
chr1,3403323,3403737,SRX16500060,CTCF,414
chr1,3403329,3403641,SRX16500061,CTCF,312
chr1,3403347,3403689,SRX16500059,CTCF,342
chr1,3403389,3403731,SRX16500062,CTCF,342
chr1,3410142,3410486,SRX16500060,CTCF,344
chr1,3410183,3410494,SRX16500061,CTCF,311
chr1,3410189,3410451,SRX4174629,CTCF,262
chr1,3410210,3410506,SRX16500059,CTCF,296
chr1,3410231,3410515,SRX16500062,CTCF,284
chr1,3417090,3417411,SRX16500060,CTCF,321
chr1,3417094,3417453,SRX16500061,CTCF,359
chr1,3417102,3417516,SRX16500059,CTCF,414
chr1,3417122,3417388,SRX16500062,CTCF,266
chr1,3424589,3425075,SRX16500062,CTCF,486
chr1,3424606,3425083,SRX16500061,CTCF,477
chr1,3424620,3425106,SRX16500060,CTCF,486
chr1,3424635,3425104,SRX16500059,CTCF,469
chr1,3424673,3425065,SRX4174629,CTCF,392
chr1,3424805,3424984,SRX5075174,SMARCA4,179
chr1,3431179,3431697,SRX16500059,CTCF,518
chr1,3431240,3431719,SRX16500060,CTCF,479
chr1,3431283,3431628,SRX16500062,CTCF,345
chr1,3431312,3431616,SRX16500061,CTCF,304
chr1,3441439,3441671,SRX5075174,SMARCA4,232
chr1,3453049,3453593,SRX16500060,CTCF,544
chr1,3453073,3453567,SRX16500061,CTCF,494
chr1,3453074,3453496,SRX4174629,CTCF,422
chr1,3453084,3453637,SRX16500059,CTCF,553
chr1,3453114,3453548,SRX16500062,CTCF,434
chr1,3454174,3454754,SRX20140895,INTS13,580
chr1,3454190,3454496,SRX16500059,CTCF,306
chr1,3454206,3454468,SRX16500060,CTCF,262
chr1,3471331,3472087,SRX5075168,SMARCA4,756
chr1,3471390,3472056,SRX20140895,INTS13,666
chr1,3471419,3472076,SRX5075174,SMARCA4,657
chr1,3471423,3471606,SRX5054309,FOSL2,183
chr1,3471433,3472027,SRX20140868,INTS10,594
chr1,3471459,3471770,SRX5716463,SMARCA4,311
chr1,3471571,3471761,SRX5075170,SMARCA4,190
chr1,3471611,3471862,SRX5075169,SMARCA4,251
chr1,3471706,3472213,SRX16500059,CTCF,507
chr1,3471808,3472202,SRX16500060,CTCF,394
chr1,3471872,3472116,SRX16500061,CTCF,244
chr1,3473509,3473758,SRX5075175,SMARCA4,249
chr1,3473557,3473863,SRX5716470,SMARCA4,306
chr1,3473558,3473849,SRX5075169,SMARCA4,291
chr1,3473568,3473849,SRX5075176,SMARCA4,281
chr1,3473621,3473833,SRX5716469,SMARCA4,212
chr1,3483842,3484238,SRX16500059,CTCF,396
chr1,3483854,3484232,SRX16500062,CTCF,378
chr1,3483870,3484239,SRX16500061,CTCF,369
chr1,3483871,3484269,SRX16500060,CTCF,398
chr1,3491072,3491655,SRX16500059,CTCF,583
chr1,3491081,3491605,SRX16500062,CTCF,524
chr1,3491150,3491629,SRX16500061,CTCF,479
chr1,3491159,3491656,SRX16500060,CTCF,497
chr1,3491193,3491582,SRX4174629,CTCF,389
chr1,3491257,3491530,SRX5075175,SMARCA4,273
chr1,3491257,3491591,SRX5075168,SMARCA4,334
chr1,3491260,3491552,SRX5716463,SMARCA4,292
chr1,3491265,3491571,SRX5716464,SMARCA4,306
chr1,3491282,3491554,SRX5716470,SMARCA4,272
chr1,3491283,3491602,SRX5075174,SMARCA4,319
chr1,3491299,3491507,SRX5075169,SMARCA4,208
chr1,3491299,3491577,SRX5075170,SMARCA4,278
chr1,3491343,3491545,SRX5075176,SMARCA4,202
chr1,3518137,3518556,SRX16500061,CTCF,419
chr1,3518160,3518578,SRX16500059,CTCF,418
chr1,3518204,3518590,SRX16500060,CTCF,386
chr1,3518208,3518573,SRX16500062,CTCF,365
chr1,3522864,3523239,SRX5075170,SMARCA4,375
chr1,3522884,3523190,SRX5075176,SMARCA4,306
chr1,3531146,3531835,SRX20140895,INTS13,689
chr1,3531279,3531752,SRX5075168,SMARCA4,473
chr1,3531326,3531777,SRX5075174,SMARCA4,451
chr1,3531359,3531621,SRX5075176,SMARCA4,262
chr1,3531402,3531623,SRX5075170,SMARCA4,221
chr1,3531438,3531739,SRX5716463,SMARCA4,301
chr1,3531440,3531627,SRX5075175,SMARCA4,187
chr1,3565195,3565725,SRX16500059,CTCF,530
chr1,3565214,3565718,SRX16500061,CTCF,504
chr1,3565223,3565709,SRX16500060,CTCF,486
chr1,3565247,3565620,SRX4174629,CTCF,373
chr1,3565266,3565626,SRX16500062,CTCF,360
chr1,3587868,3588214,SRX16500061,CTCF,346
chr1,3587874,3588144,SRX16500060,CTCF,270
chr1,3588373,3588656,SRX16500060,CTCF,283
chr1,3610449,3610743,SRX5075170,SMARCA4,294
chr1,3610492,3610703,SRX5716470,SMARCA4,211
chr1,3610620,3610845,SRX5075176,SMARCA4,225
chr1,3611145,3611494,SRX20140895,INTS13,349
chr1,3611686,3611874,SRX5075168,SMARCA4,188
chr1,3611696,3611899,SRX5075174,SMARCA4,203
chr1,3613413,3613725,SRX5054309,FOSL2,312
chr1,3613428,3613708,SRX5054308,FOSL2,280
chr1,3615100,3615451,SRX16500062,CTCF,351
chr1,3615132,3615437,SRX16500061,CTCF,305
chr1,3615133,3615435,SRX16500060,CTCF,302
chr1,3615136,3615477,SRX16500059,CTCF,341
chr1,3618959,3619281,SRX5716470,SMARCA4,322
chr1,3618971,3619399,SRX16500059,CTCF,428
chr1,3618971,3619399,SRX16500060,CTCF,428
chr1,3618986,3619285,SRX5075176,SMARCA4,299
chr1,3619001,3619417,SRX16500061,CTCF,416
chr1,3619004,3619223,SRX5075170,SMARCA4,219
chr1,3619040,3619290,SRX5075175,SMARCA4,250
chr1,3619041,3619422,SRX16500062,CTCF,381
chr1,3619048,3619261,SRX5075174,SMARCA4,213
chr1,3619054,3619248,SRX5075168,SMARCA4,194
chr1,3619057,3619387,SRX4174629,CTCF,330
chr1,3619080,3619291,SRX5716464,SMARCA4,211
chr1,3621096,3621510,SRX16500060,CTCF,414
chr1,3621123,3621553,SRX16500059,CTCF,430
chr1,3621153,3621492,SRX16500062,CTCF,339
chr1,3621153,3621563,SRX16500061,CTCF,410
chr1,3621228,3621508,SRX4174629,CTCF,280
chr1,3624463,3624783,SRX5075175,SMARCA4,320
chr1,3624558,3624735,SRX5075170,SMARCA4,177
chr1,3624558,3624976,SRX5075174,SMARCA4,418
chr1,3624558,3625062,SRX20140895,INTS13,504
chr1,3624595,3624949,SRX5075168,SMARCA4,354
chr1,3624619,3624895,SRX5716463,SMARCA4,276
chr1,3624749,3624984,SRX5054308,FOSL2,235
chr1,3624759,3624942,SRX5054309,FOSL2,183
chr1,3624764,3625051,SRX5054307,FOSL2,287
chr1,3649817,3650216,SRX20140895,INTS13,399
chr1,3649886,3650248,SRX5075168,SMARCA4,362
chr1,3649958,3650165,SRX5075176,SMARCA4,207
chr1,3649961,3650326,SRX5075174,SMARCA4,365
chr1,3695550,3696040,SRX16500059,CTCF,490
chr1,3695562,3696036,SRX16500060,CTCF,474
chr1,3695595,3695993,SRX16500061,CTCF,398
chr1,3695617,3695956,SRX16500062,CTCF,339
chr1,3724323,3724845,SRX16500059,CTCF,522
chr1,3724327,3724821,SRX16500062,CTCF,494
chr1,3724359,3724893,SRX16500060,CTCF,534
chr1,3724366,3724849,SRX16500061,CTCF,483
chr1,3724395,3724744,SRX5075168,SMARCA4,349
chr1,3724411,3724744,SRX4174629,CTCF,333
chr1,3724446,3724719,SRX5075174,SMARCA4,273
chr1,3724567,3724743,SRX5075170,SMARCA4,176
chr1,3731760,3731994,SRX5075168,SMARCA4,234
chr1,3747032,3747486,SRX20140895,INTS13,454
chr1,3747112,3747350,SRX5075175,SMARCA4,238
chr1,3747171,3747611,SRX5075168,SMARCA4,440
chr1,3747201,3747592,SRX5075174,SMARCA4,391
chr1,3747310,3747620,SRX5075170,SMARCA4,310
chr1,3772039,3772537,SRX20140895,INTS13,498
chr1,3772247,3772835,SRX5075174,SMARCA4,588
chr1,3772292,3772841,SRX5075168,SMARCA4,549
chr1,3775451,3775762,SRX5716470,SMARCA4,311
chr1,3785523,3785756,SRX16500061,CTCF,233
chr1,3785550,3785772,SRX16500060,CTCF,222
chr1,3796241,3796876,SRX20140895,INTS13,635
chr1,3796276,3796876,SRX20140869,INTS10,600
chr1,3796303,3796802,SRX20140897,INTS13,499
chr1,3796325,3796825,SRX20140868,INTS10,500
chr1,3796326,3796583,SRX5075175,SMARCA4,257
chr1,3796336,3796690,SRX20140867,INTS10,354
chr1,3796385,3796729,SRX5075170,SMARCA4,344
chr1,3796400,3796668,SRX5075174,SMARCA4,268
chr1,3796412,3796762,SRX20140879,CPSF3L,350
chr1,3796461,3796705,SRX5075168,SMARCA4,244
chr1,3796480,3796754,SRX20140881,CPSF3L,274
chr1,3796550,3796816,SRX20140894,INTS13,266
chr1,3801396,3801901,SRX16500060,CTCF,505
chr1,3801430,3801833,SRX16500061,CTCF,403
chr1,3801438,3801867,SRX16500059,CTCF,429
chr1,3801456,3801844,SRX16500062,CTCF,388
chr1,3801462,3801639,SRX5075174,SMARCA4,177
chr1,3801466,3801781,SRX4174629,CTCF,315
chr1,3801536,3801722,SRX5075168,SMARCA4,186
chr1,3856958,3857144,SRX5075169,SMARCA4,186
chr1,3856978,3857168,SRX5075175,SMARCA4,190
chr1,3857044,3857623,SRX5075168,SMARCA4,579
chr1,3857082,3857383,SRX5075174,SMARCA4,301
chr1,3857143,3857506,SRX20140895,INTS13,363
chr1,3900051,3901326,SRX20140895,INTS13,1275
chr1,3900056,3901102,SRX20140897,INTS13,1046
chr1,3900186,3900828,SRX20140868,INTS10,642
chr1,3900222,3900777,SRX20140867,INTS10,555
chr1,3900236,3900694,SRX20140896,INTS13,458
chr1,3900302,3900742,SRX20140894,INTS13,440
chr1,3900380,3900843,SRX20140869,INTS10,463
chr1,3900381,3900701,SRX20140879,CPSF3L,320
chr1,3900383,3900695,SRX20140881,CPSF3L,312
chr1,3900623,3901043,SRX5075174,SMARCA4,420
chr1,3900711,3900922,SRX5075168,SMARCA4,211
chr1,3900859,3901142,SRX20140867,INTS10,283
chr1,3900959,3901291,SRX20140868,INTS10,332
chr1,3901033,3901317,SRX5075175,SMARCA4,284
chr1,3901221,3901576,SRX5075176,SMARCA4,355
chr1,3901302,3901559,SRX5075174,SMARCA4,257
chr1,3901331,3901571,SRX5075168,SMARCA4,240
chr1,3901414,3901589,SRX5075170,SMARCA4,175
chr1,3910714,3911189,SRX16500059,CTCF,475
chr1,3910727,3911167,SRX16500061,CTCF,440
chr1,3910736,3911226,SRX16500060,CTCF,490
chr1,3910778,3911177,SRX16500062,CTCF,399
chr1,3910887,3911178,SRX4174629,CTCF,291
chr1,3954356,3955051,SRX20140895,INTS13,695
chr1,3983288,3983606,SRX5075174,SMARCA4,318
chr1,3983299,3983617,SRX5075168,SMARCA4,318
chr1,4269110,4269401,SRX16500062,CTCF,291
chr1,4303014,4303058,SRX1424891,POU3F2,44
chr1,4303022,4303147,SRX1424894,POU3F2,125
chr1,4303101,4303147,SRX1424893,POU3F2,46
chr1,4303102,4303151,SRX1424892,POU3F2,49
chr1,4303106,4303149,SRX1424891,POU3F2,43
chr1,4341163,4341602,SRX20140869,INTS10,439
chr1,4341331,4341664,SRX20140881,CPSF3L,333
chr1,4341332,4341648,SRX20140897,INTS13,316
chr1,4341355,4341586,SRX20140867,INTS10,231
chr1,4375831,4376140,SRX5054309,FOSL2,309
chr1,4375882,4376157,SRX5075168,SMARCA4,275
chr1,4375883,4376112,SRX5075174,SMARCA4,229
chr1,4380598,4380828,SRX5054309,FOSL2,230
chr1,4396576,4396915,SRX5075174,SMARCA4,339
chr1,4396580,4396895,SRX5075168,SMARCA4,315
chr1,4421940,4422490,SRX5075168,SMARCA4,550
chr1,4422064,4422437,SRX5075174,SMARCA4,373
chr1,4422560,4422819,SRX5075168,SMARCA4,259
chr1,4422564,4422912,SRX16500060,CTCF,348
chr1,4422569,4422891,SRX16500062,CTCF,322
chr1,4422600,4422902,SRX16500059,CTCF,302
chr1,4422649,4422882,SRX5075174,SMARCA4,233
chr1,4448040,4448292,SRX5075168,SMARCA4,252
chr1,4449958,4450317,SRX5075174,SMARCA4,359
chr1,4450063,4450310,SRX5075168,SMARCA4,247
chr1,4585166,4585588,SRX16500059,CTCF,422
chr1,4585188,4585582,SRX16500062,CTCF,394
chr1,4585216,4585545,SRX16500061,CTCF,329
chr1,4585249,4585586,SRX16500060,CTCF,337
chr1,4650534,4650809,SRX5054309,FOSL2,275
chr1,4652441,4652969,SRX16500061,CTCF,528
chr1,4652497,4653035,SRX16500059,CTCF,538
chr1,4652505,4652987,SRX16500062,CTCF,482
chr1,4652514,4652972,SRX16500060,CTCF,458
chr1,4652657,4652860,SRX5075168,SMARCA4,203
chr1,4656258,4656733,SRX16500059,CTCF,475
chr1,4656295,4656679,SRX16500061,CTCF,384
chr1,4656299,4656683,SRX16500060,CTCF,384
chr1,4656317,4656751,SRX16500062,CTCF,434
chr1,4656393,4656775,SRX4174629,CTCF,382
chr1,4659404,4659610,SRX5075174,SMARCA4,206
chr1,4684904,4685133,SRX5075168,SMARCA4,229
chr1,4699457,4699652,SRX5075174,SMARCA4,195
chr1,4755413,4755745,SRX5075168,SMARCA4,332
chr1,4755488,4755736,SRX5075174,SMARCA4,248
chr1,4777933,4778381,SRX16500059,CTCF,448
chr1,4777961,4778343,SRX16500060,CTCF,382
chr1,4777976,4778351,SRX16500061,CTCF,375
chr1,4778002,4778289,SRX16500062,CTCF,287
chr1,4826000,4826393,SRX4174629,CTCF,393
chr1,4826006,4826458,SRX16500060,CTCF,452
chr1,4826015,4826484,SRX16500059,CTCF,469
chr1,4826027,4826467,SRX16500061,CTCF,440
chr1,4826056,4826470,SRX16500062,CTCF,414
chr1,5119540,5119888,SRX16500061,CTCF,348
chr1,5119545,5119962,SRX16500059,CTCF,417
chr1,5119563,5119835,SRX16500060,CTCF,272
chr1,5191534,5191751,SRX5075168,SMARCA4,217
chr1,5286244,5286576,SRX16500060,CTCF,332
chr1,5396668,5397077,SRX5075168,SMARCA4,409
chr1,5424738,5425393,SRX5075174,SMARCA4,655
chr1,5424768,5425463,SRX5075168,SMARCA4,695
chr1,5424843,5425039,SRX5075170,SMARCA4,196
chr1,5424905,5425170,SRX5075176,SMARCA4,265
chr1,5424959,5425152,SRX5054307,FOSL2,193
chr1,5448584,5448842,SRX16500061,CTCF,258
chr1,5455183,5455466,SRX5075168,SMARCA4,283
chr1,5455187,5455463,SRX5075174,SMARCA4,276
chr1,5481899,5482269,SRX16500059,CTCF,370
chr1,5481914,5482227,SRX16500061,CTCF,313
chr1,5481959,5482218,SRX16500060,CTCF,259
chr1,5509831,5510232,SRX16500060,CTCF,401
chr1,5509831,5510274,SRX16500059,CTCF,443
chr1,5509834,5510219,SRX16500061,CTCF,385
chr1,5509839,5510223,SRX16500062,CTCF,384
chr1,5509983,5510259,SRX4174629,CTCF,276
chr1,5514503,5514953,SRX16500062,CTCF,450
chr1,5514513,5514960,SRX16500060,CTCF,447
chr1,5514520,5514966,SRX16500059,CTCF,446
chr1,5514527,5514961,SRX16500061,CTCF,434
chr1,5514647,5514869,SRX5075174,SMARCA4,222
chr1,5514659,5514884,SRX5075168,SMARCA4,225
chr1,5514678,5515033,SRX4174629,CTCF,355
chr1,5598584,5598940,SRX16500060,CTCF,356
chr1,5598590,5598889,SRX16500062,CTCF,299
chr1,5598602,5598850,SRX16500059,CTCF,248
chr1,5621001,5621421,SRX16500062,CTCF,420
chr1,5621015,5621443,SRX16500060,CTCF,428
chr1,5621020,5621425,SRX16500059,CTCF,405
chr1,5621072,5621439,SRX16500061,CTCF,367
chr1,5719196,5719440,SRX16500059,CTCF,244
chr1,5719287,5719506,SRX16500061,CTCF,219
chr1,5745638,5746272,SRX16500062,CTCF,634
chr1,5745669,5746270,SRX16500059,CTCF,601
chr1,5745683,5746234,SRX16500060,CTCF,551
chr1,5745717,5746269,SRX16500061,CTCF,552
chr1,5745781,5746210,SRX4174629,CTCF,429
chr1,5745864,5746045,SRX5075168,SMARCA4,181
chr1,5830738,5831153,SRX16500059,CTCF,415
chr1,5830756,5831118,SRX16500061,CTCF,362
chr1,5830757,5831116,SRX16500062,CTCF,359
chr1,5830764,5831162,SRX16500060,CTCF,398
chr1,5847369,5847606,SRX5716464,SMARCA4,237
chr1,5847371,5847660,SRX5075174,SMARCA4,289
chr1,5847394,5847651,SRX5716470,SMARCA4,257
chr1,5847403,5847617,SRX5075168,SMARCA4,214
chr1,5893673,5893991,SRX16500059,CTCF,318
chr1,5893706,5894022,SRX16500060,CTCF,316
chr1,5893769,5894033,SRX16500061,CTCF,264
chr1,5915906,5916480,SRX16500061,CTCF,574
chr1,5915918,5916428,SRX16500060,CTCF,510
chr1,5915929,5916433,SRX16500059,CTCF,504
chr1,5915946,5916384,SRX16500062,CTCF,438
chr1,5915956,5916246,SRX5075169,SMARCA4,290
chr1,5916014,5916243,SRX5075175,SMARCA4,229
chr1,5916049,5916233,SRX5075170,SMARCA4,184
chr1,5916057,5916255,SRX5075176,SMARCA4,198
chr1,5938502,5938706,SRX5075169,SMARCA4,204
chr1,5938515,5938724,SRX5075175,SMARCA4,209
chr1,5975145,5975510,SRX16500060,CTCF,365
chr1,5975163,5975531,SRX16500059,CTCF,368
chr1,5975182,5975550,SRX16500061,CTCF,368
chr1,5975209,5975517,SRX16500062,CTCF,308
chr1,5975243,5975465,SRX4174629,CTCF,222
chr1,5980398,5980674,SRX16500061,CTCF,276
chr1,5980446,5980723,SRX16500060,CTCF,277
chr1,5980484,5980698,SRX16500062,CTCF,214
chr1,5982941,5983111,SRX5075170,SMARCA4,170
chr1,5992074,5992289,SRX20140867,INTS10,215
chr1,5992158,5992936,SRX20140895,INTS13,778
chr1,5992179,5992483,SRX20140879,CPSF3L,304
chr1,5992263,5992687,SRX20140881,CPSF3L,424
chr1,5992269,5992483,SRX5075174,SMARCA4,214
chr1,5992271,5992558,SRX20140868,INTS10,287
chr1,5992283,5992948,SRX5075168,SMARCA4,665
chr1,5992323,5992587,SRX20140897,INTS13,264
chr1,5992355,5992580,SRX20140867,INTS10,225
chr1,5992431,5992730,SRX5054308,FOSL2,299
chr1,5992462,5992716,SRX5716463,SMARCA4,254
chr1,5992463,5992714,SRX5054307,FOSL2,251
chr1,5992483,5992753,SRX5716464,SMARCA4,270
chr1,5992520,5992891,SRX5075170,SMARCA4,371
chr1,5992545,5992951,SRX5075174,SMARCA4,406
chr1,5995064,5995338,SRX16500062,CTCF,274
chr1,6003717,6004207,SRX20140895,INTS13,490
chr1,6003834,6004044,SRX5075174,SMARCA4,210
chr1,6003855,6004203,SRX5075168,SMARCA4,348
chr1,6016269,6016460,SRX5054308,FOSL2,191
chr1,6034273,6034834,SRX16500061,CTCF,561
chr1,6034289,6034855,SRX16500059,CTCF,566
chr1,6034318,6034880,SRX16500060,CTCF,562
chr1,6034325,6034846,SRX16500062,CTCF,521
chr1,6037344,6037524,SRX5075169,SMARCA4,180
chr1,6037347,6037638,SRX5075175,SMARCA4,291
chr1,6041398,6041821,SRX16500060,CTCF,423
chr1,6041410,6041820,SRX16500059,CTCF,410
chr1,6041427,6041807,SRX16500061,CTCF,380
chr1,6041444,6041795,SRX16500062,CTCF,351
chr1,6052498,6052760,SRX5075175,SMARCA4,262
chr1,6052500,6052813,SRX5075170,SMARCA4,313
chr1,6052505,6052825,SRX5716470,SMARCA4,320
chr1,6052510,6052780,SRX5075174,SMARCA4,270
chr1,6052530,6052823,SRX5075169,SMARCA4,293
chr1,6052530,6052900,SRX5716469,SMARCA4,370
chr1,6052535,6052788,SRX5075168,SMARCA4,253
chr1,6052535,6052796,SRX5075176,SMARCA4,261
chr1,6052692,6053302,SRX16500060,CTCF,610
chr1,6052825,6053307,SRX16500059,CTCF,482
chr1,6052831,6053362,SRX16500061,CTCF,531
chr1,6052840,6053279,SRX4174629,CTCF,439
chr1,6052862,6053296,SRX16500062,CTCF,434
chr1,6052889,6053178,SRX5075169,SMARCA4,289
chr1,6052897,6053273,SRX5075168,SMARCA4,376
chr1,6052919,6053274,SRX5075174,SMARCA4,355
chr1,6052998,6053244,SRX5075176,SMARCA4,246
chr1,6053010,6053260,SRX5075175,SMARCA4,250
chr1,6053015,6053211,SRX5075170,SMARCA4,196
chr1,6083892,6084467,SRX5075174,SMARCA4,575
chr1,6083911,6084123,SRX5716469,SMARCA4,212
chr1,6083917,6084258,SRX5054309,FOSL2,341
chr1,6083937,6084213,SRX5075168,SMARCA4,276
chr1,6083990,6084234,SRX5075170,SMARCA4,244
chr1,6084002,6084230,SRX5075176,SMARCA4,228
chr1,6148551,6148902,SRX5075168,SMARCA4,351
chr1,6148667,6148995,SRX5075174,SMARCA4,328
chr1,6157702,6157985,SRX5075170,SMARCA4,283
chr1,6157745,6157947,SRX5054308,FOSL2,202
chr1,6157746,6157977,SRX5075176,SMARCA4,231
chr1,6157784,6157980,SRX5075175,SMARCA4,196
chr1,6157830,6158010,SRX5075169,SMARCA4,180
chr1,6157839,6158032,SRX5054309,FOSL2,193
chr1,6161737,6161967,SRX5075175,SMARCA4,230
chr1,6161742,6161949,SRX5075170,SMARCA4,207
chr1,6161799,6161979,SRX5075169,SMARCA4,180
chr1,6171569,6171795,SRX16500062,CTCF,226
chr1,6171569,6171832,SRX16500060,CTCF,263
chr1,6171646,6171865,SRX16500061,CTCF,219
chr1,6180277,6180490,SRX16500062,CTCF,213
chr1,6180346,6180567,SRX16500060,CTCF,221
chr1,6185769,6186177,SRX16500060,CTCF,408
chr1,6185772,6186181,SRX16500059,CTCF,409
chr1,6185781,6186128,SRX16500061,CTCF,347
chr1,6185815,6186160,SRX16500062,CTCF,345
chr1,6185847,6186022,SRX5075176,SMARCA4,175
chr1,6185859,6186049,SRX5075168,SMARCA4,190
chr1,6199230,6200219,SRX20140895,INTS13,989
chr1,6199351,6200046,SRX20140897,INTS13,695
chr1,6199354,6200013,SRX5075170,SMARCA4,659
chr1,6199356,6199885,SRX5716470,SMARCA4,529
chr1,6199381,6199568,SRX5075175,SMARCA4,187
chr1,6199414,6199974,SRX5075168,SMARCA4,560
chr1,6199437,6199944,SRX5716463,SMARCA4,507
chr1,6199438,6199871,SRX20140867,INTS10,433
chr1,6199452,6200039,SRX20140868,INTS10,587
chr1,6199455,6199967,SRX5075174,SMARCA4,512
chr1,6199497,6199956,SRX5075176,SMARCA4,459
chr1,6199506,6200074,SRX20140879,CPSF3L,568
chr1,6199556,6200069,SRX20140869,INTS10,513
chr1,6199619,6199850,SRX5054309,FOSL2,231
chr1,6199639,6199959,SRX5075175,SMARCA4,320
chr1,6199672,6199877,SRX5716454,SOX3,205
chr1,6199703,6199957,SRX5716464,SMARCA4,254
chr1,6199788,6200009,SRX5075169,SMARCA4,221
chr1,6205029,6205631,SRX16500059,CTCF,602
chr1,6205134,6205561,SRX16500062,CTCF,427
chr1,6205136,6205500,SRX4174629,CTCF,364
chr1,6205141,6205613,SRX16500061,CTCF,472
chr1,6205142,6205578,SRX5716463,SMARCA4,436
chr1,6205145,6205577,SRX16500060,CTCF,432
chr1,6205191,6205487,SRX5075174,SMARCA4,296
chr1,6205199,6205501,SRX5716464,SMARCA4,302
chr1,6205216,6205516,SRX5716470,SMARCA4,300
chr1,6205220,6205502,SRX5075176,SMARCA4,282
chr1,6205223,6205498,SRX5075170,SMARCA4,275
chr1,6205223,6205526,SRX5075168,SMARCA4,303
chr1,6205231,6205457,SRX5075169,SMARCA4,226
chr1,6205232,6205501,SRX5075175,SMARCA4,269
chr1,6208731,6208983,SRX16500062,CTCF,252
chr1,6208733,6208984,SRX16500059,CTCF,251
chr1,6208736,6209173,SRX20140895,INTS13,437
chr1,6208740,6208970,SRX16500061,CTCF,230
chr1,6208759,6209508,SRX16500060,CTCF,749
chr1,6209161,6209462,SRX20140868,INTS10,301
chr1,6209268,6209455,SRX5075176,SMARCA4,187
chr1,6209275,6209485,SRX5075168,SMARCA4,210
chr1,6209275,6209524,SRX5075174,SMARCA4,249
chr1,6235611,6236285,SRX5075170,SMARCA4,674
chr1,6235633,6236182,SRX20140895,INTS13,549
chr1,6235667,6236128,SRX20140868,INTS10,461
chr1,6235688,6235888,SRX5075175,SMARCA4,200
chr1,6235692,6235953,SRX5075169,SMARCA4,261
chr1,6235712,6235962,SRX5716469,SMARCA4,250
chr1,6235718,6236099,SRX20140867,INTS10,381
chr1,6235734,6236055,SRX20140897,INTS13,321
chr1,6235747,6236220,SRX5075174,SMARCA4,473
chr1,6235764,6236167,SRX5716470,SMARCA4,403
chr1,6235797,6236285,SRX5075176,SMARCA4,488
chr1,6235832,6236169,SRX5716464,SMARCA4,337
chr1,6235953,6236209,SRX5075168,SMARCA4,256
chr1,6236014,6236277,SRX5075169,SMARCA4,263
chr1,6236046,6236301,SRX5075175,SMARCA4,255
chr1,6236054,6236281,SRX5716469,SMARCA4,227
chr1,6238600,6239006,SRX16500059,CTCF,406
chr1,6238629,6238974,SRX16500060,CTCF,345
chr1,6238678,6239024,SRX16500061,CTCF,346
chr1,6238703,6238966,SRX16500062,CTCF,263
chr1,6240385,6240673,SRX5075168,SMARCA4,288
chr1,6240424,6240622,SRX5075174,SMARCA4,198
chr1,6240483,6240669,SRX5075176,SMARCA4,186
chr1,6241962,6242684,SRX20140895,INTS13,722
chr1,6242176,6242666,SRX20140868,INTS10,490
chr1,6245124,6245391,SRX5075176,SMARCA4,267
chr1,6245126,6245380,SRX5075175,SMARCA4,254
chr1,6245130,6245411,SRX16500062,CTCF,281
chr1,6245132,6245410,SRX5075169,SMARCA4,278
chr1,6245132,6245437,SRX5075168,SMARCA4,305
chr1,6245133,6245422,SRX5716470,SMARCA4,289
chr1,6245135,6245412,SRX16500060,CTCF,277
chr1,6245149,6245345,SRX5075174,SMARCA4,196
chr1,6245156,6245439,SRX5075170,SMARCA4,283
chr1,6245165,6245436,SRX16500061,CTCF,271
chr1,6245688,6246024,SRX20140868,INTS10,336
chr1,6246601,6247092,SRX16500062,CTCF,491
chr1,6246639,6247139,SRX16500060,CTCF,500
chr1,6246640,6247133,SRX16500059,CTCF,493
chr1,6246646,6247119,SRX16500061,CTCF,473
chr1,6246698,6247048,SRX4174629,CTCF,350
chr1,6261147,6261319,SRX5075170,SMARCA4,172
chr1,6261166,6261546,SRX20140895,INTS13,380
chr1,6263195,6263370,SRX5075176,SMARCA4,175
chr1,6271555,6271757,SRX5075169,SMARCA4,202
chr1,6271583,6271810,SRX5075175,SMARCA4,227
chr1,6271638,6271813,SRX5075176,SMARCA4,175
chr1,6272886,6273151,SRX16500060,CTCF,265
chr1,6273327,6273665,SRX5075170,SMARCA4,338
chr1,6273332,6273685,SRX5054309,FOSL2,353
chr1,6273351,6273643,SRX5075174,SMARCA4,292
chr1,6273352,6273711,SRX5075168,SMARCA4,359
chr1,6273358,6273641,SRX5054307,FOSL2,283
chr1,6273389,6273655,SRX5054308,FOSL2,266
chr1,6273397,6273686,SRX5075169,SMARCA4,289
chr1,6273401,6273679,SRX5075176,SMARCA4,278
chr1,6273411,6273700,SRX5716470,SMARCA4,289
chr1,6273428,6273708,SRX5075175,SMARCA4,280
chr1,6276325,6276842,SRX20140895,INTS13,517
chr1,6276339,6276568,SRX5075168,SMARCA4,229
chr1,6276349,6276671,SRX5075176,SMARCA4,322
chr1,6276361,6276650,SRX5716470,SMARCA4,289
chr1,6276394,6276631,SRX5075169,SMARCA4,237
chr1,6276403,6276729,SRX5075170,SMARCA4,326
chr1,6276428,6276699,SRX5075174,SMARCA4,271
chr1,6280791,6281177,SRX16500060,CTCF,386
chr1,6280841,6281060,SRX16500062,CTCF,219
chr1,6280882,6281242,SRX16500059,CTCF,360
chr1,6317331,6317675,SRX5075176,SMARCA4,344
chr1,6317389,6317675,SRX5075169,SMARCA4,286
chr1,6317414,6317667,SRX5075170,SMARCA4,253
chr1,6317425,6317680,SRX5075175,SMARCA4,255
chr1,6329420,6329722,SRX5075170,SMARCA4,302
chr1,6330367,6330746,SRX5075176,SMARCA4,379
chr1,6335821,6336001,SRX5075174,SMARCA4,180
chr1,6338641,6339039,SRX5075168,SMARCA4,398
chr1,6338762,6339049,SRX5075174,SMARCA4,287
chr1,6338768,6339015,SRX5716463,SMARCA4,247
chr1,6343377,6343813,SRX16500060,CTCF,436
chr1,6343387,6343806,SRX16500062,CTCF,419
chr1,6343393,6343791,SRX4174629,CTCF,398
chr1,6343410,6343818,SRX16500061,CTCF,408
chr1,6343424,6343829,SRX16500059,CTCF,405
chr1,6343461,6343693,SRX5716464,SMARCA4,232
chr1,6343490,6343691,SRX5075174,SMARCA4,201
chr1,6343496,6343749,SRX5075176,SMARCA4,253
chr1,6343498,6343721,SRX5075168,SMARCA4,223
chr1,6343528,6343746,SRX5075169,SMARCA4,218
chr1,6343573,6343751,SRX5075170,SMARCA4,178
chr1,6347882,6348263,SRX16500062,CTCF,381
chr1,6347942,6348305,SRX16500059,CTCF,363
chr1,6347946,6348286,SRX16500060,CTCF,340
chr1,6347994,6348284,SRX16500061,CTCF,290
chr1,6348547,6348869,SRX5075168,SMARCA4,322
chr1,6348610,6348877,SRX5075174,SMARCA4,267
chr1,6358975,6359169,SRX5075174,SMARCA4,194
chr1,6358975,6359289,SRX5075168,SMARCA4,314
chr1,6359005,6359190,SRX5075176,SMARCA4,185
chr1,6362972,6363473,SRX16500060,CTCF,501
chr1,6362998,6363502,SRX16500059,CTCF,504
chr1,6363022,6363483,SRX16500061,CTCF,461
chr1,6363052,6363458,SRX16500062,CTCF,406
chr1,6363131,6363430,SRX4174629,CTCF,299
chr1,6363158,6363364,SRX5075170,SMARCA4,206
chr1,6363162,6363339,SRX5075174,SMARCA4,177
chr1,6385759,6386016,SRX5075174,SMARCA4,257
chr1,6385764,6385976,SRX5075170,SMARCA4,212
chr1,6385821,6386012,SRX5075168,SMARCA4,191
chr1,6386433,6386723,SRX5054309,FOSL2,290
chr1,6386438,6386691,SRX5075169,SMARCA4,253
chr1,6386453,6386729,SRX5054308,FOSL2,276
chr1,6386492,6386717,SRX5075170,SMARCA4,225
chr1,6386558,6386733,SRX5075176,SMARCA4,175
chr1,6393177,6394020,SRX20140868,INTS10,843
chr1,6393179,6394264,SRX20140895,INTS13,1085
chr1,6393287,6393649,SRX5075174,SMARCA4,362
chr1,6393291,6393956,SRX20140867,INTS10,665
chr1,6393342,6394173,SRX5075168,SMARCA4,831
chr1,6393360,6393538,SRX5075170,SMARCA4,178
chr1,6393423,6393682,SRX5054307,FOSL2,259
chr1,6393488,6394061,SRX20140897,INTS13,573
chr1,6393489,6394121,SRX5716470,SMARCA4,632
chr1,6393513,6394149,SRX5075176,SMARCA4,636
chr1,6393516,6393718,SRX5075175,SMARCA4,202
chr1,6393552,6393981,SRX20140869,INTS10,429
chr1,6393565,6394062,SRX5075169,SMARCA4,497
chr1,6393642,6394158,SRX5075170,SMARCA4,516
chr1,6393692,6394081,SRX20140879,CPSF3L,389
chr1,6393721,6394130,SRX5075174,SMARCA4,409
chr1,6393788,6394078,SRX5075175,SMARCA4,290
chr1,6393817,6394152,SRX5716469,SMARCA4,335
chr1,6404654,6405095,SRX16500060,CTCF,441
chr1,6404678,6405105,SRX16500059,CTCF,427
chr1,6404690,6405052,SRX16500062,CTCF,362
chr1,6404698,6405063,SRX16500061,CTCF,365
chr1,6404721,6404896,SRX5075176,SMARCA4,175
chr1,6404761,6404940,SRX5075168,SMARCA4,179
chr1,6404765,6404938,SRX5075174,SMARCA4,173
chr1,6414263,6414709,SRX16500059,CTCF,446
chr1,6414283,6414647,SRX16500060,CTCF,364
chr1,6414321,6414656,SRX16500061,CTCF,335
chr1,6414324,6414588,SRX5075174,SMARCA4,264
chr1,6414372,6414723,SRX16500062,CTCF,351
chr1,6414396,6414714,SRX5075170,SMARCA4,318
chr1,6414397,6414653,SRX5075168,SMARCA4,256
chr1,6414399,6414625,SRX5075169,SMARCA4,226
chr1,6414463,6414702,SRX5075176,SMARCA4,239
chr1,6423277,6423806,SRX16500062,CTCF,529
chr1,6423354,6423838,SRX16500060,CTCF,484
chr1,6423363,6423865,SRX16500059,CTCF,502
chr1,6423365,6423881,SRX16500061,CTCF,516
chr1,6423445,6423690,SRX5075170,SMARCA4,245
chr1,6423484,6423748,SRX4174629,CTCF,264
chr1,6437953,6438430,SRX16500059,CTCF,477
chr1,6437983,6438434,SRX16500060,CTCF,451
chr1,6437999,6438436,SRX16500061,CTCF,437
chr1,6438018,6438438,SRX16500062,CTCF,420
chr1,6438093,6438310,SRX4174629,CTCF,217
chr1,6440626,6440987,SRX16500059,CTCF,361
chr1,6440639,6440910,SRX5075174,SMARCA4,271
chr1,6440668,6440971,SRX16500060,CTCF,303
chr1,6440688,6440946,SRX16500062,CTCF,258
chr1,6440700,6440940,SRX16500061,CTCF,240
chr1,6445197,6445421,SRX16500061,CTCF,224
chr1,6445200,6445471,SRX16500060,CTCF,271
chr1,6448697,6448944,SRX5075170,SMARCA4,247
chr1,6448698,6449064,SRX5075175,SMARCA4,366
chr1,6448701,6448990,SRX5075174,SMARCA4,289
chr1,6448737,6448958,SRX5075176,SMARCA4,221
chr1,6448793,6448973,SRX5075169,SMARCA4,180
chr1,6475396,6475944,SRX16500061,CTCF,548
chr1,6475421,6475964,SRX16500059,CTCF,543
chr1,6475427,6475920,SRX16500060,CTCF,493
chr1,6475435,6475932,SRX16500062,CTCF,497
chr1,6475519,6475764,SRX4174629,CTCF,245
chr1,6486409,6486884,SRX16500061,CTCF,475
chr1,6486420,6486857,SRX16500059,CTCF,437
chr1,6486421,6486840,SRX16500060,CTCF,419
chr1,6486425,6486841,SRX16500062,CTCF,416
chr1,6486515,6486777,SRX4174629,CTCF,262
chr1,6486544,6486777,SRX5075168,SMARCA4,233
chr1,6486546,6486778,SRX5075174,SMARCA4,232
chr1,6489804,6490323,SRX16500059,CTCF,519
chr1,6489829,6490274,SRX16500060,CTCF,445
chr1,6489846,6490287,SRX16500061,CTCF,441
chr1,6489856,6490239,SRX16500062,CTCF,383
chr1,6489913,6490109,SRX5075168,SMARCA4,196
chr1,6489923,6490198,SRX4174629,CTCF,275
chr1,6489932,6490123,SRX5075170,SMARCA4,191
chr1,6489944,6490147,SRX5075174,SMARCA4,203
chr1,6490547,6490774,SRX5075174,SMARCA4,227
chr1,6490571,6490881,SRX20140895,INTS13,310
chr1,6491546,6491788,SRX5075176,SMARCA4,242
chr1,6491558,6491787,SRX5075170,SMARCA4,229
chr1,6491568,6491852,SRX5075169,SMARCA4,284
chr1,6491587,6491828,SRX5054309,FOSL2,241
chr1,6497397,6497869,SRX5075168,SMARCA4,472
chr1,6497494,6497883,SRX5075174,SMARCA4,389
chr1,6497522,6497790,SRX20140895,INTS13,268
chr1,6497671,6497943,SRX5716463,SMARCA4,272
chr1,6519890,6520264,SRX5075168,SMARCA4,374
chr1,6519910,6520306,SRX5075170,SMARCA4,396
chr1,6519919,6520313,SRX5075174,SMARCA4,394
chr1,6519927,6520284,SRX5075176,SMARCA4,357
chr1,6519977,6520331,SRX5716470,SMARCA4,354
chr1,6519985,6520244,SRX5716464,SMARCA4,259
chr1,6523606,6524025,SRX16500059,CTCF,419
chr1,6523644,6523920,SRX16500061,CTCF,276
chr1,6523656,6524037,SRX16500060,CTCF,381
chr1,6523672,6524023,SRX16500062,CTCF,351
chr1,6538968,6539168,SRX5054309,FOSL2,200
chr1,6539009,6539321,SRX5075169,SMARCA4,312
chr1,6544806,6545602,SRX5075170,SMARCA4,796
chr1,6544806,6545624,SRX5075176,SMARCA4,818
chr1,6544833,6545221,SRX5054309,FOSL2,388
chr1,6544842,6545530,SRX5075169,SMARCA4,688
chr1,6544846,6545553,SRX5716469,SMARCA4,707
chr1,6544863,6545247,SRX5075175,SMARCA4,384
chr1,6544865,6545188,SRX5054308,FOSL2,323
chr1,6544881,6545081,SRX5020211,SMARCA2,200
chr1,6544881,6545116,SRX5020214,SMARCA2,235
chr1,6544913,6545157,SRX5716470,SMARCA4,244
chr1,6544917,6545122,SRX5075168,SMARCA4,205
chr1,6545004,6545274,SRX5716459,Epitope tags,270
chr1,6545015,6545494,SRX5716467,SMARCA2,479
chr1,6554193,6554797,SRX20140895,INTS13,604
chr1,6554265,6554738,SRX20140867,INTS10,473
chr1,6554271,6554744,SRX20140868,INTS10,473
chr1,6554274,6554608,SRX20140896,INTS13,334
chr1,6554298,6554551,SRX5716470,SMARCA4,253
chr1,6554299,6554935,SRX16500062,CTCF,636
chr1,6554313,6554884,SRX16500059,CTCF,571
chr1,6554330,6554675,SRX20140881,CPSF3L,345
chr1,6554334,6554716,SRX20140897,INTS13,382
chr1,6554339,6554870,SRX5075170,SMARCA4,531
chr1,6554343,6554841,SRX16500060,CTCF,498
chr1,6554351,6554671,SRX20140879,CPSF3L,320
chr1,6554360,6554830,SRX5075168,SMARCA4,470
chr1,6554367,6554842,SRX5075174,SMARCA4,475
chr1,6554383,6554903,SRX16500061,CTCF,520
chr1,6554403,6554776,SRX5075176,SMARCA4,373
chr1,6554430,6554677,SRX20140894,INTS13,247
chr1,6554443,6554790,SRX5075169,SMARCA4,347
chr1,6554476,6554731,SRX5716464,SMARCA4,255
chr1,6554502,6554769,SRX5716469,SMARCA4,267
chr1,6554519,6554812,SRX4174629,CTCF,293
chr1,6554537,6554789,SRX5716463,SMARCA4,252
chr1,6554604,6554820,SRX5075175,SMARCA4,216
chr1,6579469,6579964,SRX20140895,INTS13,495
chr1,6579536,6579877,SRX20140868,INTS10,341
chr1,6579601,6580075,SRX5075176,SMARCA4,474
chr1,6579669,6579990,SRX5716470,SMARCA4,321
chr1,6579695,6580173,SRX5075168,SMARCA4,478
chr1,6579714,6580029,SRX5075174,SMARCA4,315
chr1,6579720,6580057,SRX20140869,INTS10,337
chr1,6579747,6580036,SRX5716464,SMARCA4,289
chr1,6579775,6580037,SRX5075170,SMARCA4,262
chr1,6579782,6580027,SRX5054307,FOSL2,245
chr1,6579787,6580044,SRX5075169,SMARCA4,257
chr1,6579795,6580005,SRX5716451,SOX2,210
chr1,6579800,6580031,SRX5716454,SOX3,231
chr1,6580061,6580248,SRX5075175,SMARCA4,187
chr1,6601154,6601336,SRX5075170,SMARCA4,182
chr1,6602437,6603163,SRX20140867,INTS10,726
chr1,6602472,6604372,SRX20140895,INTS13,1900
chr1,6602550,6603361,SRX20140868,INTS10,811
chr1,6602579,6602920,SRX20140879,CPSF3L,341
chr1,6602697,6602999,SRX5075175,SMARCA4,302
chr1,6602773,6603287,SRX5075168,SMARCA4,514
chr1,6602817,6603177,SRX5075174,SMARCA4,360
chr1,6602859,6603198,SRX5054308,FOSL2,339
chr1,6602863,6603137,SRX5075176,SMARCA4,274
chr1,6602875,6603194,SRX5075169,SMARCA4,319
chr1,6602900,6603155,SRX5054307,FOSL2,255
chr1,6602900,6603250,SRX5054309,FOSL2,350
chr1,6602915,6603129,SRX5075170,SMARCA4,214
chr1,6602948,6603222,SRX5716470,SMARCA4,274
chr1,6603160,6603364,SRX5075175,SMARCA4,204
chr1,6603452,6604205,SRX20140868,INTS10,753
chr1,6603573,6603798,SRX20140867,INTS10,225
chr1,6604196,6604514,SRX5075168,SMARCA4,318
chr1,6612757,6612926,SRX5075170,SMARCA4,169
chr1,6613035,6613470,SRX5716469,SMARCA4,435
chr1,6613062,6613482,SRX5075176,SMARCA4,420
chr1,6613093,6613595,SRX20140895,INTS13,502
chr1,6613127,6613465,SRX20140868,INTS10,338
chr1,6613242,6613413,SRX5075170,SMARCA4,171
chr1,6613273,6613607,SRX20140867,INTS10,334
chr1,6613514,6613798,SRX5075174,SMARCA4,284
chr1,6613521,6613700,SRX5054307,FOSL2,179
chr1,6624917,6625319,SRX5075174,SMARCA4,402
chr1,6624926,6625167,SRX5075176,SMARCA4,241
chr1,6624947,6625300,SRX5075168,SMARCA4,353
chr1,6624956,6625167,SRX5716470,SMARCA4,211
chr1,6625017,6625582,SRX20140895,INTS13,565
chr1,6625131,6625393,SRX20140897,INTS13,262
chr1,6625146,6625590,SRX20140868,INTS10,444
chr1,6634720,6634941,SRX16500060,CTCF,221
chr1,6646476,6646942,SRX16500060,CTCF,466
chr1,6646477,6646908,SRX16500061,CTCF,431
chr1,6646494,6646948,SRX16500059,CTCF,454
chr1,6646511,6646887,SRX16500062,CTCF,376
chr1,6646555,6646782,SRX4174629,CTCF,227
chr1,6646559,6646817,SRX5075176,SMARCA4,258
chr1,6646560,6646794,SRX5075170,SMARCA4,234
chr1,6646565,6646776,SRX5716470,SMARCA4,211
chr1,6653937,6654110,SRX5075174,SMARCA4,173
chr1,6686279,6686473,SRX5075169,SMARCA4,194
chr1,6701446,6702209,SRX20140895,INTS13,763
chr1,6701504,6701884,SRX20140881,CPSF3L,380
chr1,6701548,6702063,SRX20140869,INTS10,515
chr1,6701554,6702074,SRX20140868,INTS10,520
chr1,6701610,6702095,SRX20140867,INTS10,485
chr1,6701616,6702250,SRX16500060,CTCF,634
chr1,6701622,6702041,SRX20140897,INTS13,419
chr1,6701651,6702091,SRX5716464,SMARCA4,440
chr1,6701658,6702273,SRX16500059,CTCF,615
chr1,6701681,6702039,SRX5716463,SMARCA4,358
chr1,6701681,6702222,SRX16500062,CTCF,541
chr1,6701684,6702132,SRX5075174,SMARCA4,448
chr1,6701705,6702176,SRX4174629,CTCF,471
chr1,6701712,6702290,SRX16500061,CTCF,578
chr1,6701723,6702105,SRX5716469,SMARCA4,382
chr1,6701736,6702121,SRX5075168,SMARCA4,385
chr1,6701741,6702078,SRX5716470,SMARCA4,337
chr1,6701760,6702226,SRX5075170,SMARCA4,466
chr1,6701776,6702147,SRX5075175,SMARCA4,371
chr1,6701782,6702117,SRX5075176,SMARCA4,335
chr1,6701820,6702133,SRX5075169,SMARCA4,313
chr1,6719852,6720445,SRX16500059,CTCF,593
chr1,6719891,6720436,SRX16500060,CTCF,545
chr1,6719910,6720418,SRX16500062,CTCF,508
chr1,6719940,6720408,SRX16500061,CTCF,468
chr1,6719975,6720385,SRX4174629,CTCF,410
chr1,6720066,6720289,SRX5075174,SMARCA4,223
chr1,6720080,6720263,SRX5075176,SMARCA4,183
chr1,6720115,6720289,SRX5075170,SMARCA4,174
chr1,6720116,6720298,SRX5075168,SMARCA4,182
chr1,6724507,6724876,SRX5716469,SMARCA4,369
chr1,6724517,6724891,SRX5716470,SMARCA4,374
chr1,6724523,6724916,SRX5075170,SMARCA4,393
chr1,6724534,6724864,SRX5020211,SMARCA2,330
chr1,6724543,6724914,SRX5075169,SMARCA4,371
chr1,6724561,6724894,SRX5075175,SMARCA4,333
chr1,6724584,6724896,SRX5075174,SMARCA4,312
chr1,6724600,6724815,SRX5716467,SMARCA2,215
chr1,6724601,6724895,SRX5054308,FOSL2,294
chr1,6724604,6724783,SRX5054307,FOSL2,179
chr1,6724614,6724954,SRX5054309,FOSL2,340
chr1,6724617,6724888,SRX5075176,SMARCA4,271
chr1,6724624,6724936,SRX5075168,SMARCA4,312
chr1,6724673,6724911,SRX5020214,SMARCA2,238
chr1,6727391,6727946,SRX16500059,CTCF,555
chr1,6727446,6727924,SRX16500060,CTCF,478
chr1,6727446,6727929,SRX16500061,CTCF,483
chr1,6727464,6727855,SRX16500062,CTCF,391
chr1,6727539,6727766,SRX5075174,SMARCA4,227
chr1,6743527,6744216,SRX5075170,SMARCA4,689
chr1,6743529,6744202,SRX5075176,SMARCA4,673
chr1,6743571,6744177,SRX5075169,SMARCA4,606
chr1,6743610,6744203,SRX5075175,SMARCA4,593
chr1,6743632,6744231,SRX5716470,SMARCA4,599
chr1,6743648,6744218,SRX5716469,SMARCA4,570
chr1,6743776,6744146,SRX5716467,SMARCA2,370
chr1,6743787,6744105,SRX5716468,SMARCA2,318
chr1,6743853,6744124,SRX5054309,FOSL2,271
chr1,6743861,6744182,SRX5716460,Epitope tags,321
chr1,6743868,6744088,SRX5020211,SMARCA2,220
chr1,6743890,6744080,SRX5054308,FOSL2,190
chr1,6743926,6744189,SRX5716459,Epitope tags,263
chr1,6770651,6771403,SRX5075176,SMARCA4,752
chr1,6770670,6771382,SRX5075170,SMARCA4,712
chr1,6770700,6771330,SRX5075169,SMARCA4,630
chr1,6770754,6771076,SRX5054308,FOSL2,322
chr1,6770770,6771170,SRX5075175,SMARCA4,400
chr1,6770780,6771262,SRX5075174,SMARCA4,482
chr1,6770783,6771221,SRX5716470,SMARCA4,438
chr1,6770799,6771130,SRX5054309,FOSL2,331
chr1,6770856,6771171,SRX5075168,SMARCA4,315
chr1,6784218,6784890,SRX5075175,SMARCA4,672
chr1,6784275,6785151,SRX20140895,INTS13,876
chr1,6784277,6784912,SRX5716470,SMARCA4,635
chr1,6784288,6784960,SRX5075170,SMARCA4,672
chr1,6784292,6784575,SRX5716469,SMARCA4,283
chr1,6784294,6784993,SRX5075174,SMARCA4,699
chr1,6784303,6784970,SRX20140868,INTS10,667
chr1,6784337,6784744,SRX5075169,SMARCA4,407
chr1,6784357,6785074,SRX20140897,INTS13,717
chr1,6784362,6784753,SRX5075176,SMARCA4,391
chr1,6784380,6784693,SRX20140867,INTS10,313
chr1,6784383,6784754,SRX5054309,FOSL2,371
chr1,6784391,6785022,SRX5075168,SMARCA4,631
chr1,6784434,6784803,SRX5054308,FOSL2,369
chr1,6784501,6784755,SRX5054307,FOSL2,254
chr1,6784663,6784998,SRX20140869,INTS10,335
chr1,6784755,6785056,SRX20140867,INTS10,301
chr1,6784769,6785030,SRX20140881,CPSF3L,261
chr1,6785037,6785456,SRX5054307,FOSL2,419
chr1,6786051,6786488,SRX16500061,CTCF,437
chr1,6794093,6794555,SRX16500060,CTCF,462
chr1,6794137,6794564,SRX16500062,CTCF,427
chr1,6794142,6794529,SRX16500061,CTCF,387
chr1,6794143,6794610,SRX16500059,CTCF,467
chr1,6795592,6795825,SRX5075169,SMARCA4,233
chr1,6795686,6795902,SRX5075176,SMARCA4,216
chr1,6795729,6795928,SRX5075170,SMARCA4,199
chr1,6795740,6795932,SRX5054309,FOSL2,192
chr1,6805123,6805298,SRX5075176,SMARCA4,175
chr1,6805135,6805315,SRX5075169,SMARCA4,180
chr1,6859872,6860360,SRX5716469,SMARCA4,488
chr1,6859913,6860371,SRX5716470,SMARCA4,458
chr1,6859922,6860573,SRX5075175,SMARCA4,651
chr1,6859927,6860500,SRX5075170,SMARCA4,573
chr1,6859930,6860563,SRX5075169,SMARCA4,633
chr1,6859948,6860437,SRX5075176,SMARCA4,489
chr1,6859960,6860396,SRX5054308,FOSL2,436
chr1,6859963,6860403,SRX5054309,FOSL2,440
chr1,6859982,6860406,SRX5075174,SMARCA4,424
chr1,6860015,6860271,SRX5716459,Epitope tags,256
chr1,6860019,6860316,SRX5716468,SMARCA2,297
chr1,6860023,6860376,SRX5020211,SMARCA2,353
chr1,6860040,6860450,SRX5075168,SMARCA4,410
chr1,6860068,6860364,SRX5716467,SMARCA2,296
chr1,6860073,6860304,SRX5054307,FOSL2,231
chr1,6860083,6860447,SRX5020214,SMARCA2,364
chr1,6860148,6860352,SRX5716463,SMARCA4,204
chr1,6860211,6860533,SRX5716460,Epitope tags,322
chr1,6866876,6867102,SRX5075168,SMARCA4,226
chr1,6866903,6867143,SRX5075174,SMARCA4,240
chr1,6868994,6869335,SRX5075168,SMARCA4,341
chr1,6869016,6869422,SRX5075174,SMARCA4,406
chr1,6869034,6869252,SRX5716463,SMARCA4,218
chr1,6888335,6888574,SRX5054308,FOSL2,239
chr1,6888370,6888635,SRX5054309,FOSL2,265
chr1,6889794,6890359,SRX16500059,CTCF,565
chr1,6889814,6890259,SRX16500062,CTCF,445
chr1,6889848,6890338,SRX16500060,CTCF,490
chr1,6889880,6890146,SRX5075168,SMARCA4,266
chr1,6889909,6890304,SRX16500061,CTCF,395
chr1,6889929,6890140,SRX5075176,SMARCA4,211
chr1,6889931,6890198,SRX5075174,SMARCA4,267
chr1,6889959,6890239,SRX5075170,SMARCA4,280
chr1,6889974,6890256,SRX4174629,CTCF,282
chr1,6899154,6899475,SRX5075176,SMARCA4,321
chr1,6899201,6899441,SRX5716469,SMARCA4,240
chr1,6899216,6899484,SRX5075170,SMARCA4,268
chr1,6899243,6899423,SRX5075169,SMARCA4,180
chr1,6899273,6899523,SRX5716470,SMARCA4,250
chr1,6912100,6912497,SRX20140895,INTS13,397
chr1,6912108,6912523,SRX20140868,INTS10,415
chr1,6912119,6912407,SRX5716463,SMARCA4,288
chr1,6912134,6912595,SRX5075174,SMARCA4,461
chr1,6912200,6912718,SRX5075168,SMARCA4,518
chr1,6922450,6922838,SRX5075176,SMARCA4,388
chr1,6922512,6922786,SRX20140867,INTS10,274
chr1,6922558,6922909,SRX5075170,SMARCA4,351
chr1,6922581,6922831,SRX5716469,SMARCA4,250
chr1,6922635,6922822,SRX5075175,SMARCA4,187
chr1,6922665,6922927,SRX5716470,SMARCA4,262
chr1,6935300,6935539,SRX5075169,SMARCA4,239
chr1,6935388,6935574,SRX5075176,SMARCA4,186
chr1,6935587,6935804,SRX5075170,SMARCA4,217
chr1,6935634,6935934,SRX5716470,SMARCA4,300
chr1,6960322,6960617,SRX5075170,SMARCA4,295
chr1,6960398,6960579,SRX5075176,SMARCA4,181
chr1,6963392,6963740,SRX20140879,CPSF3L,348
chr1,6991219,6991661,SRX5075176,SMARCA4,442
chr1,6991227,6991624,SRX5075169,SMARCA4,397
chr1,6991250,6991660,SRX5716469,SMARCA4,410
chr1,6991251,6991648,SRX5075175,SMARCA4,397
chr1,6991280,6991629,SRX5054309,FOSL2,349
chr1,6991289,6991655,SRX5075170,SMARCA4,366
chr1,6991297,6991588,SRX5716470,SMARCA4,291
chr1,6991333,6991596,SRX5020211,SMARCA2,263
chr1,6991334,6991621,SRX5054308,FOSL2,287
chr1,6991369,6991620,SRX5716467,SMARCA2,251
chr1,7042663,7043187,SRX16500060,CTCF,524
chr1,7042684,7043154,SRX16500059,CTCF,470
chr1,7042695,7043116,SRX16500061,CTCF,421
chr1,7042717,7043149,SRX16500062,CTCF,432
chr1,7046247,7046675,SRX5075169,SMARCA4,428
chr1,7046267,7046714,SRX5075175,SMARCA4,447
chr1,7046268,7046649,SRX5075176,SMARCA4,381
chr1,7046279,7046669,SRX5075170,SMARCA4,390
chr1,7046285,7046671,SRX5716470,SMARCA4,386
chr1,7046298,7046498,SRX5020211,SMARCA2,200
chr1,7046299,7046643,SRX5716469,SMARCA4,344
chr1,7046332,7046687,SRX5075181,SMARCA2,355
chr1,7046340,7046551,SRX5716468,SMARCA2,211
chr1,7046482,7046770,SRX5054308,FOSL2,288
chr1,7046494,7046718,SRX5054309,FOSL2,224
chr1,7070274,7070952,SRX16500060,CTCF,678
chr1,7070305,7070931,SRX16500059,CTCF,626
chr1,7070330,7070894,SRX16500062,CTCF,564
chr1,7070333,7070857,SRX16500061,CTCF,524
chr1,7070377,7070774,SRX4174629,CTCF,397
chr1,7070440,7070643,SRX5075176,SMARCA4,203
chr1,7070475,7070648,SRX5075174,SMARCA4,173
chr1,7075327,7075676,SRX5075176,SMARCA4,349
chr1,7075348,7075667,SRX5075174,SMARCA4,319
chr1,7075354,7075684,SRX5716470,SMARCA4,330
chr1,7075366,7075694,SRX5075169,SMARCA4,328
chr1,7075369,7075677,SRX5075170,SMARCA4,308
chr1,7075379,7075694,SRX5075168,SMARCA4,315
chr1,7075386,7075648,SRX5075175,SMARCA4,262
chr1,7075392,7075695,SRX5716469,SMARCA4,303
chr1,7097101,7097491,SRX20140867,INTS10,390
chr1,7110357,7110544,SRX5075175,SMARCA4,187
chr1,7112539,7112895,SRX20140867,INTS10,356
chr1,7117409,7117760,SRX16500061,CTCF,351
chr1,7117529,7118243,SRX5075175,SMARCA4,714
chr1,7117537,7118240,SRX5075170,SMARCA4,703
chr1,7117569,7118187,SRX5716469,SMARCA4,618
chr1,7117619,7118189,SRX5075176,SMARCA4,570
chr1,7117639,7118175,SRX5054309,FOSL2,536
chr1,7117674,7118201,SRX5075169,SMARCA4,527
chr1,7117707,7117918,SRX5716470,SMARCA4,211
chr1,7117737,7118058,SRX5075174,SMARCA4,321
chr1,7117803,7118052,SRX5075168,SMARCA4,249
chr1,7117844,7118133,SRX5054308,FOSL2,289
chr1,7117862,7118126,SRX5716467,SMARCA2,264
chr1,7207831,7208333,SRX16500060,CTCF,502
chr1,7207874,7208274,SRX16500061,CTCF,400
chr1,7207885,7208306,SRX16500059,CTCF,421
chr1,7207903,7208240,SRX16500062,CTCF,337
chr1,7207958,7208163,SRX5075168,SMARCA4,205
chr1,7207969,7208181,SRX5075174,SMARCA4,212
chr1,7218194,7218611,SRX16500059,CTCF,417
chr1,7218198,7218615,SRX16500060,CTCF,417
chr1,7218226,7218602,SRX16500061,CTCF,376
chr1,7218234,7218660,SRX16500062,CTCF,426
chr1,7218302,7218525,SRX4174629,CTCF,223
chr1,7223482,7223919,SRX5075175,SMARCA4,437
chr1,7223498,7223917,SRX5075170,SMARCA4,419
chr1,7223522,7224005,SRX5075176,SMARCA4,483
chr1,7223546,7223856,SRX5716469,SMARCA4,310
chr1,7223552,7223916,SRX5075169,SMARCA4,364
chr1,7223561,7223818,SRX5020214,SMARCA2,257
chr1,7223565,7223891,SRX5054308,FOSL2,326
chr1,7223576,7223842,SRX5716467,SMARCA2,266
chr1,7223604,7223885,SRX5716470,SMARCA4,281
chr1,7223606,7223927,SRX5054309,FOSL2,321
chr1,7229711,7230322,SRX5075170,SMARCA4,611
chr1,7229715,7230371,SRX5075176,SMARCA4,656
chr1,7229720,7230247,SRX5075175,SMARCA4,527
chr1,7229748,7230149,SRX5716469,SMARCA4,401
chr1,7229754,7230329,SRX5075169,SMARCA4,575
chr1,7229758,7229969,SRX5716470,SMARCA4,211
chr1,7229772,7230041,SRX5054309,FOSL2,269
chr1,7229784,7230092,SRX5054308,FOSL2,308
chr1,7229846,7230075,SRX5716467,SMARCA2,229
chr1,7247927,7248385,SRX20140895,INTS13,458
chr1,7247931,7248404,SRX5075174,SMARCA4,473
chr1,7247951,7248397,SRX5075168,SMARCA4,446
chr1,7247983,7248225,SRX5075170,SMARCA4,242
chr1,7248084,7248305,SRX5716463,SMARCA4,221
chr1,7248124,7248436,SRX20140867,INTS10,312
chr1,7251139,7251381,SRX5716470,SMARCA4,242
chr1,7251205,7251428,SRX5075169,SMARCA4,223
chr1,7265752,7266019,SRX5075170,SMARCA4,267
chr1,7265753,7266036,SRX5075176,SMARCA4,283
chr1,7265762,7266007,SRX5075169,SMARCA4,245
chr1,7265784,7266009,SRX5054308,FOSL2,225
chr1,7265785,7265972,SRX5054309,FOSL2,187
chr1,7281753,7282192,SRX5075170,SMARCA4,439
chr1,7281786,7282168,SRX5716469,SMARCA4,382
chr1,7281857,7282241,SRX5075169,SMARCA4,384
chr1,7281864,7282234,SRX5075176,SMARCA4,370
chr1,7281874,7282237,SRX5075175,SMARCA4,363
chr1,7281920,7282166,SRX5716467,SMARCA2,246
chr1,7281921,7282136,SRX5716470,SMARCA4,215
chr1,7291704,7291977,SRX5075169,SMARCA4,273
chr1,7292146,7292409,SRX5075176,SMARCA4,263
chr1,7292263,7292478,SRX5716467,SMARCA2,215
chr1,7299198,7299631,SRX5075168,SMARCA4,433
chr1,7299215,7299697,SRX5075170,SMARCA4,482
chr1,7299232,7299712,SRX5075169,SMARCA4,480
chr1,7299247,7299631,SRX5716459,Epitope tags,384
chr1,7299250,7299660,SRX5716469,SMARCA4,410
chr1,7299252,7299662,SRX5075176,SMARCA4,410
chr1,7299253,7299695,SRX5075175,SMARCA4,442
chr1,7299259,7299649,SRX5054309,FOSL2,390
chr1,7299264,7299683,SRX5716467,SMARCA2,419
chr1,7299281,7299659,SRX5716470,SMARCA4,378
chr1,7299292,7299673,SRX5054308,FOSL2,381
chr1,7299302,7299614,SRX5020211,SMARCA2,312
chr1,7299312,7299819,SRX5716460,Epitope tags,507
chr1,7299313,7299599,SRX5075174,SMARCA4,286
chr1,7299329,7299675,SRX5075181,SMARCA2,346
chr1,7299330,7299631,SRX5020214,SMARCA2,301
chr1,7299344,7299548,SRX5075182,SMARCA2,204
chr1,7299359,7299619,SRX5716468,SMARCA2,260
chr1,7300047,7300308,SRX5075176,SMARCA4,261
chr1,7300066,7300301,SRX5075170,SMARCA4,235
chr1,7300069,7300311,SRX5075169,SMARCA4,242
chr1,7300079,7300280,SRX5054309,FOSL2,201
chr1,7300921,7301254,SRX5054309,FOSL2,333
chr1,7300927,7301203,SRX5054308,FOSL2,276
chr1,7300970,7301167,SRX5075175,SMARCA4,197
chr1,7300974,7301237,SRX5075169,SMARCA4,263
chr1,7335126,7335176,SRX1424891,POU3F2,50
chr1,7335127,7335174,SRX1424892,POU3F2,47
chr1,7335127,7335174,SRX1424893,POU3F2,47
chr1,7335128,7335178,SRX1424894,POU3F2,50
chr1,7373863,7374361,SRX5075170,SMARCA4,498
chr1,7373868,7374296,SRX5716470,SMARCA4,428
chr1,7373903,7374241,SRX5075175,SMARCA4,338
chr1,7373954,7374331,SRX5075169,SMARCA4,377
chr1,7374030,7374341,SRX5716469,SMARCA4,311
chr1,7374084,7374360,SRX5075176,SMARCA4,276
chr1,7379335,7379689,SRX5716469,SMARCA4,354
chr1,7379337,7379951,SRX5075176,SMARCA4,614
chr1,7379375,7379940,SRX5075174,SMARCA4,565
chr1,7379386,7379743,SRX5075169,SMARCA4,357
chr1,7379386,7379783,SRX5075170,SMARCA4,397
chr1,7379386,7379873,SRX5716470,SMARCA4,487
chr1,7379392,7379763,SRX5075175,SMARCA4,371
chr1,7379408,7380036,SRX5075168,SMARCA4,628
chr1,7379491,7380008,SRX5716463,SMARCA4,517
chr1,7389497,7389811,SRX5075176,SMARCA4,314
chr1,7389507,7389862,SRX5075169,SMARCA4,355
chr1,7389569,7389866,SRX5075170,SMARCA4,297
chr1,7389582,7389795,SRX5716469,SMARCA4,213
chr1,7389600,7389843,SRX5075175,SMARCA4,243
chr1,7401707,7402209,SRX5716470,SMARCA4,502
chr1,7401737,7402282,SRX5075170,SMARCA4,545
chr1,7401743,7402223,SRX5716469,SMARCA4,480
chr1,7401743,7402309,SRX5075176,SMARCA4,566
chr1,7401743,7402337,SRX5075175,SMARCA4,594
chr1,7401759,7402208,SRX5716467,SMARCA2,449
chr1,7401769,7402275,SRX5075169,SMARCA4,506
chr1,7401774,7402277,SRX5054309,FOSL2,503
chr1,7401777,7402249,SRX5075174,SMARCA4,472
chr1,7401786,7402117,SRX5020211,SMARCA2,331
chr1,7401787,7402246,SRX5054308,FOSL2,459
chr1,7401793,7402198,SRX5075168,SMARCA4,405
chr1,7401819,7402166,SRX5020214,SMARCA2,347
chr1,7401834,7402139,SRX5054307,FOSL2,305
chr1,7401846,7402168,SRX5075182,SMARCA2,322
chr1,7401866,7402121,SRX5716468,SMARCA2,255
chr1,7401880,7402153,SRX5075181,SMARCA2,273
chr1,7427148,7427347,SRX5054309,FOSL2,199
chr1,7430785,7431021,SRX5075170,SMARCA4,236
chr1,7469449,7469768,SRX5075175,SMARCA4,319
chr1,7470884,7471239,SRX5075169,SMARCA4,355
chr1,7470937,7471254,SRX5075175,SMARCA4,317
chr1,7470937,7471289,SRX5054309,FOSL2,352
chr1,7470960,7471280,SRX5075176,SMARCA4,320
chr1,7470971,7471222,SRX5075170,SMARCA4,251
chr1,7470978,7471193,SRX5716467,SMARCA2,215
chr1,7470983,7471273,SRX5054308,FOSL2,290
chr1,7471780,7472184,SRX5716469,SMARCA4,404
chr1,7471796,7472245,SRX5075169,SMARCA4,449
chr1,7471802,7472181,SRX5716470,SMARCA4,379
chr1,7471823,7472194,SRX5075176,SMARCA4,371
chr1,7471825,7472170,SRX5075175,SMARCA4,345
chr1,7471828,7472181,SRX5075170,SMARCA4,353
chr1,7471848,7472117,SRX5054309,FOSL2,269
chr1,7471863,7472108,SRX5020214,SMARCA2,245
chr1,7471865,7472132,SRX5716467,SMARCA2,267
chr1,7471872,7472158,SRX5716468,SMARCA2,286
chr1,7471881,7472088,SRX5054308,FOSL2,207
chr1,7491417,7491899,SRX5075169,SMARCA4,482
chr1,7491472,7491756,SRX5716467,SMARCA2,284
chr1,7491507,7491859,SRX5716469,SMARCA4,352
chr1,7491508,7491793,SRX5075175,SMARCA4,285
chr1,7491517,7491850,SRX5075170,SMARCA4,333
chr1,7491520,7491842,SRX5075176,SMARCA4,322
chr1,7491521,7491851,SRX5716470,SMARCA4,330
chr1,7491534,7491714,SRX5054308,FOSL2,180
chr1,7494116,7494413,SRX5075176,SMARCA4,297
chr1,7494127,7494394,SRX5075170,SMARCA4,267
chr1,7494142,7494398,SRX5716467,SMARCA2,256
chr1,7495984,7496391,SRX20140895,INTS13,407
chr1,7501099,7501358,SRX5075175,SMARCA4,259
chr1,7501099,7501431,SRX5075169,SMARCA4,332
chr1,7501109,7501512,SRX5716470,SMARCA4,403
chr1,7501110,7501497,SRX5075176,SMARCA4,387
chr1,7501110,7501566,SRX5075170,SMARCA4,456
chr1,7501195,7501508,SRX5716467,SMARCA2,313
chr1,7502017,7502252,SRX5075170,SMARCA4,235
chr1,7502149,7502355,SRX5075176,SMARCA4,206
chr1,7511372,7511695,SRX5075176,SMARCA4,323
chr1,7516322,7516543,SRX16500060,CTCF,221
chr1,7521884,7522096,SRX5075176,SMARCA4,212
chr1,7521922,7522091,SRX5075170,SMARCA4,169
chr1,7533952,7534508,SRX5075170,SMARCA4,556
chr1,7533985,7534516,SRX5075169,SMARCA4,531
chr1,7533994,7534469,SRX5716470,SMARCA4,475
chr1,7533996,7534433,SRX5075175,SMARCA4,437
chr1,7534010,7534464,SRX5075176,SMARCA4,454
chr1,7534011,7534463,SRX5716469,SMARCA4,452
chr1,7534026,7534377,SRX5716467,SMARCA2,351
chr1,7534069,7534409,SRX5020211,SMARCA2,340
chr1,7534087,7534422,SRX5716468,SMARCA2,335
chr1,7534088,7534321,SRX5075182,SMARCA2,233
chr1,7534129,7534321,SRX5054309,FOSL2,192
chr1,7534140,7534330,SRX5054308,FOSL2,190
chr1,7534150,7534371,SRX5075181,SMARCA2,221
chr1,7534150,7534391,SRX5020214,SMARCA2,241
chr1,7538077,7538329,SRX5075175,SMARCA4,252
chr1,7538109,7538351,SRX5075174,SMARCA4,242
chr1,7538111,7538353,SRX5075170,SMARCA4,242
chr1,7538114,7538386,SRX5075169,SMARCA4,272
chr1,7538119,7538357,SRX5075176,SMARCA4,238
chr1,7538127,7538377,SRX5054308,FOSL2,250
chr1,7538147,7538413,SRX5054309,FOSL2,266
chr1,7538172,7538351,SRX5054307,FOSL2,179
chr1,7538183,7538392,SRX5075168,SMARCA4,209
chr1,7539398,7539638,SRX16500059,CTCF,240
chr1,7539428,7539669,SRX16500062,CTCF,241
chr1,7539433,7540060,SRX16500060,CTCF,627
chr1,7539724,7539995,SRX16500061,CTCF,271
chr1,7539780,7540076,SRX16500059,CTCF,296
chr1,7539793,7540073,SRX16500062,CTCF,280
chr1,7549300,7549781,SRX5075170,SMARCA4,481
chr1,7549302,7549671,SRX5054309,FOSL2,369
chr1,7549326,7549730,SRX5075176,SMARCA4,404
chr1,7549330,7549640,SRX5075174,SMARCA4,310
chr1,7549330,7549751,SRX5075175,SMARCA4,421
chr1,7549333,7549719,SRX5716469,SMARCA4,386
chr1,7549334,7549553,SRX5716468,SMARCA2,219
chr1,7549334,7549716,SRX5716467,SMARCA2,382
chr1,7549346,7549744,SRX5075169,SMARCA4,398
chr1,7549367,7549812,SRX5716470,SMARCA4,445
chr1,7549373,7549654,SRX5054308,FOSL2,281
chr1,7549385,7549646,SRX5020211,SMARCA2,261
chr1,7549392,7549613,SRX5075168,SMARCA4,221
chr1,7549419,7549644,SRX5020214,SMARCA2,225
chr1,7549440,7549622,SRX5054307,FOSL2,182
chr1,7549443,7549745,SRX5075181,SMARCA2,302
chr1,7561298,7561673,SRX16500061,CTCF,375
chr1,7561399,7561724,SRX16500059,CTCF,325
chr1,7561439,7561649,SRX16500062,CTCF,210
chr1,7561488,7561772,SRX16500060,CTCF,284
chr1,7581154,7581589,SRX5716469,SMARCA4,435
chr1,7581182,7581551,SRX5075169,SMARCA4,369
chr1,7581198,7581662,SRX5075170,SMARCA4,464
chr1,7581207,7581566,SRX5716470,SMARCA4,359
chr1,7581210,7581552,SRX5075176,SMARCA4,342
chr1,7581217,7581516,SRX5716467,SMARCA2,299
chr1,7581233,7581568,SRX5075175,SMARCA4,335
chr1,7581264,7581490,SRX5020211,SMARCA2,226
chr1,7581270,7581565,SRX5716468,SMARCA2,295
chr1,7581279,7581505,SRX5054308,FOSL2,226
chr1,7581280,7581509,SRX5054309,FOSL2,229
chr1,7608996,7609191,SRX5075174,SMARCA4,195
chr1,7616327,7616693,SRX5716470,SMARCA4,366
chr1,7616350,7616613,SRX5716463,SMARCA4,263
chr1,7616355,7616671,SRX5075170,SMARCA4,316
chr1,7616360,7616657,SRX5075168,SMARCA4,297
chr1,7616366,7616657,SRX5716469,SMARCA4,291
chr1,7616374,7616628,SRX5075174,SMARCA4,254
chr1,7616375,7616675,SRX5075176,SMARCA4,300
chr1,7616376,7616696,SRX5075169,SMARCA4,320
chr1,7616395,7616756,SRX5075175,SMARCA4,361
chr1,7616407,7616612,SRX5716464,SMARCA4,205
chr1,7647148,7647667,SRX16500059,CTCF,519
chr1,7647161,7647675,SRX16500060,CTCF,514
chr1,7647192,7647557,SRX4174629,CTCF,365
chr1,7647213,7647675,SRX16500061,CTCF,462
chr1,7647215,7647647,SRX16500062,CTCF,432
chr1,7647313,7647516,SRX5075175,SMARCA4,203
chr1,7650865,7651258,SRX20140895,INTS13,393
chr1,7667467,7667990,SRX16500062,CTCF,523
chr1,7667472,7667956,SRX16500059,CTCF,484
chr1,7667472,7667960,SRX16500060,CTCF,488
chr1,7667489,7667959,SRX16500061,CTCF,470
chr1,7667514,7668007,SRX4174629,CTCF,493
chr1,7667635,7667884,SRX5075174,SMARCA4,249
chr1,7667676,7667923,SRX5075170,SMARCA4,247
chr1,7667678,7667897,SRX5075168,SMARCA4,219
chr1,7667680,7667974,SRX5716470,SMARCA4,294
chr1,7667683,7667906,SRX5075175,SMARCA4,223
chr1,7667684,7667939,SRX5075169,SMARCA4,255
chr1,7667691,7667951,SRX5075176,SMARCA4,260
chr1,7667736,7667970,SRX5716469,SMARCA4,234
chr1,7668417,7669006,SRX5075168,SMARCA4,589
chr1,7668469,7669012,SRX5716463,SMARCA4,543
chr1,7668473,7668802,SRX20140880,CPSF3L,329
chr1,7668488,7669126,SRX5075174,SMARCA4,638
chr1,7668501,7668834,SRX5716464,SMARCA4,333
chr1,7668511,7668861,SRX5716470,SMARCA4,350
chr1,7668525,7669028,SRX5075170,SMARCA4,503
chr1,7668535,7668833,SRX5716454,SOX3,298
chr1,7668545,7669061,SRX5716469,SMARCA4,516
chr1,7668546,7668979,SRX5075176,SMARCA4,433
chr1,7668548,7668940,SRX20140868,INTS10,392
chr1,7668553,7668833,SRX5054309,FOSL2,280
chr1,7668556,7669345,SRX20140895,INTS13,789
chr1,7668561,7668844,SRX5716451,SOX2,283
chr1,7668564,7669074,SRX20140867,INTS10,510
chr1,7668567,7668846,SRX20140879,CPSF3L,279
chr1,7668567,7668903,SRX5716467,SMARCA2,336
chr1,7668582,7668772,SRX5054307,FOSL2,190
chr1,7668584,7668856,SRX5075175,SMARCA4,272
chr1,7668588,7668841,SRX5054308,FOSL2,253
chr1,7668593,7668893,SRX5075169,SMARCA4,300
chr1,7668597,7668676,SRX1424894,POU3F2,79
chr1,7668609,7668861,SRX20140894,INTS13,252
chr1,7668661,7668708,SRX1424893,POU3F2,47
chr1,7668670,7668955,SRX20140881,CPSF3L,285
chr1,7669356,7669843,SRX16500061,CTCF,487
chr1,7669433,7669843,SRX16500060,CTCF,410
chr1,7669438,7669882,SRX16500059,CTCF,444
chr1,7669458,7669831,SRX16500062,CTCF,373
chr1,7680008,7681108,SRX20140895,INTS13,1100
chr1,7680084,7680486,SRX5075168,SMARCA4,402
chr1,7680088,7681079,SRX20140868,INTS10,991
chr1,7680165,7681060,SRX5716470,SMARCA4,895
chr1,7680167,7680629,SRX5075176,SMARCA4,462
chr1,7680181,7680952,SRX5075169,SMARCA4,771
chr1,7680198,7681074,SRX5075174,SMARCA4,876
chr1,7680230,7680687,SRX5075170,SMARCA4,457
chr1,7680387,7680680,SRX20140867,INTS10,293
chr1,7680395,7680964,SRX5075175,SMARCA4,569
chr1,7680556,7681119,SRX5075168,SMARCA4,563
chr1,7704000,7704934,SRX20140867,INTS10,934
chr1,7704261,7704753,SRX20140896,INTS13,492
chr1,7704518,7704857,SRX20140895,INTS13,339
chr1,7704542,7704805,SRX5075168,SMARCA4,263
chr1,7704543,7704843,SRX5075176,SMARCA4,300
chr1,7704610,7704815,SRX5075170,SMARCA4,205
chr1,7704675,7704861,SRX5075174,SMARCA4,186
chr1,7728067,7728302,SRX20140867,INTS10,235
chr1,7752550,7752994,SRX5075169,SMARCA4,444
chr1,7752600,7753181,SRX5075168,SMARCA4,581
chr1,7752667,7753355,SRX4174629,CTCF,688
chr1,7752679,7753099,SRX5716463,SMARCA4,420
chr1,7752700,7753107,SRX5716470,SMARCA4,407
chr1,7752721,7753241,SRX5075174,SMARCA4,520
chr1,7752732,7753309,SRX16500060,CTCF,577
chr1,7752737,7753248,SRX16500059,CTCF,511
chr1,7752757,7753243,SRX16500061,CTCF,486
chr1,7752772,7753127,SRX5075170,SMARCA4,355
chr1,7752787,7753253,SRX16500062,CTCF,466
chr1,7752794,7753006,SRX5716469,SMARCA4,212
chr1,7752804,7753162,SRX5716464,SMARCA4,358
chr1,7752847,7753100,SRX5075176,SMARCA4,253
chr1,7752860,7753088,SRX5075175,SMARCA4,228
chr1,7770951,7771507,SRX20140895,INTS13,556
chr1,7770973,7771153,SRX5075169,SMARCA4,180
chr1,7770975,7771502,SRX5075168,SMARCA4,527
chr1,7770976,7771192,SRX5075176,SMARCA4,216
chr1,7770987,7771187,SRX5075175,SMARCA4,200
chr1,7771024,7771444,SRX5075174,SMARCA4,420
chr1,7771031,7771410,SRX5075170,SMARCA4,379
chr1,7771060,7771363,SRX5716469,SMARCA4,303
chr1,7771151,7771330,SRX5054307,FOSL2,179
chr1,7771246,7771508,SRX20140868,INTS10,262
chr1,7783858,7784298,SRX5075174,SMARCA4,440
chr1,7783871,7784513,SRX20140895,INTS13,642
chr1,7783928,7784263,SRX5054307,FOSL2,335
chr1,7783943,7784214,SRX5075170,SMARCA4,271
chr1,7783945,7784183,SRX5054309,FOSL2,238
chr1,7783963,7784282,SRX5075176,SMARCA4,319
chr1,7783969,7784191,SRX5054308,FOSL2,222
chr1,7783969,7784294,SRX5075168,SMARCA4,325
chr1,7784000,7784289,SRX20140897,INTS13,289
chr1,7784027,7784255,SRX5716451,SOX2,228
chr1,7784027,7784425,SRX5075169,SMARCA4,398
chr1,7784031,7784390,SRX20140867,INTS10,359
chr1,7808256,7808703,SRX16500061,CTCF,447
chr1,7808273,7808691,SRX16500060,CTCF,418
chr1,7808285,7808728,SRX16500062,CTCF,443
chr1,7808299,7808717,SRX16500059,CTCF,418
chr1,7808370,7808556,SRX5075170,SMARCA4,186
chr1,7808384,7808575,SRX5075168,SMARCA4,191
chr1,7810402,7810748,SRX5075175,SMARCA4,346
chr1,7810408,7810677,SRX5054308,FOSL2,269
chr1,7810412,7810755,SRX5075176,SMARCA4,343
chr1,7810423,7810787,SRX5075169,SMARCA4,364
chr1,7810445,7810720,SRX5075170,SMARCA4,275
chr1,7810446,7810757,SRX5054309,FOSL2,311
chr1,7810484,7810696,SRX5716469,SMARCA4,212
chr1,7810492,7810678,SRX5075174,SMARCA4,186
chr1,7847615,7847935,SRX5075176,SMARCA4,320
chr1,7847623,7847954,SRX5075170,SMARCA4,331
chr1,7847625,7847950,SRX5716469,SMARCA4,325
chr1,7847680,7848017,SRX5075175,SMARCA4,337
chr1,7847690,7847968,SRX5075169,SMARCA4,278
chr1,7847691,7847964,SRX5054308,FOSL2,273
chr1,7847706,7847975,SRX5054309,FOSL2,269
chr1,7873957,7874162,SRX5075168,SMARCA4,205
chr1,7886441,7886668,SRX5075176,SMARCA4,227
chr1,7893768,7894153,SRX5075176,SMARCA4,385
chr1,7893794,7894082,SRX5716469,SMARCA4,288
chr1,7893801,7894209,SRX5075169,SMARCA4,408
chr1,7893809,7894179,SRX5075175,SMARCA4,370
chr1,7893825,7894138,SRX5075170,SMARCA4,313
chr1,7893831,7894086,SRX5716470,SMARCA4,255
chr1,7893886,7894140,SRX5716467,SMARCA2,254
chr1,7902641,7903067,SRX16500060,CTCF,426
chr1,7902656,7903150,SRX4174629,CTCF,494
chr1,7902660,7903108,SRX16500059,CTCF,448
chr1,7902689,7903053,SRX16500062,CTCF,364
chr1,7902722,7903109,SRX16500061,CTCF,387
chr1,7902725,7902995,SRX5716470,SMARCA4,270
chr1,7902744,7903010,SRX5075168,SMARCA4,266
chr1,7902756,7903024,SRX5075174,SMARCA4,268
chr1,7902771,7903035,SRX5075170,SMARCA4,264
chr1,7902778,7902965,SRX5075175,SMARCA4,187
chr1,7902795,7903018,SRX5075176,SMARCA4,223
chr1,7920481,7920933,SRX5075168,SMARCA4,452
chr1,7920543,7920933,SRX5075174,SMARCA4,390
chr1,7920582,7920841,SRX5075170,SMARCA4,259
chr1,7920644,7920898,SRX5075176,SMARCA4,254
chr1,7920647,7920900,SRX5054309,FOSL2,253
chr1,7922429,7922643,SRX5075169,SMARCA4,214
chr1,7942342,7942631,SRX16500059,CTCF,289
chr1,7942346,7942521,SRX5075176,SMARCA4,175
chr1,7942354,7942610,SRX5075168,SMARCA4,256
chr1,7942375,7942568,SRX5075174,SMARCA4,193
chr1,7942379,7942591,SRX5716470,SMARCA4,212
chr1,7942380,7942635,SRX16500060,CTCF,255
chr1,7948949,7949357,SRX5054309,FOSL2,408
chr1,7948998,7949298,SRX5054308,FOSL2,300
chr1,7949019,7949353,SRX5075169,SMARCA4,334
chr1,7949039,7949208,SRX5075170,SMARCA4,169
chr1,7949048,7949324,SRX5075175,SMARCA4,276
chr1,7956635,7956819,SRX5054309,FOSL2,184
chr1,7961121,7961550,SRX16500061,CTCF,429
chr1,7961149,7961669,SRX5075174,SMARCA4,520
chr1,7961150,7961893,SRX20140895,INTS13,743
chr1,7961170,7961576,SRX20140879,CPSF3L,406
chr1,7961194,7961542,SRX16500060,CTCF,348
chr1,7961206,7961664,SRX20140897,INTS13,458
chr1,7961216,7961533,SRX16500062,CTCF,317
chr1,7961217,7961512,SRX20140869,INTS10,295
chr1,7961221,7961594,SRX5716470,SMARCA4,373
chr1,7961222,7961926,SRX5075168,SMARCA4,704
chr1,7961231,7961526,SRX20140881,CPSF3L,295
chr1,7961244,7961635,SRX5075176,SMARCA4,391
chr1,7961246,7961458,SRX5716469,SMARCA4,212
chr1,7961246,7961910,SRX5716464,SMARCA4,664
chr1,7961251,7961518,SRX5075169,SMARCA4,267
chr1,7961268,7962120,SRX5075170,SMARCA4,852
chr1,7961273,7961828,SRX5716463,SMARCA4,555
chr1,7961277,7961959,SRX20140867,INTS10,682
chr1,7961293,7961606,SRX20140896,INTS13,313
chr1,7961298,7961623,SRX16500059,CTCF,325
chr1,7961309,7961694,SRX20140868,INTS10,385
chr1,7961708,7962133,SRX5075169,SMARCA4,425
chr1,7961732,7962058,SRX5075174,SMARCA4,326
chr1,7961748,7961976,SRX5075175,SMARCA4,228
chr1,7961748,7962140,SRX5075176,SMARCA4,392
chr1,7961825,7962036,SRX5716470,SMARCA4,211
chr1,7975191,7975706,SRX16500059,CTCF,515
chr1,7975210,7975719,SRX4174629,CTCF,509
chr1,7975213,7975685,SRX16500061,CTCF,472
chr1,7975216,7975715,SRX16500060,CTCF,499
chr1,7975223,7975723,SRX16500062,CTCF,500
chr1,7975274,7975647,SRX5075168,SMARCA4,373
chr1,7975298,7975649,SRX5075174,SMARCA4,351
chr1,7975306,7975638,SRX5075170,SMARCA4,332
chr1,7975328,7975635,SRX5716463,SMARCA4,307
chr1,7975337,7975637,SRX5075176,SMARCA4,300
chr1,7975359,7975604,SRX5716470,SMARCA4,245
chr1,7975379,7975603,SRX5075169,SMARCA4,224
chr1,7982181,7982810,SRX16500061,CTCF,629
chr1,7982192,7982803,SRX16500059,CTCF,611
chr1,7982223,7982728,SRX16500060,CTCF,505
chr1,7982249,7982766,SRX16500062,CTCF,517
chr1,7982299,7982712,SRX4174629,CTCF,413
chr1,7982317,7982708,SRX5075168,SMARCA4,391
chr1,7982323,7982627,SRX5075170,SMARCA4,304
chr1,7982335,7982678,SRX5716463,SMARCA4,343
chr1,7982359,7982635,SRX5075176,SMARCA4,276
chr1,7982384,7982622,SRX5075174,SMARCA4,238
chr1,7982390,7982603,SRX5075175,SMARCA4,213
chr1,7982414,7982619,SRX5716464,SMARCA4,205
chr1,7982450,7982683,SRX5716470,SMARCA4,233
chr1,7982451,7982689,SRX5075169,SMARCA4,238
chr1,7994049,7994378,SRX5716469,SMARCA4,329
chr1,7994107,7994362,SRX5020211,SMARCA2,255
chr1,7994109,7994457,SRX5054308,FOSL2,348
chr1,7994112,7994390,SRX5075170,SMARCA4,278
chr1,7994134,7994443,SRX5075176,SMARCA4,309
chr1,7994160,7994473,SRX5075175,SMARCA4,313
chr1,7994175,7994449,SRX5075169,SMARCA4,274
chr1,7994190,7994434,SRX5054309,FOSL2,244
chr1,8004895,8005359,SRX5075176,SMARCA4,464
chr1,8004905,8005411,SRX5075169,SMARCA4,506
chr1,8004934,8005218,SRX5054308,FOSL2,284
chr1,8004934,8005272,SRX5075175,SMARCA4,338
chr1,8005298,8005513,SRX5716470,SMARCA4,215
chr1,8014928,8015358,SRX16500062,CTCF,430
chr1,8014935,8015414,SRX16500060,CTCF,479
chr1,8014955,8015417,SRX16500061,CTCF,462
chr1,8014958,8015451,SRX16500059,CTCF,493
chr1,8014964,8015222,SRX5054308,FOSL2,258
chr1,8015027,8015404,SRX4174629,CTCF,377
chr1,8015031,8015304,SRX5075176,SMARCA4,273
chr1,8015053,8015273,SRX5075169,SMARCA4,220
chr1,8015053,8015304,SRX5075174,SMARCA4,251
chr1,8015055,8015317,SRX5075168,SMARCA4,262
chr1,8015060,8015292,SRX5075170,SMARCA4,232
chr1,8018712,8019049,SRX5075168,SMARCA4,337
chr1,8018724,8019050,SRX5716463,SMARCA4,326
chr1,8018761,8019164,SRX5075174,SMARCA4,403
chr1,8018777,8019056,SRX5716454,SOX3,279
chr1,8018798,8019008,SRX5716451,SOX2,210
chr1,8018889,8019225,SRX20140895,INTS13,336
chr1,8020124,8020320,SRX5075170,SMARCA4,196
chr1,8020146,8020364,SRX5054309,FOSL2,218
chr1,8020148,8020339,SRX5054308,FOSL2,191
chr1,8025957,8026790,SRX20140895,INTS13,833
chr1,8025989,8026617,SRX20140867,INTS10,628
chr1,8025995,8026584,SRX20140881,CPSF3L,589
chr1,8026000,8026605,SRX20140879,CPSF3L,605
chr1,8026010,8026747,SRX20140869,INTS10,737
chr1,8026025,8026710,SRX20140868,INTS10,685
chr1,8026031,8026643,SRX5075168,SMARCA4,612
chr1,8026043,8026672,SRX5075174,SMARCA4,629
chr1,8026047,8026418,SRX20140882,CPSF3L,371
chr1,8026047,8026534,SRX20140894,INTS13,487
chr1,8026050,8026339,SRX5716463,SMARCA4,289
chr1,8026082,8026512,SRX20140896,INTS13,430
chr1,8026091,8026715,SRX20140897,INTS13,624
chr1,8026113,8026480,SRX20140880,CPSF3L,367
chr1,8026135,8026501,SRX20140870,INTS10,366
chr1,8026155,8026684,SRX5075170,SMARCA4,529
chr1,8026294,8026562,SRX5716464,SMARCA4,268
chr1,8026334,8026645,SRX5075176,SMARCA4,311
chr1,8026426,8026663,SRX5075169,SMARCA4,237
chr1,8028006,8028237,SRX5054309,FOSL2,231
chr1,8031074,8031598,SRX16500059,CTCF,524
chr1,8031125,8031585,SRX16500062,CTCF,460
chr1,8031156,8031591,SRX16500060,CTCF,435
chr1,8031195,8031659,SRX16500061,CTCF,464
chr1,8040557,8040993,SRX5075169,SMARCA4,436
chr1,8040557,8041031,SRX5075176,SMARCA4,474
chr1,8040558,8041027,SRX5075175,SMARCA4,469
chr1,8040572,8041033,SRX5075170,SMARCA4,461
chr1,8040577,8041007,SRX5716469,SMARCA4,430
chr1,8040603,8040965,SRX5054309,FOSL2,362
chr1,8040615,8040987,SRX5054308,FOSL2,372
chr1,8040656,8040944,SRX5020214,SMARCA2,288
chr1,8040674,8040971,SRX5716470,SMARCA4,297
chr1,8040674,8040980,SRX5020211,SMARCA2,306
chr1,8040698,8040968,SRX5716467,SMARCA2,270
chr1,8047663,8048370,SRX5075169,SMARCA4,707
chr1,8047681,8048481,SRX5075176,SMARCA4,800
chr1,8047711,8048518,SRX5075170,SMARCA4,807
chr1,8047731,8048361,SRX5075175,SMARCA4,630
chr1,8047740,8048088,SRX5054309,FOSL2,348
chr1,8047746,8048229,SRX5716470,SMARCA4,483
chr1,8047753,8048320,SRX5716467,SMARCA2,567
chr1,8047763,8048273,SRX5716469,SMARCA4,510
chr1,8047793,8048075,SRX5054308,FOSL2,282
chr1,8047835,8048162,SRX5020214,SMARCA2,327
chr1,8047889,8048127,SRX5020211,SMARCA2,238
chr1,8047904,8048200,SRX5716468,SMARCA2,296
chr1,8056040,8056313,SRX5054308,FOSL2,273
chr1,8056059,8056305,SRX5054309,FOSL2,246
chr1,8056060,8056267,SRX5075169,SMARCA4,207
chr1,8056143,8056325,SRX5075170,SMARCA4,182
chr1,8059322,8059511,SRX5075175,SMARCA4,189
chr1,8061259,8061536,SRX5054309,FOSL2,277
chr1,8061273,8061559,SRX5054308,FOSL2,286
chr1,8061280,8061567,SRX5716470,SMARCA4,287
chr1,8061285,8061600,SRX5075169,SMARCA4,315
chr1,8061288,8061579,SRX5075176,SMARCA4,291
chr1,8061307,8061595,SRX5075175,SMARCA4,288
chr1,8061311,8061558,SRX5020211,SMARCA2,247
chr1,8061323,8061603,SRX5075170,SMARCA4,280
chr1,8077055,8077617,SRX5075176,SMARCA4,562
chr1,8077108,8077514,SRX5716467,SMARCA2,406
chr1,8077118,8077583,SRX5075170,SMARCA4,465
chr1,8077141,8077610,SRX5075169,SMARCA4,469
chr1,8077145,8077507,SRX5716469,SMARCA4,362
chr1,8077153,8077534,SRX5075175,SMARCA4,381
chr1,8077155,8077464,SRX5716470,SMARCA4,309
chr1,8077160,8077511,SRX5020211,SMARCA2,351
chr1,8077162,8077489,SRX5716468,SMARCA2,327
chr1,8077171,8077559,SRX5054308,FOSL2,388
chr1,8077193,8077547,SRX5054309,FOSL2,354
chr1,8077258,8077463,SRX5020214,SMARCA2,205
chr1,8078235,8078575,SRX5054309,FOSL2,340
chr1,8078252,8078639,SRX5075169,SMARCA4,387
chr1,8078253,8078770,SRX5054308,FOSL2,517
chr1,8078286,8078584,SRX5075176,SMARCA4,298
chr1,8078293,8078619,SRX5075170,SMARCA4,326
chr1,8078322,8078576,SRX5075174,SMARCA4,254
chr1,8078345,8078533,SRX5075175,SMARCA4,188
chr1,8078437,8078713,SRX5716470,SMARCA4,276
chr1,8078528,8078730,SRX5020211,SMARCA2,202
chr1,8083686,8084117,SRX5075170,SMARCA4,431
chr1,8083708,8084247,SRX5075176,SMARCA4,539
chr1,8083724,8084096,SRX5075175,SMARCA4,372
chr1,8083730,8084137,SRX5075169,SMARCA4,407
chr1,8083860,8084236,SRX5054308,FOSL2,376
chr1,8083917,8084247,SRX5716470,SMARCA4,330
chr1,8083929,8084141,SRX5054309,FOSL2,212
chr1,8090041,8090707,SRX5075169,SMARCA4,666
chr1,8090135,8090689,SRX5075170,SMARCA4,554
chr1,8090141,8090692,SRX5075176,SMARCA4,551
chr1,8090144,8090592,SRX5020211,SMARCA2,448
chr1,8090163,8090675,SRX5716469,SMARCA4,512
chr1,8090166,8090692,SRX5054309,FOSL2,526
chr1,8090180,8090706,SRX5075175,SMARCA4,526
chr1,8090188,8090465,SRX5716470,SMARCA4,277
chr1,8090195,8090679,SRX5054308,FOSL2,484
chr1,8090209,8090648,SRX5716467,SMARCA2,439
chr1,8090226,8090618,SRX5020214,SMARCA2,392
chr1,8090257,8090486,SRX5075182,SMARCA2,229
chr1,8090363,8090657,SRX5716460,Epitope tags,294
chr1,8094662,8094841,SRX5075176,SMARCA4,179
chr1,8096547,8096991,SRX5054309,FOSL2,444
chr1,8096562,8096973,SRX5075169,SMARCA4,411
chr1,8096610,8096842,SRX5075175,SMARCA4,232
chr1,8096611,8096972,SRX5054308,FOSL2,361
chr1,8096638,8096979,SRX5075170,SMARCA4,341
chr1,8096714,8096940,SRX5716469,SMARCA4,226
chr1,8096728,8096971,SRX5075176,SMARCA4,243
chr1,8097412,8097884,SRX5075175,SMARCA4,472
chr1,8097414,8097890,SRX5054308,FOSL2,476
chr1,8097421,8097855,SRX5075170,SMARCA4,434
chr1,8097429,8097850,SRX5075169,SMARCA4,421
chr1,8097440,8097871,SRX5054309,FOSL2,431
chr1,8097468,8097890,SRX5075176,SMARCA4,422
chr1,8097499,8097754,SRX5716467,SMARCA2,255
chr1,8097521,8097843,SRX5716470,SMARCA4,322
chr1,8097529,8097821,SRX5020214,SMARCA2,292
chr1,8097537,8097821,SRX20140869,INTS10,284
chr1,8097560,8097809,SRX5020211,SMARCA2,249
chr1,8097572,8097851,SRX5716469,SMARCA4,279
chr1,8097650,8097895,SRX5075168,SMARCA4,245
chr1,8113235,8113454,SRX5075176,SMARCA4,219
chr1,8113248,8113461,SRX5075174,SMARCA4,213
chr1,8113250,8113570,SRX5075168,SMARCA4,320
chr1,8116912,8117266,SRX5075175,SMARCA4,354
chr1,8116942,8117281,SRX5075170,SMARCA4,339
chr1,8116943,8117241,SRX5054308,FOSL2,298
chr1,8116946,8117284,SRX5716470,SMARCA4,338
chr1,8116946,8117292,SRX5075169,SMARCA4,346
chr1,8116984,8117283,SRX5075176,SMARCA4,299
chr1,8116984,8117323,SRX5716467,SMARCA2,339
chr1,8116985,8117284,SRX5716468,SMARCA2,299
chr1,8116989,8117303,SRX5716469,SMARCA4,314
chr1,8117004,8117290,SRX5020211,SMARCA2,286
chr1,8117006,8117201,SRX5054309,FOSL2,195
chr1,8117024,8117278,SRX5075181,SMARCA2,254
chr1,8120909,8121719,SRX5075168,SMARCA4,810
chr1,8120916,8121699,SRX5075174,SMARCA4,783
chr1,8121202,8121726,SRX5075176,SMARCA4,524
chr1,8121239,8121569,SRX20140895,INTS13,330
chr1,8121241,8121712,SRX5716469,SMARCA4,471
chr1,8121252,8121713,SRX5075175,SMARCA4,461
chr1,8121271,8121740,SRX5075170,SMARCA4,469
chr1,8121286,8121658,SRX5716468,SMARCA2,372
chr1,8121288,8121674,SRX5716470,SMARCA4,386
chr1,8121293,8121685,SRX5075169,SMARCA4,392
chr1,8121309,8121676,SRX5054309,FOSL2,367
chr1,8121314,8121630,SRX5716467,SMARCA2,316
chr1,8121334,8121680,SRX5716463,SMARCA4,346
chr1,8121346,8121643,SRX5054308,FOSL2,297
chr1,8121347,8121580,SRX5020214,SMARCA2,233
chr1,8121349,8121648,SRX20140867,INTS10,299
chr1,8133544,8134336,SRX5075170,SMARCA4,792
chr1,8133544,8134415,SRX5075176,SMARCA4,871
chr1,8133584,8133926,SRX5054309,FOSL2,342
chr1,8133619,8133916,SRX5054308,FOSL2,297
chr1,8133623,8134272,SRX5075175,SMARCA4,649
chr1,8133655,8134427,SRX5075169,SMARCA4,772
chr1,8133687,8133913,SRX5716467,SMARCA2,226
chr1,8133696,8134250,SRX5716469,SMARCA4,554
chr1,8133740,8133944,SRX5020211,SMARCA2,204
chr1,8133759,8134388,SRX5716470,SMARCA4,629
chr1,8133806,8134176,SRX5716468,SMARCA2,370
chr1,8134095,8134294,SRX5054308,FOSL2,199
chr1,8134112,8134347,SRX5054309,FOSL2,235
chr1,8137684,8138184,SRX5075170,SMARCA4,500
chr1,8137712,8138184,SRX5075174,SMARCA4,472
chr1,8137719,8138101,SRX5054309,FOSL2,382
chr1,8137728,8138044,SRX5020211,SMARCA2,316
chr1,8137730,8138195,SRX5075169,SMARCA4,465
chr1,8137750,8138020,SRX5716470,SMARCA4,270
chr1,8137759,8138143,SRX5054308,FOSL2,384
chr1,8137769,8138160,SRX5075176,SMARCA4,391
chr1,8137772,8138036,SRX5716469,SMARCA4,264
chr1,8137784,8138184,SRX5075168,SMARCA4,400
chr1,8137792,8138037,SRX5020214,SMARCA2,245
chr1,8137801,8138145,SRX5075175,SMARCA4,344
chr1,8137833,8138054,SRX5716467,SMARCA2,221
chr1,8142886,8143388,SRX5054309,FOSL2,502
chr1,8142889,8143474,SRX5716470,SMARCA4,585
chr1,8142904,8143348,SRX5075170,SMARCA4,444
chr1,8142912,8143404,SRX5075176,SMARCA4,492
chr1,8142926,8143212,SRX5716467,SMARCA2,286
chr1,8142929,8143280,SRX5020214,SMARCA2,351
chr1,8142932,8143343,SRX5054308,FOSL2,411
chr1,8142933,8143319,SRX5075169,SMARCA4,386
chr1,8142935,8143372,SRX5075175,SMARCA4,437
chr1,8142945,8143274,SRX5020211,SMARCA2,329
chr1,8142953,8143334,SRX5075174,SMARCA4,381
chr1,8142965,8143295,SRX5716468,SMARCA2,330
chr1,8142984,8143396,SRX5716469,SMARCA4,412
chr1,8143002,8143224,SRX5075168,SMARCA4,222
chr1,8154631,8155116,SRX5075170,SMARCA4,485
chr1,8154667,8154936,SRX5020211,SMARCA2,269
chr1,8154670,8155030,SRX5716470,SMARCA4,360
chr1,8154670,8155068,SRX5075168,SMARCA4,398
chr1,8154681,8155051,SRX5075169,SMARCA4,370
chr1,8154684,8155064,SRX5075174,SMARCA4,380
chr1,8154687,8154920,SRX5716464,SMARCA4,233
chr1,8154691,8155074,SRX5716469,SMARCA4,383
chr1,8154710,8155093,SRX5075176,SMARCA4,383
chr1,8154715,8154981,SRX5054308,FOSL2,266
chr1,8154730,8154983,SRX5075181,SMARCA2,253
chr1,8154767,8155067,SRX5075175,SMARCA4,300
chr1,8154805,8154988,SRX5054309,FOSL2,183
chr1,8155432,8155714,SRX5075170,SMARCA4,282
chr1,8155452,8155765,SRX5075176,SMARCA4,313
chr1,8155478,8155776,SRX5054309,FOSL2,298
chr1,8155507,8155712,SRX5054308,FOSL2,205
chr1,8165701,8165944,SRX16500059,CTCF,243
chr1,8165722,8165987,SRX16500060,CTCF,265
chr1,8167161,8167392,SRX5075170,SMARCA4,231
chr1,8167262,8167526,SRX5054308,FOSL2,264
chr1,8169337,8169620,SRX5054309,FOSL2,283
chr1,8169345,8170029,SRX5075176,SMARCA4,684
chr1,8169348,8169539,SRX5075170,SMARCA4,191
chr1,8169354,8170013,SRX5075169,SMARCA4,659
chr1,8169414,8169703,SRX5716469,SMARCA4,289
chr1,8169418,8169874,SRX5075175,SMARCA4,456
chr1,8169654,8170116,SRX5075170,SMARCA4,462
chr1,8169720,8169924,SRX5020211,SMARCA2,204
chr1,8182491,8182680,SRX5054309,FOSL2,189
chr1,8189937,8190148,SRX5020211,SMARCA2,211
chr1,8189959,8190180,SRX5054308,FOSL2,221
chr1,8189965,8190187,SRX5075169,SMARCA4,222
chr1,8194016,8194310,SRX5075170,SMARCA4,294
chr1,8197694,8198071,SRX5075176,SMARCA4,377
chr1,8197703,8198006,SRX5075175,SMARCA4,303
chr1,8197703,8198006,SRX5716469,SMARCA4,303
chr1,8197713,8198044,SRX5075169,SMARCA4,331
chr1,8197718,8198022,SRX5075170,SMARCA4,304
chr1,8197720,8198007,SRX5716470,SMARCA4,287
chr1,8197731,8198001,SRX5716467,SMARCA2,270
chr1,8197778,8198015,SRX5054308,FOSL2,237
chr1,8197784,8197976,SRX5054309,FOSL2,192
chr1,8211823,8212322,SRX5716469,SMARCA4,499
chr1,8211824,8212321,SRX5075170,SMARCA4,497
chr1,8211828,8212297,SRX5075169,SMARCA4,469
chr1,8211830,8212244,SRX5075175,SMARCA4,414
chr1,8211849,8212257,SRX5716470,SMARCA4,408
chr1,8211871,8212299,SRX5075176,SMARCA4,428
chr1,8211891,8212142,SRX5020214,SMARCA2,251
chr1,8211896,8212209,SRX5716468,SMARCA2,313
chr1,8211907,8212194,SRX5716459,Epitope tags,287
chr1,8211920,8212245,SRX5054309,FOSL2,325
chr1,8211931,8212242,SRX5075174,SMARCA4,311
chr1,8211933,8212244,SRX5054308,FOSL2,311
chr1,8211961,8212305,SRX5716467,SMARCA2,344
chr1,8238115,8238373,SRX5075174,SMARCA4,258
chr1,8238178,8238429,SRX5054309,FOSL2,251
chr1,8238216,8238431,SRX5075168,SMARCA4,215
chr1,8238344,8238513,SRX5075170,SMARCA4,169
chr1,8259196,8259781,SRX5075176,SMARCA4,585
chr1,8259444,8259830,SRX5075169,SMARCA4,386
chr1,8259466,8259752,SRX5075175,SMARCA4,286
chr1,8259480,8259763,SRX5075170,SMARCA4,283
chr1,8259490,8259789,SRX5054308,FOSL2,299
chr1,8259499,8259746,SRX5054309,FOSL2,247
chr1,8259583,8259800,SRX5716470,SMARCA4,217
chr1,8266340,8266812,SRX20140895,INTS13,472
chr1,8266452,8266845,SRX20140868,INTS10,393
chr1,8266547,8266752,SRX5716454,SOX3,205
chr1,8266556,8266729,SRX5075174,SMARCA4,173
chr1,8284185,8284397,SRX5716469,SMARCA4,212
chr1,8284237,8284470,SRX5054308,FOSL2,233
chr1,8284252,8284460,SRX5054309,FOSL2,208
chr1,8284273,8284468,SRX5075175,SMARCA4,195
chr1,8314173,8314622,SRX4174629,CTCF,449
chr1,8314251,8314752,SRX16500059,CTCF,501
chr1,8314256,8314748,SRX16500060,CTCF,492
chr1,8314262,8314730,SRX16500061,CTCF,468
chr1,8314278,8314697,SRX16500062,CTCF,419
chr1,8314324,8314499,SRX5075176,SMARCA4,175
chr1,8314348,8314595,SRX5075174,SMARCA4,247
chr1,8314369,8314548,SRX5075168,SMARCA4,179
chr1,8317862,8318322,SRX20140895,INTS13,460
chr1,8317915,8318221,SRX5075174,SMARCA4,306
chr1,8317919,8318310,SRX5716470,SMARCA4,391
chr1,8317922,8318196,SRX5075176,SMARCA4,274
chr1,8317926,8318218,SRX5075169,SMARCA4,292
chr1,8317935,8318296,SRX5075168,SMARCA4,361
chr1,8317947,8318258,SRX5075175,SMARCA4,311
chr1,8317978,8318259,SRX5075170,SMARCA4,281
chr1,8343360,8343760,SRX5054309,FOSL2,400
chr1,8343375,8343764,SRX5075174,SMARCA4,389
chr1,8343381,8343641,SRX5716460,Epitope tags,260
chr1,8343401,8343855,SRX5075170,SMARCA4,454
chr1,8343403,8343797,SRX5716470,SMARCA4,394
chr1,8343404,8343716,SRX5054308,FOSL2,312
chr1,8343410,8343774,SRX5075175,SMARCA4,364
chr1,8343414,8343791,SRX5075169,SMARCA4,377
chr1,8343422,8343928,SRX5075176,SMARCA4,506
chr1,8343423,8343795,SRX5716469,SMARCA4,372
chr1,8343440,8343743,SRX5020211,SMARCA2,303
chr1,8343444,8343854,SRX5716467,SMARCA2,410
chr1,8343458,8343783,SRX5075168,SMARCA4,325
chr1,8343490,8343752,SRX5020214,SMARCA2,262
chr1,8348906,8349387,SRX16500060,CTCF,481
chr1,8348940,8349280,SRX5075174,SMARCA4,340
chr1,8348953,8349405,SRX16500061,CTCF,452
chr1,8348954,8349420,SRX16500059,CTCF,466
chr1,8348955,8349399,SRX16500062,CTCF,444
chr1,8348982,8349235,SRX5075168,SMARCA4,253
chr1,8349042,8349222,SRX5075170,SMARCA4,180
chr1,8349107,8349317,SRX4174629,CTCF,210
chr1,8351616,8351986,SRX16500060,CTCF,370
chr1,8351680,8352038,SRX16500059,CTCF,358
chr1,8351683,8351969,SRX16500061,CTCF,286
chr1,8351704,8351980,SRX16500062,CTCF,276
chr1,8370467,8370965,SRX5075174,SMARCA4,498
chr1,8370491,8370689,SRX5075170,SMARCA4,198
chr1,8370526,8371061,SRX5075168,SMARCA4,535
chr1,8370578,8370898,SRX20140895,INTS13,320
chr1,8370589,8370826,SRX5716451,SOX2,237
chr1,8370590,8370773,SRX5075176,SMARCA4,183
chr1,8371044,8371261,SRX5075176,SMARCA4,217
chr1,8373505,8374221,SRX5075169,SMARCA4,716
chr1,8373576,8373832,SRX5075170,SMARCA4,256
chr1,8373615,8373806,SRX5075175,SMARCA4,191
chr1,8373633,8374198,SRX5716469,SMARCA4,565
chr1,8373686,8373969,SRX5716467,SMARCA2,283
chr1,8373791,8374203,SRX5075176,SMARCA4,412
chr1,8373935,8374157,SRX5716470,SMARCA4,222
chr1,8373936,8374161,SRX5075170,SMARCA4,225
chr1,8373952,8374208,SRX5075175,SMARCA4,256
chr1,8374867,8375097,SRX16500062,CTCF,230
chr1,8374871,8375162,SRX16500059,CTCF,291
chr1,8382033,8382293,SRX5075176,SMARCA4,260
chr1,8382065,8382285,SRX5075170,SMARCA4,220
chr1,8382103,8382300,SRX5075174,SMARCA4,197
chr1,8394937,8395208,SRX5075169,SMARCA4,271
chr1,8395938,8397208,SRX5075174,SMARCA4,1270
chr1,8396013,8397346,SRX5075168,SMARCA4,1333
chr1,8396260,8396818,SRX5716464,SMARCA4,558
chr1,8396278,8396811,SRX5716463,SMARCA4,533
chr1,8396343,8396820,SRX5716470,SMARCA4,477
chr1,8396387,8396634,SRX5075176,SMARCA4,247
chr1,8396406,8397285,SRX5075170,SMARCA4,879
chr1,8396411,8397369,SRX5716469,SMARCA4,958
chr1,8396421,8397329,SRX5075169,SMARCA4,908
chr1,8396460,8397344,SRX5075175,SMARCA4,884
chr1,8396719,8397340,SRX5075176,SMARCA4,621
chr1,8396778,8397257,SRX5054309,FOSL2,479
chr1,8396865,8397163,SRX20140895,INTS13,298
chr1,8396954,8397271,SRX5716470,SMARCA4,317
chr1,8396994,8397221,SRX5054308,FOSL2,227
chr1,8408126,8408710,SRX5075175,SMARCA4,584
chr1,8408133,8408400,SRX5716468,SMARCA2,267
chr1,8408162,8408735,SRX5075176,SMARCA4,573
chr1,8408168,8408749,SRX5075170,SMARCA4,581
chr1,8408174,8408820,SRX5716470,SMARCA4,646
chr1,8408200,8408722,SRX5075169,SMARCA4,522
chr1,8408201,8408683,SRX5716469,SMARCA4,482
chr1,8408428,8408702,SRX5716467,SMARCA2,274
chr1,8409089,8409551,SRX16500060,CTCF,462
chr1,8409097,8409525,SRX16500061,CTCF,428
chr1,8409149,8409516,SRX4174629,CTCF,367
chr1,8409162,8409538,SRX5075174,SMARCA4,376
chr1,8409170,8409448,SRX16500059,CTCF,278
chr1,8409173,8409525,SRX5075170,SMARCA4,352
chr1,8409194,8409543,SRX5075176,SMARCA4,349
chr1,8409235,8409535,SRX5075169,SMARCA4,300
chr1,8409254,8409528,SRX5075175,SMARCA4,274
chr1,8409280,8409546,SRX5075168,SMARCA4,266
chr1,8409312,8409530,SRX5716470,SMARCA4,218
chr1,8412243,8412539,SRX5054308,FOSL2,296
chr1,8412280,8412539,SRX5054309,FOSL2,259
chr1,8412328,8412511,SRX5075169,SMARCA4,183
chr1,8423845,8424018,SRX5075174,SMARCA4,173
chr1,8423903,8424484,SRX5075168,SMARCA4,581
chr1,8423924,8424350,SRX20140868,INTS10,426
chr1,8423924,8424430,SRX20140895,INTS13,506
chr1,8424074,8424445,SRX5075174,SMARCA4,371
chr1,8424108,8424575,SRX5075170,SMARCA4,467
chr1,8424170,8424618,SRX5075176,SMARCA4,448
chr1,8424248,8424613,SRX5054309,FOSL2,365
chr1,8424284,8424654,SRX5054308,FOSL2,370
chr1,8438925,8439473,SRX5075174,SMARCA4,548
chr1,8438946,8439340,SRX5716463,SMARCA4,394
chr1,8438949,8439367,SRX5075168,SMARCA4,418
chr1,8438954,8439655,SRX5075176,SMARCA4,701
chr1,8438960,8439426,SRX5075170,SMARCA4,466
chr1,8438966,8439611,SRX5716470,SMARCA4,645
chr1,8438969,8439319,SRX5075169,SMARCA4,350
chr1,8438976,8439306,SRX5716469,SMARCA4,330
chr1,8438980,8439340,SRX5716467,SMARCA2,360
chr1,8439029,8439329,SRX5075175,SMARCA4,300
chr1,8439064,8439269,SRX5716464,SMARCA4,205
chr1,8439536,8439757,SRX16500060,CTCF,221
chr1,8456340,8456721,SRX5075176,SMARCA4,381
chr1,8456341,8456692,SRX5054308,FOSL2,351
chr1,8456345,8456645,SRX5075175,SMARCA4,300
chr1,8456346,8456657,SRX5054309,FOSL2,311
chr1,8456359,8456618,SRX5716469,SMARCA4,259
chr1,8456373,8456654,SRX5075170,SMARCA4,281
chr1,8456377,8456619,SRX5075169,SMARCA4,242
chr1,8456398,8456622,SRX5716470,SMARCA4,224
chr1,8456454,8456633,SRX5054307,FOSL2,179
chr1,8459913,8460490,SRX5075174,SMARCA4,577
chr1,8459946,8460458,SRX5716463,SMARCA4,512
chr1,8459977,8460496,SRX5075168,SMARCA4,519
chr1,8459979,8460342,SRX5716451,SOX2,363
chr1,8460049,8460381,SRX5716464,SMARCA4,332
chr1,8460066,8460419,SRX5716454,SOX3,353
chr1,8460183,8460632,SRX16500062,CTCF,449
chr1,8460221,8460683,SRX16500061,CTCF,462
chr1,8460222,8460629,SRX16500060,CTCF,407
chr1,8460225,8460722,SRX16500059,CTCF,497
chr1,8463069,8463690,SRX5075176,SMARCA4,621
chr1,8463100,8463661,SRX5075175,SMARCA4,561
chr1,8463125,8463434,SRX5716470,SMARCA4,309
chr1,8463132,8463683,SRX5075170,SMARCA4,551
chr1,8463182,8463365,SRX5054309,FOSL2,183
chr1,8463185,8463677,SRX5075169,SMARCA4,492
chr1,8463282,8463524,SRX5716467,SMARCA2,242
chr1,8477279,8477653,SRX5716469,SMARCA4,374
chr1,8480708,8481161,SRX5075174,SMARCA4,453
chr1,8480795,8481182,SRX5075168,SMARCA4,387
chr1,8480839,8481062,SRX5054309,FOSL2,223
chr1,8480890,8481078,SRX5054307,FOSL2,188
chr1,8480902,8481136,SRX5075176,SMARCA4,234
chr1,8480918,8481133,SRX5716463,SMARCA4,215
chr1,8510195,8510838,SRX5075170,SMARCA4,643
chr1,8510206,8510824,SRX5716470,SMARCA4,618
chr1,8510236,8510854,SRX5075176,SMARCA4,618
chr1,8510240,8510805,SRX5075175,SMARCA4,565
chr1,8510294,8510794,SRX5075169,SMARCA4,500
chr1,8510326,8510748,SRX5020211,SMARCA2,422
chr1,8510348,8510762,SRX5716469,SMARCA4,414
chr1,8510401,8510781,SRX5716468,SMARCA2,380
chr1,8510416,8510719,SRX5054308,FOSL2,303
chr1,8510497,8510785,SRX5075181,SMARCA2,288
chr1,8510532,8510796,SRX5716467,SMARCA2,264
chr1,8516849,8517228,SRX5075168,SMARCA4,379
chr1,8516852,8517234,SRX5075174,SMARCA4,382
chr1,8517028,8517426,SRX5075176,SMARCA4,398
chr1,8517153,8517368,SRX5716470,SMARCA4,215
chr1,8517582,8517901,SRX5075176,SMARCA4,319
chr1,8517630,8517905,SRX5716470,SMARCA4,275
chr1,8517637,8517869,SRX5075169,SMARCA4,232
chr1,8517724,8517901,SRX5075170,SMARCA4,177
chr1,8525791,8526328,SRX5075174,SMARCA4,537
chr1,8525820,8526297,SRX5075176,SMARCA4,477
chr1,8525821,8526357,SRX5075168,SMARCA4,536
chr1,8525860,8526305,SRX5075169,SMARCA4,445
chr1,8525864,8526323,SRX5075170,SMARCA4,459
chr1,8525918,8526287,SRX5716470,SMARCA4,369
chr1,8525924,8526225,SRX5020211,SMARCA2,301
chr1,8525924,8526238,SRX5075175,SMARCA4,314
chr1,8525925,8526161,SRX5716468,SMARCA2,236
chr1,8525931,8526166,SRX5054308,FOSL2,235
chr1,8525937,8526153,SRX5054309,FOSL2,216
chr1,8525959,8526286,SRX5716469,SMARCA4,327
chr1,8525980,8526287,SRX5716463,SMARCA4,307
chr1,8526016,8526247,SRX5716464,SMARCA4,231
chr1,8540584,8540893,SRX5054309,FOSL2,309
chr1,8540590,8540860,SRX5075170,SMARCA4,270
chr1,8540592,8540892,SRX5075175,SMARCA4,300
chr1,8540604,8540862,SRX5054308,FOSL2,258
chr1,8540622,8540884,SRX5075176,SMARCA4,262
chr1,8540638,8540978,SRX5716469,SMARCA4,340
chr1,8540663,8540887,SRX5075169,SMARCA4,224
chr1,8552138,8552462,SRX5075168,SMARCA4,324
chr1,8552152,8552486,SRX5075174,SMARCA4,334
chr1,8555091,8555278,SRX5075175,SMARCA4,187
chr1,8555168,8555423,SRX5075176,SMARCA4,255
chr1,8555199,8555423,SRX5075169,SMARCA4,224
chr1,8560920,8561481,SRX16500059,CTCF,561
chr1,8560948,8561475,SRX16500060,CTCF,527
chr1,8560963,8561446,SRX16500062,CTCF,483
chr1,8560983,8561500,SRX16500061,CTCF,517
chr1,8561091,8561466,SRX5075168,SMARCA4,375
chr1,8561116,8561439,SRX5075174,SMARCA4,323
chr1,8561118,8561374,SRX5075170,SMARCA4,256
chr1,8561136,8561441,SRX5075176,SMARCA4,305
chr1,8561146,8561390,SRX5075169,SMARCA4,244
chr1,8561190,8561409,SRX5716463,SMARCA4,219
chr1,8563494,8563709,SRX5075176,SMARCA4,215
chr1,8563565,8563788,SRX5054309,FOSL2,223
chr1,8571055,8571398,SRX16500061,CTCF,343
chr1,8571132,8571414,SRX16500059,CTCF,282
chr1,8571141,8571414,SRX16500060,CTCF,273
chr1,8571165,8571474,SRX5075176,SMARCA4,309
chr1,8571202,8571431,SRX5075175,SMARCA4,229
chr1,8571232,8571463,SRX5075170,SMARCA4,231
chr1,8571240,8571489,SRX5075169,SMARCA4,249
chr1,8571690,8571886,SRX5075174,SMARCA4,196
chr1,8571701,8572036,SRX5075168,SMARCA4,335
chr1,8578552,8578907,SRX5075168,SMARCA4,355
chr1,8578561,8578886,SRX5075174,SMARCA4,325
chr1,8578620,8578824,SRX5716463,SMARCA4,204
chr1,8586585,8586767,SRX5054308,FOSL2,182
chr1,8586664,8586892,SRX5020211,SMARCA2,228
chr1,8598068,8598238,SRX5075170,SMARCA4,170
chr1,8612130,8612572,SRX5075176,SMARCA4,442
chr1,8612163,8612502,SRX5075170,SMARCA4,339
chr1,8612171,8612493,SRX5716470,SMARCA4,322
chr1,8612183,8612418,SRX5020211,SMARCA2,235
chr1,8612213,8612447,SRX5075175,SMARCA4,234
chr1,8612221,8612522,SRX5716467,SMARCA2,301
chr1,8612236,8612507,SRX5716468,SMARCA2,271
chr1,8612276,8612498,SRX5716469,SMARCA4,222
chr1,8612290,8612486,SRX5075169,SMARCA4,196
chr1,8616886,8617100,SRX5054309,FOSL2,214
chr1,8616899,8617084,SRX5054308,FOSL2,185
chr1,8619566,8619795,SRX5075176,SMARCA4,229
chr1,8626422,8626791,SRX5054309,FOSL2,369
chr1,8626449,8626705,SRX5716470,SMARCA4,256
chr1,8626489,8626746,SRX5075175,SMARCA4,257
chr1,8626494,8626758,SRX5716469,SMARCA4,264
chr1,8626595,8626804,SRX5075169,SMARCA4,209
chr1,8629333,8629520,SRX5075170,SMARCA4,187
chr1,8629414,8629765,SRX5075168,SMARCA4,351
chr1,8629439,8629774,SRX5075174,SMARCA4,335
chr1,8629456,8629708,SRX5075176,SMARCA4,252
chr1,8641465,8641750,SRX5075168,SMARCA4,285
chr1,8641480,8641787,SRX5075174,SMARCA4,307
chr1,8641710,8641975,SRX20140895,INTS13,265
chr1,8647572,8647861,SRX5075169,SMARCA4,289
chr1,8647611,8647868,SRX5054309,FOSL2,257
chr1,8647626,8647904,SRX5075175,SMARCA4,278
chr1,8647685,8647948,SRX5054308,FOSL2,263
chr1,8649084,8649312,SRX5075174,SMARCA4,228
chr1,8649100,8649315,SRX5075170,SMARCA4,215
chr1,8649114,8649356,SRX5075168,SMARCA4,242
chr1,8649148,8649344,SRX5075176,SMARCA4,196
chr1,8660396,8660896,SRX5075169,SMARCA4,500
chr1,8660472,8660874,SRX5075176,SMARCA4,402
chr1,8660518,8660859,SRX5716469,SMARCA4,341
chr1,8660523,8660808,SRX5075175,SMARCA4,285
chr1,8660526,8660843,SRX5075170,SMARCA4,317
chr1,8660546,8660763,SRX5054309,FOSL2,217
chr1,8661706,8662082,SRX5075170,SMARCA4,376
chr1,8661737,8661959,SRX5716470,SMARCA4,222
chr1,8661747,8662007,SRX5075176,SMARCA4,260
chr1,8661747,8662092,SRX5075169,SMARCA4,345
chr1,8661767,8662074,SRX5075175,SMARCA4,307
chr1,8661782,8661982,SRX5020211,SMARCA2,200
chr1,8661842,8662047,SRX5054308,FOSL2,205
chr1,8668265,8668468,SRX5075168,SMARCA4,203
chr1,8668307,8668481,SRX5075174,SMARCA4,174
chr1,8671231,8671633,SRX16500061,CTCF,402
chr1,8671266,8671733,SRX16500060,CTCF,467
chr1,8671272,8671702,SRX16500059,CTCF,430
chr1,8671290,8671679,SRX16500062,CTCF,389
chr1,8671327,8671622,SRX5075174,SMARCA4,295
chr1,8671330,8671617,SRX5716463,SMARCA4,287
chr1,8671362,8671585,SRX5716470,SMARCA4,223
chr1,8671365,8671632,SRX5075168,SMARCA4,267
chr1,8671366,8671585,SRX5075169,SMARCA4,219
chr1,8671367,8671594,SRX5716469,SMARCA4,227
chr1,8671367,8671601,SRX5075176,SMARCA4,234
chr1,8671374,8671624,SRX5075170,SMARCA4,250
chr1,8671377,8671622,SRX5075175,SMARCA4,245
chr1,8687003,8687430,SRX5075170,SMARCA4,427
chr1,8687026,8687387,SRX5075176,SMARCA4,361
chr1,8687059,8687331,SRX5075175,SMARCA4,272
chr1,8687106,8687363,SRX5075169,SMARCA4,257
chr1,8687178,8687415,SRX5716467,SMARCA2,237
chr1,8701459,8701760,SRX5075176,SMARCA4,301
chr1,8701488,8701759,SRX5075169,SMARCA4,271
chr1,8702891,8703639,SRX20140895,INTS13,748
chr1,8703029,8703681,SRX20140868,INTS10,652
chr1,8703079,8703632,SRX20140867,INTS10,553
chr1,8703185,8703615,SRX20140896,INTS13,430
chr1,8703228,8703521,SRX20140869,INTS10,293
chr1,8703330,8703605,SRX20140897,INTS13,275
chr1,8703334,8703753,SRX5716470,SMARCA4,419
chr1,8703335,8703760,SRX5075170,SMARCA4,425
chr1,8703346,8703787,SRX5075176,SMARCA4,441
chr1,8703347,8703767,SRX5075174,SMARCA4,420
chr1,8703350,8703750,SRX5075169,SMARCA4,400
chr1,8703358,8703601,SRX5054309,FOSL2,243
chr1,8703360,8703754,SRX5716469,SMARCA4,394
chr1,8703366,8703629,SRX20140879,CPSF3L,263
chr1,8703379,8703759,SRX5075168,SMARCA4,380
chr1,8703386,8703736,SRX5075175,SMARCA4,350
chr1,8703418,8703625,SRX5716464,SMARCA4,207
chr1,8703420,8703643,SRX5716463,SMARCA4,223
chr1,8703435,8703730,SRX5716467,SMARCA2,295
chr1,8703488,8703717,SRX5716468,SMARCA2,229
chr1,8706891,8707297,SRX5716463,SMARCA4,406
chr1,8706891,8707355,SRX5075168,SMARCA4,464
chr1,8706894,8707390,SRX5075174,SMARCA4,496
chr1,8706956,8707311,SRX5716464,SMARCA4,355
chr1,8707002,8707241,SRX5075176,SMARCA4,239
chr1,8707020,8707210,SRX5716451,SOX2,190
chr1,8707024,8707210,SRX5075169,SMARCA4,186
chr1,8707030,8707276,SRX5075170,SMARCA4,246
chr1,8707037,8707257,SRX5716470,SMARCA4,220
chr1,8712210,8713070,SRX5075168,SMARCA4,860
chr1,8712226,8713139,SRX5075174,SMARCA4,913
chr1,8712298,8713145,SRX5054309,FOSL2,847
chr1,8712302,8712803,SRX20140895,INTS13,501
chr1,8712306,8713298,SRX5075176,SMARCA4,992
chr1,8712314,8713259,SRX5075169,SMARCA4,945
chr1,8712325,8713261,SRX5075170,SMARCA4,936
chr1,8712339,8713182,SRX5075175,SMARCA4,843
chr1,8712369,8712869,SRX5716463,SMARCA4,500
chr1,8712409,8712709,SRX5716454,SOX3,300
chr1,8712415,8712788,SRX5716451,SOX2,373
chr1,8712439,8713209,SRX5716467,SMARCA2,770
chr1,8712475,8713119,SRX5054308,FOSL2,644
chr1,8712542,8713216,SRX5716468,SMARCA2,674
chr1,8712555,8713239,SRX5716470,SMARCA4,684
chr1,8712582,8713175,SRX5075181,SMARCA2,593
chr1,8712613,8713248,SRX5716469,SMARCA4,635
chr1,8712757,8713114,SRX5020214,SMARCA2,357
chr1,8712791,8713040,SRX5716464,SMARCA4,249
chr1,8712815,8713225,SRX5020211,SMARCA2,410
chr1,8718944,8719271,SRX5075170,SMARCA4,327
chr1,8718980,8719352,SRX5075168,SMARCA4,372
chr1,8719019,8719219,SRX5075176,SMARCA4,200
chr1,8719039,8719348,SRX5075174,SMARCA4,309
chr1,8726414,8726987,SRX16500059,CTCF,573
chr1,8726478,8726912,SRX16500062,CTCF,434
chr1,8726479,8726949,SRX16500060,CTCF,470
chr1,8726519,8726962,SRX16500061,CTCF,443
chr1,8726520,8726741,SRX4174629,CTCF,221
chr1,8726533,8726779,SRX5075170,SMARCA4,246
chr1,8726563,8726800,SRX5075174,SMARCA4,237
chr1,8726567,8726801,SRX5075176,SMARCA4,234
chr1,8726604,8726802,SRX5075168,SMARCA4,198
chr1,8727035,8727075,SRX1424892,POU3F2,40
chr1,8727981,8728285,SRX5075174,SMARCA4,304
chr1,8727994,8728217,SRX5075168,SMARCA4,223
chr1,8728012,8728208,SRX5075170,SMARCA4,196
chr1,8728014,8728231,SRX5716468,SMARCA2,217
chr1,8740189,8740432,SRX5716469,SMARCA4,243
chr1,8740219,8740498,SRX5075176,SMARCA4,279
chr1,8740222,8740517,SRX5075169,SMARCA4,295
chr1,8740241,8740522,SRX5075170,SMARCA4,281
chr1,8740267,8740473,SRX5054309,FOSL2,206
chr1,8740273,8740517,SRX5075175,SMARCA4,244
chr1,8746570,8746757,SRX5054308,FOSL2,187
chr1,8753022,8753276,SRX5075170,SMARCA4,254
chr1,8753023,8753256,SRX5075176,SMARCA4,233
chr1,8753024,8753239,SRX5054308,FOSL2,215
chr1,8754198,8754637,SRX5075174,SMARCA4,439
chr1,8754260,8754505,SRX5075168,SMARCA4,245
chr1,8815696,8815886,SRX5716451,SOX2,190
chr1,8815704,8815962,SRX5075168,SMARCA4,258
chr1,8817482,8818300,SRX20140895,INTS13,818
chr1,8817520,8817860,SRX20140881,CPSF3L,340
chr1,8817548,8817973,SRX20140879,CPSF3L,425
chr1,8817575,8818060,SRX20140897,INTS13,485
chr1,8817609,8818003,SRX20140896,INTS13,394
chr1,8817650,8818144,SRX5075174,SMARCA4,494
chr1,8817694,8818120,SRX20140867,INTS10,426
chr1,8817700,8818164,SRX20140868,INTS10,464
chr1,8817716,8818186,SRX5075168,SMARCA4,470
chr1,8817731,8817974,SRX5716464,SMARCA4,243
chr1,8817982,8818198,SRX5716470,SMARCA4,216
chr1,8818544,8818812,SRX5054308,FOSL2,268
chr1,8818621,8818805,SRX5054309,FOSL2,184
chr1,8822639,8823129,SRX5075170,SMARCA4,490
chr1,8822643,8823150,SRX5075175,SMARCA4,507
chr1,8822659,8823152,SRX5075176,SMARCA4,493
chr1,8822668,8823106,SRX5075169,SMARCA4,438
chr1,8822694,8823074,SRX5716467,SMARCA2,380
chr1,8822700,8822923,SRX5054309,FOSL2,223
chr1,8822703,8823095,SRX5716469,SMARCA4,392
chr1,8822711,8823100,SRX5716470,SMARCA4,389
chr1,8822771,8823124,SRX5716468,SMARCA2,353
chr1,8822814,8823014,SRX5020211,SMARCA2,200
chr1,8831313,8831786,SRX16500059,CTCF,473
chr1,8831351,8831623,SRX16500060,CTCF,272
chr1,8831359,8831744,SRX16500061,CTCF,385
chr1,8831406,8831657,SRX5075170,SMARCA4,251
chr1,8836333,8836610,SRX5075168,SMARCA4,277
chr1,8836336,8836638,SRX5075176,SMARCA4,302
chr1,8836343,8836554,SRX5716470,SMARCA4,211
chr1,8836371,8836544,SRX5075174,SMARCA4,173
chr1,8836432,8836624,SRX5075169,SMARCA4,192
chr1,8848744,8849154,SRX5716469,SMARCA4,410
chr1,8848755,8849135,SRX5075175,SMARCA4,380
chr1,8848764,8849161,SRX5075176,SMARCA4,397
chr1,8848769,8849172,SRX5716470,SMARCA4,403
chr1,8848783,8849179,SRX5075170,SMARCA4,396
chr1,8848818,8849314,SRX16500062,CTCF,496
chr1,8848827,8849170,SRX5075169,SMARCA4,343
chr1,8848832,8849195,SRX5075174,SMARCA4,363
chr1,8848841,8849324,SRX16500061,CTCF,483
chr1,8848841,8849344,SRX16500060,CTCF,503
chr1,8848845,8849163,SRX5716463,SMARCA4,318
chr1,8848858,8849204,SRX5075168,SMARCA4,346
chr1,8848859,8849320,SRX16500059,CTCF,461
chr1,8848867,8849373,SRX4174629,CTCF,506
chr1,8848962,8849175,SRX5716464,SMARCA4,213
chr1,8858021,8858362,SRX5075174,SMARCA4,341
chr1,8858024,8858414,SRX5075170,SMARCA4,390
chr1,8858033,8858382,SRX5075175,SMARCA4,349
chr1,8858050,8858389,SRX5054309,FOSL2,339
chr1,8858050,8858394,SRX5075168,SMARCA4,344
chr1,8858088,8858356,SRX5716468,SMARCA2,268
chr1,8858088,8858533,SRX5075181,SMARCA2,445
chr1,8858095,8858475,SRX5075169,SMARCA4,380
chr1,8858106,8858444,SRX5075176,SMARCA4,338
chr1,8858114,8858358,SRX5054308,FOSL2,244
chr1,8858162,8858408,SRX5716470,SMARCA4,246
chr1,8858186,8858419,SRX5716467,SMARCA2,233
chr1,8859324,8859814,SRX16500059,CTCF,490
chr1,8859340,8859811,SRX16500060,CTCF,471
chr1,8859404,8859807,SRX16500061,CTCF,403
chr1,8859441,8859790,SRX16500062,CTCF,349
chr1,8859517,8859718,SRX5075176,SMARCA4,201
chr1,8862498,8862788,SRX16500062,CTCF,290
chr1,8862500,8862775,SRX16500060,CTCF,275
chr1,8862510,8862808,SRX16500061,CTCF,298
chr1,8862545,8862807,SRX16500059,CTCF,262
chr1,8871642,8871876,SRX16500060,CTCF,234
chr1,8873474,8873952,SRX5075170,SMARCA4,478
chr1,8873483,8873937,SRX5075176,SMARCA4,454
chr1,8873498,8873945,SRX5075169,SMARCA4,447
chr1,8873512,8873911,SRX5716469,SMARCA4,399
chr1,8873531,8873937,SRX5075175,SMARCA4,406
chr1,8873533,8873906,SRX5075168,SMARCA4,373
chr1,8873543,8873885,SRX5716470,SMARCA4,342
chr1,8873548,8873865,SRX5716467,SMARCA2,317
chr1,8873551,8873931,SRX5054309,FOSL2,380
chr1,8873559,8873904,SRX5075174,SMARCA4,345
chr1,8873590,8873947,SRX5054308,FOSL2,357
chr1,8873593,8873814,SRX5020214,SMARCA2,221
chr1,8873628,8873848,SRX5054307,FOSL2,220
chr1,8877903,8878122,SRX5054308,FOSL2,219
chr1,8878053,8879382,SRX20140895,INTS13,1329
chr1,8878298,8879189,SRX20140868,INTS10,891
chr1,8878669,8878873,SRX5054307,FOSL2,204
chr1,8878919,8879213,SRX20140867,INTS10,294
chr1,8879047,8879295,SRX20140897,INTS13,248
chr1,8879373,8879637,SRX16500060,CTCF,264
chr1,8879406,8879641,SRX16500059,CTCF,235
chr1,8879977,8880452,SRX5075175,SMARCA4,475
chr1,8880012,8880320,SRX5075169,SMARCA4,308
chr1,8880012,8880564,SRX5075170,SMARCA4,552
chr1,8880036,8880450,SRX5075176,SMARCA4,414
chr1,8880042,8880299,SRX5054309,FOSL2,257
chr1,8880079,8880355,SRX5716469,SMARCA4,276
chr1,8880101,8880320,SRX5716467,SMARCA2,219
chr1,8880114,8880346,SRX5054308,FOSL2,232
chr1,8880185,8880432,SRX5716470,SMARCA4,247
chr1,8889868,8890214,SRX5716467,SMARCA2,346
chr1,8889924,8890212,SRX5716468,SMARCA2,288
chr1,8889936,8890672,SRX5075169,SMARCA4,736
chr1,8889958,8890563,SRX5075176,SMARCA4,605
chr1,8889990,8890379,SRX5075170,SMARCA4,389
chr1,8890001,8890563,SRX5716469,SMARCA4,562
chr1,8890041,8890628,SRX5075175,SMARCA4,587
chr1,8890107,8890486,SRX5716470,SMARCA4,379
chr1,8890139,8890399,SRX5716460,Epitope tags,260
chr1,8890484,8890716,SRX5075170,SMARCA4,232
chr1,8903855,8904323,SRX5075169,SMARCA4,468
chr1,8903873,8904356,SRX5716470,SMARCA4,483
chr1,8903884,8904322,SRX5075170,SMARCA4,438
chr1,8903884,8904332,SRX5075176,SMARCA4,448
chr1,8903887,8904262,SRX5716467,SMARCA2,375
chr1,8903887,8904298,SRX5716469,SMARCA4,411
chr1,8903890,8904156,SRX5020214,SMARCA2,266
chr1,8903911,8904325,SRX5075175,SMARCA4,414
chr1,8903926,8904181,SRX5054308,FOSL2,255
chr1,8903932,8904242,SRX5054309,FOSL2,310
chr1,8903955,8904234,SRX5020211,SMARCA2,279
chr1,8903966,8904278,SRX5716468,SMARCA2,312
chr1,8903972,8904176,SRX5075181,SMARCA2,204
chr1,8903978,8904177,SRX5075168,SMARCA4,199
chr1,8915491,8915870,SRX5075174,SMARCA4,379
chr1,8915501,8915863,SRX5075168,SMARCA4,362
chr1,8917984,8918494,SRX16500061,CTCF,510
chr1,8918042,8918500,SRX16500059,CTCF,458
chr1,8918056,8918585,SRX16500060,CTCF,529
chr1,8918072,8918523,SRX16500062,CTCF,451
chr1,8918164,8918400,SRX5075174,SMARCA4,236
chr1,8918169,8918444,SRX5075176,SMARCA4,275
chr1,8918173,8918455,SRX4174629,CTCF,282
chr1,8918178,8918450,SRX5075170,SMARCA4,272
chr1,8918189,8918475,SRX5075168,SMARCA4,286
chr1,8918258,8918438,SRX5075169,SMARCA4,180
chr1,8931531,8931736,SRX5075176,SMARCA4,205
chr1,8931573,8931767,SRX5075170,SMARCA4,194
chr1,8938497,8939187,SRX5716470,SMARCA4,690
chr1,8938662,8939083,SRX5075170,SMARCA4,421
chr1,8938750,8939147,SRX5075176,SMARCA4,397
chr1,8938756,8938990,SRX5075175,SMARCA4,234
chr1,8938792,8939077,SRX5075169,SMARCA4,285
chr1,8941830,8942145,SRX5075169,SMARCA4,315
chr1,8941844,8942209,SRX5075170,SMARCA4,365
chr1,8941861,8942181,SRX5075176,SMARCA4,320
chr1,8941866,8942147,SRX5054309,FOSL2,281
chr1,8941867,8942118,SRX5716470,SMARCA4,251
chr1,8941873,8942143,SRX5054308,FOSL2,270
chr1,8941887,8942246,SRX5075175,SMARCA4,359
chr1,8941903,8942119,SRX5075168,SMARCA4,216
chr1,8941915,8942094,SRX5054307,FOSL2,179
chr1,8941944,8942163,SRX5716469,SMARCA4,219
chr1,8941944,8942165,SRX5075174,SMARCA4,221
chr1,8951263,8951675,SRX5075174,SMARCA4,412
chr1,8951300,8951641,SRX5075168,SMARCA4,341
chr1,8955572,8955746,SRX5075174,SMARCA4,174
chr1,8962978,8963237,SRX16500059,CTCF,259
chr1,8963050,8963297,SRX16500062,CTCF,247
chr1,8974013,8974260,SRX5075175,SMARCA4,247
chr1,8974028,8974312,SRX5716469,SMARCA4,284
chr1,8974028,8974322,SRX5054308,FOSL2,294
chr1,8974036,8974289,SRX5054309,FOSL2,253
chr1,8974050,8974327,SRX5075169,SMARCA4,277
chr1,8974062,8974416,SRX5075176,SMARCA4,354
chr1,8974065,8974297,SRX5075170,SMARCA4,232
chr1,8986098,8986550,SRX5075175,SMARCA4,452
chr1,8986152,8986462,SRX5716467,SMARCA2,310
chr1,8986168,8986590,SRX5075176,SMARCA4,422
chr1,8986178,8986484,SRX5716469,SMARCA4,306
chr1,8986208,8986501,SRX5716470,SMARCA4,293
chr1,8986242,8986549,SRX5075170,SMARCA4,307
chr1,8986266,8986528,SRX5054309,FOSL2,262
chr1,8986278,8986564,SRX5075169,SMARCA4,286
chr1,8986296,8986486,SRX5054308,FOSL2,190
chr1,8987894,8988474,SRX16500059,CTCF,580
chr1,8987959,8988468,SRX16500060,CTCF,509
chr1,8987971,8988549,SRX16500062,CTCF,578
chr1,8987994,8988459,SRX16500061,CTCF,465
chr1,8988032,8988428,SRX4174629,CTCF,396
chr1,8988067,8988356,SRX5075174,SMARCA4,289
chr1,8988069,8988302,SRX5075168,SMARCA4,233
chr1,8988080,8988258,SRX5075170,SMARCA4,178
chr1,9005022,9005353,SRX5075175,SMARCA4,331
chr1,9005045,9005435,SRX5075174,SMARCA4,390
chr1,9005045,9005533,SRX16500061,CTCF,488
chr1,9005051,9005544,SRX16500059,CTCF,493
chr1,9005061,9005536,SRX16500060,CTCF,475
chr1,9005063,9005441,SRX5075170,SMARCA4,378
chr1,9005086,9005375,SRX5054309,FOSL2,289
chr1,9005086,9005410,SRX5075169,SMARCA4,324
chr1,9005087,9005551,SRX16500062,CTCF,464
chr1,9005094,9005465,SRX5075176,SMARCA4,371
chr1,9005097,9005432,SRX5075168,SMARCA4,335
chr1,9005114,9005389,SRX4174629,CTCF,275
chr1,9005124,9005476,SRX5716464,SMARCA4,352
chr1,9005151,9005355,SRX5716463,SMARCA4,204
chr1,9005153,9005365,SRX5716469,SMARCA4,212
chr1,9010038,9010367,SRX16500062,CTCF,329
chr1,9010066,9010408,SRX16500059,CTCF,342
chr1,9010067,9010406,SRX16500060,CTCF,339
chr1,9010096,9010378,SRX16500061,CTCF,282
chr1,9018370,9018661,SRX5075169,SMARCA4,291
chr1,9018399,9018694,SRX5075170,SMARCA4,295
chr1,9018418,9018742,SRX5075176,SMARCA4,324
chr1,9018453,9018675,SRX5716469,SMARCA4,222
chr1,9018477,9018673,SRX5075175,SMARCA4,196
chr1,9019901,9020258,SRX5075170,SMARCA4,357
chr1,9019901,9020406,SRX5075176,SMARCA4,505
chr1,9019911,9020316,SRX5716470,SMARCA4,405
chr1,9019917,9020271,SRX5716468,SMARCA2,354
chr1,9019921,9020253,SRX5075175,SMARCA4,332
chr1,9019926,9020149,SRX5716467,SMARCA2,223
chr1,9019948,9020246,SRX5020214,SMARCA2,298
chr1,9019952,9020178,SRX5075181,SMARCA2,226
chr1,9019966,9020192,SRX5075169,SMARCA4,226
chr1,9019974,9020271,SRX5020211,SMARCA2,297
chr1,9019980,9020373,SRX5716469,SMARCA4,393
chr1,9029153,9029397,SRX5075170,SMARCA4,244
chr1,9029312,9029672,SRX5075176,SMARCA4,360
chr1,9061997,9062273,SRX5075176,SMARCA4,276
chr1,9062054,9062451,SRX5075169,SMARCA4,397
chr1,9062091,9062437,SRX5075170,SMARCA4,346
chr1,9064311,9064559,SRX5075176,SMARCA4,248
chr1,9067174,9067569,SRX5075176,SMARCA4,395
chr1,9067232,9067552,SRX5075170,SMARCA4,320
chr1,9067252,9067478,SRX5075169,SMARCA4,226
chr1,9067258,9067508,SRX5075175,SMARCA4,250
chr1,9067281,9067520,SRX5054309,FOSL2,239
chr1,9067300,9067480,SRX5054308,FOSL2,180
chr1,9074459,9074639,SRX5054308,FOSL2,180
chr1,9074485,9074697,SRX5075176,SMARCA4,212
chr1,9078105,9078466,SRX5075168,SMARCA4,361
chr1,9078142,9078413,SRX5054309,FOSL2,271
chr1,9078182,9078398,SRX5716463,SMARCA4,216
chr1,9078256,9078473,SRX5075174,SMARCA4,217
chr1,9080627,9080941,SRX5075176,SMARCA4,314
chr1,9080647,9080985,SRX5054308,FOSL2,338
chr1,9080682,9081000,SRX5054309,FOSL2,318
chr1,9080726,9081024,SRX5716469,SMARCA4,298
chr1,9080727,9080930,SRX5075170,SMARCA4,203
chr1,9080746,9080955,SRX5075175,SMARCA4,209
chr1,9080754,9081063,SRX5075169,SMARCA4,309
chr1,9081261,9081301,SRX1424891,POU3F2,40
chr1,9101477,9102084,SRX16500060,CTCF,607
chr1,9101483,9101933,SRX16500062,CTCF,450
chr1,9101511,9101969,SRX16500061,CTCF,458
chr1,9101544,9101951,SRX16500059,CTCF,407
chr1,9101612,9101822,SRX4174629,CTCF,210
chr1,9110685,9111181,SRX16500061,CTCF,496
chr1,9110690,9111200,SRX16500060,CTCF,510
chr1,9110705,9111220,SRX16500062,CTCF,515
chr1,9110720,9111192,SRX16500059,CTCF,472
chr1,9110737,9111107,SRX4174629,CTCF,370
chr1,9110767,9111049,SRX5716463,SMARCA4,282
chr1,9110784,9111109,SRX5075174,SMARCA4,325
chr1,9110789,9111108,SRX5075168,SMARCA4,319
chr1,9110791,9111068,SRX5075175,SMARCA4,277
chr1,9110794,9111069,SRX5075176,SMARCA4,275
chr1,9110810,9111065,SRX5075169,SMARCA4,255
chr1,9110815,9111109,SRX5075170,SMARCA4,294
chr1,9110817,9111087,SRX5716464,SMARCA4,270
chr1,9110838,9111049,SRX5716470,SMARCA4,211
chr1,9115841,9116106,SRX5075176,SMARCA4,265
chr1,9115850,9116120,SRX5075170,SMARCA4,270
chr1,9128722,9128948,SRX5075176,SMARCA4,226
chr1,9128731,9129150,SRX5075170,SMARCA4,419
chr1,9128775,9129145,SRX5075175,SMARCA4,370
chr1,9128787,9129114,SRX5716470,SMARCA4,327
chr1,9128855,9129129,SRX5075168,SMARCA4,274
chr1,9128959,9129280,SRX5075174,SMARCA4,321
chr1,9128965,9129197,SRX5075169,SMARCA4,232
chr1,9142162,9142645,SRX16500060,CTCF,483
chr1,9142199,9142654,SRX16500061,CTCF,455
chr1,9142215,9142670,SRX16500059,CTCF,455
chr1,9142220,9142638,SRX16500062,CTCF,418
chr1,9142318,9142537,SRX5075174,SMARCA4,219
chr1,9142347,9142597,SRX5075168,SMARCA4,250
chr1,9142369,9142544,SRX5075176,SMARCA4,175
chr1,9158714,9158760,SRX1424894,POU3F2,46
chr1,9158717,9158757,SRX1424892,POU3F2,40
chr1,9158718,9158758,SRX1424891,POU3F2,40
chr1,9158718,9158760,SRX1424893,POU3F2,42
chr1,9163618,9164282,SRX5716460,Epitope tags,664
chr1,9163698,9164321,SRX5075176,SMARCA4,623
chr1,9163714,9164323,SRX5075175,SMARCA4,609
chr1,9163716,9164335,SRX5075170,SMARCA4,619
chr1,9163722,9164279,SRX5716469,SMARCA4,557
chr1,9163745,9164319,SRX5075169,SMARCA4,574
chr1,9163800,9164260,SRX5716467,SMARCA2,460
chr1,9163818,9164292,SRX5054309,FOSL2,474
chr1,9163925,9164225,SRX5716470,SMARCA4,300
chr1,9163947,9164283,SRX5054308,FOSL2,336
chr1,9163957,9164250,SRX5020214,SMARCA2,293
chr1,9163977,9164210,SRX5716468,SMARCA2,233
chr1,9163980,9164280,SRX5020211,SMARCA2,300
chr1,9164003,9164182,SRX5075182,SMARCA2,179
chr1,9181163,9181661,SRX16500060,CTCF,498
chr1,9181181,9181673,SRX16500061,CTCF,492
chr1,9181204,9181705,SRX16500059,CTCF,501
chr1,9181210,9181643,SRX16500062,CTCF,433
chr1,9181342,9181655,SRX5075170,SMARCA4,313
chr1,9181370,9181657,SRX5075168,SMARCA4,287
chr1,9181374,9181639,SRX5075176,SMARCA4,265
chr1,9181383,9181653,SRX5075174,SMARCA4,270
chr1,9181385,9181662,SRX5075175,SMARCA4,277
chr1,9181404,9181602,SRX5075169,SMARCA4,198
chr1,9181408,9181684,SRX5716470,SMARCA4,276
chr1,9181422,9181799,SRX4174629,CTCF,377
chr1,9182087,9182451,SRX20140895,INTS13,364
chr1,9182139,9182466,SRX20140869,INTS10,327
chr1,9196229,9196477,SRX5716459,Epitope tags,248
chr1,9196238,9196491,SRX5054308,FOSL2,253
chr1,9196268,9196653,SRX5075169,SMARCA4,385
chr1,9196283,9196711,SRX5075176,SMARCA4,428
chr1,9196301,9196689,SRX5075170,SMARCA4,388
chr1,9196321,9196693,SRX5075175,SMARCA4,372
chr1,9196326,9196583,SRX5054309,FOSL2,257
chr1,9196327,9196660,SRX5716469,SMARCA4,333
chr1,9196354,9196691,SRX5020211,SMARCA2,337
chr1,9196379,9196875,SRX16500060,CTCF,496
chr1,9196395,9196812,SRX16500059,CTCF,417
chr1,9196395,9196890,SRX16500061,CTCF,495
chr1,9196442,9196809,SRX16500062,CTCF,367
chr1,9196446,9196677,SRX5075174,SMARCA4,231
chr1,9196477,9196721,SRX5075168,SMARCA4,244
chr1,9201859,9202041,SRX5075168,SMARCA4,182
chr1,9211267,9211828,SRX5075175,SMARCA4,561
chr1,9211343,9211731,SRX5716469,SMARCA4,388
chr1,9211344,9211831,SRX5075169,SMARCA4,487
chr1,9211351,9211828,SRX5075176,SMARCA4,477
chr1,9211352,9211699,SRX5716470,SMARCA4,347
chr1,9211359,9211814,SRX5054309,FOSL2,455
chr1,9211376,9211773,SRX5075170,SMARCA4,397
chr1,9211408,9211792,SRX5054308,FOSL2,384
chr1,9211481,9211763,SRX5020211,SMARCA2,282
chr1,9212759,9213089,SRX20140868,INTS10,330
chr1,9228567,9228906,SRX5054308,FOSL2,339
chr1,9228576,9228849,SRX5020214,SMARCA2,273
chr1,9228578,9228935,SRX5054309,FOSL2,357
chr1,9228613,9228792,SRX5075182,SMARCA2,179
chr1,9228614,9228845,SRX5075170,SMARCA4,231
chr1,9228617,9228881,SRX5075176,SMARCA4,264
chr1,9228634,9228866,SRX5075169,SMARCA4,232
chr1,9228647,9228919,SRX5075175,SMARCA4,272
chr1,9228648,9228964,SRX5716469,SMARCA4,316
chr1,9234292,9234639,SRX16500062,CTCF,347
chr1,9234308,9234681,SRX16500060,CTCF,373
chr1,9234334,9234663,SRX16500061,CTCF,329
chr1,9234355,9234659,SRX16500059,CTCF,304
chr1,9234427,9234686,SRX5075168,SMARCA4,259
chr1,9234453,9234706,SRX5075174,SMARCA4,253
chr1,9234493,9234713,SRX5075170,SMARCA4,220
chr1,9234526,9234965,SRX5075176,SMARCA4,439
chr1,9234604,9235228,SRX20140867,INTS10,624
chr1,9234708,9235371,SRX20140895,INTS13,663
chr1,9234734,9235118,SRX20140868,INTS10,384
chr1,9234760,9235005,SRX20140897,INTS13,245
chr1,9234784,9235030,SRX20140879,CPSF3L,246
chr1,9234841,9235182,SRX20140869,INTS10,341
chr1,9239540,9239813,SRX5054308,FOSL2,273
chr1,9239713,9239900,SRX5075175,SMARCA4,187
chr1,9249959,9250401,SRX16500060,CTCF,442
chr1,9249968,9250399,SRX16500059,CTCF,431
chr1,9249991,9250405,SRX16500061,CTCF,414
chr1,9250009,9250372,SRX16500062,CTCF,363
chr1,9252971,9253367,SRX5075174,SMARCA4,396
chr1,9253015,9253355,SRX5075168,SMARCA4,340
chr1,9253022,9253501,SRX5075170,SMARCA4,479
chr1,9253027,9253561,SRX20140895,INTS13,534
chr1,9253029,9253452,SRX20140868,INTS10,423
chr1,9253030,9253441,SRX5716469,SMARCA4,411
chr1,9253038,9253393,SRX5075169,SMARCA4,355
chr1,9253047,9253409,SRX5075176,SMARCA4,362
chr1,9253059,9253427,SRX5075175,SMARCA4,368
chr1,9253073,9253433,SRX20140867,INTS10,360
chr1,9253082,9253384,SRX20140879,CPSF3L,302
chr1,9253085,9253425,SRX5716470,SMARCA4,340
chr1,9253099,9253423,SRX5716468,SMARCA2,324
chr1,9253117,9253400,SRX20140860,SOX2,283
chr1,9253136,9253529,SRX5716463,SMARCA4,393
chr1,9253145,9253376,SRX5716467,SMARCA2,231
chr1,9267006,9267390,SRX20140895,INTS13,384
chr1,9267018,9267541,SRX16500060,CTCF,523
chr1,9267042,9267540,SRX16500059,CTCF,498
chr1,9267069,9267433,SRX5716470,SMARCA4,364
chr1,9267070,9267529,SRX16500062,CTCF,459
chr1,9267093,9267591,SRX16500061,CTCF,498
chr1,9267137,9267481,SRX5075170,SMARCA4,344
chr1,9267141,9267445,SRX5075169,SMARCA4,304
chr1,9267159,9267503,SRX4174629,CTCF,344
chr1,9267169,9267442,SRX5075168,SMARCA4,273
chr1,9267171,9267437,SRX5075174,SMARCA4,266
chr1,9267183,9267485,SRX5075176,SMARCA4,302
chr1,9275546,9275825,SRX5075169,SMARCA4,279
chr1,9275570,9275793,SRX5075176,SMARCA4,223
chr1,9280413,9280661,SRX5054309,FOSL2,248
chr1,9280424,9280698,SRX5075176,SMARCA4,274
chr1,9280430,9280680,SRX5075175,SMARCA4,250
chr1,9280433,9280657,SRX5054308,FOSL2,224
chr1,9280439,9280737,SRX5075170,SMARCA4,298
chr1,9280446,9280711,SRX5075169,SMARCA4,265
chr1,9288925,9289385,SRX16500060,CTCF,460
chr1,9288948,9289428,SRX16500059,CTCF,480
chr1,9288973,9289426,SRX16500061,CTCF,453
chr1,9288992,9289421,SRX16500062,CTCF,429
chr1,9289123,9289379,SRX4174629,CTCF,256
chr1,9292581,9292984,SRX5075168,SMARCA4,403
chr1,9292595,9292799,SRX5716463,SMARCA4,204
chr1,9292636,9292857,SRX5075176,SMARCA4,221
chr1,9292652,9293228,SRX20140895,INTS13,576
chr1,9292668,9292988,SRX5075174,SMARCA4,320
chr1,9292682,9292927,SRX5075170,SMARCA4,245
chr1,9292756,9293106,SRX20140868,INTS10,350
chr1,9294455,9294738,SRX5075170,SMARCA4,283
chr1,9294459,9294722,SRX5075176,SMARCA4,263
chr1,9294515,9294718,SRX5075175,SMARCA4,203
chr1,9294519,9294710,SRX5054309,FOSL2,191
chr1,9294519,9294711,SRX5075169,SMARCA4,192
chr1,9294540,9294727,SRX5054308,FOSL2,187
chr1,9302877,9303497,SRX5075169,SMARCA4,620
chr1,9303011,9303521,SRX5075176,SMARCA4,510
chr1,9303038,9303513,SRX5075170,SMARCA4,475
chr1,9303046,9303471,SRX5075175,SMARCA4,425
chr1,9303090,9303467,SRX5716470,SMARCA4,377
chr1,9303111,9303441,SRX5054309,FOSL2,330
chr1,9303135,9303426,SRX5716467,SMARCA2,291
chr1,9303148,9303434,SRX5054308,FOSL2,286
chr1,9303176,9303376,SRX5075182,SMARCA2,200
chr1,9303191,9303466,SRX5716469,SMARCA4,275
chr1,9315569,9316013,SRX5716469,SMARCA4,444
chr1,9315601,9316084,SRX5075176,SMARCA4,483
chr1,9315668,9315889,SRX5075169,SMARCA4,221
chr1,9315677,9316020,SRX5075170,SMARCA4,343
chr1,9315720,9315900,SRX5054308,FOSL2,180
chr1,9315736,9315952,SRX5716467,SMARCA2,216
chr1,9315819,9316086,SRX5716470,SMARCA4,267
chr1,9317685,9317890,SRX5075169,SMARCA4,205
chr1,9322916,9323137,SRX5075168,SMARCA4,221
chr1,9322972,9323145,SRX5075174,SMARCA4,173
chr1,9326596,9326951,SRX5075176,SMARCA4,355
chr1,9326667,9326990,SRX5075169,SMARCA4,323
chr1,9326670,9326918,SRX5716469,SMARCA4,248
chr1,9326678,9326984,SRX5075170,SMARCA4,306
chr1,9326687,9326883,SRX5075175,SMARCA4,196
chr1,9326706,9326891,SRX5054308,FOSL2,185
chr1,9338894,9339129,SRX5075170,SMARCA4,235
chr1,9371316,9372107,SRX5075170,SMARCA4,791
chr1,9371346,9372039,SRX5075176,SMARCA4,693
chr1,9371407,9371963,SRX5716470,SMARCA4,556
chr1,9371417,9371961,SRX5075169,SMARCA4,544
chr1,9371426,9371997,SRX5716467,SMARCA2,571
chr1,9371444,9371730,SRX5716463,SMARCA4,286
chr1,9371454,9371842,SRX5020211,SMARCA2,388
chr1,9371459,9372059,SRX5716469,SMARCA4,600
chr1,9371462,9371991,SRX5075175,SMARCA4,529
chr1,9371469,9371848,SRX5716468,SMARCA2,379
chr1,9371487,9371970,SRX5075174,SMARCA4,483
chr1,9371500,9371866,SRX5716464,SMARCA4,366
chr1,9371506,9371686,SRX5075168,SMARCA4,180
chr1,9371510,9371872,SRX5075181,SMARCA2,362
chr1,9371527,9371774,SRX5054309,FOSL2,247
chr1,9371554,9371781,SRX5020214,SMARCA2,227
chr1,9371574,9371954,SRX5054308,FOSL2,380
chr1,9376822,9377080,SRX5054309,FOSL2,258
chr1,9376839,9377240,SRX5075170,SMARCA4,401
chr1,9376845,9377157,SRX5075175,SMARCA4,312
chr1,9376847,9377194,SRX5075169,SMARCA4,347
chr1,9376893,9377095,SRX5075168,SMARCA4,202
chr1,9376915,9377231,SRX5075176,SMARCA4,316
chr1,9376945,9377162,SRX5075174,SMARCA4,217
chr1,9388907,9389076,SRX5075170,SMARCA4,169
chr1,9388930,9389160,SRX5075169,SMARCA4,230
chr1,9398147,9398354,SRX5054308,FOSL2,207
chr1,9398164,9398448,SRX5075176,SMARCA4,284
chr1,9400122,9400291,SRX5075170,SMARCA4,169
chr1,9400732,9400912,SRX5075176,SMARCA4,180
chr1,9400738,9400930,SRX5075170,SMARCA4,192
chr1,9413012,9413444,SRX5075170,SMARCA4,432
chr1,9413126,9413821,SRX5075169,SMARCA4,695
chr1,9413131,9413725,SRX5075175,SMARCA4,594
chr1,9413142,9413904,SRX5075176,SMARCA4,762
chr1,9413185,9413548,SRX5716469,SMARCA4,363
chr1,9413251,9413431,SRX5054308,FOSL2,180
chr1,9413257,9413577,SRX5054309,FOSL2,320
chr1,9413512,9413950,SRX5716470,SMARCA4,438
chr1,9413548,9413921,SRX5075170,SMARCA4,373
chr1,9413955,9414142,SRX5075175,SMARCA4,187
chr1,9413999,9414179,SRX5075169,SMARCA4,180
chr1,9428593,9429222,SRX5075176,SMARCA4,629
chr1,9428733,9429316,SRX5075168,SMARCA4,583
chr1,9428742,9429348,SRX20140895,INTS13,606
chr1,9428747,9429251,SRX20140868,INTS10,504
chr1,9428767,9428966,SRX5075169,SMARCA4,199
chr1,9428774,9429220,SRX5075174,SMARCA4,446
chr1,9428803,9429044,SRX5054308,FOSL2,241
chr1,9428829,9429171,SRX20140867,INTS10,342
chr1,9428913,9429266,SRX20140897,INTS13,353
chr1,9428927,9429138,SRX5054307,FOSL2,211
chr1,9428934,9429249,SRX5716463,SMARCA4,315
chr1,9428939,9429141,SRX5054309,FOSL2,202
chr1,9428940,9429159,SRX5716454,SOX3,219
chr1,9428957,9429297,SRX5075170,SMARCA4,340
chr1,9429032,9429378,SRX20140869,INTS10,346
chr1,9429156,9429342,SRX5075169,SMARCA4,186
chr1,9441405,9441657,SRX5075176,SMARCA4,252
chr1,9444009,9444270,SRX5075168,SMARCA4,261
chr1,9444097,9444289,SRX5075176,SMARCA4,192
chr1,9444144,9444327,SRX5075174,SMARCA4,183
chr1,9455748,9456179,SRX16500059,CTCF,431
chr1,9455752,9456170,SRX16500061,CTCF,418
chr1,9455767,9456175,SRX16500062,CTCF,408
chr1,9455767,9456188,SRX16500060,CTCF,421
chr1,9455839,9456135,SRX4174629,CTCF,296
chr1,9472956,9473428,SRX5075176,SMARCA4,472
chr1,9472959,9473475,SRX5075170,SMARCA4,516
chr1,9473036,9473434,SRX5075169,SMARCA4,398
chr1,9473046,9473399,SRX5075175,SMARCA4,353
chr1,9473053,9473327,SRX5075168,SMARCA4,274
chr1,9473117,9473416,SRX5054309,FOSL2,299
chr1,9473124,9473376,SRX5716469,SMARCA4,252
chr1,9473126,9473299,SRX5075174,SMARCA4,173
chr1,9473141,9473383,SRX5054308,FOSL2,242
chr1,9491023,9491466,SRX16500059,CTCF,443
chr1,9491028,9491416,SRX16500062,CTCF,388
chr1,9491040,9491456,SRX16500060,CTCF,416
chr1,9491057,9491456,SRX16500061,CTCF,399
chr1,9491063,9491433,SRX4174629,CTCF,370
chr1,9491121,9491370,SRX5075168,SMARCA4,249
chr1,9491128,9491360,SRX5075174,SMARCA4,232
chr1,9491132,9491324,SRX5075170,SMARCA4,192
chr1,9495151,9495676,SRX16500059,CTCF,525
chr1,9495175,9495651,SRX16500062,CTCF,476
chr1,9495177,9495644,SRX16500060,CTCF,467
chr1,9495188,9495645,SRX16500061,CTCF,457
chr1,9495239,9495594,SRX5075168,SMARCA4,355
chr1,9495264,9495623,SRX5075174,SMARCA4,359
chr1,9495283,9495500,SRX5716469,SMARCA4,217
chr1,9495320,9495581,SRX5075175,SMARCA4,261
chr1,9495325,9495609,SRX5075170,SMARCA4,284
chr1,9495330,9495510,SRX5075169,SMARCA4,180
chr1,9495355,9495634,SRX5075176,SMARCA4,279
chr1,9539065,9539452,SRX5075176,SMARCA4,387
chr1,9539105,9539422,SRX5716463,SMARCA4,317
chr1,9539123,9539965,SRX20140895,INTS13,842
chr1,9539154,9539554,SRX5075168,SMARCA4,400
chr1,9539159,9539639,SRX5075174,SMARCA4,480
chr1,9539205,9539868,SRX20140897,INTS13,663
chr1,9539218,9539500,SRX5054308,FOSL2,282
chr1,9539232,9539598,SRX5075170,SMARCA4,366
chr1,9539238,9539503,SRX5054307,FOSL2,265
chr1,9539255,9539619,SRX5716470,SMARCA4,364
chr1,9539257,9539494,SRX5054309,FOSL2,237
chr1,9539265,9539902,SRX20140868,INTS10,637
chr1,9539289,9539989,SRX20140867,INTS10,700
chr1,9539299,9539751,SRX20140896,INTS13,452
chr1,9539315,9539520,SRX5716464,SMARCA4,205
chr1,9539356,9539536,SRX5075169,SMARCA4,180
chr1,9539588,9539852,SRX16500059,CTCF,264
chr1,9539603,9539869,SRX20140869,INTS10,266
chr1,9539848,9540069,SRX5716470,SMARCA4,221
chr1,9540036,9540233,SRX5075169,SMARCA4,197
chr1,9553204,9553245,SRX1424894,POU3F2,41
chr1,9561400,9561829,SRX5075169,SMARCA4,429
chr1,9561420,9561868,SRX5716470,SMARCA4,448
chr1,9561458,9561864,SRX5075170,SMARCA4,406
chr1,9561459,9561870,SRX5075168,SMARCA4,411
chr1,9561483,9561870,SRX5075176,SMARCA4,387
chr1,9561486,9561858,SRX5075174,SMARCA4,372
chr1,9561505,9561800,SRX5054309,FOSL2,295
chr1,9561506,9561840,SRX5075175,SMARCA4,334
chr1,9561513,9561831,SRX5716469,SMARCA4,318
chr1,9561539,9561804,SRX5020211,SMARCA2,265
chr1,9561582,9561765,SRX5054308,FOSL2,183
chr1,9561593,9561804,SRX5716468,SMARCA2,211
chr1,9561673,9561719,SRX1424891,POU3F2,46
chr1,9561688,9561730,SRX1424892,POU3F2,42
chr1,9573729,9574023,SRX16500060,CTCF,294
chr1,9573765,9574125,SRX16500059,CTCF,360
chr1,9573792,9574113,SRX16500062,CTCF,321
chr1,9573868,9574098,SRX16500061,CTCF,230
chr1,9588349,9588789,SRX16500060,CTCF,440
chr1,9588360,9588752,SRX16500062,CTCF,392
chr1,9588378,9588794,SRX16500059,CTCF,416
chr1,9588382,9588819,SRX5075168,SMARCA4,437
chr1,9588385,9588854,SRX5075174,SMARCA4,469
chr1,9588388,9588773,SRX5075170,SMARCA4,385
chr1,9588408,9588763,SRX16500061,CTCF,355
chr1,9588432,9588861,SRX5075176,SMARCA4,429
chr1,9588468,9588723,SRX5075169,SMARCA4,255
chr1,9588470,9588822,SRX5716463,SMARCA4,352
chr1,9588504,9588811,SRX5716470,SMARCA4,307
chr1,9588516,9588726,SRX5075175,SMARCA4,210
chr1,9593376,9593760,SRX5075174,SMARCA4,384
chr1,9593443,9593874,SRX5075168,SMARCA4,431
chr1,9593518,9593761,SRX5075170,SMARCA4,243
chr1,9593552,9593768,SRX5716463,SMARCA4,216
chr1,9593572,9593907,SRX5716451,SOX2,335
chr1,9615548,9615964,SRX16500059,CTCF,416
chr1,9615593,9616001,SRX16500060,CTCF,408
chr1,9615637,9616004,SRX16500061,CTCF,367
chr1,9615653,9615958,SRX16500062,CTCF,305
chr1,9615733,9615941,SRX5075174,SMARCA4,208
chr1,9626861,9627539,SRX16500061,CTCF,678
chr1,9626866,9627487,SRX16500059,CTCF,621
chr1,9626892,9627457,SRX16500062,CTCF,565
chr1,9626924,9627470,SRX16500060,CTCF,546
chr1,9626924,9627529,SRX4174629,CTCF,605
chr1,9626967,9627366,SRX5075176,SMARCA4,399
chr1,9626968,9627334,SRX5075169,SMARCA4,366
chr1,9626968,9627397,SRX5075170,SMARCA4,429
chr1,9626974,9627366,SRX5075174,SMARCA4,392
chr1,9626977,9627389,SRX5075168,SMARCA4,412
chr1,9626981,9627368,SRX5716470,SMARCA4,387
chr1,9626992,9627340,SRX5716463,SMARCA4,348
chr1,9627000,9627385,SRX5075175,SMARCA4,385
chr1,9627016,9627300,SRX5716469,SMARCA4,284
chr1,9627030,9627324,SRX5716464,SMARCA4,294
chr1,9659455,9659635,SRX5075169,SMARCA4,180
chr1,9687212,9687640,SRX5075169,SMARCA4,428
chr1,9687308,9687614,SRX5075176,SMARCA4,306
chr1,9687330,9687618,SRX5054309,FOSL2,288
chr1,9687334,9687722,SRX5075175,SMARCA4,388
chr1,9687336,9687557,SRX5716469,SMARCA4,221
chr1,9687345,9687652,SRX5075170,SMARCA4,307
chr1,9687391,9687747,SRX5075174,SMARCA4,356
chr1,9687407,9687632,SRX5075168,SMARCA4,225
chr1,9700273,9700485,SRX5716469,SMARCA4,212
chr1,9700282,9700562,SRX5054308,FOSL2,280
chr1,9700349,9700558,SRX5075176,SMARCA4,209
chr1,9700376,9700615,SRX5054309,FOSL2,239
chr1,9700390,9700654,SRX5075170,SMARCA4,264
chr1,9700408,9700614,SRX5075175,SMARCA4,206
chr1,9702219,9702590,SRX16500061,CTCF,371
chr1,9702242,9702587,SRX16500059,CTCF,345
chr1,9702267,9702634,SRX16500060,CTCF,367
chr1,9702279,9702509,SRX16500062,CTCF,230
chr1,9702332,9702508,SRX5075174,SMARCA4,176
chr1,9705286,9705595,SRX5716460,Epitope tags,309
chr1,9705372,9705700,SRX5716469,SMARCA4,328
chr1,9705373,9705682,SRX5075169,SMARCA4,309
chr1,9705388,9705642,SRX5075168,SMARCA4,254
chr1,9705407,9705725,SRX5075175,SMARCA4,318
chr1,9705411,9705743,SRX5075176,SMARCA4,332
chr1,9705432,9705708,SRX5075170,SMARCA4,276
chr1,9705436,9705720,SRX5054309,FOSL2,284
chr1,9705436,9705728,SRX5075174,SMARCA4,292
chr1,9705459,9705710,SRX5054308,FOSL2,251
chr1,9719050,9719420,SRX5716469,SMARCA4,370
chr1,9719117,9719458,SRX5075169,SMARCA4,341
chr1,9719132,9719470,SRX5075175,SMARCA4,338
chr1,9719146,9719393,SRX5054308,FOSL2,247
chr1,9719149,9719432,SRX5054309,FOSL2,283
chr1,9719160,9719462,SRX5075170,SMARCA4,302
chr1,9719163,9719443,SRX5075176,SMARCA4,280
chr1,9719180,9719395,SRX5716467,SMARCA2,215
chr1,9721688,9722134,SRX16500061,CTCF,446
chr1,9721689,9722148,SRX16500059,CTCF,459
chr1,9721706,9722123,SRX16500062,CTCF,417
chr1,9721743,9722158,SRX16500060,CTCF,415
chr1,9724949,9725356,SRX4174629,CTCF,407
chr1,9724979,9725436,SRX16500060,CTCF,457
chr1,9725008,9725401,SRX16500059,CTCF,393
chr1,9725014,9725396,SRX16500062,CTCF,382
chr1,9725055,9725407,SRX16500061,CTCF,352
chr1,9725102,9725285,SRX5075168,SMARCA4,183
chr1,9725134,9725367,SRX5075174,SMARCA4,233
chr1,9753350,9753533,SRX5054309,FOSL2,183
chr1,9753352,9753595,SRX5075176,SMARCA4,243
chr1,9753370,9753569,SRX5075170,SMARCA4,199
chr1,9753452,9753632,SRX5075169,SMARCA4,180
chr1,9755470,9755703,SRX5075176,SMARCA4,233
chr1,9755567,9755764,SRX5075174,SMARCA4,197
chr1,9765843,9766076,SRX20140867,INTS10,233
chr1,9765898,9766100,SRX5075176,SMARCA4,202
chr1,9765942,9766115,SRX5075174,SMARCA4,173
chr1,9766653,9767117,SRX5716467,SMARCA2,464
chr1,9766667,9767146,SRX5054309,FOSL2,479
chr1,9766673,9767200,SRX5075169,SMARCA4,527
chr1,9766674,9767220,SRX5716469,SMARCA4,546
chr1,9766676,9767201,SRX5075175,SMARCA4,525
chr1,9766682,9767196,SRX5075170,SMARCA4,514
chr1,9766686,9767211,SRX5075176,SMARCA4,525
chr1,9766728,9767095,SRX5054308,FOSL2,367
chr1,9766737,9767133,SRX5075168,SMARCA4,396
chr1,9766739,9767101,SRX5020214,SMARCA2,362
chr1,9766749,9767072,SRX5075174,SMARCA4,323
chr1,9766758,9767029,SRX5716470,SMARCA4,271
chr1,9766789,9767018,SRX5716468,SMARCA2,229
chr1,9766800,9767042,SRX5020211,SMARCA2,242
chr1,9766808,9767017,SRX5075182,SMARCA2,209
chr1,9784463,9784984,SRX16500060,CTCF,521
chr1,9784524,9784898,SRX16500061,CTCF,374
chr1,9784560,9784976,SRX16500059,CTCF,416
chr1,9784564,9784963,SRX16500062,CTCF,399
chr1,9792430,9792739,SRX5075170,SMARCA4,309
chr1,9792430,9792786,SRX5716470,SMARCA4,356
chr1,9792486,9792745,SRX5075175,SMARCA4,259
chr1,9792540,9792799,SRX5075176,SMARCA4,259
chr1,9823696,9824155,SRX20140895,INTS13,459
chr1,9823811,9824357,SRX5075168,SMARCA4,546
chr1,9823844,9824232,SRX5075174,SMARCA4,388
chr1,9823875,9824276,SRX5075176,SMARCA4,401
chr1,9823914,9824334,SRX5075170,SMARCA4,420
chr1,9823966,9824180,SRX20140867,INTS10,214
chr1,9824011,9824259,SRX20140880,CPSF3L,248
chr1,9825459,9825704,SRX5054309,FOSL2,245
chr1,9825482,9825687,SRX5075170,SMARCA4,205
chr1,9825518,9825707,SRX5075176,SMARCA4,189
chr1,9827860,9828244,SRX16500059,CTCF,384
chr1,9827930,9828225,SRX16500061,CTCF,295
chr1,9827957,9828182,SRX16500062,CTCF,225
chr1,9827968,9828225,SRX16500060,CTCF,257
chr1,9835637,9836157,SRX5075168,SMARCA4,520
chr1,9835689,9836083,SRX5075174,SMARCA4,394
chr1,9835738,9836036,SRX5075176,SMARCA4,298
chr1,9835801,9836002,SRX5075170,SMARCA4,201
chr1,9842134,9842519,SRX5075170,SMARCA4,385
chr1,9842149,9842457,SRX5075175,SMARCA4,308
chr1,9842153,9842490,SRX5075176,SMARCA4,337
chr1,9842184,9842469,SRX5716468,SMARCA2,285
chr1,9842224,9842482,SRX5075169,SMARCA4,258
chr1,9852483,9852717,SRX5075176,SMARCA4,234
chr1,9852493,9852745,SRX5075170,SMARCA4,252
chr1,9852561,9852741,SRX5075169,SMARCA4,180
chr1,9859373,9859622,SRX5075176,SMARCA4,249
chr1,9861439,9861704,SRX16500059,CTCF,265
chr1,9861440,9861676,SRX16500060,CTCF,236
chr1,9867350,9867942,SRX16500059,CTCF,592
chr1,9867354,9867916,SRX16500060,CTCF,562
chr1,9867400,9867895,SRX16500062,CTCF,495
chr1,9867405,9867886,SRX16500061,CTCF,481
chr1,9867449,9867865,SRX4174629,CTCF,416
chr1,9867470,9867761,SRX5075174,SMARCA4,291
chr1,9867506,9867789,SRX5075175,SMARCA4,283
chr1,9867522,9867786,SRX5075170,SMARCA4,264
chr1,9867537,9867748,SRX5075176,SMARCA4,211
chr1,9867543,9867786,SRX5075168,SMARCA4,243
chr1,9874775,9875306,SRX16500059,CTCF,531
chr1,9874789,9875345,SRX16500060,CTCF,556
chr1,9874791,9875308,SRX16500062,CTCF,517
chr1,9874809,9875310,SRX16500061,CTCF,501
chr1,9874876,9875276,SRX5075174,SMARCA4,400
chr1,9874877,9875268,SRX4174629,CTCF,391
chr1,9874913,9875247,SRX5075168,SMARCA4,334
chr1,9874936,9875238,SRX5075176,SMARCA4,302
chr1,9874941,9875202,SRX5075170,SMARCA4,261
chr1,9874943,9875271,SRX5716470,SMARCA4,328
chr1,9874965,9875333,SRX5075175,SMARCA4,368
chr1,9874971,9875295,SRX5716464,SMARCA4,324
chr1,9874979,9875229,SRX5716463,SMARCA4,250
chr1,9874986,9875223,SRX5075169,SMARCA4,237
chr1,9881783,9882153,SRX5716470,SMARCA4,370
chr1,9881802,9882131,SRX5716469,SMARCA4,329
chr1,9881812,9882168,SRX5075170,SMARCA4,356
chr1,9881817,9882191,SRX5075176,SMARCA4,374
chr1,9881848,9882113,SRX5075175,SMARCA4,265
chr1,9881865,9882108,SRX5054309,FOSL2,243
chr1,9881872,9882214,SRX5075169,SMARCA4,342
chr1,9890168,9890615,SRX5075174,SMARCA4,447
chr1,9890244,9890870,SRX5075176,SMARCA4,626
chr1,9890256,9890728,SRX5075169,SMARCA4,472
chr1,9890287,9890929,SRX5075170,SMARCA4,642
chr1,9890320,9890648,SRX5716469,SMARCA4,328
chr1,9890339,9890557,SRX5716470,SMARCA4,218
chr1,9890342,9890605,SRX5020211,SMARCA2,263
chr1,9890367,9890707,SRX5054309,FOSL2,340
chr1,9890382,9890735,SRX5075175,SMARCA4,353
chr1,9890386,9890694,SRX5054308,FOSL2,308
chr1,9890407,9890615,SRX5020214,SMARCA2,208
chr1,9890413,9890700,SRX5075168,SMARCA4,287
chr1,9891279,9891648,SRX5075176,SMARCA4,369
chr1,9891291,9891658,SRX5075170,SMARCA4,367
chr1,9891341,9891624,SRX5075169,SMARCA4,283
chr1,9891353,9891589,SRX5716469,SMARCA4,236
chr1,9891354,9891619,SRX5075175,SMARCA4,265
chr1,9891414,9891625,SRX5716470,SMARCA4,211
chr1,9892522,9892969,SRX20140895,INTS13,447
chr1,9893282,9893562,SRX5054309,FOSL2,280
chr1,9893347,9893543,SRX5075176,SMARCA4,196
chr1,9898947,9899206,SRX5054308,FOSL2,259
chr1,9898957,9899214,SRX5054309,FOSL2,257
chr1,9905052,9905309,SRX5075170,SMARCA4,257
chr1,9905067,9905333,SRX5054309,FOSL2,266
chr1,9905073,9905277,SRX5075169,SMARCA4,204
chr1,9905085,9905356,SRX5075175,SMARCA4,271
chr1,9905126,9905352,SRX5054308,FOSL2,226
chr1,9909993,9910393,SRX20140867,INTS10,400
chr1,9910121,9910960,SRX20140895,INTS13,839
chr1,9910169,9911076,SRX5075168,SMARCA4,907
chr1,9910175,9910401,SRX5075169,SMARCA4,226
chr1,9910179,9910393,SRX5075170,SMARCA4,214
chr1,9910195,9910873,SRX5075174,SMARCA4,678
chr1,9910233,9910555,SRX5054309,FOSL2,322
chr1,9910335,9910636,SRX5054307,FOSL2,301
chr1,9910351,9910568,SRX5054308,FOSL2,217
chr1,9910407,9910624,SRX5716463,SMARCA4,217
chr1,9910462,9910826,SRX5716470,SMARCA4,364
chr1,9910512,9910848,SRX5075170,SMARCA4,336
chr1,9922338,9922618,SRX5075168,SMARCA4,280
chr1,9922340,9922574,SRX5075169,SMARCA4,234
chr1,9922377,9922589,SRX5075175,SMARCA4,212
chr1,9922400,9922667,SRX5075176,SMARCA4,267
chr1,9929344,9929812,SRX5075174,SMARCA4,468
chr1,9929356,9929764,SRX5075168,SMARCA4,408
chr1,9929419,9929709,SRX5075176,SMARCA4,290
chr1,9929457,9929784,SRX5075170,SMARCA4,327
chr1,9942257,9942859,SRX16500060,CTCF,602
chr1,9942259,9942817,SRX16500061,CTCF,558
chr1,9942284,9942870,SRX16500059,CTCF,586
chr1,9942347,9942801,SRX16500062,CTCF,454
chr1,9942388,9942594,SRX5075168,SMARCA4,206
chr1,9942420,9942667,SRX5075170,SMARCA4,247
chr1,9942428,9942643,SRX5075176,SMARCA4,215
chr1,9942430,9942620,SRX5075174,SMARCA4,190
chr1,9942433,9942728,SRX4174629,CTCF,295
chr1,9942921,9943659,SRX20140869,INTS10,738
chr1,9943074,9943757,SRX20140895,INTS13,683
chr1,9943110,9943708,SRX20140897,INTS13,598
chr1,9943177,9943699,SRX20140868,INTS10,522
chr1,9943186,9943562,SRX5075168,SMARCA4,376
chr1,9943231,9943512,SRX5716463,SMARCA4,281
chr1,9943241,9943630,SRX20140896,INTS13,389
chr1,9943242,9943683,SRX20140867,INTS10,441
chr1,9943243,9943661,SRX5075174,SMARCA4,418
chr1,9943248,9943719,SRX20140881,CPSF3L,471
chr1,9943268,9943725,SRX20140879,CPSF3L,457
chr1,9943330,9943748,SRX20140894,INTS13,418
chr1,9943369,9943674,SRX5716470,SMARCA4,305
chr1,9943374,9943604,SRX5075170,SMARCA4,230
chr1,9950202,9950708,SRX16500062,CTCF,506
chr1,9950202,9950765,SRX16500059,CTCF,563
chr1,9950208,9950723,SRX16500060,CTCF,515
chr1,9950265,9950714,SRX16500061,CTCF,449
chr1,9950284,9950690,SRX4174629,CTCF,406
chr1,9950350,9950746,SRX5075174,SMARCA4,396
chr1,9950360,9950671,SRX5075168,SMARCA4,311
chr1,9950369,9950640,SRX5075170,SMARCA4,271
chr1,9950370,9950644,SRX5075175,SMARCA4,274
chr1,9950381,9950680,SRX5075169,SMARCA4,299
chr1,9950389,9950756,SRX5716463,SMARCA4,367
chr1,9950408,9950713,SRX5075176,SMARCA4,305
chr1,9950469,9950765,SRX20140895,INTS13,296
chr1,10007248,10007585,SRX5075170,SMARCA4,337
chr1,10007262,10007474,SRX5716469,SMARCA4,212
chr1,10007265,10007565,SRX5075176,SMARCA4,300
chr1,10015654,10016006,SRX5075170,SMARCA4,352
chr1,10015707,10015938,SRX5075176,SMARCA4,231
chr1,10020720,10020988,SRX5075176,SMARCA4,268
chr1,10020727,10021017,SRX5075170,SMARCA4,290
chr1,10031491,10031792,SRX5054309,FOSL2,301
chr1,10031565,10031753,SRX5075169,SMARCA4,188
chr1,10032391,10032866,SRX16500061,CTCF,475
chr1,10032405,10032903,SRX16500059,CTCF,498
chr1,10032436,10033139,SRX5075174,SMARCA4,703
chr1,10032442,10033154,SRX5075176,SMARCA4,712
chr1,10032446,10033166,SRX5075168,SMARCA4,720
chr1,10032447,10032757,SRX5716469,SMARCA4,310
chr1,10032449,10032892,SRX5716470,SMARCA4,443
chr1,10032451,10033064,SRX5716463,SMARCA4,613
chr1,10032453,10032865,SRX16500060,CTCF,412
chr1,10032453,10032889,SRX5075175,SMARCA4,436
chr1,10032463,10032725,SRX4174629,CTCF,262
chr1,10032467,10032910,SRX16500062,CTCF,443
chr1,10032472,10033070,SRX5075170,SMARCA4,598
chr1,10032478,10033126,SRX5716464,SMARCA4,648
chr1,10032480,10032818,SRX5075169,SMARCA4,338
chr1,10032625,10033478,SRX20140895,INTS13,853
chr1,10032691,10033116,SRX5716451,SOX2,425
chr1,10032707,10033089,SRX5716454,SOX3,382
chr1,10032728,10033040,SRX5054307,FOSL2,312
chr1,10032809,10033040,SRX5054309,FOSL2,231
chr1,10032829,10033459,SRX20140897,INTS13,630
chr1,10033056,10033369,SRX20140867,INTS10,313
chr1,10033120,10033482,SRX20140881,CPSF3L,362
chr1,10034422,10034660,SRX16500062,CTCF,238
chr1,10034478,10034703,SRX5075175,SMARCA4,225
chr1,10034534,10034718,SRX5075169,SMARCA4,184
chr1,10055756,10056251,SRX5075176,SMARCA4,495
chr1,10055774,10056062,SRX5020211,SMARCA2,288
chr1,10055778,10056129,SRX5054309,FOSL2,351
chr1,10055786,10056173,SRX5075170,SMARCA4,387
chr1,10055791,10056122,SRX5075169,SMARCA4,331
chr1,10055795,10056178,SRX5716469,SMARCA4,383
chr1,10055823,10056100,SRX5054308,FOSL2,277
chr1,10055825,10056108,SRX5716468,SMARCA2,283
chr1,10055827,10056195,SRX5075175,SMARCA4,368
chr1,10055833,10056120,SRX5716470,SMARCA4,287
chr1,10055882,10056139,SRX5716467,SMARCA2,257
chr1,10057384,10057576,SRX5075169,SMARCA4,192
chr1,10057456,10057644,SRX5075175,SMARCA4,188
chr1,10067040,10067402,SRX5716469,SMARCA4,362
chr1,10067052,10067299,SRX5716470,SMARCA4,247
chr1,10067080,10067283,SRX5075169,SMARCA4,203
chr1,10067108,10067301,SRX5075175,SMARCA4,193
chr1,10067124,10067337,SRX5075170,SMARCA4,213
chr1,10067129,10067350,SRX5075176,SMARCA4,221
chr1,10067130,10067349,SRX5054309,FOSL2,219
chr1,10067142,10067370,SRX5716467,SMARCA2,228
chr1,10067165,10067386,SRX5020211,SMARCA2,221
chr1,10074277,10074798,SRX5075169,SMARCA4,521
chr1,10074348,10074782,SRX5075170,SMARCA4,434
chr1,10074349,10074745,SRX5054308,FOSL2,396
chr1,10074352,10074792,SRX5075176,SMARCA4,440
chr1,10074356,10074633,SRX5716460,Epitope tags,277
chr1,10074362,10074710,SRX5716470,SMARCA4,348
chr1,10074367,10074731,SRX5075175,SMARCA4,364
chr1,10074386,10074705,SRX5716469,SMARCA4,319
chr1,10074387,10074658,SRX5716467,SMARCA2,271
chr1,10074396,10074745,SRX5054309,FOSL2,349
chr1,10074420,10074704,SRX5020211,SMARCA2,284
chr1,10074421,10074684,SRX5716468,SMARCA2,263
chr1,10074433,10074681,SRX5716459,Epitope tags,248
chr1,10074453,10074645,SRX5075182,SMARCA2,192
chr1,10074464,10074720,SRX5075181,SMARCA2,256
chr1,10074466,10074671,SRX5020214,SMARCA2,205
chr1,10085137,10085460,SRX5075174,SMARCA4,323
chr1,10085266,10085457,SRX5075168,SMARCA4,191
chr1,10085293,10085497,SRX5716463,SMARCA4,204
chr1,10108111,10108557,SRX5075168,SMARCA4,446
chr1,10108152,10108487,SRX5075174,SMARCA4,335
chr1,10108186,10108753,SRX5075170,SMARCA4,567
chr1,10108193,10108603,SRX5716470,SMARCA4,410
chr1,10108194,10108729,SRX5075175,SMARCA4,535
chr1,10108197,10108674,SRX5075169,SMARCA4,477
chr1,10108218,10108688,SRX5716469,SMARCA4,470
chr1,10108262,10108702,SRX5054309,FOSL2,440
chr1,10108266,10108703,SRX5075176,SMARCA4,437
chr1,10108313,10108696,SRX5054308,FOSL2,383
chr1,10108368,10108609,SRX5716467,SMARCA2,241
chr1,10108409,10108667,SRX5716468,SMARCA2,258
chr1,10122773,10123287,SRX5075169,SMARCA4,514
chr1,10122870,10123224,SRX5716467,SMARCA2,354
chr1,10122886,10123222,SRX5716469,SMARCA4,336
chr1,10122907,10123213,SRX5075175,SMARCA4,306
chr1,10122909,10123287,SRX5075176,SMARCA4,378
chr1,10122910,10123214,SRX5075170,SMARCA4,304
chr1,10122920,10123255,SRX5716470,SMARCA4,335
chr1,10122921,10123153,SRX5054308,FOSL2,232
chr1,10122951,10123290,SRX5054309,FOSL2,339
chr1,10122968,10123168,SRX5020211,SMARCA2,200
chr1,10123007,10123228,SRX5716468,SMARCA2,221
chr1,10152896,10153302,SRX16500059,CTCF,406
chr1,10152931,10153304,SRX16500062,CTCF,373
chr1,10152971,10153357,SRX16500060,CTCF,386
chr1,10152995,10153274,SRX16500061,CTCF,279
chr1,10171238,10171494,SRX20140895,INTS13,256
chr1,10178891,10180129,SRX20140895,INTS13,1238
chr1,10178919,10179122,SRX5075176,SMARCA4,203
chr1,10178958,10179488,SRX5075168,SMARCA4,530
chr1,10178976,10179614,SRX5075174,SMARCA4,638
chr1,10178980,10179198,SRX5075170,SMARCA4,218
chr1,10179098,10179926,SRX20140868,INTS10,828
chr1,10179105,10179371,SRX5716451,SOX2,266
chr1,10179120,10179326,SRX5716454,SOX3,206
chr1,10179736,10180057,SRX5075174,SMARCA4,321
chr1,10186452,10186806,SRX5075176,SMARCA4,354
chr1,10186607,10186793,SRX5075170,SMARCA4,186
chr1,10196989,10197326,SRX5716469,SMARCA4,337
chr1,10197027,10197302,SRX5075176,SMARCA4,275
chr1,10197061,10197355,SRX5075170,SMARCA4,294
chr1,10197124,10197339,SRX5716467,SMARCA2,215
chr1,10209706,10210528,SRX5075174,SMARCA4,822
chr1,10209709,10210538,SRX5075168,SMARCA4,829
chr1,10209714,10210045,SRX5716463,SMARCA4,331
chr1,10209726,10210515,SRX20140881,CPSF3L,789
chr1,10209760,10210719,SRX20140895,INTS13,959
chr1,10209768,10210471,SRX5075170,SMARCA4,703
chr1,10209776,10210125,SRX5075175,SMARCA4,349
chr1,10209790,10210545,SRX5075176,SMARCA4,755
chr1,10209800,10210062,SRX5054309,FOSL2,262
chr1,10209802,10210438,SRX20140879,CPSF3L,636
chr1,10209815,10210033,SRX5075169,SMARCA4,218
chr1,10209818,10210195,SRX5716470,SMARCA4,377
chr1,10209818,10210744,SRX20140867,INTS10,926
chr1,10209824,10210542,SRX20140868,INTS10,718
chr1,10209873,10210104,SRX5716467,SMARCA2,231
chr1,10209882,10210194,SRX5716469,SMARCA4,312
chr1,10209898,10210569,SRX16500060,CTCF,671
chr1,10209910,10210649,SRX20140897,INTS13,739
chr1,10209911,10210375,SRX20140869,INTS10,464
chr1,10209971,10210571,SRX16500059,CTCF,600
chr1,10209991,10210276,SRX20140894,INTS13,285
chr1,10210033,10210603,SRX16500062,CTCF,570
chr1,10210036,10210571,SRX16500061,CTCF,535
chr1,10210077,10210558,SRX4174629,CTCF,481
chr1,10210276,10210499,SRX5716464,SMARCA4,223
chr1,10210320,10210522,SRX5054307,FOSL2,202
chr1,10230767,10231039,SRX5075169,SMARCA4,272
chr1,10230827,10231016,SRX5054309,FOSL2,189
chr1,10236869,10237113,SRX5075176,SMARCA4,244
chr1,10236887,10237084,SRX5075169,SMARCA4,197
chr1,10236928,10237160,SRX5075170,SMARCA4,232
chr1,10252585,10252786,SRX5054309,FOSL2,201
chr1,10252595,10252797,SRX5054308,FOSL2,202
chr1,10253707,10254257,SRX5716469,SMARCA4,550
chr1,10253720,10254144,SRX5716470,SMARCA4,424
chr1,10253720,10254164,SRX5716467,SMARCA2,444
chr1,10253755,10254122,SRX5075176,SMARCA4,367
chr1,10253778,10254148,SRX5075170,SMARCA4,370
chr1,10253787,10254106,SRX5020211,SMARCA2,319
chr1,10253787,10254166,SRX5075169,SMARCA4,379
chr1,10253820,10254136,SRX5075175,SMARCA4,316
chr1,10253822,10254087,SRX5075181,SMARCA2,265
chr1,10253823,10254061,SRX5716468,SMARCA2,238
chr1,10267925,10268282,SRX5075174,SMARCA4,357
chr1,10267929,10268148,SRX5075168,SMARCA4,219
chr1,10268033,10268313,SRX20140895,INTS13,280
chr1,10280712,10280953,SRX5075175,SMARCA4,241
chr1,10280799,10281332,SRX5075176,SMARCA4,533
chr1,10280861,10281330,SRX5075170,SMARCA4,469
chr1,10280994,10281335,SRX5075169,SMARCA4,341
chr1,10281027,10281309,SRX5075175,SMARCA4,282
chr1,10281038,10281312,SRX5054308,FOSL2,274
chr1,10281046,10281305,SRX5054309,FOSL2,259
chr1,10295419,10296134,SRX5075174,SMARCA4,715
chr1,10295450,10296156,SRX5075168,SMARCA4,706
chr1,10295495,10296083,SRX5716451,SOX2,588
chr1,10295523,10296155,SRX5716463,SMARCA4,632
chr1,10295528,10296070,SRX5716454,SOX3,542
chr1,10295541,10295905,SRX20140895,INTS13,364
chr1,10295615,10295948,SRX5716464,SMARCA4,333
chr1,10337947,10338371,SRX16500061,CTCF,424
chr1,10337966,10338424,SRX16500060,CTCF,458
chr1,10338006,10338435,SRX16500062,CTCF,429
chr1,10338006,10338517,SRX16500059,CTCF,511
chr1,10338055,10338388,SRX4174629,CTCF,333
chr1,10338092,10338293,SRX5075168,SMARCA4,201
chr1,10338151,10338377,SRX5075174,SMARCA4,226
chr1,10339807,10340133,SRX5716463,SMARCA4,326
chr1,10339825,10340146,SRX5075168,SMARCA4,321
chr1,10339827,10340172,SRX5075174,SMARCA4,345
chr1,10339865,10340110,SRX5075170,SMARCA4,245
chr1,10339879,10340144,SRX5054309,FOSL2,265
chr1,10353395,10353570,SRX5075176,SMARCA4,175
chr1,10377297,10377716,SRX5075175,SMARCA4,419
chr1,10377321,10377731,SRX4174629,CTCF,410
chr1,10377347,10377837,SRX16500059,CTCF,490
chr1,10377354,10377837,SRX16500060,CTCF,483
chr1,10377365,10377734,SRX16500061,CTCF,369
chr1,10377371,10377841,SRX16500062,CTCF,470
chr1,10377394,10377710,SRX5075169,SMARCA4,316
chr1,10377395,10377761,SRX5075170,SMARCA4,366
chr1,10377414,10377723,SRX5716470,SMARCA4,309
chr1,10377452,10377735,SRX5075168,SMARCA4,283
chr1,10377458,10377738,SRX5075174,SMARCA4,280
chr1,10377470,10377742,SRX5716464,SMARCA4,272
chr1,10377506,10377789,SRX5075176,SMARCA4,283
chr1,10377534,10377781,SRX5716463,SMARCA4,247
chr1,10380661,10381048,SRX5075169,SMARCA4,387
chr1,10380670,10381122,SRX5075170,SMARCA4,452
chr1,10380671,10381042,SRX5054309,FOSL2,371
chr1,10380686,10380948,SRX5075176,SMARCA4,262
chr1,10380691,10381080,SRX5054308,FOSL2,389
chr1,10380701,10380987,SRX5075175,SMARCA4,286
chr1,10380727,10381064,SRX5716469,SMARCA4,337
chr1,10387552,10388373,SRX5075175,SMARCA4,821
chr1,10387631,10388444,SRX5075170,SMARCA4,813
chr1,10387641,10388425,SRX5075176,SMARCA4,784
chr1,10387671,10388394,SRX5075169,SMARCA4,723
chr1,10387691,10388189,SRX5716469,SMARCA4,498
chr1,10387776,10388028,SRX5716467,SMARCA2,252
chr1,10387788,10388228,SRX5716470,SMARCA4,440
chr1,10388032,10388348,SRX5054309,FOSL2,316
chr1,10388132,10388407,SRX5075168,SMARCA4,275
chr1,10398493,10399602,SRX20140895,INTS13,1109
chr1,10398507,10399033,SRX5075174,SMARCA4,526
chr1,10398586,10399005,SRX5075168,SMARCA4,419
chr1,10398598,10399486,SRX20140868,INTS10,888
chr1,10398650,10399334,SRX20140867,INTS10,684
chr1,10398696,10398968,SRX5075170,SMARCA4,272
chr1,10398712,10398887,SRX5075176,SMARCA4,175
chr1,10398833,10399054,SRX5054307,FOSL2,221
chr1,10398874,10399336,SRX20140897,INTS13,462
chr1,10415333,10415783,SRX5075176,SMARCA4,450
chr1,10415355,10415664,SRX5075170,SMARCA4,309
chr1,10415415,10415684,SRX5075169,SMARCA4,269
chr1,10415438,10415687,SRX5075175,SMARCA4,249
chr1,10428013,10428475,SRX16500059,CTCF,462
chr1,10428039,10428455,SRX4174629,CTCF,416
chr1,10428043,10428506,SRX16500061,CTCF,463
chr1,10428044,10428357,SRX5075174,SMARCA4,313
chr1,10428052,10428504,SRX16500060,CTCF,452
chr1,10428075,10428336,SRX5075176,SMARCA4,261
chr1,10428084,10428480,SRX16500062,CTCF,396
chr1,10428089,10428339,SRX5075168,SMARCA4,250
chr1,10428116,10428321,SRX5716464,SMARCA4,205
chr1,10428117,10428317,SRX5075170,SMARCA4,200
chr1,10430135,10430595,SRX16500059,CTCF,460
chr1,10430157,10430580,SRX16500062,CTCF,423
chr1,10430159,10430733,SRX16500060,CTCF,574
chr1,10430161,10430597,SRX16500061,CTCF,436
chr1,10430230,10430519,SRX5075174,SMARCA4,289
chr1,10430244,10430500,SRX5075169,SMARCA4,256
chr1,10430251,10430974,SRX20140868,INTS10,723
chr1,10430268,10430684,SRX5075170,SMARCA4,416
chr1,10430274,10431028,SRX20140895,INTS13,754
chr1,10430278,10430876,SRX5075168,SMARCA4,598
chr1,10430281,10430533,SRX5075176,SMARCA4,252
chr1,10430281,10430829,SRX20140867,INTS10,548
chr1,10430325,10430535,SRX5716464,SMARCA4,210
chr1,10430345,10430761,SRX20140881,CPSF3L,416
chr1,10430385,10430783,SRX20140869,INTS10,398
chr1,10430404,10430710,SRX20140879,CPSF3L,306
chr1,10430422,10430692,SRX20140894,INTS13,270
chr1,10430684,10430966,SRX5075174,SMARCA4,282
chr1,10430729,10430979,SRX5075176,SMARCA4,250
chr1,10430740,10430927,SRX5075175,SMARCA4,187
chr1,10430748,10430974,SRX5075170,SMARCA4,226
chr1,10430766,10430977,SRX5075169,SMARCA4,211
chr1,10430777,10430988,SRX5716470,SMARCA4,211
chr1,10450561,10450982,SRX5075176,SMARCA4,421
chr1,10450596,10451044,SRX5716470,SMARCA4,448
chr1,10450622,10451095,SRX5075170,SMARCA4,473
chr1,10450662,10450966,SRX5075175,SMARCA4,304
chr1,10450669,10450939,SRX5075169,SMARCA4,270
chr1,10450673,10450908,SRX5716469,SMARCA4,235
chr1,10451271,10451583,SRX5075176,SMARCA4,312
chr1,10451271,10451710,SRX5075170,SMARCA4,439
chr1,10451322,10451584,SRX5075169,SMARCA4,262
chr1,10451390,10451597,SRX5075175,SMARCA4,207
chr1,10459105,10459407,SRX5054308,FOSL2,302
chr1,10459109,10459469,SRX5075170,SMARCA4,360
chr1,10459119,10459521,SRX5075169,SMARCA4,402
chr1,10459127,10459425,SRX5716469,SMARCA4,298
chr1,10459135,10459405,SRX5054309,FOSL2,270
chr1,10459139,10459486,SRX5075176,SMARCA4,347
chr1,10459153,10459486,SRX5075175,SMARCA4,333
chr1,10459193,10459438,SRX5716470,SMARCA4,245
chr1,10472269,10472811,SRX20140897,INTS13,542
chr1,10472277,10472464,SRX5075175,SMARCA4,187
chr1,10472329,10472847,SRX20140895,INTS13,518
chr1,10472356,10472644,SRX20140879,CPSF3L,288
chr1,10472376,10472851,SRX5075168,SMARCA4,475
chr1,10472415,10472817,SRX5075174,SMARCA4,402
chr1,10472574,10472837,SRX5716463,SMARCA4,263
chr1,10474712,10474980,SRX5075176,SMARCA4,268
chr1,10474738,10475091,SRX5075174,SMARCA4,353
chr1,10474739,10474960,SRX5075168,SMARCA4,221
chr1,10474756,10475202,SRX20140895,INTS13,446
chr1,10474783,10474979,SRX5075170,SMARCA4,196
chr1,10474841,10475163,SRX20140879,CPSF3L,322
chr1,10474848,10475124,SRX20140867,INTS10,276
chr1,10474852,10475174,SRX20140868,INTS10,322
chr1,10474862,10475144,SRX20140897,INTS13,282
chr1,10490332,10490669,SRX5075174,SMARCA4,337
chr1,10494542,10495323,SRX16500059,CTCF,781
chr1,10494562,10495333,SRX16500061,CTCF,771
chr1,10494605,10495280,SRX16500062,CTCF,675
chr1,10494610,10495299,SRX16500060,CTCF,689
chr1,10494649,10494913,SRX5075174,SMARCA4,264
chr1,10494671,10494997,SRX5075168,SMARCA4,326
chr1,10494686,10494949,SRX5075170,SMARCA4,263
chr1,10494706,10495360,SRX4174629,CTCF,654
chr1,10494752,10494936,SRX5075176,SMARCA4,184
chr1,10494753,10494978,SRX5716470,SMARCA4,225
chr1,10494762,10495028,SRX5075169,SMARCA4,266
chr1,10507268,10507834,SRX16500059,CTCF,566
chr1,10507278,10507857,SRX16500062,CTCF,579
chr1,10507308,10507878,SRX16500061,CTCF,570
chr1,10507330,10507819,SRX16500060,CTCF,489
chr1,10507396,10507787,SRX4174629,CTCF,391
chr1,10507484,10507782,SRX5075168,SMARCA4,298
chr1,10507501,10507780,SRX5075174,SMARCA4,279
chr1,10507524,10507776,SRX5716463,SMARCA4,252
chr1,10507529,10507753,SRX5075170,SMARCA4,224
chr1,10510582,10510883,SRX5075169,SMARCA4,301
chr1,10510924,10511133,SRX5075168,SMARCA4,209
chr1,10510932,10511144,SRX5075170,SMARCA4,212
chr1,10510949,10511243,SRX5075176,SMARCA4,294
chr1,10510951,10511249,SRX5075169,SMARCA4,298
chr1,10511005,10511308,SRX5054309,FOSL2,303
chr1,10511009,10511285,SRX5054308,FOSL2,276
chr1,10511055,10511265,SRX5075175,SMARCA4,210
chr1,10514396,10514821,SRX16500059,CTCF,425
chr1,10514414,10514826,SRX16500060,CTCF,412
chr1,10514429,10514765,SRX16500062,CTCF,336
chr1,10514460,10514766,SRX16500061,CTCF,306
chr1,10528325,10528700,SRX5716469,SMARCA4,375
chr1,10528355,10528894,SRX5075176,SMARCA4,539
chr1,10528381,10528754,SRX5075169,SMARCA4,373
chr1,10528385,10528718,SRX5054309,FOSL2,333
chr1,10528391,10528718,SRX5054308,FOSL2,327
chr1,10528393,10528762,SRX5075175,SMARCA4,369
chr1,10528406,10528744,SRX5075174,SMARCA4,338
chr1,10528426,10528843,SRX5716470,SMARCA4,417
chr1,10528436,10528690,SRX5075168,SMARCA4,254
chr1,10528438,10528862,SRX5075170,SMARCA4,424
chr1,10528563,10528814,SRX5716467,SMARCA2,251
chr1,10530149,10530726,SRX16500059,CTCF,577
chr1,10530199,10530695,SRX16500061,CTCF,496
chr1,10530218,10530745,SRX16500062,CTCF,527
chr1,10530227,10530714,SRX16500060,CTCF,487
chr1,10530289,10530566,SRX4174629,CTCF,277
chr1,10530312,10530534,SRX5075168,SMARCA4,222
chr1,10530326,10530632,SRX5075174,SMARCA4,306
chr1,10530345,10530587,SRX5075176,SMARCA4,242
chr1,10530360,10530594,SRX5075170,SMARCA4,234
chr1,10530389,10530575,SRX5075169,SMARCA4,186
chr1,10530404,10530608,SRX5075175,SMARCA4,204
chr1,10562053,10562260,SRX5054309,FOSL2,207
chr1,10575561,10575828,SRX5716469,SMARCA4,267
chr1,10575653,10575992,SRX5054309,FOSL2,339
chr1,10575689,10575972,SRX5075175,SMARCA4,283
chr1,10575693,10576039,SRX5075169,SMARCA4,346
chr1,10575700,10575925,SRX5075170,SMARCA4,225
chr1,10575704,10575915,SRX5054308,FOSL2,211
chr1,10575716,10575909,SRX5075176,SMARCA4,193
chr1,10599641,10599872,SRX5054308,FOSL2,231
chr1,10599667,10599857,SRX5075169,SMARCA4,190
chr1,10628729,10628982,SRX5075170,SMARCA4,253
chr1,10628761,10628970,SRX5075176,SMARCA4,209
chr1,10632370,10632554,SRX5075176,SMARCA4,184
chr1,10632390,10632652,SRX5075170,SMARCA4,262
chr1,10632437,10632731,SRX5075175,SMARCA4,294
chr1,10649660,10650081,SRX5075174,SMARCA4,421
chr1,10649753,10649961,SRX5716463,SMARCA4,208
chr1,10649866,10650045,SRX5075168,SMARCA4,179
chr1,10649877,10650082,SRX5716464,SMARCA4,205
chr1,10649997,10650252,SRX5075170,SMARCA4,255
chr1,10650037,10650275,SRX5075176,SMARCA4,238
chr1,10651457,10651718,SRX5075174,SMARCA4,261
chr1,10663629,10663885,SRX5075169,SMARCA4,256
chr1,10663637,10663912,SRX5075168,SMARCA4,275
chr1,10663689,10663865,SRX5075174,SMARCA4,176
chr1,10668298,10668480,SRX5075168,SMARCA4,182
chr1,10679691,10679910,SRX5075176,SMARCA4,219
chr1,10693870,10694109,SRX5716470,SMARCA4,239
chr1,10693871,10694114,SRX5716469,SMARCA4,243
chr1,10693925,10694114,SRX5075175,SMARCA4,189
chr1,10693927,10694100,SRX5075174,SMARCA4,173
chr1,10704231,10704928,SRX20140868,INTS10,697
chr1,10704251,10704884,SRX20140867,INTS10,633
chr1,10704252,10704929,SRX20140895,INTS13,677
chr1,10704314,10704953,SRX20140879,CPSF3L,639
chr1,10704345,10704644,SRX20140894,INTS13,299
chr1,10704412,10704804,SRX20140880,CPSF3L,392
chr1,10704419,10704930,SRX5075168,SMARCA4,511
chr1,10704494,10704960,SRX5075174,SMARCA4,466
chr1,10704608,10704866,SRX5716464,SMARCA4,258
chr1,10709193,10709647,SRX5075174,SMARCA4,454
chr1,10709215,10709557,SRX5075168,SMARCA4,342
chr1,10709457,10709918,SRX20140895,INTS13,461
chr1,10714568,10714913,SRX5075174,SMARCA4,345
chr1,10725134,10725637,SRX5075170,SMARCA4,503
chr1,10725251,10725458,SRX5075175,SMARCA4,207
chr1,10725315,10725580,SRX5075176,SMARCA4,265
chr1,10725341,10725580,SRX5716469,SMARCA4,239
chr1,10728511,10729081,SRX20140868,INTS10,570
chr1,10728522,10729139,SRX20140895,INTS13,617
chr1,10728535,10729256,SRX5075174,SMARCA4,721
chr1,10728539,10728954,SRX5075168,SMARCA4,415
chr1,10728566,10728888,SRX5716463,SMARCA4,322
chr1,10728570,10728847,SRX20140894,INTS13,277
chr1,10728577,10728961,SRX20140879,CPSF3L,384
chr1,10728580,10729071,SRX20140867,INTS10,491
chr1,10728596,10728875,SRX5716464,SMARCA4,279
chr1,10728623,10729030,SRX5716451,SOX2,407
chr1,10728653,10728962,SRX5716454,SOX3,309
chr1,10728664,10728904,SRX20140880,CPSF3L,240
chr1,10728677,10729014,SRX20140881,CPSF3L,337
chr1,10731044,10731244,SRX5020211,SMARCA2,200
chr1,10731047,10731301,SRX5075169,SMARCA4,254
chr1,10731062,10731378,SRX5054309,FOSL2,316
chr1,10731095,10731299,SRX5075175,SMARCA4,204
chr1,10731096,10731364,SRX5054308,FOSL2,268
chr1,10734836,10735517,SRX5075168,SMARCA4,681
chr1,10734864,10735435,SRX5075174,SMARCA4,571
chr1,10734906,10735471,SRX20140895,INTS13,565
chr1,10734921,10735344,SRX5716464,SMARCA4,423
chr1,10734933,10735298,SRX5716463,SMARCA4,365
chr1,10734955,10735290,SRX5716454,SOX3,335
chr1,10735030,10735348,SRX20140868,INTS10,318
chr1,10735060,10735256,SRX5716451,SOX2,196
chr1,10753220,10753515,SRX16500060,CTCF,295
chr1,10753318,10753528,SRX16500062,CTCF,210
chr1,10753324,10753544,SRX16500061,CTCF,220
chr1,10788812,10789047,SRX16500059,CTCF,235
chr1,10788831,10789062,SRX16500061,CTCF,231
chr1,10793728,10794163,SRX16500059,CTCF,435
chr1,10793787,10794161,SRX16500060,CTCF,374
chr1,10793808,10794178,SRX16500062,CTCF,370
chr1,10793810,10794129,SRX16500061,CTCF,319
chr1,10796446,10796879,SRX5075168,SMARCA4,433
chr1,10796461,10796796,SRX5075176,SMARCA4,335
chr1,10796496,10796810,SRX5075174,SMARCA4,314
chr1,10796587,10796756,SRX5075170,SMARCA4,169
chr1,10815166,10815383,SRX5716451,SOX2,217
chr1,10815314,10815952,SRX20140879,CPSF3L,638
chr1,10815469,10815904,SRX20140894,INTS13,435
chr1,10825008,10825213,SRX5075170,SMARCA4,205
chr1,10835756,10836173,SRX20140895,INTS13,417
chr1,10835796,10836273,SRX5075168,SMARCA4,477
chr1,10835815,10836276,SRX5075174,SMARCA4,461
chr1,10835861,10836182,SRX5075176,SMARCA4,321
chr1,10835864,10836234,SRX5075170,SMARCA4,370
chr1,10835869,10836110,SRX5716451,SOX2,241
chr1,10835875,10836157,SRX5716470,SMARCA4,282
chr1,10835881,10836219,SRX5716463,SMARCA4,338
chr1,10835897,10836155,SRX5075169,SMARCA4,258
chr1,10835930,10836220,SRX5716464,SMARCA4,290
chr1,10866987,10867530,SRX16500061,CTCF,543
chr1,10867008,10867536,SRX16500062,CTCF,528
chr1,10867022,10867392,SRX5075175,SMARCA4,370
chr1,10867028,10867442,SRX5075174,SMARCA4,414
chr1,10867047,10867545,SRX5075176,SMARCA4,498
chr1,10867050,10867550,SRX16500060,CTCF,500
chr1,10867062,10867273,SRX5716470,SMARCA4,211
chr1,10867066,10867632,SRX16500059,CTCF,566
chr1,10867095,10867299,SRX5716463,SMARCA4,204
chr1,10867096,10867404,SRX5075169,SMARCA4,308
chr1,10867096,10867412,SRX5075168,SMARCA4,316
chr1,10867102,10867394,SRX5075170,SMARCA4,292
chr1,10867115,10867541,SRX20140895,INTS13,426
chr1,10888166,10888491,SRX16500061,CTCF,325
chr1,10888196,10888551,SRX16500059,CTCF,355
chr1,10888246,10888507,SRX16500060,CTCF,261
chr1,10888251,10888513,SRX16500062,CTCF,262
chr1,10898334,10898585,SRX5075169,SMARCA4,251
chr1,10901480,10902096,SRX5075168,SMARCA4,616
chr1,10901514,10901756,SRX5054308,FOSL2,242
chr1,10901537,10902070,SRX5075174,SMARCA4,533
chr1,10901574,10901803,SRX5075169,SMARCA4,229
chr1,10909884,10910325,SRX16500059,CTCF,441
chr1,10909900,10910285,SRX16500060,CTCF,385
chr1,10909927,10910292,SRX16500062,CTCF,365
chr1,10909946,10910286,SRX16500061,CTCF,340
chr1,10918638,10918907,SRX5075169,SMARCA4,269
chr1,10941830,10942359,SRX16500059,CTCF,529
chr1,10941860,10942370,SRX16500062,CTCF,510
chr1,10941862,10942374,SRX16500060,CTCF,512
chr1,10941881,10942400,SRX16500061,CTCF,519
chr1,10941916,10942262,SRX4174629,CTCF,346
chr1,10941945,10942288,SRX5075174,SMARCA4,343
chr1,10941989,10942252,SRX5075168,SMARCA4,263
chr1,10942031,10942267,SRX5075176,SMARCA4,236
chr1,10942110,10942297,SRX5075169,SMARCA4,187
chr1,10960907,10961458,SRX16500061,CTCF,551
chr1,10960928,10961503,SRX16500059,CTCF,575
chr1,10960934,10961419,SRX16500060,CTCF,485
chr1,10960971,10961465,SRX16500062,CTCF,494
chr1,10961005,10961261,SRX4174629,CTCF,256
chr1,10961050,10961259,SRX5075168,SMARCA4,209
chr1,10962500,10962675,SRX5075176,SMARCA4,175
chr1,10962520,10962724,SRX5075169,SMARCA4,204
chr1,10962530,10962734,SRX5075170,SMARCA4,204
chr1,10975646,10976059,SRX5075170,SMARCA4,413
chr1,10975652,10976125,SRX5075176,SMARCA4,473
chr1,10975687,10976091,SRX5054309,FOSL2,404
chr1,10975707,10976051,SRX5075169,SMARCA4,344
chr1,10975753,10976041,SRX5716469,SMARCA4,288
chr1,10975771,10976059,SRX5075175,SMARCA4,288
chr1,10975781,10975999,SRX5075174,SMARCA4,218
chr1,10975797,10976022,SRX5054307,FOSL2,225
chr1,10975824,10976050,SRX5054308,FOSL2,226
chr1,10979444,10979788,SRX5075174,SMARCA4,344
chr1,10979548,10979762,SRX5075168,SMARCA4,214
chr1,10980141,10980712,SRX16500059,CTCF,571
chr1,10980219,10980484,SRX5716470,SMARCA4,265
chr1,10980230,10980499,SRX5075176,SMARCA4,269
chr1,10980235,10980548,SRX5075170,SMARCA4,313
chr1,10980241,10980562,SRX5075174,SMARCA4,321
chr1,10980249,10980575,SRX5075168,SMARCA4,326
chr1,10980252,10980658,SRX16500060,CTCF,406
chr1,10980267,10980651,SRX16500062,CTCF,384
chr1,10980275,10980586,SRX16500061,CTCF,311
chr1,10980506,10981166,SRX20140895,INTS13,660
chr1,10980830,10981277,SRX5075174,SMARCA4,447
chr1,10980888,10981165,SRX5716451,SOX2,277
chr1,10980898,10981323,SRX5075168,SMARCA4,425
chr1,10980900,10981132,SRX5716463,SMARCA4,232
chr1,10980902,10981177,SRX5716454,SOX3,275
chr1,10980926,10981189,SRX20140868,INTS10,263
chr1,11012133,11012325,SRX5075168,SMARCA4,192
chr1,11012135,11012625,SRX5075174,SMARCA4,490
chr1,11012390,11012602,SRX5075168,SMARCA4,212
chr1,11012415,11012628,SRX5716470,SMARCA4,213
chr1,11012427,11012983,SRX20140869,INTS10,556
chr1,11012445,11012930,SRX20140868,INTS10,485
chr1,11012452,11013109,SRX20140895,INTS13,657
chr1,11012458,11012868,SRX20140867,INTS10,410
chr1,11012469,11013135,SRX20140897,INTS13,666
chr1,11012495,11012792,SRX20140881,CPSF3L,297
chr1,11012754,11012953,SRX5075170,SMARCA4,199
chr1,11012852,11013122,SRX5716469,SMARCA4,270
chr1,11037494,11038020,SRX16500059,CTCF,526
chr1,11037512,11038006,SRX16500061,CTCF,494
chr1,11037538,11037994,SRX16500062,CTCF,456
chr1,11037547,11038032,SRX16500060,CTCF,485
chr1,11037584,11037992,SRX5075176,SMARCA4,408
chr1,11037601,11037932,SRX5716464,SMARCA4,331
chr1,11037611,11037961,SRX5075168,SMARCA4,350
chr1,11037627,11037934,SRX4174629,CTCF,307
chr1,11037630,11037937,SRX5075175,SMARCA4,307
chr1,11037638,11037954,SRX5716463,SMARCA4,316
chr1,11037642,11037999,SRX5075174,SMARCA4,357
chr1,11037665,11037985,SRX5075170,SMARCA4,320
chr1,11037667,11037973,SRX5716470,SMARCA4,306
chr1,11037672,11038004,SRX5075169,SMARCA4,332
chr1,11037674,11037954,SRX5716469,SMARCA4,280
chr1,11045589,11045897,SRX5075174,SMARCA4,308
chr1,11045690,11045924,SRX5075168,SMARCA4,234
chr1,11059644,11060540,SRX20140895,INTS13,896
chr1,11059759,11060063,SRX20140896,INTS13,304
chr1,11059817,11060400,SRX20140867,INTS10,583
chr1,11060010,11060342,SRX5075168,SMARCA4,332
chr1,11060028,11060448,SRX5075174,SMARCA4,420
chr1,11060051,11060361,SRX5075170,SMARCA4,310
chr1,11060061,11060245,SRX5054307,FOSL2,184
chr1,11060072,11060454,SRX5075176,SMARCA4,382
chr1,11060087,11060385,SRX16500062,CTCF,298
chr1,11060089,11060440,SRX16500061,CTCF,351
chr1,11060090,11060478,SRX5075175,SMARCA4,388
chr1,11060092,11060421,SRX16500060,CTCF,329
chr1,11060110,11060439,SRX16500059,CTCF,329
chr1,11060138,11060350,SRX5716463,SMARCA4,212
chr1,11060142,11060474,SRX20140868,INTS10,332
chr1,11060180,11060424,SRX20140897,INTS13,244
chr1,11060271,11060506,SRX20140879,CPSF3L,235
chr1,11060309,11060571,SRX5075169,SMARCA4,262
chr1,11099372,11099864,SRX20140868,INTS10,492
chr1,11099409,11100056,SRX20140895,INTS13,647
chr1,11099446,11099895,SRX20140867,INTS10,449
chr1,11099570,11099825,SRX20140879,CPSF3L,255
chr1,11099577,11099880,SRX20140881,CPSF3L,303
chr1,11099612,11099886,SRX20140897,INTS13,274
chr1,11099664,11100048,SRX5075174,SMARCA4,384
chr1,11099722,11100098,SRX5075168,SMARCA4,376
chr1,11099846,11100118,SRX5075176,SMARCA4,272
chr1,11138986,11139256,SRX5054308,FOSL2,270
chr1,11139038,11139213,SRX5075176,SMARCA4,175
chr1,11139094,11139291,SRX5075170,SMARCA4,197
chr1,11147422,11147708,SRX5075176,SMARCA4,286
chr1,11147427,11147662,SRX5075170,SMARCA4,235
chr1,11152315,11152589,SRX5075170,SMARCA4,274
chr1,11152374,11152578,SRX5075176,SMARCA4,204
chr1,11152393,11152605,SRX5716469,SMARCA4,212
chr1,11158459,11159131,SRX5075176,SMARCA4,672
chr1,11158463,11159031,SRX5075175,SMARCA4,568
chr1,11158581,11159015,SRX5054309,FOSL2,434
chr1,11158593,11159101,SRX5075169,SMARCA4,508
chr1,11158597,11159003,SRX5716470,SMARCA4,406
chr1,11158610,11159099,SRX5075170,SMARCA4,489
chr1,11158617,11159068,SRX5716469,SMARCA4,451
chr1,11158662,11159002,SRX5716460,Epitope tags,340
chr1,11158697,11159029,SRX5054308,FOSL2,332
chr1,11158745,11159009,SRX5716467,SMARCA2,264
chr1,11158795,11159034,SRX5020214,SMARCA2,239
chr1,11174324,11174499,SRX5075176,SMARCA4,175
chr1,11178298,11178652,SRX5075170,SMARCA4,354
chr1,11178394,11178617,SRX5075168,SMARCA4,223
chr1,11178413,11178612,SRX5075176,SMARCA4,199
chr1,11178474,11178693,SRX5075174,SMARCA4,219
chr1,11241581,11242131,SRX16500061,CTCF,550
chr1,11241616,11242184,SRX16500059,CTCF,568
chr1,11241661,11242204,SRX16500060,CTCF,543
chr1,11241687,11242076,SRX16500062,CTCF,389
chr1,11241774,11242007,SRX5075174,SMARCA4,233
chr1,11241814,11242070,SRX5075168,SMARCA4,256
chr1,11241829,11242038,SRX5075176,SMARCA4,209
chr1,11241838,11242102,SRX5075170,SMARCA4,264
chr1,11262238,11262993,SRX20140895,INTS13,755
chr1,11262437,11262711,SRX5075168,SMARCA4,274
chr1,11262494,11262840,SRX20140868,INTS10,346
chr1,11262507,11262767,SRX5054307,FOSL2,260
chr1,11262576,11262769,SRX5716451,SOX2,193
chr1,11262612,11263034,SRX5075174,SMARCA4,422
chr1,11262658,11262838,SRX5054308,FOSL2,180
chr1,11262793,11263022,SRX5075176,SMARCA4,229
chr1,11262802,11263045,SRX16500062,CTCF,243
chr1,11262806,11263042,SRX5075170,SMARCA4,236
chr1,11262825,11263073,SRX20140894,INTS13,248
chr1,11272717,11272927,SRX5075176,SMARCA4,210
chr1,11272719,11272945,SRX5075168,SMARCA4,226
chr1,11272736,11272923,SRX5075170,SMARCA4,187
chr1,11272758,11272997,SRX5075174,SMARCA4,239
chr1,11272764,11273075,SRX5054307,FOSL2,311
chr1,11273101,11273578,SRX20140895,INTS13,477
chr1,11273124,11273451,SRX20140896,INTS13,327
chr1,11273125,11273298,SRX5075174,SMARCA4,173
chr1,11273127,11273400,SRX5075170,SMARCA4,273
chr1,11273129,11273445,SRX5075176,SMARCA4,316
chr1,11273136,11273505,SRX20140868,INTS10,369
chr1,11273149,11273582,SRX20140867,INTS10,433
chr1,11273164,11273529,SRX20140879,CPSF3L,365
chr1,11273167,11273507,SRX20140897,INTS13,340
chr1,11273172,11273719,SRX20140869,INTS10,547
chr1,11273198,11273486,SRX20140894,INTS13,288
chr1,11273206,11273610,SRX5075169,SMARCA4,404
chr1,11273229,11273623,SRX5716470,SMARCA4,394
chr1,11281766,11282285,SRX5716467,SMARCA2,519
chr1,11281814,11282443,SRX5075176,SMARCA4,629
chr1,11281818,11282385,SRX5716469,SMARCA4,567
chr1,11281822,11282334,SRX5716470,SMARCA4,512
chr1,11281849,11282319,SRX5075175,SMARCA4,470
chr1,11281871,11282393,SRX5716468,SMARCA2,522
chr1,11281872,11282197,SRX5020214,SMARCA2,325
chr1,11281873,11282201,SRX5054309,FOSL2,328
chr1,11281891,11282351,SRX5075170,SMARCA4,460
chr1,11281906,11282195,SRX5020211,SMARCA2,289
chr1,11281919,11282278,SRX5075181,SMARCA2,359
chr1,11281934,11282185,SRX5075182,SMARCA2,251
chr1,11281956,11282328,SRX5075169,SMARCA4,372
chr1,11286112,11286613,SRX16500062,CTCF,501
chr1,11286143,11286648,SRX16500060,CTCF,505
chr1,11286146,11286577,SRX16500059,CTCF,431
chr1,11286208,11286601,SRX16500061,CTCF,393
chr1,11286409,11286647,SRX4174629,CTCF,238
chr1,11316615,11317059,SRX5075176,SMARCA4,444
chr1,11316628,11317077,SRX5075170,SMARCA4,449
chr1,11316661,11317040,SRX5716469,SMARCA4,379
chr1,11316662,11316998,SRX5716467,SMARCA2,336
chr1,11316673,11317039,SRX5075169,SMARCA4,366
chr1,11316707,11317163,SRX5075175,SMARCA4,456
chr1,11316722,11317034,SRX5716470,SMARCA4,312
chr1,11316727,11317018,SRX5716468,SMARCA2,291
chr1,11316746,11316947,SRX5020211,SMARCA2,201
chr1,11316760,11316995,SRX5054308,FOSL2,235
chr1,11316762,11316986,SRX5054309,FOSL2,224
chr1,11320060,11320644,SRX16500060,CTCF,584
chr1,11320108,11320635,SRX16500061,CTCF,527
chr1,11320130,11320593,SRX16500062,CTCF,463
chr1,11320155,11320604,SRX16500059,CTCF,449
chr1,11320305,11320478,SRX5075174,SMARCA4,173
chr1,11324620,11324796,SRX5075176,SMARCA4,176
chr1,11337442,11337938,SRX16500059,CTCF,496
chr1,11337447,11337881,SRX16500061,CTCF,434
chr1,11337468,11337931,SRX16500062,CTCF,463
chr1,11337473,11337936,SRX16500060,CTCF,463
chr1,11337538,11337827,SRX4174629,CTCF,289
chr1,11339814,11340122,SRX20140895,INTS13,308
chr1,11339982,11340213,SRX5075170,SMARCA4,231
chr1,11340011,11340185,SRX5075174,SMARCA4,174
chr1,11340034,11340219,SRX5075168,SMARCA4,185
chr1,11342177,11342548,SRX5075170,SMARCA4,371
chr1,11342188,11342748,SRX5075176,SMARCA4,560
chr1,11342219,11342430,SRX5716468,SMARCA2,211
chr1,11342619,11342843,SRX5075170,SMARCA4,224
chr1,11350296,11350625,SRX5075170,SMARCA4,329
chr1,11350324,11350652,SRX5075176,SMARCA4,328
chr1,11350336,11350609,SRX5054309,FOSL2,273
chr1,11350445,11350636,SRX5075169,SMARCA4,191
chr1,11355113,11355830,SRX20140895,INTS13,717
chr1,11355201,11356077,SRX5075168,SMARCA4,876
chr1,11355531,11355955,SRX5075174,SMARCA4,424
chr1,11355597,11355842,SRX5716463,SMARCA4,245
chr1,11355745,11355980,SRX20140879,CPSF3L,235
chr1,11355832,11356037,SRX5716464,SMARCA4,205
chr1,11364212,11364487,SRX16500059,CTCF,275
chr1,11384183,11384561,SRX5075170,SMARCA4,378
chr1,11384265,11384491,SRX5054308,FOSL2,226
chr1,11384278,11384541,SRX5054309,FOSL2,263
chr1,11384287,11384478,SRX5075169,SMARCA4,191
chr1,11384295,11384618,SRX5075176,SMARCA4,323
chr1,11384326,11384513,SRX5075174,SMARCA4,187
chr1,11413973,11414451,SRX20140895,INTS13,478
chr1,11414013,11414399,SRX20140868,INTS10,386
chr1,11414019,11414390,SRX5075174,SMARCA4,371
chr1,11414121,11414330,SRX5075168,SMARCA4,209
chr1,11417136,11417359,SRX5075176,SMARCA4,223
chr1,11417161,11417507,SRX5075170,SMARCA4,346
chr1,11478570,11479119,SRX16500061,CTCF,549
chr1,11478602,11479158,SRX16500060,CTCF,556
chr1,11478623,11479150,SRX16500059,CTCF,527
chr1,11478632,11479143,SRX16500062,CTCF,511
chr1,11478642,11479070,SRX5075174,SMARCA4,428
chr1,11478741,11479101,SRX5075168,SMARCA4,360
chr1,11478781,11479040,SRX5075176,SMARCA4,259
chr1,11478837,11479513,SRX20140895,INTS13,676
chr1,11478858,11479063,SRX5716454,SOX3,205
chr1,11478859,11479402,SRX20140867,INTS10,543
chr1,11478859,11479446,SRX20140868,INTS10,587
chr1,11478889,11479128,SRX5716451,SOX2,239
chr1,11478901,11479338,SRX20140896,INTS13,437
chr1,11478940,11479119,SRX5075170,SMARCA4,179
chr1,11478971,11479408,SRX20140879,CPSF3L,437
chr1,11478974,11479458,SRX20140881,CPSF3L,484
chr1,11479083,11479501,SRX20140894,INTS13,418
chr1,11480074,11480356,SRX5716469,SMARCA4,282
chr1,11480101,11480406,SRX5075176,SMARCA4,305
chr1,11480132,11480422,SRX5075169,SMARCA4,290
chr1,11480133,11480432,SRX5716470,SMARCA4,299
chr1,11480137,11480401,SRX5075170,SMARCA4,264
chr1,11480156,11480423,SRX5075175,SMARCA4,267
chr1,11480157,11480350,SRX5075168,SMARCA4,193
chr1,11480162,11480405,SRX5075174,SMARCA4,243
chr1,11499735,11499975,SRX5075174,SMARCA4,240
chr1,11499821,11500113,SRX5075168,SMARCA4,292
chr1,11535831,11536033,SRX5054309,FOSL2,202
chr1,11550699,11551015,SRX5716469,SMARCA4,316
chr1,11550732,11551011,SRX5075170,SMARCA4,279
chr1,11550740,11551049,SRX5716470,SMARCA4,309
chr1,11550746,11551002,SRX5716464,SMARCA4,256
chr1,11550748,11551081,SRX5075176,SMARCA4,333
chr1,11550755,11551042,SRX5075174,SMARCA4,287
chr1,11550763,11551025,SRX5075168,SMARCA4,262
chr1,11550778,11551034,SRX5075175,SMARCA4,256
chr1,11550791,11551019,SRX5075169,SMARCA4,228
chr1,11550812,11551030,SRX5716463,SMARCA4,218
chr1,11563530,11563826,SRX5075168,SMARCA4,296
chr1,11563534,11563812,SRX5075174,SMARCA4,278
chr1,11568809,11568998,SRX5054308,FOSL2,189
chr1,11572190,11572461,SRX16500060,CTCF,271
chr1,11572194,11572466,SRX16500059,CTCF,272
chr1,11572219,11572442,SRX16500061,CTCF,223
chr1,11594138,11594481,SRX16500060,CTCF,343
chr1,11594190,11594519,SRX16500059,CTCF,329
chr1,11594232,11594528,SRX16500061,CTCF,296
chr1,11594259,11594492,SRX5075174,SMARCA4,233
chr1,11594261,11594526,SRX16500062,CTCF,265
chr1,11594295,11594476,SRX5075168,SMARCA4,181
chr1,11635871,11636163,SRX5075174,SMARCA4,292
chr1,11635907,11636184,SRX5075170,SMARCA4,277
chr1,11635909,11636122,SRX5075169,SMARCA4,213
chr1,11635910,11636117,SRX5075175,SMARCA4,207
chr1,11635910,11636131,SRX5075176,SMARCA4,221
chr1,11635910,11636155,SRX5716470,SMARCA4,245
chr1,11635936,11636163,SRX5075168,SMARCA4,227
chr1,11642370,11642790,SRX16500062,CTCF,420
chr1,11642375,11642868,SRX16500059,CTCF,493
chr1,11642376,11642821,SRX16500060,CTCF,445
chr1,11642399,11642820,SRX16500061,CTCF,421
chr1,11642401,11642684,SRX4174629,CTCF,283
chr1,11642444,11642698,SRX5075168,SMARCA4,254
chr1,11642468,11642652,SRX5075174,SMARCA4,184
chr1,11642481,11642650,SRX5075170,SMARCA4,169
chr1,11645652,11646073,SRX16500060,CTCF,421
chr1,11645667,11646071,SRX16500059,CTCF,404
chr1,11645675,11646026,SRX16500062,CTCF,351
chr1,11645678,11646009,SRX16500061,CTCF,331
chr1,11645710,11646031,SRX4174629,CTCF,321
chr1,11663947,11664432,SRX16500061,CTCF,485
chr1,11663952,11664388,SRX16500060,CTCF,436
chr1,11664007,11664441,SRX16500059,CTCF,434
chr1,11664018,11664426,SRX5075168,SMARCA4,408
chr1,11664075,11664431,SRX16500062,CTCF,356
chr1,11664114,11664367,SRX5075174,SMARCA4,253
chr1,11664145,11664381,SRX5075170,SMARCA4,236
chr1,11664400,11664726,SRX5716470,SMARCA4,326
chr1,11680806,11681442,SRX20140895,INTS13,636
chr1,11680975,11681657,SRX5075168,SMARCA4,682
chr1,11680987,11681616,SRX5075176,SMARCA4,629
chr1,11681042,11681402,SRX5075170,SMARCA4,360
chr1,11681068,11681511,SRX5075174,SMARCA4,443
chr1,11681091,11681535,SRX20140867,INTS10,444
chr1,11681154,11681503,SRX5716469,SMARCA4,349
chr1,11681181,11681460,SRX5075169,SMARCA4,279
chr1,11681188,11681557,SRX5075175,SMARCA4,369
chr1,11681192,11681516,SRX5716470,SMARCA4,324
chr1,11682516,11682740,SRX5075169,SMARCA4,224
chr1,11690611,11691780,SRX20140895,INTS13,1169
chr1,11690650,11691706,SRX20140868,INTS10,1056
chr1,11690695,11690912,SRX5075168,SMARCA4,217
chr1,11690746,11690967,SRX5075174,SMARCA4,221
chr1,11691147,11691586,SRX20140867,INTS10,439
chr1,11691179,11691519,SRX20140879,CPSF3L,340
chr1,11691316,11691544,SRX5075168,SMARCA4,228
chr1,11693136,11693384,SRX5054308,FOSL2,248
chr1,11693148,11693474,SRX5054309,FOSL2,326
chr1,11693153,11693540,SRX5075169,SMARCA4,387
chr1,11693155,11693465,SRX5075170,SMARCA4,310
chr1,11693203,11693522,SRX5075176,SMARCA4,319
chr1,11693207,11693622,SRX5075175,SMARCA4,415
chr1,11693230,11693445,SRX5716470,SMARCA4,215
chr1,11693234,11693507,SRX5716469,SMARCA4,273
chr1,11704261,11704469,SRX5075174,SMARCA4,208
chr1,11704262,11704595,SRX5075168,SMARCA4,333
chr1,11704275,11704521,SRX20140867,INTS10,246
chr1,11710968,11711405,SRX4174629,CTCF,437
chr1,11710990,11711526,SRX16500060,CTCF,536
chr1,11710999,11711422,SRX16500059,CTCF,423
chr1,11711064,11711364,SRX16500062,CTCF,300
chr1,11711068,11711462,SRX16500061,CTCF,394
chr1,11719658,11720217,SRX16500060,CTCF,559
chr1,11719701,11720180,SRX16500062,CTCF,479
chr1,11719703,11720195,SRX16500059,CTCF,492
chr1,11719703,11720247,SRX16500061,CTCF,544
chr1,11719769,11720068,SRX5075175,SMARCA4,299
chr1,11719779,11720079,SRX5075174,SMARCA4,300
chr1,11719806,11720080,SRX4174629,CTCF,274
chr1,11719827,11720101,SRX5075168,SMARCA4,274
chr1,11719833,11720100,SRX5716470,SMARCA4,267
chr1,11719848,11720121,SRX5075176,SMARCA4,273
chr1,11731707,11732103,SRX5075176,SMARCA4,396
chr1,11731722,11732020,SRX5075170,SMARCA4,298
chr1,11735798,11736375,SRX20140895,INTS13,577
chr1,11735828,11736192,SRX5075174,SMARCA4,364
chr1,11735870,11736319,SRX5075168,SMARCA4,449
chr1,11735876,11736079,SRX5075176,SMARCA4,203
chr1,11735877,11736307,SRX20140897,INTS13,430
chr1,11735899,11736103,SRX5716463,SMARCA4,204
chr1,11735971,11736215,SRX5716464,SMARCA4,244
chr1,11735996,11736190,SRX5075175,SMARCA4,194
chr1,11736855,11737041,SRX5075174,SMARCA4,186
chr1,11749264,11749499,SRX16500061,CTCF,235
chr1,11785056,11785581,SRX16500061,CTCF,525
chr1,11785056,11785600,SRX16500059,CTCF,544
chr1,11785093,11785622,SRX16500062,CTCF,529
chr1,11785095,11785451,SRX5075174,SMARCA4,356
chr1,11785102,11785613,SRX16500060,CTCF,511
chr1,11785291,11785470,SRX5075168,SMARCA4,179
chr1,11790924,11791128,SRX5075175,SMARCA4,204
chr1,11803511,11803732,SRX5075168,SMARCA4,221
chr1,11803547,11803971,SRX5075176,SMARCA4,424
chr1,11803593,11803941,SRX5075170,SMARCA4,348
chr1,11803597,11803826,SRX5716470,SMARCA4,229
chr1,11803643,11803876,SRX5075175,SMARCA4,233
chr1,11805503,11806135,SRX5075170,SMARCA4,632
chr1,11805519,11806093,SRX5054309,FOSL2,574
chr1,11805586,11806265,SRX5075168,SMARCA4,679
chr1,11805644,11805960,SRX20140879,CPSF3L,316
chr1,11805644,11806125,SRX5075174,SMARCA4,481
chr1,11805667,11805996,SRX20140881,CPSF3L,329
chr1,11805704,11806043,SRX20140867,INTS10,339
chr1,11805726,11806092,SRX20140868,INTS10,366
chr1,11805726,11806156,SRX5716463,SMARCA4,430
chr1,11805733,11806030,SRX5716469,SMARCA4,297
chr1,11805737,11806066,SRX5075169,SMARCA4,329
chr1,11805740,11806078,SRX5054308,FOSL2,338
chr1,11805746,11805999,SRX5075175,SMARCA4,253
chr1,11805751,11806112,SRX5075176,SMARCA4,361
chr1,11805765,11805970,SRX5716464,SMARCA4,205
chr1,11805778,11806532,SRX20140895,INTS13,754
chr1,11805791,11806164,SRX5054307,FOSL2,373
chr1,11805800,11806063,SRX5020211,SMARCA2,263
chr1,11805812,11806460,SRX20140897,INTS13,648
chr1,11805875,11806190,SRX5716454,SOX3,315
chr1,11805935,11806420,SRX20140896,INTS13,485
chr1,11805965,11806364,SRX20140894,INTS13,399
chr1,11806088,11806297,SRX5716464,SMARCA4,209
chr1,11821548,11821884,SRX5054308,FOSL2,336
chr1,11821562,11821893,SRX5054309,FOSL2,331
chr1,11821567,11821834,SRX5075169,SMARCA4,267
chr1,11821580,11821825,SRX5020211,SMARCA2,245
chr1,11821583,11821861,SRX5075170,SMARCA4,278
chr1,11821613,11821896,SRX5716469,SMARCA4,283
chr1,11821621,11821836,SRX5075175,SMARCA4,215
chr1,11821636,11821915,SRX5716470,SMARCA4,279
chr1,11821642,11821869,SRX5075176,SMARCA4,227
chr1,11838581,11839119,SRX16500059,CTCF,538
chr1,11838611,11839084,SRX16500060,CTCF,473
chr1,11838625,11839104,SRX16500061,CTCF,479
chr1,11838627,11839067,SRX16500062,CTCF,440
chr1,11838725,11839047,SRX4174629,CTCF,322
chr1,11838728,11839032,SRX5075174,SMARCA4,304
chr1,11838760,11839024,SRX5075168,SMARCA4,264
chr1,11838770,11839017,SRX5075176,SMARCA4,247
chr1,11838783,11838972,SRX5075169,SMARCA4,189
chr1,11838808,11839022,SRX5075170,SMARCA4,214
chr1,11842268,11842439,SRX5075170,SMARCA4,171
chr1,11848200,11848375,SRX5075176,SMARCA4,175
chr1,11848202,11848435,SRX5075170,SMARCA4,233
chr1,11859269,11859602,SRX5075168,SMARCA4,333
chr1,11859287,11859605,SRX5716470,SMARCA4,318
chr1,11859295,11859654,SRX5075175,SMARCA4,359
chr1,11859305,11859550,SRX5716469,SMARCA4,245
chr1,11859312,11859589,SRX5075169,SMARCA4,277
chr1,11859315,11859692,SRX5075174,SMARCA4,377
chr1,11859325,11859592,SRX5075170,SMARCA4,267
chr1,11859339,11859605,SRX5075176,SMARCA4,266
chr1,11859377,11859634,SRX5716463,SMARCA4,257
chr1,11865396,11865843,SRX16500060,CTCF,447
chr1,11865469,11865829,SRX16500061,CTCF,360
chr1,11865536,11865821,SRX16500062,CTCF,285
chr1,11865549,11865866,SRX16500059,CTCF,317
chr1,11893890,11894347,SRX16500060,CTCF,457
chr1,11893896,11894321,SRX16500059,CTCF,425
chr1,11893913,11894312,SRX16500061,CTCF,399
chr1,11893922,11894308,SRX16500062,CTCF,386
chr1,11893983,11894257,SRX4174629,CTCF,274
chr1,11893997,11894209,SRX5075168,SMARCA4,212
chr1,11907574,11908029,SRX16500061,CTCF,455
chr1,11907599,11908115,SRX16500059,CTCF,516
chr1,11907603,11908048,SRX16500060,CTCF,445
chr1,11907658,11907974,SRX5075168,SMARCA4,316
chr1,11907668,11908072,SRX16500062,CTCF,404
chr1,11907676,11907988,SRX5075174,SMARCA4,312
chr1,11907702,11907932,SRX5075176,SMARCA4,230
chr1,11907733,11907920,SRX5075170,SMARCA4,187
chr1,11907740,11908025,SRX4174629,CTCF,285
chr1,11907743,11907947,SRX5716463,SMARCA4,204
chr1,11907946,11909998,SRX20140895,INTS13,2052
chr1,11907955,11909127,SRX20140868,INTS10,1172
chr1,11907962,11910011,SRX20140869,INTS10,2049
chr1,11907965,11909245,SRX20140879,CPSF3L,1280
chr1,11907966,11908982,SRX20140894,INTS13,1016
chr1,11907970,11909149,SRX20140897,INTS13,1179
chr1,11907977,11909977,SRX20140881,CPSF3L,2000
chr1,11907994,11910001,SRX20140867,INTS10,2007
chr1,11908007,11909899,SRX20140896,INTS13,1892
chr1,11908009,11909125,SRX20140880,CPSF3L,1116
chr1,11908014,11908431,SRX20140860,SOX2,417
chr1,11908057,11908542,SRX20140882,CPSF3L,485
chr1,11908101,11908376,SRX5716469,SMARCA4,275
chr1,11908151,11908437,SRX5075174,SMARCA4,286
chr1,11908154,11908641,SRX20140870,INTS10,487
chr1,11908160,11908417,SRX20140861,SOX2,257
chr1,11908162,11908489,SRX5075168,SMARCA4,327
chr1,11908201,11908520,SRX5075176,SMARCA4,319
chr1,11908222,11908712,SRX5075170,SMARCA4,490
chr1,11908285,11908530,SRX5075175,SMARCA4,245
chr1,11908520,11908843,SRX5716470,SMARCA4,323
chr1,11909303,11910048,SRX20140879,CPSF3L,745
chr1,11909401,11909996,SRX20140868,INTS10,595
chr1,11909450,11910047,SRX20140894,INTS13,597
chr1,11909463,11909974,SRX20140897,INTS13,511
chr1,11918905,11919231,SRX5054309,FOSL2,326
chr1,11918914,11919172,SRX5054308,FOSL2,258
chr1,11918967,11919181,SRX5075169,SMARCA4,214
chr1,11918973,11919198,SRX5075175,SMARCA4,225
chr1,11918974,11919180,SRX5075176,SMARCA4,206
chr1,11918978,11919207,SRX5075170,SMARCA4,229
chr1,11926375,11926687,SRX5075174,SMARCA4,312
chr1,11926396,11926703,SRX5075168,SMARCA4,307
chr1,11926434,11926675,SRX5716463,SMARCA4,241
chr1,11926460,11926684,SRX5075170,SMARCA4,224
chr1,11926472,11926696,SRX5075176,SMARCA4,224
chr1,11927957,11928176,SRX5054308,FOSL2,219
chr1,11927997,11928295,SRX5075170,SMARCA4,298
chr1,11928009,11928250,SRX5075176,SMARCA4,241
chr1,11928031,11928258,SRX5054309,FOSL2,227
chr1,11931119,11931372,SRX5075176,SMARCA4,253
chr1,11934271,11935046,SRX20140895,INTS13,775
chr1,11934321,11934992,SRX20140867,INTS10,671
chr1,11934390,11934853,SRX5075168,SMARCA4,463
chr1,11934392,11934937,SRX5075174,SMARCA4,545
chr1,11934443,11935051,SRX20140868,INTS10,608
chr1,11934469,11934935,SRX5075170,SMARCA4,466
chr1,11934470,11934695,SRX5054307,FOSL2,225
chr1,11934512,11934861,SRX5075176,SMARCA4,349
chr1,11934513,11934836,SRX20140897,INTS13,323
chr1,11934532,11934864,SRX5716470,SMARCA4,332
chr1,11934574,11934762,SRX5054308,FOSL2,188
chr1,11934574,11934865,SRX5716467,SMARCA2,291
chr1,11967120,11967502,SRX16500061,CTCF,382
chr1,11967134,11967538,SRX16500060,CTCF,404
chr1,11967137,11967554,SRX16500059,CTCF,417
chr1,11967150,11967517,SRX16500062,CTCF,367
chr1,11967233,11967607,SRX4174629,CTCF,374
chr1,11979626,11980678,SRX20140895,INTS13,1052
chr1,11979747,11980509,SRX5075174,SMARCA4,762
chr1,11979797,11980103,SRX5075169,SMARCA4,306
chr1,11979811,11980546,SRX5716463,SMARCA4,735
chr1,11979812,11980387,SRX5075170,SMARCA4,575
chr1,11979816,11980551,SRX5075168,SMARCA4,735
chr1,11979829,11980592,SRX20140867,INTS10,763
chr1,11979832,11980062,SRX5075175,SMARCA4,230
chr1,11979842,11980466,SRX5054309,FOSL2,624
chr1,11979854,11980575,SRX5075176,SMARCA4,721
chr1,11979867,11980429,SRX5054307,FOSL2,562
chr1,11979869,11980471,SRX5716464,SMARCA4,602
chr1,11979874,11980168,SRX5716469,SMARCA4,294
chr1,11979874,11980387,SRX5054308,FOSL2,513
chr1,11979936,11980254,SRX5716454,SOX3,318
chr1,11979939,11980446,SRX5716470,SMARCA4,507
chr1,11979955,11980621,SRX20140868,INTS10,666
chr1,11979982,11980217,SRX20140879,CPSF3L,235
chr1,11979986,11980359,SRX5716451,SOX2,373
chr1,11980195,11980652,SRX20140869,INTS10,457
chr1,11980211,11980391,SRX5075169,SMARCA4,180
chr1,11980379,11980630,SRX20140894,INTS13,251
chr1,11980404,11980677,SRX20140897,INTS13,273
chr1,12001573,12001935,SRX16500062,CTCF,362
chr1,12001585,12001971,SRX16500061,CTCF,386
chr1,12001599,12001984,SRX16500059,CTCF,385
chr1,12001600,12001949,SRX16500060,CTCF,349
chr1,12013564,12013799,SRX5075170,SMARCA4,235
chr1,12018962,12019433,SRX20140881,CPSF3L,471
chr1,12018971,12019893,SRX20140895,INTS13,922
chr1,12018977,12019845,SRX20140868,INTS10,868
chr1,12019019,12019418,SRX20140879,CPSF3L,399
chr1,12019054,12019446,SRX20140867,INTS10,392
chr1,12019114,12019696,SRX20140897,INTS13,582
chr1,12019159,12019395,SRX5075174,SMARCA4,236
chr1,12019163,12019434,SRX20140896,INTS13,271
chr1,12019173,12019396,SRX5075169,SMARCA4,223
chr1,12019224,12019497,SRX5054307,FOSL2,273
chr1,12019256,12019708,SRX5075168,SMARCA4,452
chr1,12019296,12019486,SRX5054308,FOSL2,190
chr1,12019297,12019501,SRX5716463,SMARCA4,204
chr1,12019308,12019754,SRX5075176,SMARCA4,446
chr1,12019443,12019613,SRX5075170,SMARCA4,170
chr1,12019476,12019649,SRX5075174,SMARCA4,173
chr1,12040436,12040946,SRX5075176,SMARCA4,510
chr1,12040449,12041023,SRX5075174,SMARCA4,574
chr1,12040480,12041001,SRX5075170,SMARCA4,521
chr1,12040494,12040952,SRX5054308,FOSL2,458
chr1,12040503,12040887,SRX5054309,FOSL2,384
chr1,12040508,12040953,SRX5020211,SMARCA2,445
chr1,12040512,12040929,SRX5075169,SMARCA4,417
chr1,12040515,12040943,SRX5075175,SMARCA4,428
chr1,12040528,12041016,SRX5075168,SMARCA4,488
chr1,12040533,12040819,SRX5716468,SMARCA2,286
chr1,12040550,12040920,SRX5716469,SMARCA4,370
chr1,12040570,12040895,SRX5716460,Epitope tags,325
chr1,12040577,12040947,SRX5716470,SMARCA4,370
chr1,12040578,12040975,SRX5716467,SMARCA2,397
chr1,12040590,12040949,SRX5716463,SMARCA4,359
chr1,12040609,12040847,SRX5054307,FOSL2,238
chr1,12040627,12040863,SRX5020214,SMARCA2,236
chr1,12051944,12052346,SRX5075170,SMARCA4,402
chr1,12051965,12052388,SRX5075176,SMARCA4,423
chr1,12051967,12052331,SRX5075169,SMARCA4,364
chr1,12051975,12052360,SRX5075175,SMARCA4,385
chr1,12051979,12052311,SRX5716469,SMARCA4,332
chr1,12051991,12052372,SRX5054308,FOSL2,381
chr1,12051994,12052223,SRX5020211,SMARCA2,229
chr1,12051996,12052369,SRX5054309,FOSL2,373
chr1,12052010,12052321,SRX5075168,SMARCA4,311
chr1,12052020,12052411,SRX5716470,SMARCA4,391
chr1,12052040,12052232,SRX5054307,FOSL2,192
chr1,12052049,12052349,SRX5716467,SMARCA2,300
chr1,12052052,12052347,SRX5075174,SMARCA4,295
chr1,12067938,12068190,SRX5075169,SMARCA4,252
chr1,12067959,12068228,SRX5075170,SMARCA4,269
chr1,12067961,12068217,SRX5075176,SMARCA4,256
chr1,12079454,12080002,SRX16500059,CTCF,548
chr1,12079491,12080039,SRX16500060,CTCF,548
chr1,12079549,12080014,SRX16500061,CTCF,465
chr1,12079602,12079967,SRX16500062,CTCF,365
chr1,12096004,12096293,SRX20140895,INTS13,289
chr1,12106798,12107257,SRX16500060,CTCF,459
chr1,12106814,12107237,SRX16500059,CTCF,423
chr1,12106851,12107136,SRX16500062,CTCF,285
chr1,12106874,12107149,SRX16500061,CTCF,275
chr1,12118571,12119010,SRX16500059,CTCF,439
chr1,12118582,12119013,SRX16500061,CTCF,431
chr1,12118584,12119000,SRX16500060,CTCF,416
chr1,12118634,12119025,SRX16500062,CTCF,391
chr1,12118667,12118918,SRX5075174,SMARCA4,251
chr1,12118680,12118909,SRX5075168,SMARCA4,229
chr1,12118707,12118882,SRX5075176,SMARCA4,175
chr1,12124717,12125195,SRX16500060,CTCF,478
chr1,12124739,12125198,SRX16500061,CTCF,459
chr1,12124741,12125272,SRX16500059,CTCF,531
chr1,12124748,12125172,SRX16500062,CTCF,424
chr1,12124845,12125162,SRX4174629,CTCF,317
chr1,12124872,12125099,SRX5075170,SMARCA4,227
chr1,12124874,12125106,SRX5075176,SMARCA4,232
chr1,12124884,12125163,SRX5075174,SMARCA4,279
chr1,12124892,12125154,SRX5075168,SMARCA4,262
chr1,12132934,12133323,SRX5075176,SMARCA4,389
chr1,12132966,12133314,SRX5075175,SMARCA4,348
chr1,12132970,12133286,SRX5075170,SMARCA4,316
chr1,12132986,12133237,SRX5075169,SMARCA4,251
chr1,12143572,12143929,SRX5075176,SMARCA4,357
chr1,12143664,12143906,SRX5075170,SMARCA4,242
chr1,12143679,12143883,SRX5075169,SMARCA4,204
chr1,12153517,12153771,SRX5075175,SMARCA4,254
chr1,12153561,12153764,SRX5075169,SMARCA4,203
chr1,12153639,12153851,SRX5716469,SMARCA4,212
chr1,12158386,12158709,SRX5075168,SMARCA4,323
chr1,12158411,12158619,SRX5716463,SMARCA4,208
chr1,12158420,12158638,SRX5075174,SMARCA4,218
chr1,12161819,12162200,SRX5054309,FOSL2,381
chr1,12161826,12162169,SRX5716469,SMARCA4,343
chr1,12161829,12162192,SRX5054308,FOSL2,363
chr1,12161859,12162208,SRX5075169,SMARCA4,349
chr1,12161881,12162231,SRX5075176,SMARCA4,350
chr1,12161907,12162133,SRX5075175,SMARCA4,226
chr1,12161919,12162241,SRX5075170,SMARCA4,322
chr1,12166786,12167080,SRX5075168,SMARCA4,294
chr1,12166812,12167177,SRX20140895,INTS13,365
chr1,12166915,12167104,SRX5075169,SMARCA4,189
chr1,12166954,12167143,SRX5075176,SMARCA4,189
chr1,12175103,12175290,SRX5075170,SMARCA4,187
chr1,12178222,12178423,SRX5075170,SMARCA4,201
chr1,12184047,12184572,SRX5075176,SMARCA4,525
chr1,12184049,12184644,SRX5075168,SMARCA4,595
chr1,12184050,12184658,SRX5075174,SMARCA4,608
chr1,12184063,12184573,SRX5075170,SMARCA4,510
chr1,12184081,12184581,SRX5075169,SMARCA4,500
chr1,12184092,12184748,SRX20140895,INTS13,656
chr1,12184099,12184443,SRX5075175,SMARCA4,344
chr1,12184106,12184451,SRX5716468,SMARCA2,345
chr1,12184107,12184455,SRX5716469,SMARCA4,348
chr1,12184130,12184670,SRX5716470,SMARCA4,540
chr1,12184134,12184540,SRX5716467,SMARCA2,406
chr1,12184169,12184482,SRX5054308,FOSL2,313
chr1,12184177,12184371,SRX5075181,SMARCA2,194
chr1,12184222,12184488,SRX5054309,FOSL2,266
chr1,12184241,12184478,SRX5716451,SOX2,237
chr1,12184270,12184474,SRX5716463,SMARCA4,204
chr1,12196765,12197000,SRX16500059,CTCF,235
chr1,12196817,12197052,SRX16500062,CTCF,235
chr1,12196833,12197081,SRX16500061,CTCF,248
chr1,12208613,12209185,SRX5075174,SMARCA4,572
chr1,12208653,12209146,SRX5075168,SMARCA4,493
chr1,12208684,12209060,SRX5716463,SMARCA4,376
chr1,12208726,12208976,SRX5716470,SMARCA4,250
chr1,12208745,12209296,SRX16500060,CTCF,551
chr1,12208781,12209393,SRX16500059,CTCF,612
chr1,12208790,12209291,SRX16500062,CTCF,501
chr1,12208799,12209264,SRX16500061,CTCF,465
chr1,12208810,12209015,SRX5716464,SMARCA4,205
chr1,12208824,12209226,SRX4174629,CTCF,402
chr1,12208896,12209144,SRX5075176,SMARCA4,248
chr1,12208903,12209117,SRX5075170,SMARCA4,214
chr1,12229572,12230302,SRX16500059,CTCF,730
chr1,12229665,12230298,SRX16500060,CTCF,633
chr1,12229675,12230250,SRX16500062,CTCF,575
chr1,12229733,12230191,SRX16500061,CTCF,458
chr1,12229764,12230231,SRX5075168,SMARCA4,467
chr1,12229793,12230228,SRX5075174,SMARCA4,435
chr1,12229799,12230242,SRX5716470,SMARCA4,443
chr1,12229804,12230310,SRX20140895,INTS13,506
chr1,12229827,12230031,SRX5716463,SMARCA4,204
chr1,12229847,12230174,SRX5075176,SMARCA4,327
chr1,12229853,12230227,SRX5075175,SMARCA4,374
chr1,12229854,12230192,SRX5075170,SMARCA4,338
chr1,12229876,12230127,SRX5716464,SMARCA4,251
chr1,12229886,12230128,SRX5075169,SMARCA4,242
chr1,12249080,12249646,SRX5075168,SMARCA4,566
chr1,12249086,12249602,SRX5075174,SMARCA4,516
chr1,12249203,12249442,SRX5716463,SMARCA4,239
chr1,12249262,12249454,SRX5716451,SOX2,192
chr1,12275396,12275777,SRX16500059,CTCF,381
chr1,12275410,12275714,SRX16500061,CTCF,304
chr1,12275449,12275705,SRX16500060,CTCF,256
chr1,12275461,12275701,SRX16500062,CTCF,240
chr1,12276110,12276411,SRX4174629,CTCF,301
chr1,12276228,12276621,SRX16500060,CTCF,393
chr1,12276240,12276604,SRX16500062,CTCF,364
chr1,12276256,12276598,SRX16500059,CTCF,342
chr1,12276266,12276661,SRX16500061,CTCF,395
chr1,12276340,12276522,SRX5075168,SMARCA4,182
chr1,12296511,12296938,SRX5075169,SMARCA4,427
chr1,12296588,12297002,SRX5054309,FOSL2,414
chr1,12296636,12296883,SRX5020211,SMARCA2,247
chr1,12296663,12297019,SRX5054308,FOSL2,356
chr1,12314264,12314720,SRX16500059,CTCF,456
chr1,12314282,12314861,SRX16500060,CTCF,579
chr1,12314361,12314742,SRX16500062,CTCF,381
chr1,12314371,12314784,SRX16500061,CTCF,413
chr1,12320631,12320871,SRX5075168,SMARCA4,240
chr1,12336145,12336983,SRX5075174,SMARCA4,838
chr1,12336160,12336923,SRX5075168,SMARCA4,763
chr1,12336165,12336838,SRX5716463,SMARCA4,673
chr1,12336255,12336795,SRX5716454,SOX3,540
chr1,12336313,12336755,SRX5716451,SOX2,442
chr1,12336359,12336865,SRX20140895,INTS13,506
chr1,12336433,12336703,SRX20140868,INTS10,270
chr1,12356111,12356311,SRX5020211,SMARCA2,200
chr1,12424095,12424322,SRX5716469,SMARCA4,227
chr1,12424103,12424320,SRX5075175,SMARCA4,217
chr1,12424109,12424564,SRX5054309,FOSL2,455
chr1,12424130,12424617,SRX5054308,FOSL2,487
chr1,12424159,12424410,SRX5020211,SMARCA2,251
chr1,12424180,12424435,SRX5075169,SMARCA4,255
chr1,12428943,12429124,SRX5075174,SMARCA4,181
chr1,12433527,12433771,SRX5054308,FOSL2,244
chr1,12433545,12433740,SRX5054309,FOSL2,195
chr1,12433555,12433778,SRX5020211,SMARCA2,223
chr1,12434192,12434461,SRX5075175,SMARCA4,269
chr1,12434284,12434522,SRX5075169,SMARCA4,238
chr1,12435685,12435871,SRX5075176,SMARCA4,186
chr1,12435723,12435930,SRX5075175,SMARCA4,207
chr1,12456940,12457248,SRX5054308,FOSL2,308
chr1,12456963,12457334,SRX5054309,FOSL2,371
chr1,12457003,12457175,SRX5075170,SMARCA4,172
chr1,12457009,12457334,SRX5075175,SMARCA4,325
chr1,12464658,12464910,SRX5075170,SMARCA4,252
chr1,12464711,12464888,SRX5075176,SMARCA4,177
chr1,12464719,12464928,SRX5054308,FOSL2,209
chr1,12478095,12478547,SRX20140867,INTS10,452
chr1,12478184,12478384,SRX5020211,SMARCA2,200
chr1,12478193,12478635,SRX5054308,FOSL2,442
chr1,12478283,12478494,SRX5716470,SMARCA4,211
chr1,12480726,12481102,SRX5075175,SMARCA4,376
chr1,12480740,12481092,SRX5075176,SMARCA4,352
chr1,12480760,12481044,SRX5054308,FOSL2,284
chr1,12480763,12481053,SRX5054309,FOSL2,290
chr1,12480781,12481057,SRX5075169,SMARCA4,276
chr1,12480784,12481100,SRX5075170,SMARCA4,316
chr1,12480810,12481072,SRX5075174,SMARCA4,262
chr1,12488796,12489001,SRX5054309,FOSL2,205
chr1,12501637,12501981,SRX5075175,SMARCA4,344
chr1,12501639,12501908,SRX5075176,SMARCA4,269
chr1,12501687,12501995,SRX5075169,SMARCA4,308
chr1,12501691,12501956,SRX5075170,SMARCA4,265
chr1,12501691,12501998,SRX5054309,FOSL2,307
chr1,12501743,12501923,SRX5054308,FOSL2,180
chr1,12510204,12510471,SRX5054309,FOSL2,267
chr1,12510231,12510419,SRX5054308,FOSL2,188
chr1,12539771,12540032,SRX5054308,FOSL2,261
chr1,12539800,12540093,SRX5054309,FOSL2,293
chr1,12539953,12540153,SRX5020211,SMARCA2,200
chr1,12539976,12540190,SRX5075169,SMARCA4,214
chr1,12540105,12540440,SRX5716470,SMARCA4,335
chr1,12540183,12540467,SRX5054309,FOSL2,284
chr1,12540230,12540488,SRX5075170,SMARCA4,258
chr1,12540254,12540618,SRX5075174,SMARCA4,364
chr1,12540261,12540455,SRX5075168,SMARCA4,194
chr1,12540275,12540534,SRX5075176,SMARCA4,259
chr1,12540354,12540642,SRX20140895,INTS13,288
chr1,12541559,12541740,SRX5054308,FOSL2,181
chr1,12549592,12550157,SRX5716459,Epitope tags,565
chr1,12549664,12550253,SRX5075176,SMARCA4,589
chr1,12549710,12550227,SRX5075169,SMARCA4,517
chr1,12549757,12550298,SRX5054308,FOSL2,541
chr1,12549778,12550325,SRX5075170,SMARCA4,547
chr1,12549784,12550231,SRX5716467,SMARCA2,447
chr1,12549786,12550143,SRX5020211,SMARCA2,357
chr1,12549795,12550281,SRX5054309,FOSL2,486
chr1,12549819,12550164,SRX5716470,SMARCA4,345
chr1,12549820,12550254,SRX5075175,SMARCA4,434
chr1,12549838,12550219,SRX5716469,SMARCA4,381
chr1,12556453,12556780,SRX5716470,SMARCA4,327
chr1,12556454,12556786,SRX5075170,SMARCA4,332
chr1,12556462,12556855,SRX5075169,SMARCA4,393
chr1,12556466,12556759,SRX5716469,SMARCA4,293
chr1,12556477,12556821,SRX5075176,SMARCA4,344
chr1,12556484,12556748,SRX5716468,SMARCA2,264
chr1,12556497,12556760,SRX5716467,SMARCA2,263
chr1,12556509,12556764,SRX5075175,SMARCA4,255
chr1,12556530,12556770,SRX5075181,SMARCA2,240
chr1,12556533,12556729,SRX5054309,FOSL2,196
chr1,12556539,12556748,SRX5020211,SMARCA2,209
chr1,12556551,12556768,SRX5054308,FOSL2,217
chr1,12595947,12596230,SRX5075168,SMARCA4,283
chr1,12596025,12596198,SRX5075174,SMARCA4,173
chr1,12596496,12596806,SRX5054308,FOSL2,310
chr1,12596504,12596727,SRX5075169,SMARCA4,223
chr1,12596506,12596832,SRX5054309,FOSL2,326
chr1,12596549,12596772,SRX5075176,SMARCA4,223
chr1,12596590,12596796,SRX5075170,SMARCA4,206
chr1,12601948,12602384,SRX5075168,SMARCA4,436
chr1,12602006,12602253,SRX5075174,SMARCA4,247
chr1,12602031,12602277,SRX5075176,SMARCA4,246
chr1,12604333,12604682,SRX5075168,SMARCA4,349
chr1,12604344,12604686,SRX5054309,FOSL2,342
chr1,12604361,12604663,SRX5054308,FOSL2,302
chr1,12604361,12604664,SRX5075176,SMARCA4,303
chr1,12604364,12604631,SRX5075174,SMARCA4,267
chr1,12604400,12604647,SRX5075175,SMARCA4,247
chr1,12604415,12604661,SRX5020214,SMARCA2,246
chr1,12604432,12604632,SRX5020211,SMARCA2,200
chr1,12604452,12604650,SRX5075169,SMARCA4,198
chr1,12604481,12604679,SRX5075170,SMARCA4,198
chr1,12618023,12618611,SRX20140895,INTS13,588
chr1,12618071,12618482,SRX20140868,INTS10,411
chr1,12618276,12618477,SRX5075174,SMARCA4,201
chr1,12618998,12619343,SRX5054308,FOSL2,345
chr1,12619019,12619316,SRX5054309,FOSL2,297
chr1,12619793,12620253,SRX16500060,CTCF,460
chr1,12619800,12620278,SRX16500059,CTCF,478
chr1,12619818,12620245,SRX16500062,CTCF,427
chr1,12619819,12620264,SRX16500061,CTCF,445
chr1,12619844,12620229,SRX4174629,CTCF,385
chr1,12619923,12620103,SRX5075169,SMARCA4,180
chr1,12619925,12620127,SRX5075174,SMARCA4,202
chr1,12658901,12659423,SRX16500062,CTCF,522
chr1,12658904,12659395,SRX16500059,CTCF,491
chr1,12658913,12659434,SRX16500060,CTCF,521
chr1,12658935,12659397,SRX16500061,CTCF,462
chr1,12658990,12659332,SRX5075174,SMARCA4,342
chr1,12658991,12659333,SRX5075168,SMARCA4,342
chr1,12658994,12659259,SRX5716464,SMARCA4,265
chr1,12659004,12659239,SRX5075176,SMARCA4,235
chr1,12659008,12659281,SRX5075169,SMARCA4,273
chr1,12659022,12659260,SRX5716470,SMARCA4,238
chr1,12659024,12659328,SRX5716463,SMARCA4,304
chr1,12659033,12659254,SRX5075170,SMARCA4,221
chr1,12659074,12659376,SRX4174629,CTCF,302
chr1,12781554,12781901,SRX16500059,CTCF,347
chr1,12781559,12781784,SRX16500061,CTCF,225
chr1,12783849,12784074,SRX16500061,CTCF,225
chr1,12783852,12784082,SRX16500062,CTCF,230
chr1,12783856,12784165,SRX16500060,CTCF,309
chr1,12783867,12784217,SRX16500059,CTCF,350
chr1,13019891,13020172,SRX16500060,CTCF,281
chr1,13019900,13020176,SRX16500059,CTCF,276
chr1,13019915,13020134,SRX16500061,CTCF,219
chr1,13019929,13020159,SRX16500062,CTCF,230
chr1,13208743,13209103,SRX16500059,CTCF,360
chr1,13208795,13209017,SRX16500061,CTCF,222
chr1,13208813,13209121,SRX16500060,CTCF,308
chr1,13208823,13209047,SRX16500062,CTCF,224
chr1,13208825,13209054,SRX4174629,CTCF,229
chr1,13265125,13265335,SRX4174629,CTCF,210
chr1,13265135,13265410,SRX16500061,CTCF,275
chr1,13265150,13265394,SRX16500059,CTCF,244
chr1,13265259,13265480,SRX16500060,CTCF,221
chr1,13356747,13357233,SRX16500059,CTCF,486
chr1,13356749,13357169,SRX16500060,CTCF,420
chr1,13356756,13357124,SRX16500062,CTCF,368
chr1,13356802,13357211,SRX16500061,CTCF,409
chr1,13422480,13422995,SRX16500059,CTCF,515
chr1,13422519,13423039,SRX16500060,CTCF,520
chr1,13422526,13422984,SRX16500061,CTCF,458
chr1,13422565,13422984,SRX16500062,CTCF,419
chr1,13443395,13443976,SRX5075168,SMARCA4,581
chr1,13443437,13443997,SRX5075174,SMARCA4,560
chr1,13469242,13469647,SRX16500059,CTCF,405
chr1,13469253,13469578,SRX16500060,CTCF,325
chr1,13469266,13469539,SRX16500062,CTCF,273
chr1,13469303,13469541,SRX16500061,CTCF,238
chr1,13517203,13517577,SRX16500059,CTCF,374
chr1,13517226,13517639,SRX16500060,CTCF,413
chr1,13517279,13517569,SRX16500062,CTCF,290
chr1,13517288,13517532,SRX16500061,CTCF,244
chr1,13543868,13544164,SRX5716470,SMARCA4,296
chr1,13543931,13544162,SRX5075168,SMARCA4,231
chr1,13543950,13544171,SRX5075170,SMARCA4,221
chr1,13543963,13544251,SRX5716463,SMARCA4,288
chr1,13543964,13544242,SRX5075174,SMARCA4,278
chr1,13544015,13544190,SRX5075176,SMARCA4,175
chr1,13544085,13544319,SRX16500060,CTCF,234
chr1,13570959,13571176,SRX16500062,CTCF,217
chr1,13583503,13583797,SRX5075170,SMARCA4,294
chr1,13583537,13583893,SRX5075176,SMARCA4,356
chr1,13583568,13583819,SRX5075174,SMARCA4,251
chr1,13583576,13583845,SRX5716469,SMARCA4,269
chr1,13583581,13583830,SRX5075168,SMARCA4,249
chr1,13583602,13583932,SRX5075169,SMARCA4,330
chr1,13583634,13584042,SRX20140895,INTS13,408
chr1,13583890,13584161,SRX5716470,SMARCA4,271
chr1,13585478,13586131,SRX20140895,INTS13,653
chr1,13585512,13585958,SRX5075168,SMARCA4,446
chr1,13585599,13586120,SRX5075174,SMARCA4,521
chr1,13585681,13585980,SRX5716451,SOX2,299
chr1,13585730,13585993,SRX20140868,INTS10,263
chr1,13593422,13593924,SRX5075174,SMARCA4,502
chr1,13593425,13593786,SRX5075170,SMARCA4,361
chr1,13593466,13593850,SRX5075169,SMARCA4,384
chr1,13593475,13593818,SRX5716470,SMARCA4,343
chr1,13593482,13594106,SRX5075176,SMARCA4,624
chr1,13593489,13593730,SRX5716464,SMARCA4,241
chr1,13593494,13593917,SRX5075168,SMARCA4,423
chr1,13593505,13593897,SRX5716463,SMARCA4,392
chr1,13593538,13593766,SRX5075175,SMARCA4,228
chr1,13593561,13593769,SRX5054308,FOSL2,208
chr1,13593562,13593793,SRX5054309,FOSL2,231
chr1,13605281,13605483,SRX5075170,SMARCA4,202
chr1,13628579,13628964,SRX5075174,SMARCA4,385
chr1,13628656,13628925,SRX5075168,SMARCA4,269
chr1,13662569,13662754,SRX5075176,SMARCA4,185
chr1,13665613,13666118,SRX16500059,CTCF,505
chr1,13665627,13666091,SRX16500062,CTCF,464
chr1,13665630,13666193,SRX16500060,CTCF,563
chr1,13665640,13666078,SRX16500061,CTCF,438
chr1,13665682,13666041,SRX5075168,SMARCA4,359
chr1,13665723,13666076,SRX4174629,CTCF,353
chr1,13665755,13665985,SRX5075174,SMARCA4,230
chr1,13674991,13675778,SRX5075176,SMARCA4,787
chr1,13675023,13675196,SRX5075170,SMARCA4,173
chr1,13675075,13675698,SRX5075169,SMARCA4,623
chr1,13675134,13675373,SRX5716470,SMARCA4,239
chr1,13675159,13675617,SRX5716469,SMARCA4,458
chr1,13675321,13675539,SRX5716467,SMARCA2,218
chr1,13675327,13675811,SRX5075170,SMARCA4,484
chr1,13699880,13700444,SRX20140869,INTS10,564
chr1,13699907,13700791,SRX20140895,INTS13,884
chr1,13699983,13700431,SRX20140867,INTS10,448
chr1,13699990,13700480,SRX20140868,INTS10,490
chr1,13700022,13700289,SRX5075174,SMARCA4,267
chr1,13700076,13700301,SRX5075176,SMARCA4,225
chr1,13700404,13700712,SRX5075175,SMARCA4,308
chr1,13700539,13700719,SRX5075170,SMARCA4,180
chr1,13707285,13707490,SRX5075176,SMARCA4,205
chr1,13714884,13715232,SRX16500061,CTCF,348
chr1,13714901,13715356,SRX16500060,CTCF,455
chr1,13714940,13715188,SRX16500062,CTCF,248
chr1,13725678,13726014,SRX5716469,SMARCA4,336
chr1,13725696,13726094,SRX5075170,SMARCA4,398
chr1,13725708,13725991,SRX5075175,SMARCA4,283
chr1,13725714,13725900,SRX5054308,FOSL2,186
chr1,13725715,13726025,SRX5075169,SMARCA4,310
chr1,13725717,13726035,SRX5075181,SMARCA2,318
chr1,13725719,13725975,SRX5716467,SMARCA2,256
chr1,13725719,13726082,SRX5075176,SMARCA4,363
chr1,13725719,13726117,SRX5716470,SMARCA4,398
chr1,13725726,13725985,SRX5054309,FOSL2,259
chr1,13725740,13725999,SRX5716468,SMARCA2,259
chr1,13725750,13726005,SRX5020211,SMARCA2,255
chr1,13725762,13726064,SRX5020214,SMARCA2,302
chr1,13748966,13749219,SRX5716470,SMARCA4,253
chr1,13748966,13749758,SRX20140895,INTS13,792
chr1,13748995,13749398,SRX5075176,SMARCA4,403
chr1,13749019,13749400,SRX5075170,SMARCA4,381
chr1,13749108,13749562,SRX20140868,INTS10,454
chr1,13749115,13749429,SRX5075174,SMARCA4,314
chr1,13749164,13749617,SRX20140867,INTS10,453
chr1,13749771,13750015,SRX5075175,SMARCA4,244
chr1,13749803,13750038,SRX5075168,SMARCA4,235
chr1,13752089,13752325,SRX5075174,SMARCA4,236
chr1,13764474,13764848,SRX5075174,SMARCA4,374
chr1,13764490,13764869,SRX5075176,SMARCA4,379
chr1,13764500,13764766,SRX20140869,INTS10,266
chr1,13764502,13764808,SRX5716463,SMARCA4,306
chr1,13764523,13764799,SRX5075168,SMARCA4,276
chr1,13764540,13764869,SRX5075169,SMARCA4,329
chr1,13764549,13764892,SRX5716469,SMARCA4,343
chr1,13764562,13764886,SRX5716470,SMARCA4,324
chr1,13764564,13764881,SRX5716467,SMARCA2,317
chr1,13764564,13764895,SRX5075175,SMARCA4,331
chr1,13764585,13764927,SRX5075170,SMARCA4,342
chr1,13764594,13764880,SRX5020211,SMARCA2,286
chr1,13764618,13764844,SRX5075182,SMARCA2,226
chr1,13764619,13764848,SRX5716468,SMARCA2,229
chr1,13764653,13764861,SRX5716464,SMARCA4,208
chr1,13766926,13767303,SRX5075176,SMARCA4,377
chr1,13766948,13767329,SRX5075175,SMARCA4,381
chr1,13766994,13767363,SRX5075169,SMARCA4,369
chr1,13766996,13767331,SRX5054309,FOSL2,335
chr1,13767076,13767338,SRX5054308,FOSL2,262
chr1,13767108,13767306,SRX5075170,SMARCA4,198
chr1,13781976,13782316,SRX5075169,SMARCA4,340
chr1,13781982,13782336,SRX5075176,SMARCA4,354
chr1,13782012,13782325,SRX5054308,FOSL2,313
chr1,13782032,13782280,SRX5075170,SMARCA4,248
chr1,13782036,13782291,SRX5054309,FOSL2,255
chr1,13782064,13782281,SRX5716470,SMARCA4,217
chr1,13782065,13782302,SRX5075175,SMARCA4,237
chr1,13783539,13783779,SRX5075168,SMARCA4,240
chr1,13783585,13783863,SRX5075170,SMARCA4,278
chr1,13783587,13783880,SRX5075176,SMARCA4,293
chr1,13783612,13783938,SRX5075169,SMARCA4,326
chr1,13783619,13783999,SRX5075174,SMARCA4,380
chr1,13783628,13783862,SRX5054308,FOSL2,234
chr1,13783630,13783852,SRX5716470,SMARCA4,222
chr1,13783668,13783863,SRX5054309,FOSL2,195
chr1,13783686,13783873,SRX5075175,SMARCA4,187
chr1,13807245,13807500,SRX16500060,CTCF,255
chr1,13807289,13807544,SRX16500059,CTCF,255
chr1,13813566,13814030,SRX16500059,CTCF,464
chr1,13813576,13813999,SRX16500062,CTCF,423
chr1,13813590,13814000,SRX16500061,CTCF,410
chr1,13813591,13813971,SRX16500060,CTCF,380
chr1,13828754,13829204,SRX16500059,CTCF,450
chr1,13828785,13829220,SRX16500061,CTCF,435
chr1,13828818,13829240,SRX16500060,CTCF,422
chr1,13828855,13829149,SRX16500062,CTCF,294
chr1,13892930,13893227,SRX20140895,INTS13,297
chr1,13893002,13893216,SRX5075174,SMARCA4,214
chr1,13908253,13908545,SRX20140895,INTS13,292
chr1,13929341,13929550,SRX5075174,SMARCA4,209
chr1,13929382,13929743,SRX5716463,SMARCA4,361
chr1,13930252,13930492,SRX16500059,CTCF,240
chr1,13950630,13950897,SRX16500059,CTCF,267
chr1,13950651,13951039,SRX16500060,CTCF,388
chr1,13950698,13951017,SRX16500062,CTCF,319
chr1,13956329,13956777,SRX5075176,SMARCA4,448
chr1,13956374,13956775,SRX5075170,SMARCA4,401
chr1,13956389,13956715,SRX5716470,SMARCA4,326
chr1,13956394,13956678,SRX5020214,SMARCA2,284
chr1,13956407,13956715,SRX5075175,SMARCA4,308
chr1,13956435,13956746,SRX5054309,FOSL2,311
chr1,13956460,13956676,SRX5075169,SMARCA4,216
chr1,13956474,13956730,SRX5716469,SMARCA4,256
chr1,13956495,13956693,SRX5054308,FOSL2,198
chr1,13960282,13960804,SRX16500060,CTCF,522
chr1,13960297,13960816,SRX16500059,CTCF,519
chr1,13960319,13960769,SRX16500062,CTCF,450
chr1,13960324,13960775,SRX16500061,CTCF,451
chr1,13960350,13960751,SRX4174629,CTCF,401
chr1,13960457,13960675,SRX5075168,SMARCA4,218
chr1,13965750,13966113,SRX5075176,SMARCA4,363
chr1,13965753,13966185,SRX16500060,CTCF,432
chr1,13965766,13966196,SRX16500061,CTCF,430
chr1,13965779,13966119,SRX5075170,SMARCA4,340
chr1,13965780,13966208,SRX16500059,CTCF,428
chr1,13965795,13966170,SRX16500062,CTCF,375
chr1,13965833,13966171,SRX4174629,CTCF,338
chr1,13965856,13966106,SRX5075174,SMARCA4,250
chr1,13965862,13966092,SRX5075168,SMARCA4,230
chr1,13965883,13966094,SRX5716470,SMARCA4,211
chr1,13965942,13966125,SRX5075169,SMARCA4,183
chr1,14027174,14027480,SRX5075174,SMARCA4,306
chr1,14027177,14027422,SRX5075168,SMARCA4,245
chr1,14055546,14055873,SRX5054309,FOSL2,327
chr1,14055612,14055852,SRX5075170,SMARCA4,240
chr1,14055658,14055866,SRX5075176,SMARCA4,208
chr1,14080182,14080374,SRX5054309,FOSL2,192
chr1,14095005,14095378,SRX16500060,CTCF,373
chr1,14095041,14095378,SRX16500061,CTCF,337
chr1,14095059,14095400,SRX16500059,CTCF,341
chr1,14095074,14095385,SRX16500062,CTCF,311
chr1,14095094,14095289,SRX5075168,SMARCA4,195
chr1,14095096,14095331,SRX5075174,SMARCA4,235
chr1,14106256,14106519,SRX5075170,SMARCA4,263
chr1,14106268,14106526,SRX5075176,SMARCA4,258
chr1,14106270,14106450,SRX5075169,SMARCA4,180
chr1,14113769,14114224,SRX16500059,CTCF,455
chr1,14113822,14114225,SRX16500060,CTCF,403
chr1,14113850,14114188,SRX16500061,CTCF,338
chr1,14113856,14114202,SRX16500062,CTCF,346
chr1,14113860,14114228,SRX4174629,CTCF,368
chr1,14113915,14114141,SRX5075174,SMARCA4,226
chr1,14140896,14141197,SRX5075176,SMARCA4,301
chr1,14140932,14141126,SRX5075170,SMARCA4,194
chr1,14149545,14149814,SRX16500059,CTCF,269
chr1,14181209,14181426,SRX5075170,SMARCA4,217
chr1,14181224,14181540,SRX5716470,SMARCA4,316
chr1,14181230,14181457,SRX5075175,SMARCA4,227
chr1,14181598,14181779,SRX5075168,SMARCA4,181
chr1,14215243,14215448,SRX5020214,SMARCA2,205
chr1,14215252,14215500,SRX5054309,FOSL2,248
chr1,14255792,14256090,SRX5054309,FOSL2,298
chr1,14255832,14256039,SRX5075176,SMARCA4,207
chr1,14282787,14282990,SRX5075175,SMARCA4,203
chr1,14282904,14283117,SRX5075176,SMARCA4,213
chr1,14296828,14297210,SRX5054309,FOSL2,382
chr1,14296867,14297117,SRX5054307,FOSL2,250
chr1,14296881,14297141,SRX5054308,FOSL2,260
chr1,14296898,14297123,SRX5075174,SMARCA4,225
chr1,14296903,14297072,SRX5075170,SMARCA4,169
chr1,14304359,14304919,SRX5075170,SMARCA4,560
chr1,14304391,14304894,SRX5075169,SMARCA4,503
chr1,14304391,14304935,SRX5075176,SMARCA4,544
chr1,14304437,14304938,SRX5075175,SMARCA4,501
chr1,14304489,14304721,SRX5716468,SMARCA2,232
chr1,14304513,14304876,SRX5054309,FOSL2,363
chr1,14304546,14304843,SRX5716467,SMARCA2,297
chr1,14304549,14304767,SRX5716469,SMARCA4,218
chr1,14304555,14304857,SRX5716470,SMARCA4,302
chr1,14304635,14304866,SRX5020211,SMARCA2,231
chr1,14320675,14320867,SRX5075176,SMARCA4,192
chr1,14332172,14332504,SRX5075170,SMARCA4,332
chr1,14332210,14332536,SRX5075176,SMARCA4,326
chr1,14332251,14332490,SRX5075169,SMARCA4,239
chr1,14332288,14332494,SRX5075175,SMARCA4,206
chr1,14332317,14332522,SRX5054308,FOSL2,205
chr1,14346239,14346541,SRX5075168,SMARCA4,302
chr1,14346274,14346495,SRX5075174,SMARCA4,221
chr1,14366364,14366612,SRX5075170,SMARCA4,248
chr1,14366391,14366586,SRX5075176,SMARCA4,195
chr1,14371990,14372538,SRX5075176,SMARCA4,548
chr1,14372247,14372455,SRX5054309,FOSL2,208
chr1,14372258,14372443,SRX5075169,SMARCA4,185
chr1,14372264,14372467,SRX5075175,SMARCA4,203
chr1,14372266,14372567,SRX5075170,SMARCA4,301
chr1,14377486,14377668,SRX5075170,SMARCA4,182
chr1,14377528,14377723,SRX5075176,SMARCA4,195
chr1,14392863,14393277,SRX5075174,SMARCA4,414
chr1,14392881,14393060,SRX5075168,SMARCA4,179
chr1,14404537,14405381,SRX5075174,SMARCA4,844
chr1,14404590,14405398,SRX5075168,SMARCA4,808
chr1,14404762,14405167,SRX20140881,CPSF3L,405
chr1,14404823,14405396,SRX5716463,SMARCA4,573
chr1,14404839,14405229,SRX5716464,SMARCA4,390
chr1,14404880,14405275,SRX5716454,SOX3,395
chr1,14404883,14405188,SRX5716451,SOX2,305
chr1,14404900,14405327,SRX20140895,INTS13,427
chr1,14413807,14414207,SRX5716469,SMARCA4,400
chr1,14413833,14414265,SRX5075176,SMARCA4,432
chr1,14413836,14414119,SRX5075170,SMARCA4,283
chr1,14413847,14414065,SRX5716470,SMARCA4,218
chr1,14413879,14414196,SRX5075175,SMARCA4,317
chr1,14413898,14414149,SRX5716467,SMARCA2,251
chr1,14413900,14414205,SRX5075169,SMARCA4,305
chr1,14435278,14435645,SRX16500060,CTCF,367
chr1,14435284,14435624,SRX16500059,CTCF,340
chr1,14435338,14435565,SRX16500061,CTCF,227
chr1,14435354,14435589,SRX16500062,CTCF,235
chr1,14436993,14437472,SRX5075174,SMARCA4,479
chr1,14441330,14441805,SRX5075176,SMARCA4,475
chr1,14441351,14441808,SRX5075170,SMARCA4,457
chr1,14441380,14441775,SRX5716469,SMARCA4,395
chr1,14441395,14441662,SRX5075175,SMARCA4,267
chr1,14441428,14441775,SRX5075169,SMARCA4,347
chr1,14441434,14441649,SRX5716467,SMARCA2,215
chr1,14476604,14476910,SRX5054309,FOSL2,306
chr1,14476611,14476895,SRX5075175,SMARCA4,284
chr1,14476647,14476827,SRX5075169,SMARCA4,180
chr1,14476650,14476830,SRX5054308,FOSL2,180
chr1,14476677,14476946,SRX5075170,SMARCA4,269
chr1,14486283,14487253,SRX5075169,SMARCA4,970
chr1,14486315,14486793,SRX5054309,FOSL2,478
chr1,14486329,14486635,SRX5054308,FOSL2,306
chr1,14486347,14486672,SRX5716467,SMARCA2,325
chr1,14486436,14487227,SRX5075175,SMARCA4,791
chr1,14486456,14486688,SRX5716470,SMARCA4,232
chr1,14486462,14487240,SRX5075176,SMARCA4,778
chr1,14486463,14487136,SRX5716469,SMARCA4,673
chr1,14486487,14487194,SRX5075170,SMARCA4,707
chr1,14486553,14486831,SRX5716459,Epitope tags,278
chr1,14486762,14487211,SRX5716470,SMARCA4,449
chr1,14486808,14487107,SRX5054308,FOSL2,299
chr1,14486833,14487145,SRX5716468,SMARCA2,312
chr1,14486847,14487150,SRX5054309,FOSL2,303
chr1,14486873,14487104,SRX5020211,SMARCA2,231
chr1,14486895,14487152,SRX5716467,SMARCA2,257
chr1,14486917,14487185,SRX5075181,SMARCA2,268
chr1,14489916,14490206,SRX5075174,SMARCA4,290
chr1,14495965,14496274,SRX5075174,SMARCA4,309
chr1,14496134,14496377,SRX5075168,SMARCA4,243
chr1,14511141,14511722,SRX5075170,SMARCA4,581
chr1,14517281,14518012,SRX5075176,SMARCA4,731
chr1,14517290,14518037,SRX5075170,SMARCA4,747
chr1,14517330,14517964,SRX5075175,SMARCA4,634
chr1,14517380,14517777,SRX5054309,FOSL2,397
chr1,14517428,14517767,SRX5054308,FOSL2,339
chr1,14517429,14517944,SRX5075169,SMARCA4,515
chr1,14517455,14517741,SRX5716468,SMARCA2,286
chr1,14517462,14517820,SRX5716469,SMARCA4,358
chr1,14517495,14517967,SRX5716467,SMARCA2,472
chr1,14517551,14517968,SRX5716470,SMARCA4,417
chr1,14522224,14522561,SRX5075176,SMARCA4,337
chr1,14522683,14523113,SRX5054309,FOSL2,430
chr1,14522773,14523110,SRX5054308,FOSL2,337
chr1,14522879,14523161,SRX5075174,SMARCA4,282
chr1,14522919,14523190,SRX5075168,SMARCA4,271
chr1,14539871,14540406,SRX5075168,SMARCA4,535
chr1,14539945,14540286,SRX5075174,SMARCA4,341
chr1,14540829,14541189,SRX5075174,SMARCA4,360
chr1,14570553,14570813,SRX5054309,FOSL2,260
chr1,14570622,14570824,SRX5075176,SMARCA4,202
chr1,14570639,14570835,SRX5054308,FOSL2,196
chr1,14571863,14572137,SRX16500060,CTCF,274
chr1,14571893,14572198,SRX16500061,CTCF,305
chr1,14571917,14572211,SRX16500059,CTCF,294
chr1,14571948,14572198,SRX16500062,CTCF,250
chr1,14597586,14597907,SRX5075168,SMARCA4,321
chr1,14597588,14597961,SRX5075174,SMARCA4,373
chr1,14597631,14597912,SRX5716463,SMARCA4,281
chr1,14597642,14597880,SRX5716464,SMARCA4,238
chr1,14598457,14599038,SRX20140895,INTS13,581
chr1,14598556,14598802,SRX20140867,INTS10,246
chr1,14598696,14599089,SRX20140868,INTS10,393
chr1,14598807,14599238,SRX16500059,CTCF,431
chr1,14598930,14599166,SRX16500060,CTCF,236
chr1,14599003,14599235,SRX16500061,CTCF,232
chr1,14602190,14602444,SRX5075176,SMARCA4,254
chr1,14602251,14602498,SRX5075174,SMARCA4,247
chr1,14606658,14606966,SRX16500060,CTCF,308
chr1,14606690,14606947,SRX16500062,CTCF,257
chr1,14606718,14607026,SRX16500059,CTCF,308
chr1,14606725,14606971,SRX16500061,CTCF,246
chr1,14608362,14608679,SRX16500060,CTCF,317
chr1,14626010,14626335,SRX5075174,SMARCA4,325
chr1,14626041,14626220,SRX5075168,SMARCA4,179
chr1,14634457,14634866,SRX5075174,SMARCA4,409
chr1,14634522,14634904,SRX5075168,SMARCA4,382
chr1,14634629,14634833,SRX5716463,SMARCA4,204
chr1,14634638,14634895,SRX5716464,SMARCA4,257
chr1,14671895,14672260,SRX5075174,SMARCA4,365
chr1,14672081,14672375,SRX5075168,SMARCA4,294
chr1,14677475,14677665,SRX5075176,SMARCA4,190
chr1,14683065,14683278,SRX5075170,SMARCA4,213
chr1,14693949,14694238,SRX5075176,SMARCA4,289
chr1,14693961,14694172,SRX5716470,SMARCA4,211
chr1,14694037,14694206,SRX5075170,SMARCA4,169
chr1,14724259,14724554,SRX5075169,SMARCA4,295
chr1,14724274,14724643,SRX5054309,FOSL2,369
chr1,14724292,14724708,SRX5716469,SMARCA4,416
chr1,14724312,14724563,SRX5075175,SMARCA4,251
chr1,14724322,14724560,SRX5075176,SMARCA4,238
chr1,14724344,14724631,SRX5716470,SMARCA4,287
chr1,14724368,14724594,SRX5075170,SMARCA4,226
chr1,14724486,14724666,SRX5054308,FOSL2,180
chr1,14731817,14732327,SRX16500061,CTCF,510
chr1,14731821,14732349,SRX16500059,CTCF,528
chr1,14731862,14732291,SRX16500060,CTCF,429
chr1,14731891,14732332,SRX16500062,CTCF,441
chr1,14731947,14732273,SRX5075168,SMARCA4,326
chr1,14731959,14732217,SRX5075174,SMARCA4,258
chr1,14731969,14732187,SRX5716470,SMARCA4,218
chr1,14731980,14732285,SRX5716463,SMARCA4,305
chr1,14732008,14732238,SRX5075170,SMARCA4,230
chr1,14732939,14733236,SRX5716470,SMARCA4,297
chr1,14732971,14733260,SRX5075176,SMARCA4,289
chr1,14733000,14733305,SRX5075169,SMARCA4,305
chr1,14733162,14733428,SRX5075168,SMARCA4,266
chr1,14733484,14733757,SRX5075174,SMARCA4,273
chr1,14742102,14742685,SRX5075174,SMARCA4,583
chr1,14742203,14742650,SRX5075169,SMARCA4,447
chr1,14742250,14742665,SRX5054309,FOSL2,415
chr1,14742259,14742630,SRX5075175,SMARCA4,371
chr1,14742260,14742589,SRX5075176,SMARCA4,329
chr1,14742273,14742540,SRX5716470,SMARCA4,267
chr1,14742288,14742631,SRX5075170,SMARCA4,343
chr1,14742290,14742634,SRX5075168,SMARCA4,344
chr1,14742320,14742610,SRX5054308,FOSL2,290
chr1,14742323,14742559,SRX5716469,SMARCA4,236
chr1,14779083,14779581,SRX16500061,CTCF,498
chr1,14779093,14779510,SRX16500062,CTCF,417
chr1,14779097,14779580,SRX16500060,CTCF,483
chr1,14779100,14779639,SRX16500059,CTCF,539
chr1,14779196,14779710,SRX5075168,SMARCA4,514
chr1,14779241,14779967,SRX5075174,SMARCA4,726
chr1,14779269,14779510,SRX5716464,SMARCA4,241
chr1,14779278,14779765,SRX20140895,INTS13,487
chr1,14779339,14779770,SRX5716463,SMARCA4,431
chr1,14779556,14779820,SRX20140868,INTS10,264
chr1,14789799,14789974,SRX5075170,SMARCA4,175
chr1,14789831,14790183,SRX5054309,FOSL2,352
chr1,14789858,14790071,SRX5075169,SMARCA4,213
chr1,14817761,14818092,SRX5075176,SMARCA4,331
chr1,14817799,14818108,SRX5075170,SMARCA4,309
chr1,14817825,14818048,SRX5075169,SMARCA4,223
chr1,14826178,14826516,SRX5075170,SMARCA4,338
chr1,14826189,14826415,SRX5075168,SMARCA4,226
chr1,14826200,14826574,SRX5075176,SMARCA4,374
chr1,14826223,14826595,SRX5075175,SMARCA4,372
chr1,14826234,14826581,SRX5054309,FOSL2,347
chr1,14826235,14826520,SRX5716469,SMARCA4,285
chr1,14826239,14826539,SRX5054308,FOSL2,300
chr1,14826243,14826564,SRX5075169,SMARCA4,321
chr1,14826251,14826556,SRX5716470,SMARCA4,305
chr1,14835607,14836150,SRX5075170,SMARCA4,543
chr1,14835649,14836031,SRX5075169,SMARCA4,382
chr1,14835659,14836093,SRX5716469,SMARCA4,434
chr1,14835665,14836132,SRX5075176,SMARCA4,467
chr1,14835673,14836156,SRX5075175,SMARCA4,483
chr1,14835741,14836041,SRX5054308,FOSL2,300
chr1,14835758,14836046,SRX5054309,FOSL2,288
chr1,14835776,14835991,SRX5716467,SMARCA2,215
chr1,14843065,14843248,SRX5054309,FOSL2,183
chr1,14850220,14850440,SRX5054309,FOSL2,220
chr1,14869153,14869623,SRX5075176,SMARCA4,470
chr1,14869157,14869545,SRX5075175,SMARCA4,388
chr1,14869171,14869522,SRX5075174,SMARCA4,351
chr1,14869203,14869562,SRX5075169,SMARCA4,359
chr1,14869210,14869480,SRX5075168,SMARCA4,270
chr1,14869212,14869507,SRX5716469,SMARCA4,295
chr1,14869225,14869611,SRX5075170,SMARCA4,386
chr1,14869238,14869578,SRX5054309,FOSL2,340
chr1,14869301,14869528,SRX5054308,FOSL2,227
chr1,14880317,14880771,SRX5716467,SMARCA2,454
chr1,14880343,14881011,SRX5075176,SMARCA4,668
chr1,14880359,14880882,SRX5075170,SMARCA4,523
chr1,14880361,14880795,SRX5075175,SMARCA4,434
chr1,14880372,14880940,SRX5716470,SMARCA4,568
chr1,14880400,14880812,SRX5075169,SMARCA4,412
chr1,14880450,14880819,SRX5716469,SMARCA4,369
chr1,14880496,14880728,SRX5054309,FOSL2,232
chr1,14887868,14888348,SRX5075174,SMARCA4,480
chr1,14887936,14888398,SRX5075168,SMARCA4,462
chr1,14896398,14896665,SRX5054308,FOSL2,267
chr1,14896417,14896707,SRX5075170,SMARCA4,290
chr1,14896421,14896738,SRX5054309,FOSL2,317
chr1,14896444,14896702,SRX5075176,SMARCA4,258
chr1,14896491,14896742,SRX5075168,SMARCA4,251
chr1,14896532,14896720,SRX5075169,SMARCA4,188
chr1,14915237,14915824,SRX16500059,CTCF,587
chr1,14915257,14915868,SRX16500061,CTCF,611
chr1,14915268,14915820,SRX16500060,CTCF,552
chr1,14915287,14915779,SRX16500062,CTCF,492
chr1,14915368,14915747,SRX5075168,SMARCA4,379
chr1,14915388,14915712,SRX5716463,SMARCA4,324
chr1,14915391,14915720,SRX5075170,SMARCA4,329
chr1,14915395,14915713,SRX5075169,SMARCA4,318
chr1,14915398,14915646,SRX4174629,CTCF,248
chr1,14915401,14915759,SRX5075174,SMARCA4,358
chr1,14915407,14915741,SRX5716464,SMARCA4,334
chr1,14915413,14915724,SRX5075176,SMARCA4,311
chr1,14915437,14915719,SRX5716469,SMARCA4,282
chr1,14915449,14915716,SRX5075175,SMARCA4,267
chr1,14915457,14915731,SRX5716470,SMARCA4,274
chr1,14923997,14924176,SRX5075168,SMARCA4,179
chr1,14940072,14940255,SRX5054309,FOSL2,183
chr1,14942946,14943287,SRX5075169,SMARCA4,341
chr1,14942966,14943295,SRX5716470,SMARCA4,329
chr1,14943023,14943280,SRX5716467,SMARCA2,257
chr1,14943028,14943294,SRX5020211,SMARCA2,266
chr1,14943033,14943379,SRX5075175,SMARCA4,346
chr1,14943037,14943281,SRX5716468,SMARCA2,244
chr1,14943045,14943280,SRX5075181,SMARCA2,235
chr1,14945161,14945801,SRX5075176,SMARCA4,640
chr1,14945179,14945890,SRX5075170,SMARCA4,711
chr1,14945227,14945772,SRX5075175,SMARCA4,545
chr1,14945254,14945765,SRX5075169,SMARCA4,511
chr1,14945286,14945833,SRX5716469,SMARCA4,547
chr1,14945290,14945837,SRX5716470,SMARCA4,547
chr1,14945318,14945764,SRX5716467,SMARCA2,446
chr1,14945356,14945736,SRX5716468,SMARCA2,380
chr1,14945496,14945709,SRX5075182,SMARCA2,213
chr1,14945509,14945750,SRX5054309,FOSL2,241
chr1,14946959,14947237,SRX5054309,FOSL2,278
chr1,14968374,14968972,SRX5075170,SMARCA4,598
chr1,14968387,14968792,SRX20140895,INTS13,405
chr1,14968388,14968882,SRX5716469,SMARCA4,494
chr1,14968402,14968867,SRX5075175,SMARCA4,465
chr1,14968466,14968960,SRX5075176,SMARCA4,494
chr1,14968471,14968813,SRX5075174,SMARCA4,342
chr1,14968510,14968965,SRX5075169,SMARCA4,455
chr1,14968552,14968795,SRX5075168,SMARCA4,243
chr1,14968594,14968858,SRX5716470,SMARCA4,264
chr1,14968595,14968890,SRX5054309,FOSL2,295
chr1,14968611,14968900,SRX5054308,FOSL2,289
chr1,14968647,14968868,SRX5716467,SMARCA2,221
chr1,14980682,14981232,SRX5075174,SMARCA4,550
chr1,14980691,14981188,SRX5716464,SMARCA4,497
chr1,14980747,14981185,SRX5075168,SMARCA4,438
chr1,14980769,14981179,SRX5075170,SMARCA4,410
chr1,14980776,14981139,SRX20140895,INTS13,363
chr1,14980786,14981090,SRX5716463,SMARCA4,304
chr1,14980807,14981197,SRX5075176,SMARCA4,390
chr1,14980880,14981126,SRX5716470,SMARCA4,246
chr1,14980922,14981111,SRX5054307,FOSL2,189
chr1,14980938,14981165,SRX5075175,SMARCA4,227
chr1,14988107,14988550,SRX5075170,SMARCA4,443
chr1,14988115,14988517,SRX5075176,SMARCA4,402
chr1,14988267,14988503,SRX5075175,SMARCA4,236
chr1,14988270,14988481,SRX5716470,SMARCA4,211
chr1,14988305,14988559,SRX5075169,SMARCA4,254
chr1,14996014,14996565,SRX5075174,SMARCA4,551
chr1,14996024,14996483,SRX5075168,SMARCA4,459
chr1,14996078,14996496,SRX5075169,SMARCA4,418
chr1,14996114,14996528,SRX5075176,SMARCA4,414
chr1,14996143,14996548,SRX5075175,SMARCA4,405
chr1,14996145,14996479,SRX5054309,FOSL2,334
chr1,14996156,14996425,SRX5054307,FOSL2,269
chr1,14996168,14996443,SRX5716470,SMARCA4,275
chr1,14996173,14996502,SRX5075170,SMARCA4,329
chr1,14996176,14996469,SRX5716469,SMARCA4,293
chr1,14996204,14996437,SRX5054308,FOSL2,233
chr1,15007075,15007313,SRX5075169,SMARCA4,238
chr1,15007083,15007342,SRX5075176,SMARCA4,259
chr1,15007086,15007337,SRX5075170,SMARCA4,251
chr1,15007098,15007286,SRX5075175,SMARCA4,188
chr1,15007105,15007323,SRX5716469,SMARCA4,218
chr1,15008708,15009069,SRX5075169,SMARCA4,361
chr1,15008786,15009134,SRX5716470,SMARCA4,348
chr1,15008807,15009156,SRX5075170,SMARCA4,349
chr1,15008816,15009203,SRX5075176,SMARCA4,387
chr1,15008826,15009125,SRX5075175,SMARCA4,299
chr1,15008851,15009097,SRX5716469,SMARCA4,246
chr1,15008880,15009108,SRX5716467,SMARCA2,228
chr1,15027410,15027887,SRX4174629,CTCF,477
chr1,15027420,15027943,SRX16500060,CTCF,523
chr1,15027443,15027913,SRX16500062,CTCF,470
chr1,15027450,15027921,SRX16500061,CTCF,471
chr1,15027460,15027915,SRX16500059,CTCF,455
chr1,15027597,15027776,SRX5075168,SMARCA4,179
chr1,15028117,15028388,SRX5075169,SMARCA4,271
chr1,15028146,15028472,SRX5075175,SMARCA4,326
chr1,15031553,15031601,SRX1424892,POU3F2,48
chr1,15031554,15031596,SRX1424893,POU3F2,42
chr1,15031554,15031599,SRX1424894,POU3F2,45
chr1,15031557,15031598,SRX1424891,POU3F2,41
chr1,15033185,15033562,SRX5054309,FOSL2,377
chr1,15033233,15033492,SRX5054308,FOSL2,259
chr1,15033305,15033505,SRX5020211,SMARCA2,200
chr1,15033332,15033619,SRX5075169,SMARCA4,287
chr1,15033385,15033709,SRX5075168,SMARCA4,324
chr1,15033393,15033671,SRX5075176,SMARCA4,278
chr1,15033399,15033673,SRX5075170,SMARCA4,274
chr1,15033436,15033623,SRX5075175,SMARCA4,187
chr1,15033451,15033715,SRX5716470,SMARCA4,264
chr1,15038117,15038569,SRX16500059,CTCF,452
chr1,15038122,15038516,SRX16500062,CTCF,394
chr1,15038122,15038527,SRX16500061,CTCF,405
chr1,15038131,15038531,SRX16500060,CTCF,400
chr1,15042774,15043536,SRX20140895,INTS13,762
chr1,15042784,15043161,SRX20140894,INTS13,377
chr1,15042805,15043364,SRX5075174,SMARCA4,559
chr1,15042818,15043089,SRX5075168,SMARCA4,271
chr1,15042819,15043422,SRX20140868,INTS10,603
chr1,15042876,15043352,SRX20140867,INTS10,476
chr1,15042921,15043433,SRX20140879,CPSF3L,512
chr1,15046448,15046756,SRX5716469,SMARCA4,308
chr1,15046457,15046825,SRX5075170,SMARCA4,368
chr1,15046467,15046962,SRX4174629,CTCF,495
chr1,15046471,15046972,SRX16500059,CTCF,501
chr1,15046475,15047023,SRX16500060,CTCF,548
chr1,15046479,15046755,SRX5716470,SMARCA4,276
chr1,15046480,15046951,SRX16500062,CTCF,471
chr1,15046481,15046953,SRX16500061,CTCF,472
chr1,15046490,15046833,SRX5075176,SMARCA4,343
chr1,15046520,15046847,SRX5075175,SMARCA4,327
chr1,15046528,15046775,SRX5075169,SMARCA4,247
chr1,15046562,15046815,SRX5075174,SMARCA4,253
chr1,15046587,15046805,SRX5075168,SMARCA4,218
chr1,15062484,15062851,SRX16500062,CTCF,367
chr1,15062486,15062905,SRX16500059,CTCF,419
chr1,15062490,15062862,SRX16500060,CTCF,372
chr1,15062527,15062858,SRX16500061,CTCF,331
chr1,15088644,15088970,SRX5075168,SMARCA4,326
chr1,15088668,15089021,SRX5075174,SMARCA4,353
chr1,15088683,15088968,SRX5716464,SMARCA4,285
chr1,15088725,15088988,SRX5716470,SMARCA4,263
chr1,15090392,15090932,SRX5075174,SMARCA4,540
chr1,15090415,15090860,SRX5075168,SMARCA4,445
chr1,15090448,15090791,SRX5716464,SMARCA4,343
chr1,15090449,15090806,SRX5716463,SMARCA4,357
chr1,15090530,15090841,SRX20140868,INTS10,311
chr1,15090532,15090772,SRX5716454,SOX3,240
chr1,15090534,15090814,SRX20140895,INTS13,280
chr1,15100240,15100790,SRX16500061,CTCF,550
chr1,15100248,15100806,SRX16500059,CTCF,558
chr1,15100289,15100775,SRX16500062,CTCF,486
chr1,15100308,15100827,SRX16500060,CTCF,519
chr1,15100388,15100620,SRX5075176,SMARCA4,232
chr1,15100403,15100651,SRX5716464,SMARCA4,248
chr1,15100406,15100628,SRX5075168,SMARCA4,222
chr1,15100410,15100673,SRX5075170,SMARCA4,263
chr1,15100412,15100728,SRX4174629,CTCF,316
chr1,15100435,15100647,SRX5075174,SMARCA4,212
chr1,15100437,15100617,SRX5075169,SMARCA4,180
chr1,15107858,15108128,SRX5075174,SMARCA4,270
chr1,15128436,15128957,SRX16500060,CTCF,521
chr1,15128438,15128996,SRX16500059,CTCF,558
chr1,15128443,15128932,SRX16500061,CTCF,489
chr1,15128462,15128912,SRX4174629,CTCF,450
chr1,15128472,15128963,SRX16500062,CTCF,491
chr1,15128612,15128802,SRX5075174,SMARCA4,190
chr1,15128624,15128884,SRX5075168,SMARCA4,260
chr1,15139770,15140242,SRX20140881,CPSF3L,472
chr1,15139819,15140162,SRX5075174,SMARCA4,343
chr1,15141780,15142568,SRX5075176,SMARCA4,788
chr1,15141804,15142542,SRX5075170,SMARCA4,738
chr1,15141874,15142502,SRX5075175,SMARCA4,628
chr1,15141877,15142477,SRX5716470,SMARCA4,600
chr1,15141900,15142461,SRX5716469,SMARCA4,561
chr1,15141909,15142530,SRX5075169,SMARCA4,621
chr1,15141918,15142433,SRX5716468,SMARCA2,515
chr1,15141920,15142407,SRX5716467,SMARCA2,487
chr1,15141944,15142366,SRX5075181,SMARCA2,422
chr1,15141964,15142488,SRX5054309,FOSL2,524
chr1,15141967,15142415,SRX5716459,Epitope tags,448
chr1,15142002,15142412,SRX5054308,FOSL2,410
chr1,15142037,15142297,SRX5716460,Epitope tags,260
chr1,15142046,15142375,SRX5020211,SMARCA2,329
chr1,15142055,15142505,SRX5020214,SMARCA2,450
chr1,15142077,15142416,SRX5075182,SMARCA2,339
chr1,15152294,15152646,SRX4174629,CTCF,352
chr1,15152308,15152697,SRX16500059,CTCF,389
chr1,15152343,15152672,SRX16500060,CTCF,329
chr1,15152351,15152679,SRX16500062,CTCF,328
chr1,15152403,15152712,SRX16500061,CTCF,309
chr1,15152417,15152729,SRX5075176,SMARCA4,312
chr1,15152441,15152659,SRX5075174,SMARCA4,218
chr1,15152454,15152682,SRX5075175,SMARCA4,228
chr1,15152500,15152714,SRX5075168,SMARCA4,214
chr1,15153561,15154233,SRX20140895,INTS13,672
chr1,15153571,15153746,SRX5075174,SMARCA4,175
chr1,15153849,15154399,SRX16500060,CTCF,550
chr1,15153912,15154445,SRX16500059,CTCF,533
chr1,15153923,15154193,SRX20140868,INTS10,270
chr1,15153994,15154444,SRX16500061,CTCF,450
chr1,15154021,15154477,SRX16500062,CTCF,456
chr1,15154035,15154317,SRX5075169,SMARCA4,282
chr1,15154055,15154307,SRX5075174,SMARCA4,252
chr1,15154100,15154330,SRX5075168,SMARCA4,230
chr1,15154104,15154379,SRX5075170,SMARCA4,275
chr1,15154109,15154284,SRX5075176,SMARCA4,175
chr1,15172651,15172822,SRX5075170,SMARCA4,171
chr1,15178745,15179477,SRX5075175,SMARCA4,732
chr1,15178772,15179522,SRX5075176,SMARCA4,750
chr1,15178783,15179497,SRX5075170,SMARCA4,714
chr1,15178817,15179261,SRX5054309,FOSL2,444
chr1,15178825,15179197,SRX5716470,SMARCA4,372
chr1,15178827,15179371,SRX5716469,SMARCA4,544
chr1,15178839,15179295,SRX5075168,SMARCA4,456
chr1,15178840,15179217,SRX5054308,FOSL2,377
chr1,15178849,15179504,SRX5075169,SMARCA4,655
chr1,15178886,15179129,SRX5075174,SMARCA4,243
chr1,15178900,15179231,SRX5020214,SMARCA2,331
chr1,15178907,15179293,SRX5716467,SMARCA2,386
chr1,15178919,15179227,SRX5020211,SMARCA2,308
chr1,15178920,15179164,SRX5716468,SMARCA2,244
chr1,15188772,15188957,SRX5075170,SMARCA4,185
chr1,15188781,15188991,SRX5075176,SMARCA4,210
chr1,15200589,15201036,SRX5075170,SMARCA4,447
chr1,15200620,15201051,SRX5716469,SMARCA4,431
chr1,15200621,15200896,SRX5716467,SMARCA2,275
chr1,15200627,15200963,SRX5054309,FOSL2,336
chr1,15200627,15201005,SRX5075169,SMARCA4,378
chr1,15200628,15201068,SRX5075176,SMARCA4,440
chr1,15200647,15200985,SRX5054308,FOSL2,338
chr1,15200647,15201008,SRX5075175,SMARCA4,361
chr1,15200651,15200871,SRX5020211,SMARCA2,220
chr1,15200671,15200906,SRX5716470,SMARCA4,235
chr1,15200714,15200888,SRX5075174,SMARCA4,174
chr1,15206640,15206973,SRX5716470,SMARCA4,333
chr1,15206667,15206968,SRX5075174,SMARCA4,301
chr1,15206680,15206895,SRX5075168,SMARCA4,215
chr1,15206680,15206970,SRX5075176,SMARCA4,290
chr1,15206960,15207498,SRX20140895,INTS13,538
chr1,15209593,15209793,SRX5020211,SMARCA2,200
chr1,15214402,15214960,SRX5075168,SMARCA4,558
chr1,15214476,15214950,SRX5075176,SMARCA4,474
chr1,15214483,15214980,SRX20140895,INTS13,497
chr1,15214486,15214825,SRX5716463,SMARCA4,339
chr1,15214496,15214750,SRX5716464,SMARCA4,254
chr1,15214502,15214948,SRX5075174,SMARCA4,446
chr1,15214523,15214874,SRX20140881,CPSF3L,351
chr1,15214535,15214852,SRX20140868,INTS10,317
chr1,15214542,15214894,SRX20140867,INTS10,352
chr1,15214547,15214862,SRX20140879,CPSF3L,315
chr1,15214548,15214845,SRX5716470,SMARCA4,297
chr1,15214551,15214948,SRX5075170,SMARCA4,397
chr1,15214566,15214849,SRX5716468,SMARCA2,283
chr1,15214567,15214828,SRX5716469,SMARCA4,261
chr1,15214569,15214907,SRX5075169,SMARCA4,338
chr1,15214570,15214862,SRX20140869,INTS10,292
chr1,15214584,15214849,SRX5716467,SMARCA2,265
chr1,15214609,15214873,SRX5075175,SMARCA4,264
chr1,15234004,15234203,SRX5075176,SMARCA4,199
chr1,15243336,15243563,SRX5075174,SMARCA4,227
chr1,15247071,15247318,SRX5075168,SMARCA4,247
chr1,15247088,15247420,SRX20140895,INTS13,332
chr1,15247106,15247355,SRX5075174,SMARCA4,249
chr1,15247175,15247365,SRX5075176,SMARCA4,190
chr1,15249236,15249441,SRX5075169,SMARCA4,205
chr1,15252645,15252993,SRX20140895,INTS13,348
chr1,15254530,15254913,SRX5075175,SMARCA4,383
chr1,15254535,15254952,SRX5075176,SMARCA4,417
chr1,15254556,15254901,SRX5075170,SMARCA4,345
chr1,15254558,15254877,SRX5716469,SMARCA4,319
chr1,15254566,15254839,SRX5075181,SMARCA2,273
chr1,15254574,15254846,SRX5716468,SMARCA2,272
chr1,15254575,15254861,SRX5716467,SMARCA2,286
chr1,15254578,15254944,SRX5075169,SMARCA4,366
chr1,15254580,15254928,SRX5716470,SMARCA4,348
chr1,15254591,15254819,SRX5054308,FOSL2,228
chr1,15254601,15254863,SRX5020211,SMARCA2,262
chr1,15254613,15254827,SRX5054309,FOSL2,214
chr1,15260608,15260931,SRX5054309,FOSL2,323
chr1,15260675,15260885,SRX5075170,SMARCA4,210
chr1,15260713,15261018,SRX5075176,SMARCA4,305
chr1,15260716,15260959,SRX5054308,FOSL2,243
chr1,15260746,15260939,SRX5075169,SMARCA4,193
chr1,15272445,15272967,SRX16500061,CTCF,522
chr1,15272458,15273060,SRX16500060,CTCF,602
chr1,15272484,15272899,SRX5075174,SMARCA4,415
chr1,15272485,15272830,SRX5054308,FOSL2,345
chr1,15272491,15273065,SRX16500059,CTCF,574
chr1,15272497,15272828,SRX5075170,SMARCA4,331
chr1,15272497,15273047,SRX16500062,CTCF,550
chr1,15272509,15272937,SRX4174629,CTCF,428
chr1,15272520,15272851,SRX5716470,SMARCA4,331
chr1,15272534,15272821,SRX5075169,SMARCA4,287
chr1,15272543,15272852,SRX5054309,FOSL2,309
chr1,15272551,15272861,SRX5075168,SMARCA4,310
chr1,15272565,15272798,SRX5054307,FOSL2,233
chr1,15272578,15272830,SRX5075176,SMARCA4,252
chr1,15300371,15300768,SRX5075170,SMARCA4,397
chr1,15300387,15300723,SRX5716467,SMARCA2,336
chr1,15300413,15300711,SRX5020211,SMARCA2,298
chr1,15300418,15300674,SRX5054308,FOSL2,256
chr1,15300428,15300725,SRX5716470,SMARCA4,297
chr1,15300452,15300739,SRX5716469,SMARCA4,287
chr1,15300471,15300696,SRX5075175,SMARCA4,225
chr1,15300476,15300693,SRX5716468,SMARCA2,217
chr1,15300484,15300787,SRX5075176,SMARCA4,303
chr1,15300504,15300689,SRX5075169,SMARCA4,185
chr1,15304650,15305175,SRX16500059,CTCF,525
chr1,15304675,15305154,SRX16500060,CTCF,479
chr1,15304676,15305151,SRX16500061,CTCF,475
chr1,15304693,15305172,SRX16500062,CTCF,479
chr1,15304812,15305096,SRX4174629,CTCF,284
chr1,15323419,15323971,SRX16500060,CTCF,552
chr1,15323475,15323984,SRX16500061,CTCF,509
chr1,15323505,15324003,SRX16500059,CTCF,498
chr1,15323506,15323946,SRX16500062,CTCF,440
chr1,15323509,15323930,SRX4174629,CTCF,421
chr1,15323551,15323783,SRX5075168,SMARCA4,232
chr1,15323630,15323835,SRX5075174,SMARCA4,205
chr1,15326727,15327164,SRX20140881,CPSF3L,437
chr1,15326814,15327057,SRX20140867,INTS10,243
chr1,15328413,15329150,SRX5075176,SMARCA4,737
chr1,15328426,15329143,SRX5075169,SMARCA4,717
chr1,15328454,15329108,SRX5075175,SMARCA4,654
chr1,15328478,15329068,SRX5716470,SMARCA4,590
chr1,15328506,15328701,SRX5075181,SMARCA2,195
chr1,15328521,15329119,SRX5075170,SMARCA4,598
chr1,15328535,15328912,SRX5716468,SMARCA2,377
chr1,15328576,15328939,SRX5716467,SMARCA2,363
chr1,15328610,15329098,SRX5716469,SMARCA4,488
chr1,15328703,15329067,SRX5020211,SMARCA2,364
chr1,15337674,15338071,SRX5075176,SMARCA4,397
chr1,15337677,15338006,SRX5054309,FOSL2,329
chr1,15337706,15338024,SRX5075175,SMARCA4,318
chr1,15337707,15338077,SRX5075170,SMARCA4,370
chr1,15337736,15338388,SRX5075169,SMARCA4,652
chr1,15337738,15337938,SRX5054308,FOSL2,200
chr1,15337751,15337966,SRX5716467,SMARCA2,215
chr1,15337867,15338468,SRX5716470,SMARCA4,601
chr1,15338149,15338411,SRX5075176,SMARCA4,262
chr1,15338166,15338382,SRX5075170,SMARCA4,216
chr1,15340390,15340672,SRX20140895,INTS13,282
chr1,15342004,15342292,SRX5054309,FOSL2,288
chr1,15342039,15342292,SRX5075169,SMARCA4,253
chr1,15342039,15342307,SRX5054308,FOSL2,268
chr1,15343749,15344124,SRX5716467,SMARCA2,375
chr1,15343752,15344127,SRX5716470,SMARCA4,375
chr1,15343759,15344113,SRX5075176,SMARCA4,354
chr1,15343764,15344129,SRX5075170,SMARCA4,365
chr1,15343765,15344121,SRX5075175,SMARCA4,356
chr1,15343766,15344126,SRX5716469,SMARCA4,360
chr1,15343773,15344103,SRX5075169,SMARCA4,330
chr1,15343774,15344105,SRX5075181,SMARCA2,331
chr1,15343796,15344124,SRX5716468,SMARCA2,328
chr1,15343801,15344029,SRX5020211,SMARCA2,228
chr1,15352499,15352676,SRX5075170,SMARCA4,177
chr1,15352534,15352755,SRX5054309,FOSL2,221
chr1,15352599,15352808,SRX5075175,SMARCA4,209
chr1,15356147,15356498,SRX5054308,FOSL2,351
chr1,15356213,15356388,SRX5075176,SMARCA4,175
chr1,15360764,15361064,SRX20140868,INTS10,300
chr1,15384277,15384834,SRX20140895,INTS13,557
chr1,15384343,15384740,SRX5075168,SMARCA4,397
chr1,15384353,15384707,SRX5075176,SMARCA4,354
chr1,15384354,15384778,SRX5075174,SMARCA4,424
chr1,15384387,15384635,SRX5716464,SMARCA4,248
chr1,15384412,15384690,SRX1424893,POU3F2,278
chr1,15384422,15384712,SRX1424891,POU3F2,290
chr1,15384427,15384686,SRX5716463,SMARCA4,259
chr1,15384430,15384700,SRX1424892,POU3F2,270
chr1,15384449,15384690,SRX1424894,POU3F2,241
chr1,15384464,15384767,SRX5075170,SMARCA4,303
chr1,15384479,15384669,SRX5716451,SOX2,190
chr1,15386239,15386548,SRX5075174,SMARCA4,309
chr1,15407169,15407512,SRX5075170,SMARCA4,343
chr1,15407196,15407527,SRX5075175,SMARCA4,331
chr1,15407214,15407519,SRX5075176,SMARCA4,305
chr1,15407217,15407517,SRX5716469,SMARCA4,300
chr1,15407236,15407534,SRX5075169,SMARCA4,298
chr1,15407305,15407530,SRX5716467,SMARCA2,225
chr1,15409354,15410018,SRX5075174,SMARCA4,664
chr1,15409415,15410128,SRX20140895,INTS13,713
chr1,15409490,15409830,SRX5075169,SMARCA4,340
chr1,15409536,15410011,SRX5075170,SMARCA4,475
chr1,15409590,15410068,SRX5075168,SMARCA4,478
chr1,15409599,15409820,SRX5716469,SMARCA4,221
chr1,15409615,15409826,SRX5716470,SMARCA4,211
chr1,15409671,15409934,SRX5075175,SMARCA4,263
chr1,15409693,15410065,SRX20140868,INTS10,372
chr1,15409717,15410083,SRX20140867,INTS10,366
chr1,15409809,15410151,SRX5075176,SMARCA4,342
chr1,15409900,15410112,SRX5716470,SMARCA4,212
chr1,15415958,15416261,SRX5054309,FOSL2,303
chr1,15415981,15416156,SRX5075176,SMARCA4,175
chr1,15416034,15416336,SRX5075169,SMARCA4,302
chr1,15416041,15416367,SRX5075170,SMARCA4,326
chr1,15416062,15416297,SRX5054308,FOSL2,235
chr1,15417573,15417835,SRX5075175,SMARCA4,262
chr1,15417593,15417762,SRX5075170,SMARCA4,169
chr1,15426829,15427116,SRX5075170,SMARCA4,287
chr1,15426833,15427044,SRX5054308,FOSL2,211
chr1,15426898,15427109,SRX5075169,SMARCA4,211
chr1,15431005,15431527,SRX16500062,CTCF,522
chr1,15431037,15431584,SRX16500060,CTCF,547
chr1,15431050,15431589,SRX16500059,CTCF,539
chr1,15431090,15431563,SRX16500061,CTCF,473
chr1,15431127,15431517,SRX4174629,CTCF,390
chr1,15431161,15431390,SRX5075174,SMARCA4,229
chr1,15453761,15454098,SRX5054309,FOSL2,337
chr1,15453908,15454103,SRX5054308,FOSL2,195
chr1,15454344,15454690,SRX5075169,SMARCA4,346
chr1,15454371,15454729,SRX5075175,SMARCA4,358
chr1,15454428,15454723,SRX5054308,FOSL2,295
chr1,15454456,15454716,SRX5054309,FOSL2,260
chr1,15454459,15454645,SRX5075170,SMARCA4,186
chr1,15459971,15460151,SRX5075169,SMARCA4,180
chr1,15501339,15501795,SRX16500060,CTCF,456
chr1,15501357,15501787,SRX16500061,CTCF,430
chr1,15501370,15501849,SRX16500059,CTCF,479
chr1,15501373,15501751,SRX16500062,CTCF,378
chr1,15501446,15501749,SRX4174629,CTCF,303
chr1,15501470,15501714,SRX5075174,SMARCA4,244
chr1,15523856,15524108,SRX5075175,SMARCA4,252
chr1,15523892,15524324,SRX5075174,SMARCA4,432
chr1,15523904,15524165,SRX5716470,SMARCA4,261
chr1,15523969,15524214,SRX20140879,CPSF3L,245
chr1,15523971,15524367,SRX20140895,INTS13,396
chr1,15523977,15524252,SRX20140881,CPSF3L,275
chr1,15523980,15524278,SRX5716469,SMARCA4,298
chr1,15524007,15524270,SRX20140868,INTS10,263
chr1,15524034,15524263,SRX5075168,SMARCA4,229
chr1,15524058,15524268,SRX5075170,SMARCA4,210
chr1,15524086,15524310,SRX5075176,SMARCA4,224
chr1,15524103,15524347,SRX20140867,INTS10,244
chr1,15524665,15525005,SRX5054308,FOSL2,340
chr1,15524730,15524943,SRX5054309,FOSL2,213
chr1,15524966,15525159,SRX5054307,FOSL2,193
chr1,15526378,15526659,SRX16500062,CTCF,281
chr1,15526420,15526976,SRX5075174,SMARCA4,556
chr1,15526443,15526943,SRX5075168,SMARCA4,500
chr1,15526495,15526777,SRX5716463,SMARCA4,282
chr1,15526507,15526804,SRX5075176,SMARCA4,297
chr1,15526532,15526807,SRX5075170,SMARCA4,275
chr1,15526544,15526826,SRX5716454,SOX3,282
chr1,15526550,15526777,SRX5716451,SOX2,227
chr1,15526561,15527156,SRX20140895,INTS13,595
chr1,15526572,15527194,SRX20140897,INTS13,622
chr1,15526717,15527051,SRX20140867,INTS10,334
chr1,15526738,15527115,SRX20140868,INTS10,377
chr1,15526756,15527113,SRX20140869,INTS10,357
chr1,15526796,15527067,SRX20140896,INTS13,271
chr1,15526844,15527136,SRX20140881,CPSF3L,292
chr1,15584417,15584798,SRX16500062,CTCF,381
chr1,15584453,15584789,SRX16500060,CTCF,336
chr1,15584489,15584815,SRX16500059,CTCF,326
chr1,15584581,15584806,SRX16500061,CTCF,225
chr1,15584694,15584949,SRX5075168,SMARCA4,255
chr1,15584812,15585015,SRX5075175,SMARCA4,203
chr1,15584822,15585119,SRX5075176,SMARCA4,297
chr1,15584823,15585021,SRX5075169,SMARCA4,198
chr1,15595018,15595460,SRX16500061,CTCF,442
chr1,15595018,15595532,SRX16500060,CTCF,514
chr1,15595047,15595478,SRX16500059,CTCF,431
chr1,15595090,15595428,SRX16500062,CTCF,338
chr1,15603252,15603850,SRX5075170,SMARCA4,598
chr1,15603255,15603613,SRX5716470,SMARCA4,358
chr1,15603330,15603548,SRX5075175,SMARCA4,218
chr1,15603344,15603964,SRX20140895,INTS13,620
chr1,15603372,15603949,SRX5075168,SMARCA4,577
chr1,15603391,15603853,SRX5716469,SMARCA4,462
chr1,15603392,15603879,SRX5075176,SMARCA4,487
chr1,15603404,15603926,SRX20140897,INTS13,522
chr1,15603423,15603881,SRX5075174,SMARCA4,458
chr1,15603464,15603891,SRX20140896,INTS13,427
chr1,15603642,15603898,SRX5075169,SMARCA4,256
chr1,15603684,15603871,SRX5075175,SMARCA4,187
chr1,15616937,15617182,SRX5716469,SMARCA4,245
chr1,15616989,15617610,SRX5075176,SMARCA4,621
chr1,15617030,15617634,SRX5075174,SMARCA4,604
chr1,15617036,15617647,SRX5075168,SMARCA4,611
chr1,15617136,15617566,SRX5716463,SMARCA4,430
chr1,15617139,15617652,SRX5075175,SMARCA4,513
chr1,15617146,15617720,SRX5075170,SMARCA4,574
chr1,15617189,15617701,SRX5075169,SMARCA4,512
chr1,15617237,15617640,SRX5054308,FOSL2,403
chr1,15617249,15617456,SRX5716451,SOX2,207
chr1,15617258,15617600,SRX5054307,FOSL2,342
chr1,15617278,15617706,SRX5716470,SMARCA4,428
chr1,15617298,15617863,SRX20140895,INTS13,565
chr1,15617317,15617657,SRX20140867,INTS10,340
chr1,15617322,15617655,SRX5054309,FOSL2,333
chr1,15617334,15617806,SRX20140868,INTS10,472
chr1,15683937,15684329,SRX20140868,INTS10,392
chr1,15684031,15684406,SRX20140895,INTS13,375
chr1,15684105,15684334,SRX5075175,SMARCA4,229
chr1,15684140,15684318,SRX5075170,SMARCA4,178
chr1,15684176,15684587,SRX20140867,INTS10,411
chr1,15684632,15684921,SRX5075170,SMARCA4,289
chr1,15684667,15685133,SRX20140895,INTS13,466
chr1,15684668,15684927,SRX5075169,SMARCA4,259
chr1,15703574,15703887,SRX5075169,SMARCA4,313
chr1,15703611,15703938,SRX5075170,SMARCA4,327
chr1,15703612,15703825,SRX5716470,SMARCA4,213
chr1,15703621,15703988,SRX5075176,SMARCA4,367
chr1,15703638,15703965,SRX5716469,SMARCA4,327
chr1,15703645,15703825,SRX5054308,FOSL2,180
chr1,15703658,15703976,SRX5075175,SMARCA4,318
chr1,15741260,15741757,SRX16500059,CTCF,497
chr1,15741263,15741793,SRX16500060,CTCF,530
chr1,15741301,15741737,SRX16500061,CTCF,436
chr1,15741336,15741727,SRX16500062,CTCF,391
chr1,15749635,15749899,SRX5075169,SMARCA4,264
chr1,15758777,15759378,SRX20140895,INTS13,601
chr1,15760615,15761032,SRX5075170,SMARCA4,417
chr1,15760649,15760941,SRX5075176,SMARCA4,292
chr1,15760657,15760859,SRX5075174,SMARCA4,202
chr1,15760668,15761101,SRX5075169,SMARCA4,433
chr1,15760676,15760872,SRX5075175,SMARCA4,196
chr1,15760692,15760878,SRX5075168,SMARCA4,186
chr1,15760700,15760997,SRX5716470,SMARCA4,297
chr1,15788636,15788856,SRX5054308,FOSL2,220
chr1,15788647,15788908,SRX5054309,FOSL2,261
chr1,15791896,15792461,SRX16500060,CTCF,565
chr1,15791902,15792457,SRX16500059,CTCF,555
chr1,15791916,15792458,SRX16500062,CTCF,542
chr1,15791970,15792503,SRX16500061,CTCF,533
chr1,15792000,15792462,SRX4174629,CTCF,462
chr1,15792022,15792332,SRX5075174,SMARCA4,310
chr1,15792025,15792368,SRX5716464,SMARCA4,343
chr1,15792064,15792337,SRX5075168,SMARCA4,273
chr1,15795049,15795402,SRX5075170,SMARCA4,353
chr1,15795062,15795442,SRX5054309,FOSL2,380
chr1,15795065,15795428,SRX5054308,FOSL2,363
chr1,15795090,15795385,SRX5075176,SMARCA4,295
chr1,15795099,15795437,SRX5075169,SMARCA4,338
chr1,15795137,15795383,SRX5020214,SMARCA2,246
chr1,15795142,15795367,SRX5075175,SMARCA4,225
chr1,15799061,15799343,SRX5075175,SMARCA4,282
chr1,15799064,15799303,SRX5075169,SMARCA4,239
chr1,15799072,15799317,SRX5716469,SMARCA4,245
chr1,15799080,15799335,SRX5054309,FOSL2,255
chr1,15799088,15799294,SRX5075170,SMARCA4,206
chr1,15799096,15799321,SRX5054308,FOSL2,225
chr1,15799109,15799294,SRX5075176,SMARCA4,185
chr1,15800453,15800735,SRX5075176,SMARCA4,282
chr1,15803358,15803730,SRX16500059,CTCF,372
chr1,15803366,15803754,SRX16500060,CTCF,388
chr1,15803385,15803774,SRX16500061,CTCF,389
chr1,15803410,15803801,SRX16500062,CTCF,391
chr1,15815339,15815884,SRX5075174,SMARCA4,545
chr1,15815363,15815972,SRX16500061,CTCF,609
chr1,15815391,15815914,SRX5075168,SMARCA4,523
chr1,15815418,15815751,SRX5716454,SOX3,333
chr1,15815436,15815778,SRX5716451,SOX2,342
chr1,15815481,15815998,SRX16500059,CTCF,517
chr1,15815489,15815813,SRX4174629,CTCF,324
chr1,15815501,15815900,SRX16500060,CTCF,399
chr1,15815518,15815797,SRX5716464,SMARCA4,279
chr1,15815530,15815894,SRX5716463,SMARCA4,364
chr1,15815538,15815946,SRX16500062,CTCF,408
chr1,15815586,15815841,SRX5075170,SMARCA4,255
chr1,15815607,15815782,SRX5075176,SMARCA4,175
chr1,15815653,15815864,SRX5716470,SMARCA4,211
chr1,15834382,15835944,SRX20140895,INTS13,1562
chr1,15834417,15834670,SRX5075176,SMARCA4,253
chr1,15834425,15835491,SRX20140868,INTS10,1066
chr1,15834474,15834818,SRX20140881,CPSF3L,344
chr1,15834519,15835318,SRX20140867,INTS10,799
chr1,15834545,15834919,SRX20140894,INTS13,374
chr1,15834572,15835260,SRX20140897,INTS13,688
chr1,15834589,15834867,SRX20140879,CPSF3L,278
chr1,15834696,15835681,SRX20140869,INTS10,985
chr1,15834770,15835126,SRX5075170,SMARCA4,356
chr1,15834771,15834958,SRX5075176,SMARCA4,187
chr1,15834864,15835082,SRX5075174,SMARCA4,218
chr1,15834911,15835343,SRX20140879,CPSF3L,432
chr1,15834940,15835515,SRX20140896,INTS13,575
chr1,15834979,15835423,SRX20140881,CPSF3L,444
chr1,15835400,15835965,SRX20140867,INTS10,565
chr1,15835556,15835963,SRX20140897,INTS13,407
chr1,15835720,15836034,SRX5716463,SMARCA4,314
chr1,15835745,15836235,SRX5075174,SMARCA4,490
chr1,15835748,15836087,SRX5075170,SMARCA4,339
chr1,15835779,15836090,SRX5716470,SMARCA4,311
chr1,15835787,15836009,SRX5716469,SMARCA4,222
chr1,15835793,15836215,SRX5075168,SMARCA4,422
chr1,15835808,15836092,SRX5716451,SOX2,284
chr1,15835822,15836126,SRX5075176,SMARCA4,304
chr1,15835870,15836077,SRX5054309,FOSL2,207
chr1,15835877,15836108,SRX5054308,FOSL2,231
chr1,15835891,15836071,SRX5075169,SMARCA4,180
chr1,15843746,15844083,SRX5075174,SMARCA4,337
chr1,15843776,15844025,SRX5716463,SMARCA4,249
chr1,15843784,15844097,SRX5075168,SMARCA4,313
chr1,15847430,15847798,SRX5075174,SMARCA4,368
chr1,15847437,15847651,SRX20140867,INTS10,214
chr1,15847442,15847788,SRX5075170,SMARCA4,346
chr1,15847456,15847809,SRX5075168,SMARCA4,353
chr1,15847515,15847813,SRX5075176,SMARCA4,298
chr1,15847552,15847797,SRX5716470,SMARCA4,245
chr1,15849152,15849451,SRX5054309,FOSL2,299
chr1,15849189,15849798,SRX20140895,INTS13,609
chr1,15849202,15849423,SRX5054308,FOSL2,221
chr1,15849211,15849592,SRX20140879,CPSF3L,381
chr1,15849246,15849695,SRX20140881,CPSF3L,449
chr1,15849273,15849697,SRX20140868,INTS10,424
chr1,15849277,15849720,SRX20140867,INTS10,443
chr1,15849306,15849597,SRX20140897,INTS13,291
chr1,15849859,15850165,SRX20140869,INTS10,306
chr1,15849891,15850259,SRX20140895,INTS13,368
chr1,15863214,15863415,SRX5075170,SMARCA4,201
chr1,15863255,15863469,SRX5075176,SMARCA4,214
chr1,15863303,15863533,SRX5716467,SMARCA2,230
chr1,15870453,15870633,SRX5054308,FOSL2,180
chr1,15876652,15876993,SRX16500059,CTCF,341
chr1,15885676,15886118,SRX5716470,SMARCA4,442
chr1,15885687,15886078,SRX5075176,SMARCA4,391
chr1,15885693,15886048,SRX5075170,SMARCA4,355
chr1,15885711,15885920,SRX5075181,SMARCA2,209
chr1,15885749,15886037,SRX5075175,SMARCA4,288
chr1,15885754,15886001,SRX5716467,SMARCA2,247
chr1,15885756,15886564,SRX5075169,SMARCA4,808
chr1,15885834,15886152,SRX5716469,SMARCA4,318
chr1,15886139,15886395,SRX5716463,SMARCA4,256
chr1,15886171,15886661,SRX5075176,SMARCA4,490
chr1,15886185,15886614,SRX5075170,SMARCA4,429
chr1,15886211,15886477,SRX20140869,INTS10,266
chr1,15886241,15886674,SRX5075174,SMARCA4,433
chr1,15886298,15886503,SRX5020214,SMARCA2,205
chr1,15886317,15886580,SRX5716470,SMARCA4,263
chr1,15886319,15886715,SRX5075168,SMARCA4,396
chr1,15886353,15886536,SRX5054309,FOSL2,183
chr1,15886384,15886704,SRX5075175,SMARCA4,320
chr1,15893264,15893476,SRX5716469,SMARCA4,212
chr1,15919264,15919523,SRX5075170,SMARCA4,259
chr1,15919406,15919660,SRX5075169,SMARCA4,254
chr1,15919407,15919710,SRX5054308,FOSL2,303
chr1,15919411,15919667,SRX5716469,SMARCA4,256
chr1,15919428,15919661,SRX5054309,FOSL2,233
chr1,15919431,15919643,SRX5075176,SMARCA4,212
chr1,15919432,15919717,SRX5716470,SMARCA4,285
chr1,15919449,15919691,SRX5075175,SMARCA4,242
chr1,15937654,15937927,SRX5075170,SMARCA4,273
chr1,15937672,15937908,SRX5075176,SMARCA4,236
chr1,15937675,15937888,SRX5054309,FOSL2,213
chr1,15952518,15953114,SRX5075176,SMARCA4,596
chr1,15952766,15953093,SRX5075175,SMARCA4,327
chr1,15952770,15953144,SRX5075169,SMARCA4,374
chr1,15952793,15953131,SRX5054309,FOSL2,338
chr1,15952796,15953140,SRX5054308,FOSL2,344
chr1,15952817,15953090,SRX5075170,SMARCA4,273
chr1,15957463,15957818,SRX16500060,CTCF,355
chr1,15957465,15957810,SRX16500062,CTCF,345
chr1,15957471,15957856,SRX16500059,CTCF,385
chr1,15957510,15957849,SRX16500061,CTCF,339
chr1,15958903,15959078,SRX5075170,SMARCA4,175
chr1,15958927,15959125,SRX5075176,SMARCA4,198
chr1,15965326,15965518,SRX5075176,SMARCA4,192
chr1,15975373,15976279,SRX20140895,INTS13,906
chr1,15975404,15975777,SRX5075168,SMARCA4,373
chr1,15975420,15975901,SRX5075174,SMARCA4,481
chr1,15975475,15975782,SRX5075170,SMARCA4,307
chr1,15975520,15975805,SRX16500059,CTCF,285
chr1,15975614,15976214,SRX20140867,INTS10,600
chr1,15975711,15976140,SRX20140868,INTS10,429
chr1,15975742,15976152,SRX20140869,INTS10,410
chr1,15975766,15976027,SRX20140881,CPSF3L,261
chr1,15975926,15976221,SRX20140897,INTS13,295
chr1,15976108,15976316,SRX5075168,SMARCA4,208
chr1,15994536,15994829,SRX16500059,CTCF,293
chr1,15994551,15994828,SRX16500060,CTCF,277
chr1,15994592,15994849,SRX16500062,CTCF,257
chr1,16008886,16009448,SRX16500061,CTCF,562
chr1,16008913,16009402,SRX16500062,CTCF,489
chr1,16008922,16009439,SRX16500059,CTCF,517
chr1,16008927,16009427,SRX16500060,CTCF,500
chr1,16008992,16009424,SRX4174629,CTCF,432
chr1,16009100,16009331,SRX5075174,SMARCA4,231
chr1,16009112,16009323,SRX5075168,SMARCA4,211
chr1,16012779,16013056,SRX5075176,SMARCA4,277
chr1,16012820,16013041,SRX5716470,SMARCA4,221
chr1,16012833,16013038,SRX5075175,SMARCA4,205
chr1,16012861,16013089,SRX5075170,SMARCA4,228
chr1,16012868,16013050,SRX5075169,SMARCA4,182
chr1,16012897,16013517,SRX5716469,SMARCA4,620
chr1,16013209,16013548,SRX5075169,SMARCA4,339
chr1,16013215,16013573,SRX5054308,FOSL2,358
chr1,16013218,16013578,SRX5075170,SMARCA4,360
chr1,16013226,16013618,SRX5054309,FOSL2,392
chr1,16013262,16013549,SRX5075176,SMARCA4,287
chr1,16013264,16013573,SRX5716470,SMARCA4,309
chr1,16013272,16013574,SRX5075175,SMARCA4,302
chr1,16013273,16013534,SRX5716467,SMARCA2,261
chr1,16013277,16013550,SRX5020211,SMARCA2,273
chr1,16017998,16018281,SRX5716469,SMARCA4,283
chr1,16018010,16018287,SRX5075170,SMARCA4,277
chr1,16018045,16018312,SRX5075175,SMARCA4,267
chr1,16018058,16018307,SRX5075176,SMARCA4,249
chr1,16018072,16018343,SRX5716467,SMARCA2,271
chr1,16018084,16018296,SRX5716468,SMARCA2,212
chr1,16018101,16018378,SRX5075169,SMARCA4,277
chr1,16026676,16026981,SRX5075174,SMARCA4,305
chr1,16026681,16026982,SRX5075168,SMARCA4,301
chr1,16032756,16033275,SRX16500059,CTCF,519
chr1,16032768,16033259,SRX16500060,CTCF,491
chr1,16032778,16033259,SRX16500062,CTCF,481
chr1,16032801,16033280,SRX16500061,CTCF,479
chr1,16032803,16033141,SRX4174629,CTCF,338
chr1,16032819,16033211,SRX5075174,SMARCA4,392
chr1,16032848,16033235,SRX5716463,SMARCA4,387
chr1,16032861,16033186,SRX5075168,SMARCA4,325
chr1,16032868,16033107,SRX5075176,SMARCA4,239
chr1,16032886,16033151,SRX5075170,SMARCA4,265
chr1,16048474,16049010,SRX5075174,SMARCA4,536
chr1,16048567,16049096,SRX5075168,SMARCA4,529
chr1,16048580,16049048,SRX20140895,INTS13,468
chr1,16048680,16049008,SRX20140867,INTS10,328
chr1,16048698,16048959,SRX5716463,SMARCA4,261
chr1,16048848,16049238,SRX16500060,CTCF,390
chr1,16048947,16049201,SRX16500059,CTCF,254
chr1,16048961,16049221,SRX16500061,CTCF,260
chr1,16049006,16049253,SRX16500062,CTCF,247
chr1,16055970,16056488,SRX16500059,CTCF,518
chr1,16055972,16056493,SRX16500060,CTCF,521
chr1,16055974,16056481,SRX16500061,CTCF,507
chr1,16055979,16056500,SRX16500062,CTCF,521
chr1,16056043,16056458,SRX4174629,CTCF,415
chr1,16056086,16056427,SRX5075168,SMARCA4,341
chr1,16056142,16056423,SRX5075175,SMARCA4,281
chr1,16056163,16056399,SRX5075170,SMARCA4,236
chr1,16056170,16056453,SRX5075174,SMARCA4,283
chr1,16056176,16056381,SRX5716464,SMARCA4,205
chr1,16067207,16067611,SRX5075174,SMARCA4,404
chr1,16067228,16067533,SRX5075168,SMARCA4,305
chr1,16073496,16073791,SRX5075174,SMARCA4,295
chr1,16073637,16073830,SRX5075168,SMARCA4,193
chr1,16078847,16079290,SRX16500060,CTCF,443
chr1,16078854,16079305,SRX16500059,CTCF,451
chr1,16078858,16079274,SRX4174629,CTCF,416
chr1,16078864,16079305,SRX16500061,CTCF,441
chr1,16078880,16079287,SRX16500062,CTCF,407
chr1,16078897,16079216,SRX5075168,SMARCA4,319
chr1,16078978,16079195,SRX5075174,SMARCA4,217
chr1,16079009,16079255,SRX5075170,SMARCA4,246
chr1,16082265,16082735,SRX16500059,CTCF,470
chr1,16082293,16082715,SRX16500060,CTCF,422
chr1,16082305,16082690,SRX16500061,CTCF,385
chr1,16082340,16082662,SRX16500062,CTCF,322
chr1,16089086,16089314,SRX5716469,SMARCA4,228
chr1,16111823,16112021,SRX5075169,SMARCA4,198
chr1,16111886,16112105,SRX5075175,SMARCA4,219
chr1,16115845,16116444,SRX5075174,SMARCA4,599
chr1,16115878,16116394,SRX20140895,INTS13,516
chr1,16115922,16116265,SRX20140868,INTS10,343
chr1,16139476,16140012,SRX5075176,SMARCA4,536
chr1,16139493,16139925,SRX5716470,SMARCA4,432
chr1,16139505,16139870,SRX5716467,SMARCA2,365
chr1,16139505,16139971,SRX5075169,SMARCA4,466
chr1,16139510,16139996,SRX5075170,SMARCA4,486
chr1,16139511,16139858,SRX5054308,FOSL2,347
chr1,16139518,16139920,SRX5054309,FOSL2,402
chr1,16139530,16139946,SRX5075175,SMARCA4,416
chr1,16139553,16139951,SRX5716469,SMARCA4,398
chr1,16139559,16139790,SRX5020214,SMARCA2,231
chr1,16139572,16139874,SRX5716468,SMARCA2,302
chr1,16139603,16139819,SRX5075182,SMARCA2,216
chr1,16139610,16139838,SRX5075181,SMARCA2,228
chr1,16139741,16139989,SRX5716459,Epitope tags,248
chr1,16145616,16145933,SRX5075175,SMARCA4,317
chr1,16145618,16145854,SRX5054309,FOSL2,236
chr1,16145620,16145955,SRX5075170,SMARCA4,335
chr1,16145655,16145835,SRX5054308,FOSL2,180
chr1,16145697,16145990,SRX5075169,SMARCA4,293
chr1,16146106,16146641,SRX5075168,SMARCA4,535
chr1,16146132,16146723,SRX5075176,SMARCA4,591
chr1,16146202,16146643,SRX5075170,SMARCA4,441
chr1,16146209,16146724,SRX5075174,SMARCA4,515
chr1,16146223,16146641,SRX5075175,SMARCA4,418
chr1,16146233,16146697,SRX5716470,SMARCA4,464
chr1,16146254,16146602,SRX5716467,SMARCA2,348
chr1,16146258,16146625,SRX5075181,SMARCA2,367
chr1,16146263,16146644,SRX5075169,SMARCA4,381
chr1,16146265,16146596,SRX5716468,SMARCA2,331
chr1,16146275,16146651,SRX5716464,SMARCA4,376
chr1,16146298,16146737,SRX20140867,INTS10,439
chr1,16146305,16146569,SRX5054309,FOSL2,264
chr1,16146325,16146701,SRX5716469,SMARCA4,376
chr1,16146326,16146700,SRX5716463,SMARCA4,374
chr1,16146337,16146516,SRX5075182,SMARCA2,179
chr1,16154528,16155003,SRX16500060,CTCF,475
chr1,16154548,16154995,SRX16500061,CTCF,447
chr1,16154601,16155163,SRX16500059,CTCF,562
chr1,16154638,16155008,SRX16500062,CTCF,370
chr1,16155566,16156287,SRX20140895,INTS13,721
chr1,16155705,16156268,SRX20140867,INTS10,563
chr1,16155740,16156151,SRX20140868,INTS10,411
chr1,16155776,16156167,SRX20140869,INTS10,391
chr1,16155824,16156222,SRX5075170,SMARCA4,398
chr1,16155854,16156344,SRX5075168,SMARCA4,490
chr1,16155859,16156247,SRX20140881,CPSF3L,388
chr1,16155869,16156220,SRX5716470,SMARCA4,351
chr1,16155878,16156369,SRX5075174,SMARCA4,491
chr1,16155888,16156153,SRX20140879,CPSF3L,265
chr1,16155921,16156262,SRX5075176,SMARCA4,341
chr1,16155938,16156177,SRX5075169,SMARCA4,239
chr1,16155972,16156339,SRX5716464,SMARCA4,367
chr1,16155973,16156248,SRX20140897,INTS13,275
chr1,16156011,16156295,SRX5716463,SMARCA4,284
chr1,16156023,16156232,SRX5075175,SMARCA4,209
chr1,16164134,16164606,SRX5075170,SMARCA4,472
chr1,16164150,16164497,SRX5075169,SMARCA4,347
chr1,16164156,16164542,SRX5075174,SMARCA4,386
chr1,16164163,16164501,SRX5075175,SMARCA4,338
chr1,16164166,16164529,SRX5054309,FOSL2,363
chr1,16164170,16164633,SRX5075176,SMARCA4,463
chr1,16164174,16164608,SRX5716469,SMARCA4,434
chr1,16164177,16164547,SRX5054308,FOSL2,370
chr1,16164212,16164500,SRX5075168,SMARCA4,288
chr1,16167326,16168159,SRX20140895,INTS13,833
chr1,16167630,16168113,SRX20140868,INTS10,483
chr1,16167687,16167958,SRX20140896,INTS13,271
chr1,16167717,16168093,SRX20140867,INTS10,376
chr1,16167721,16167956,SRX20140879,CPSF3L,235
chr1,16167817,16168160,SRX5075174,SMARCA4,343
chr1,16167836,16168157,SRX5075168,SMARCA4,321
chr1,16167870,16168075,SRX5716464,SMARCA4,205
chr1,16173515,16173763,SRX5075168,SMARCA4,248
chr1,16173577,16173764,SRX5075175,SMARCA4,187
chr1,16173579,16173810,SRX5075169,SMARCA4,231
chr1,16173586,16173775,SRX5075170,SMARCA4,189
chr1,16174865,16175059,SRX5075174,SMARCA4,194
chr1,16174918,16175238,SRX5075168,SMARCA4,320
chr1,16174953,16175335,SRX20140895,INTS13,382
chr1,16175786,16176302,SRX5075176,SMARCA4,516
chr1,16175790,16176347,SRX5716469,SMARCA4,557
chr1,16175817,16176195,SRX5716459,Epitope tags,378
chr1,16175817,16176265,SRX5075175,SMARCA4,448
chr1,16175818,16176300,SRX5716470,SMARCA4,482
chr1,16175839,16176267,SRX5075170,SMARCA4,428
chr1,16175857,16176266,SRX5075169,SMARCA4,409
chr1,16175868,16176271,SRX5716468,SMARCA2,403
chr1,16175879,16176234,SRX5716467,SMARCA2,355
chr1,16175892,16176245,SRX5054308,FOSL2,353
chr1,16175921,16176246,SRX5020211,SMARCA2,325
chr1,16175945,16176209,SRX5054309,FOSL2,264
chr1,16175953,16176339,SRX5075181,SMARCA2,386
chr1,16175960,16176208,SRX5020214,SMARCA2,248
chr1,16175975,16176272,SRX5075182,SMARCA2,297
chr1,16180367,16180565,SRX5054308,FOSL2,198
chr1,16180387,16180613,SRX5075170,SMARCA4,226
chr1,16180403,16180621,SRX5054309,FOSL2,218
chr1,16180413,16180658,SRX5075174,SMARCA4,245
chr1,16181735,16182294,SRX5075174,SMARCA4,559
chr1,16181784,16182309,SRX5075176,SMARCA4,525
chr1,16181793,16182281,SRX5075168,SMARCA4,488
chr1,16181795,16182248,SRX5075175,SMARCA4,453
chr1,16181795,16182378,SRX5716469,SMARCA4,583
chr1,16181805,16182274,SRX5075169,SMARCA4,469
chr1,16181808,16182268,SRX5716470,SMARCA4,460
chr1,16181817,16182345,SRX5075170,SMARCA4,528
chr1,16181860,16182215,SRX5054308,FOSL2,355
chr1,16181869,16182234,SRX5054309,FOSL2,365
chr1,16181918,16182164,SRX5716463,SMARCA4,246
chr1,16181920,16182171,SRX5054307,FOSL2,251
chr1,16181920,16182232,SRX5716467,SMARCA2,312
chr1,16181938,16182243,SRX5020211,SMARCA2,305
chr1,16181951,16182226,SRX5716464,SMARCA4,275
chr1,16181954,16182231,SRX5020214,SMARCA2,277
chr1,16181957,16182202,SRX5075181,SMARCA2,245
chr1,16181961,16182140,SRX5075182,SMARCA2,179
chr1,16181975,16182254,SRX5716468,SMARCA2,279
chr1,16186188,16186239,SRX1424892,POU3F2,51
chr1,16186190,16186240,SRX1424894,POU3F2,50
chr1,16186191,16186237,SRX1424893,POU3F2,46
chr1,16186193,16186237,SRX1424891,POU3F2,44
chr1,16187656,16187980,SRX5716469,SMARCA4,324
chr1,16187659,16188228,SRX16500059,CTCF,569
chr1,16187673,16188162,SRX16500061,CTCF,489
chr1,16187698,16188186,SRX16500060,CTCF,488
chr1,16187699,16188197,SRX16500062,CTCF,498
chr1,16187715,16188069,SRX4174629,CTCF,354
chr1,16187725,16188013,SRX5075169,SMARCA4,288
chr1,16187728,16188065,SRX5075174,SMARCA4,337
chr1,16187747,16187977,SRX5075175,SMARCA4,230
chr1,16187748,16187999,SRX5716470,SMARCA4,251
chr1,16187759,16187977,SRX5054309,FOSL2,218
chr1,16187769,16188055,SRX5075168,SMARCA4,286
chr1,16187771,16188031,SRX5075176,SMARCA4,260
chr1,16187775,16187996,SRX5020211,SMARCA2,221
chr1,16187784,16188042,SRX5075170,SMARCA4,258
chr1,16204986,16205318,SRX16500061,CTCF,332
chr1,16204993,16205364,SRX16500062,CTCF,371
chr1,16205009,16205380,SRX16500060,CTCF,371
chr1,16205053,16205365,SRX16500059,CTCF,312
chr1,16206398,16206837,SRX5075174,SMARCA4,439
chr1,16206456,16206862,SRX5075168,SMARCA4,406
chr1,16206556,16206848,SRX5716463,SMARCA4,292
chr1,16206569,16206773,SRX5054307,FOSL2,204
chr1,16206617,16207331,SRX20140895,INTS13,714
chr1,16206670,16207341,SRX20140879,CPSF3L,671
chr1,16206683,16207320,SRX20140881,CPSF3L,637
chr1,16206685,16207050,SRX20140867,INTS10,365
chr1,16206702,16206963,SRX5075170,SMARCA4,261
chr1,16206710,16207181,SRX20140868,INTS10,471
chr1,16206798,16207221,SRX5075176,SMARCA4,423
chr1,16206814,16207111,SRX5075175,SMARCA4,297
chr1,16206820,16207188,SRX5716470,SMARCA4,368
chr1,16206821,16207246,SRX20140894,INTS13,425
chr1,16206847,16207217,SRX20140897,INTS13,370
chr1,16206889,16207137,SRX5716469,SMARCA4,248
chr1,16206925,16207265,SRX5075168,SMARCA4,340
chr1,16206942,16207228,SRX5075174,SMARCA4,286
chr1,16206951,16207222,SRX5075169,SMARCA4,271
chr1,16207040,16207232,SRX5075170,SMARCA4,192
chr1,16210110,16210348,SRX5075176,SMARCA4,238
chr1,16210114,16210383,SRX5075170,SMARCA4,269
chr1,16210218,16210398,SRX5075169,SMARCA4,180
chr1,16216280,16216470,SRX5054307,FOSL2,190
chr1,16217005,16217719,SRX5075170,SMARCA4,714
chr1,16217053,16217591,SRX5075176,SMARCA4,538
chr1,16217070,16217262,SRX5075175,SMARCA4,192
chr1,16217385,16217739,SRX5075168,SMARCA4,354
chr1,16217412,16217806,SRX5075174,SMARCA4,394
chr1,16217450,16217656,SRX5716463,SMARCA4,206
chr1,16217489,16217716,SRX5716464,SMARCA4,227
chr1,16226846,16227160,SRX5075168,SMARCA4,314
chr1,16226853,16227221,SRX5075174,SMARCA4,368
chr1,16236212,16236547,SRX16500060,CTCF,335
chr1,16236930,16237512,SRX20140895,INTS13,582
chr1,16236938,16237363,SRX5716469,SMARCA4,425
chr1,16236946,16237436,SRX5075175,SMARCA4,490
chr1,16236947,16237461,SRX5075174,SMARCA4,514
chr1,16236972,16237441,SRX5075169,SMARCA4,469
chr1,16236977,16237387,SRX5075170,SMARCA4,410
chr1,16237002,16237302,SRX20140879,CPSF3L,300
chr1,16237022,16237611,SRX5075176,SMARCA4,589
chr1,16237063,16237367,SRX5716464,SMARCA4,304
chr1,16237064,16237467,SRX5075168,SMARCA4,403
chr1,16237084,16237373,SRX5716463,SMARCA4,289
chr1,16244302,16244808,SRX16500061,CTCF,506
chr1,16244305,16244869,SRX16500060,CTCF,564
chr1,16244321,16244869,SRX16500062,CTCF,548
chr1,16244354,16244797,SRX16500059,CTCF,443
chr1,16244369,16244575,SRX5075174,SMARCA4,206
chr1,16244389,16244670,SRX4174629,CTCF,281
chr1,16244432,16244614,SRX5075170,SMARCA4,182
chr1,16244465,16244663,SRX5075168,SMARCA4,198
chr1,16248769,16249081,SRX5075176,SMARCA4,312
chr1,16248799,16249062,SRX5075170,SMARCA4,263
chr1,16248808,16249130,SRX5716469,SMARCA4,322
chr1,16248812,16249023,SRX5075169,SMARCA4,211
chr1,16248841,16249093,SRX5716470,SMARCA4,252
chr1,16248854,16249041,SRX5075175,SMARCA4,187
chr1,16260905,16261103,SRX5054309,FOSL2,198
chr1,16321192,16321491,SRX5075176,SMARCA4,299
chr1,16321271,16321510,SRX5075169,SMARCA4,239
chr1,16324359,16324767,SRX5716470,SMARCA4,408
chr1,16324362,16324784,SRX5075170,SMARCA4,422
chr1,16324371,16324812,SRX5075176,SMARCA4,441
chr1,16324373,16324800,SRX5075169,SMARCA4,427
chr1,16324382,16324761,SRX5716469,SMARCA4,379
chr1,16324385,16324737,SRX5054309,FOSL2,352
chr1,16324396,16324723,SRX5054308,FOSL2,327
chr1,16324401,16324782,SRX5075175,SMARCA4,381
chr1,16324412,16324716,SRX5716459,Epitope tags,304
chr1,16324448,16324701,SRX5716467,SMARCA2,253
chr1,16324459,16324666,SRX5075174,SMARCA4,207
chr1,16324481,16324741,SRX5716460,Epitope tags,260
chr1,16324509,16324714,SRX5020214,SMARCA2,205
chr1,16324522,16324733,SRX5716468,SMARCA2,211
chr1,16348843,16349145,SRX5716469,SMARCA4,302
chr1,16348870,16349145,SRX5075176,SMARCA4,275
chr1,16348871,16349146,SRX5054308,FOSL2,275
chr1,16348897,16349147,SRX5075170,SMARCA4,250
chr1,16348911,16349152,SRX5054309,FOSL2,241
chr1,16348914,16349141,SRX5075175,SMARCA4,227
chr1,16348915,16349141,SRX5075169,SMARCA4,226
chr1,16352077,16352837,SRX20140895,INTS13,760
chr1,16352138,16352729,SRX20140868,INTS10,591
chr1,16352179,16352679,SRX20140897,INTS13,500
chr1,16352194,16352770,SRX5075174,SMARCA4,576
chr1,16352223,16352524,SRX20140896,INTS13,301
chr1,16352273,16352818,SRX20140867,INTS10,545
chr1,16352319,16352844,SRX16500059,CTCF,525
chr1,16352345,16352792,SRX5716470,SMARCA4,447
chr1,16352361,16352796,SRX16500060,CTCF,435
chr1,16352371,16352741,SRX16500062,CTCF,370
chr1,16352387,16352825,SRX5075168,SMARCA4,438
chr1,16352438,16352769,SRX16500061,CTCF,331
chr1,16352453,16352769,SRX5075170,SMARCA4,316
chr1,16352479,16352808,SRX5075176,SMARCA4,329
chr1,16352485,16352750,SRX5716463,SMARCA4,265
chr1,16352489,16352763,SRX5716464,SMARCA4,274
chr1,16352495,16352760,SRX5716469,SMARCA4,265
chr1,16352499,16352762,SRX5075169,SMARCA4,263
chr1,16363203,16363741,SRX16500060,CTCF,538
chr1,16363258,16363733,SRX16500062,CTCF,475
chr1,16363327,16363735,SRX16500061,CTCF,408
chr1,16363332,16363859,SRX16500059,CTCF,527
chr1,16363371,16363645,SRX5075174,SMARCA4,274
chr1,16363397,16363656,SRX5075170,SMARCA4,259
chr1,16363400,16363652,SRX5075176,SMARCA4,252
chr1,16363448,16363646,SRX5075168,SMARCA4,198
chr1,16366930,16367207,SRX20140869,INTS10,277
chr1,16366936,16367141,SRX5716451,SOX2,205
chr1,16366959,16367390,SRX5075174,SMARCA4,431
chr1,16366962,16367972,SRX20140895,INTS13,1010
chr1,16366991,16367273,SRX5075176,SMARCA4,282
chr1,16366991,16367337,SRX5075168,SMARCA4,346
chr1,16367031,16367322,SRX20140867,INTS10,291
chr1,16367035,16367231,SRX5075170,SMARCA4,196
chr1,16367091,16367443,SRX20140897,INTS13,352
chr1,16367134,16367696,SRX20140868,INTS10,562
chr1,16367178,16367524,SRX20140881,CPSF3L,346
chr1,16367564,16367776,SRX5716469,SMARCA4,212
chr1,16371835,16372102,SRX5054309,FOSL2,267
chr1,16371884,16372098,SRX5075168,SMARCA4,214
chr1,16371889,16372095,SRX5075174,SMARCA4,206
chr1,16371914,16372105,SRX5054307,FOSL2,191
chr1,16375658,16375887,SRX5716470,SMARCA4,229
chr1,16375669,16375890,SRX5075169,SMARCA4,221
chr1,16375671,16375851,SRX5054308,FOSL2,180
chr1,16375671,16375859,SRX5054309,FOSL2,188
chr1,16375679,16375891,SRX5716469,SMARCA4,212
chr1,16375679,16375950,SRX5075175,SMARCA4,271
chr1,16375723,16375956,SRX5075170,SMARCA4,233
chr1,16386442,16386752,SRX5075175,SMARCA4,310
chr1,16386447,16386635,SRX5075170,SMARCA4,188
chr1,16386485,16386724,SRX5075169,SMARCA4,239
chr1,16386528,16386711,SRX5054309,FOSL2,183
chr1,16386727,16387166,SRX5075176,SMARCA4,439
chr1,16386856,16387230,SRX5716470,SMARCA4,374
chr1,16386894,16387191,SRX5075170,SMARCA4,297
chr1,16386915,16387243,SRX5075169,SMARCA4,328
chr1,16387263,16387439,SRX5075176,SMARCA4,176
chr1,16387287,16387456,SRX5075170,SMARCA4,169
chr1,16440275,16440885,SRX16500059,CTCF,610
chr1,16440279,16440840,SRX16500062,CTCF,561
chr1,16440306,16440810,SRX16500060,CTCF,504
chr1,16440321,16440866,SRX16500061,CTCF,545
chr1,16440373,16440677,SRX4174629,CTCF,304
chr1,16440394,16440922,SRX5075174,SMARCA4,528
chr1,16440399,16440824,SRX5075176,SMARCA4,425
chr1,16440404,16440794,SRX5075170,SMARCA4,390
chr1,16440432,16440987,SRX20140895,INTS13,555
chr1,16440448,16440943,SRX5075168,SMARCA4,495
chr1,16440494,16440877,SRX20140868,INTS10,383
chr1,16440503,16440806,SRX20140897,INTS13,303
chr1,16440558,16440768,SRX5075169,SMARCA4,210
chr1,16440572,16440868,SRX20140879,CPSF3L,296
chr1,16440573,16440875,SRX5716469,SMARCA4,302
chr1,16440575,16440917,SRX20140881,CPSF3L,342
chr1,16440598,16440867,SRX20140867,INTS10,269
chr1,16474912,16475193,SRX16500059,CTCF,281
chr1,16474992,16475243,SRX4174629,CTCF,251
chr1,16493032,16493286,SRX5075174,SMARCA4,254
chr1,16493041,16493220,SRX5075168,SMARCA4,179
chr1,16498745,16499799,SRX20140895,INTS13,1054
chr1,16498828,16499203,SRX16500059,CTCF,375
chr1,16498861,16499609,SRX5075168,SMARCA4,748
chr1,16498901,16499548,SRX5075176,SMARCA4,647
chr1,16498910,16499277,SRX5075175,SMARCA4,367
chr1,16498915,16499385,SRX20140868,INTS10,470
chr1,16498995,16499635,SRX5075174,SMARCA4,640
chr1,16498995,16499786,SRX5716470,SMARCA4,791
chr1,16499095,16499343,SRX5716469,SMARCA4,248
chr1,16499125,16499352,SRX20140867,INTS10,227
chr1,16499149,16499505,SRX5075170,SMARCA4,356
chr1,16499181,16499550,SRX5075169,SMARCA4,369
chr1,16499584,16499942,SRX20140867,INTS10,358
chr1,16499649,16499884,SRX20140879,CPSF3L,235
chr1,16499719,16499907,SRX5075170,SMARCA4,188
chr1,16506630,16506832,SRX5716451,SOX2,202
chr1,16506642,16506977,SRX5075174,SMARCA4,335
chr1,16506682,16506967,SRX5075168,SMARCA4,285
chr1,16509208,16509454,SRX16500061,CTCF,246
chr1,16512953,16513191,SRX5075170,SMARCA4,238
chr1,16512983,16513200,SRX5075169,SMARCA4,217
chr1,16513009,16514537,SRX20140895,INTS13,1528
chr1,16513019,16514537,SRX20140867,INTS10,1518
chr1,16513058,16514481,SRX20140894,INTS13,1423
chr1,16513090,16514477,SRX20140881,CPSF3L,1387
chr1,16513147,16514579,SRX20140869,INTS10,1432
chr1,16513157,16514477,SRX20140879,CPSF3L,1320
chr1,16513188,16514528,SRX20140896,INTS13,1340
chr1,16513348,16514574,SRX20140868,INTS10,1226
chr1,16513381,16514463,SRX20140880,CPSF3L,1082
chr1,16513430,16514281,SRX5075176,SMARCA4,851
chr1,16513432,16514508,SRX20140897,INTS13,1076
chr1,16513461,16514146,SRX5075174,SMARCA4,685
chr1,16513467,16514239,SRX5075170,SMARCA4,772
chr1,16513480,16514211,SRX5075168,SMARCA4,731
chr1,16513521,16514489,SRX20140870,INTS10,968
chr1,16513549,16514301,SRX5075175,SMARCA4,752
chr1,16513568,16514140,SRX5075169,SMARCA4,572
chr1,16513594,16514188,SRX5716470,SMARCA4,594
chr1,16513707,16514445,SRX20140860,SOX2,738
chr1,16513719,16514359,SRX5716469,SMARCA4,640
chr1,16513721,16514115,SRX5716463,SMARCA4,394
chr1,16513754,16514137,SRX5020211,SMARCA2,383
chr1,16513800,16514281,SRX5716467,SMARCA2,481
chr1,16513810,16514384,SRX20140861,SOX2,574
chr1,16513848,16514451,SRX20140882,CPSF3L,603
chr1,16513856,16514229,SRX5716468,SMARCA2,373
chr1,16513872,16514175,SRX5716451,SOX2,303
chr1,16513876,16514108,SRX5716454,SOX3,232
chr1,16513883,16514177,SRX5020214,SMARCA2,294
chr1,16513886,16514268,SRX5054309,FOSL2,382
chr1,16513911,16514168,SRX5054308,FOSL2,257
chr1,16514009,16514289,SRX20140892,SOX2,280
chr1,16514163,16514371,SRX20140862,SOX2,208
chr1,16514218,16514818,SRX5075174,SMARCA4,600
chr1,16514243,16514503,SRX5716453,SOX2,260
chr1,16514321,16514680,SRX5716464,SMARCA4,359
chr1,16514347,16514692,SRX5716451,SOX2,345
chr1,16514357,16514670,SRX5716454,SOX3,313
chr1,16514488,16514687,SRX5054307,FOSL2,199
chr1,16514505,16514823,SRX5075168,SMARCA4,318
chr1,16514613,16514788,SRX5075176,SMARCA4,175
chr1,16532629,16532903,SRX16500059,CTCF,274
chr1,16532650,16532988,SRX16500061,CTCF,338
chr1,16532690,16532898,SRX5075174,SMARCA4,208
chr1,16532711,16532933,SRX16500060,CTCF,222
chr1,16532731,16532926,SRX5075168,SMARCA4,195
chr1,16545596,16545923,SRX5054309,FOSL2,327
chr1,16545622,16545913,SRX5054308,FOSL2,291
chr1,16545694,16546025,SRX5075176,SMARCA4,331
chr1,16560676,16560897,SRX5075170,SMARCA4,221
chr1,16573966,16574186,SRX5075168,SMARCA4,220
chr1,16574021,16574241,SRX5075174,SMARCA4,220
chr1,16579064,16579402,SRX16500059,CTCF,338
chr1,16579071,16579406,SRX16500061,CTCF,335
chr1,16579099,16579412,SRX16500062,CTCF,313
chr1,16579117,16579404,SRX16500060,CTCF,287
chr1,16579149,16579401,SRX5075168,SMARCA4,252
chr1,16579194,16579527,SRX4174629,CTCF,333
chr1,16585371,16585704,SRX16500062,CTCF,333
chr1,16585392,16585725,SRX16500059,CTCF,333
chr1,16585424,16585707,SRX16500060,CTCF,283
chr1,16585440,16585660,SRX16500061,CTCF,220
chr1,16585450,16585823,SRX4174629,CTCF,373
chr1,16591700,16592234,SRX16500059,CTCF,534
chr1,16591705,16592148,SRX16500062,CTCF,443
chr1,16591715,16592284,SRX16500061,CTCF,569
chr1,16591739,16592097,SRX5075176,SMARCA4,358
chr1,16591744,16592222,SRX16500060,CTCF,478
chr1,16591813,16592098,SRX5075168,SMARCA4,285
chr1,16591821,16592053,SRX5075170,SMARCA4,232
chr1,16591830,16592088,SRX4174629,CTCF,258
chr1,16591832,16592051,SRX5075175,SMARCA4,219
chr1,16591855,16592082,SRX5075174,SMARCA4,227
chr1,16592600,16592966,SRX5075174,SMARCA4,366
chr1,16592660,16592968,SRX5075168,SMARCA4,308
chr1,16592732,16592960,SRX5716463,SMARCA4,228
chr1,16612479,16614024,SRX5075176,SMARCA4,1545
chr1,16612511,16612876,SRX5075170,SMARCA4,365
chr1,16612514,16612871,SRX5075169,SMARCA4,357
chr1,16612545,16612954,SRX5075175,SMARCA4,409
chr1,16612626,16612910,SRX5716469,SMARCA4,284
chr1,16612977,16614030,SRX5075170,SMARCA4,1053
chr1,16613051,16614030,SRX5716470,SMARCA4,979
chr1,16613101,16614055,SRX5075169,SMARCA4,954
chr1,16613114,16614025,SRX5075175,SMARCA4,911
chr1,16613118,16614123,SRX20140895,INTS13,1005
chr1,16613157,16613794,SRX5716469,SMARCA4,637
chr1,16613228,16614066,SRX5075174,SMARCA4,838
chr1,16613248,16614016,SRX20140867,INTS10,768
chr1,16613257,16614036,SRX5075168,SMARCA4,779
chr1,16613266,16614024,SRX20140868,INTS10,758
chr1,16613270,16613516,SRX5716467,SMARCA2,246
chr1,16613270,16613903,SRX20140897,INTS13,633
chr1,16613297,16613546,SRX5020211,SMARCA2,249
chr1,16613353,16613942,SRX5716464,SMARCA4,589
chr1,16613370,16614004,SRX5716463,SMARCA4,634
chr1,16613378,16613667,SRX5075181,SMARCA2,289
chr1,16613391,16614109,SRX20140879,CPSF3L,718
chr1,16613448,16613803,SRX20140896,INTS13,355
chr1,16613467,16613861,SRX5716451,SOX2,394
chr1,16613609,16613799,SRX5054307,FOSL2,190
chr1,16613645,16614070,SRX20140894,INTS13,425
chr1,16613653,16614073,SRX20140881,CPSF3L,420
chr1,16613659,16614087,SRX20140869,INTS10,428
chr1,16620545,16621228,SRX20140895,INTS13,683
chr1,16620549,16621014,SRX20140868,INTS10,465
chr1,16620741,16621027,SRX20140879,CPSF3L,286
chr1,16620968,16621322,SRX5054309,FOSL2,354
chr1,16620977,16621226,SRX5716469,SMARCA4,249
chr1,16620979,16621497,SRX16500060,CTCF,518
chr1,16620983,16621322,SRX5075168,SMARCA4,339
chr1,16620985,16621474,SRX16500059,CTCF,489
chr1,16620989,16621284,SRX5054308,FOSL2,295
chr1,16620994,16621493,SRX16500062,CTCF,499
chr1,16620994,16621502,SRX16500061,CTCF,508
chr1,16620999,16621244,SRX5054307,FOSL2,245
chr1,16621002,16621322,SRX5075176,SMARCA4,320
chr1,16621004,16621354,SRX5716470,SMARCA4,350
chr1,16621009,16621360,SRX5075174,SMARCA4,351
chr1,16621012,16621408,SRX4174629,CTCF,396
chr1,16621013,16621295,SRX5075169,SMARCA4,282
chr1,16621026,16621300,SRX5075170,SMARCA4,274
chr1,16621057,16621302,SRX5716463,SMARCA4,245
chr1,16621065,16621280,SRX5075175,SMARCA4,215
chr1,16621076,16621286,SRX5716464,SMARCA4,210
chr1,16624820,16625347,SRX16500061,CTCF,527
chr1,16624837,16625367,SRX16500059,CTCF,530
chr1,16624841,16625350,SRX16500060,CTCF,509
chr1,16624867,16625326,SRX16500062,CTCF,459
chr1,16624912,16625298,SRX4174629,CTCF,386
chr1,16624978,16625180,SRX5075174,SMARCA4,202
chr1,16644286,16645016,SRX5716470,SMARCA4,730
chr1,16644327,16645003,SRX5075168,SMARCA4,676
chr1,16644327,16645017,SRX5075176,SMARCA4,690
chr1,16644330,16645053,SRX5075169,SMARCA4,723
chr1,16644331,16645011,SRX5075174,SMARCA4,680
chr1,16644352,16645079,SRX5075175,SMARCA4,727
chr1,16644368,16645144,SRX20140895,INTS13,776
chr1,16644386,16645017,SRX5716469,SMARCA4,631
chr1,16644416,16645019,SRX20140879,CPSF3L,603
chr1,16644424,16645020,SRX5075170,SMARCA4,596
chr1,16644429,16645170,SRX20140868,INTS10,741
chr1,16644467,16644978,SRX5716460,Epitope tags,511
chr1,16644483,16645000,SRX5716463,SMARCA4,517
chr1,16644490,16645013,SRX20140897,INTS13,523
chr1,16644493,16645003,SRX20140867,INTS10,510
chr1,16644521,16644959,SRX5716464,SMARCA4,438
chr1,16644521,16645223,SRX20140869,INTS10,702
chr1,16644526,16645020,SRX20140894,INTS13,494
chr1,16644535,16644864,SRX5075181,SMARCA2,329
chr1,16644550,16644973,SRX5716467,SMARCA2,423
chr1,16644559,16644835,SRX5020211,SMARCA2,276
chr1,16644569,16644984,SRX5716451,SOX2,415
chr1,16644574,16644784,SRX5054307,FOSL2,210
chr1,16644575,16645048,SRX16500060,CTCF,473
chr1,16644602,16645182,SRX16500059,CTCF,580
chr1,16644609,16644889,SRX5054309,FOSL2,280
chr1,16644615,16645002,SRX16500061,CTCF,387
chr1,16644617,16644850,SRX5716454,SOX3,233
chr1,16644625,16644995,SRX16500062,CTCF,370
chr1,16644642,16644955,SRX20140896,INTS13,313
chr1,16644661,16644841,SRX5054308,FOSL2,180
chr1,16651651,16651872,SRX16500060,CTCF,221
chr1,16656555,16656777,SRX16500061,CTCF,222
chr1,16656560,16657104,SRX16500059,CTCF,544
chr1,16656852,16657069,SRX16500062,CTCF,217
chr1,16658334,16658581,SRX16500061,CTCF,247
chr1,16658430,16658695,SRX5075168,SMARCA4,265
chr1,16658525,16658741,SRX5054309,FOSL2,216
chr1,16658536,16658757,SRX5054308,FOSL2,221
chr1,16658871,16659492,SRX20140895,INTS13,621
chr1,16658948,16659447,SRX5075168,SMARCA4,499
chr1,16658960,16659479,SRX20140868,INTS10,519
chr1,16659029,16659510,SRX5075174,SMARCA4,481
chr1,16659051,16659403,SRX20140879,CPSF3L,352
chr1,16659072,16659398,SRX20140894,INTS13,326
chr1,16659118,16659500,SRX5716463,SMARCA4,382
chr1,16659138,16659481,SRX20140867,INTS10,343
chr1,16659139,16659405,SRX20140861,SOX2,266
chr1,16659142,16659396,SRX5716451,SOX2,254
chr1,16659192,16659499,SRX5716454,SOX3,307
chr1,16665768,16667377,SRX20140895,INTS13,1609
chr1,16665905,16667384,SRX20140869,INTS10,1479
chr1,16665967,16667218,SRX20140867,INTS10,1251
chr1,16665992,16667193,SRX20140881,CPSF3L,1201
chr1,16666021,16667182,SRX20140879,CPSF3L,1161
chr1,16666022,16667206,SRX20140896,INTS13,1184
chr1,16666083,16667161,SRX20140894,INTS13,1078
chr1,16666108,16667351,SRX20140868,INTS10,1243
chr1,16666114,16667212,SRX20140897,INTS13,1098
chr1,16666148,16667167,SRX20140880,CPSF3L,1019
chr1,16666178,16666916,SRX5075170,SMARCA4,738
chr1,16666220,16667196,SRX20140870,INTS10,976
chr1,16666300,16667167,SRX20140882,CPSF3L,867
chr1,16666318,16666885,SRX5075176,SMARCA4,567
chr1,16666367,16666554,SRX5075175,SMARCA4,187
chr1,16666373,16666875,SRX5075169,SMARCA4,502
chr1,16666393,16666944,SRX5075168,SMARCA4,551
chr1,16666396,16666683,SRX5075174,SMARCA4,287
chr1,16666483,16666985,SRX5716469,SMARCA4,502
chr1,16666494,16666695,SRX5716451,SOX2,201
chr1,16666602,16667154,SRX20140860,SOX2,552
chr1,16666622,16666882,SRX5716470,SMARCA4,260
chr1,16666634,16666897,SRX5716467,SMARCA2,263
chr1,16666704,16666972,SRX20140890,SOX2,268
chr1,16666757,16667002,SRX5075175,SMARCA4,245
chr1,16666768,16667035,SRX20140862,SOX2,267
chr1,16666778,16667008,SRX20140892,SOX2,230
chr1,16666937,16667458,SRX5716463,SMARCA4,521
chr1,16666989,16667329,SRX5716454,SOX3,340
chr1,16667006,16667420,SRX5716451,SOX2,414
chr1,16667009,16667444,SRX5075170,SMARCA4,435
chr1,16667011,16667477,SRX5075174,SMARCA4,466
chr1,16667089,16667323,SRX5054307,FOSL2,234
chr1,16667091,16667477,SRX5075168,SMARCA4,386
chr1,16667099,16667461,SRX5075176,SMARCA4,362
chr1,16667228,16667433,SRX5716464,SMARCA4,205
chr1,16667231,16667487,SRX5075175,SMARCA4,256
chr1,16667274,16667501,SRX5716470,SMARCA4,227
chr1,16667276,16667488,SRX5716469,SMARCA4,212
chr1,16667284,16667464,SRX5075169,SMARCA4,180
chr1,16684645,16685194,SRX16500061,CTCF,549
chr1,16684667,16685186,SRX16500060,CTCF,519
chr1,16684691,16685205,SRX16500059,CTCF,514
chr1,16684712,16685144,SRX16500062,CTCF,432
chr1,16684826,16685108,SRX5075176,SMARCA4,282
chr1,16684836,16685042,SRX5075174,SMARCA4,206
chr1,16703167,16703492,SRX16500060,CTCF,325
chr1,16703180,16703498,SRX16500061,CTCF,318
chr1,16703205,16703546,SRX16500059,CTCF,341
chr1,16703214,16703483,SRX16500062,CTCF,269
chr1,16703250,16703493,SRX4174629,CTCF,243
chr1,16707434,16707622,SRX5075174,SMARCA4,188
chr1,16709686,16710158,SRX16500060,CTCF,472
chr1,16709706,16710219,SRX16500059,CTCF,513
chr1,16709734,16710171,SRX16500061,CTCF,437
chr1,16709746,16710171,SRX4174629,CTCF,425
chr1,16709759,16710152,SRX16500062,CTCF,393
chr1,16712464,16712844,SRX20140879,CPSF3L,380
chr1,16712538,16712798,SRX20140894,INTS13,260
chr1,16739975,16740283,SRX5075176,SMARCA4,308
chr1,16739976,16740404,SRX5075168,SMARCA4,428
chr1,16739976,16740498,SRX5075174,SMARCA4,522
chr1,16739993,16740372,SRX5716464,SMARCA4,379
chr1,16740002,16740434,SRX5075170,SMARCA4,432
chr1,16740017,16740287,SRX5716470,SMARCA4,270
chr1,16740031,16740368,SRX5716463,SMARCA4,337
chr1,16740069,16740464,SRX5716451,SOX2,395
chr1,16740080,16741730,SRX20140895,INTS13,1650
chr1,16740092,16740490,SRX5716454,SOX3,398
chr1,16740131,16740342,SRX5054307,FOSL2,211
chr1,16740158,16741318,SRX20140868,INTS10,1160
chr1,16740196,16741438,SRX20140869,INTS10,1242
chr1,16740220,16741417,SRX20140867,INTS10,1197
chr1,16740233,16741350,SRX20140897,INTS13,1117
chr1,16740234,16741490,SRX20140896,INTS13,1256
chr1,16740257,16741409,SRX20140879,CPSF3L,1152
chr1,16740261,16741163,SRX20140882,CPSF3L,902
chr1,16740266,16741510,SRX20140881,CPSF3L,1244
chr1,16740274,16741224,SRX20140870,INTS10,950
chr1,16740288,16741393,SRX20140894,INTS13,1105
chr1,16740318,16741257,SRX20140880,CPSF3L,939
chr1,16740347,16740646,SRX20140862,SOX2,299
chr1,16740367,16740587,SRX5075175,SMARCA4,220
chr1,16740409,16741062,SRX20140860,SOX2,653
chr1,16740415,16741285,SRX5075176,SMARCA4,870
chr1,16740428,16740740,SRX5075169,SMARCA4,312
chr1,16740430,16740713,SRX5716464,SMARCA4,283
chr1,16740436,16740809,SRX5716467,SMARCA2,373
chr1,16740530,16740809,SRX5716470,SMARCA4,279
chr1,16740537,16740724,SRX5075170,SMARCA4,187
chr1,16740562,16741032,SRX5716469,SMARCA4,470
chr1,16740601,16740787,SRX5075174,SMARCA4,186
chr1,16740614,16741044,SRX5075168,SMARCA4,430
chr1,16740645,16741000,SRX5716451,SOX2,355
chr1,16740742,16741005,SRX5054309,FOSL2,263
chr1,16740771,16740976,SRX5716464,SMARCA4,205
chr1,16740794,16741191,SRX5075170,SMARCA4,397
chr1,16740795,16741244,SRX5075169,SMARCA4,449
chr1,16740893,16741085,SRX5075175,SMARCA4,192
chr1,16740901,16741189,SRX5716470,SMARCA4,288
chr1,16747843,16748567,SRX5075174,SMARCA4,724
chr1,16747924,16748296,SRX5716463,SMARCA4,372
chr1,16747936,16748656,SRX20140895,INTS13,720
chr1,16747946,16748441,SRX5075168,SMARCA4,495
chr1,16747966,16748286,SRX5716454,SOX3,320
chr1,16747967,16748350,SRX20140867,INTS10,383
chr1,16747996,16748255,SRX20140860,SOX2,259
chr1,16747996,16748487,SRX20140868,INTS10,491
chr1,16748035,16748300,SRX5716451,SOX2,265
chr1,16748053,16748344,SRX20140879,CPSF3L,291
chr1,16748224,16748523,SRX20140894,INTS13,299
chr1,16748715,16748914,SRX5054308,FOSL2,199
chr1,16748735,16748915,SRX5075169,SMARCA4,180
chr1,16748745,16748930,SRX5054309,FOSL2,185
chr1,16748767,16749025,SRX5075174,SMARCA4,258
chr1,16750388,16750877,SRX16500060,CTCF,489
chr1,16750394,16750869,SRX16500062,CTCF,475
chr1,16750483,16750869,SRX16500059,CTCF,386
chr1,16750502,16750838,SRX16500061,CTCF,336
chr1,16750611,16750886,SRX9989504,GFP,275
chr1,16770273,16770710,SRX5075175,SMARCA4,437
chr1,16770280,16770711,SRX5075176,SMARCA4,431
chr1,16770294,16770675,SRX5716469,SMARCA4,381
chr1,16770308,16770659,SRX5054309,FOSL2,351
chr1,16770319,16770668,SRX5075169,SMARCA4,349
chr1,16770323,16770706,SRX5075170,SMARCA4,383
chr1,16770335,16770616,SRX5054308,FOSL2,281
chr1,16770373,16770662,SRX5716467,SMARCA2,289
chr1,16770374,16770638,SRX5020214,SMARCA2,264
chr1,16770378,16770621,SRX5716470,SMARCA4,243
chr1,16770409,16770692,SRX5716459,Epitope tags,283
chr1,16796478,16796833,SRX20140895,INTS13,355
chr1,16796567,16796911,SRX5716470,SMARCA4,344
chr1,16859230,16859454,SRX16500060,CTCF,224
chr1,16859241,16859493,SRX16500059,CTCF,252
chr1,16859371,16859642,SRX5716463,SMARCA4,271
chr1,16859374,16859598,SRX5075174,SMARCA4,224
chr1,16859387,16859576,SRX5075168,SMARCA4,189
chr1,16859396,16859636,SRX5716464,SMARCA4,240
chr1,16861937,16862245,SRX5075176,SMARCA4,308
chr1,16861969,16862251,SRX5075170,SMARCA4,282
chr1,16861979,16862355,SRX5054309,FOSL2,376
chr1,16862087,16862322,SRX5054308,FOSL2,235
chr1,16875003,16875224,SRX16500060,CTCF,221
chr1,16875023,16875220,SRX5075174,SMARCA4,197
chr1,16882922,16883421,SRX5075170,SMARCA4,499
chr1,16882930,16883307,SRX5075174,SMARCA4,377
chr1,16882957,16883483,SRX5075176,SMARCA4,526
chr1,16883022,16883344,SRX5075168,SMARCA4,322
chr1,16883140,16883361,SRX5075169,SMARCA4,221
chr1,16883159,16883389,SRX5716470,SMARCA4,230
chr1,16895434,16895780,SRX5075168,SMARCA4,346
chr1,16895517,16895817,SRX5075174,SMARCA4,300
chr1,16895654,16895923,SRX5716451,SOX2,269
chr1,16895739,16897175,SRX20140895,INTS13,1436
chr1,16895758,16897182,SRX20140869,INTS10,1424
chr1,16895759,16896852,SRX20140868,INTS10,1093
chr1,16895762,16896915,SRX20140867,INTS10,1153
chr1,16895771,16896912,SRX20140896,INTS13,1141
chr1,16895772,16896803,SRX20140897,INTS13,1031
chr1,16895785,16897035,SRX20140881,CPSF3L,1250
chr1,16895792,16896955,SRX20140879,CPSF3L,1163
chr1,16895804,16896990,SRX20140894,INTS13,1186
chr1,16895822,16896887,SRX20140880,CPSF3L,1065
chr1,16895834,16896700,SRX20140870,INTS10,866
chr1,16895840,16896649,SRX20140882,CPSF3L,809
chr1,16895858,16896522,SRX20140860,SOX2,664
chr1,16895891,16896718,SRX5075174,SMARCA4,827
chr1,16895896,16896715,SRX5075170,SMARCA4,819
chr1,16895929,16896711,SRX5075176,SMARCA4,782
chr1,16895931,16896145,SRX20140892,SOX2,214
chr1,16895961,16896260,SRX20140862,SOX2,299
chr1,16895994,16896723,SRX5075175,SMARCA4,729
chr1,16896005,16896665,SRX5716469,SMARCA4,660
chr1,16896006,16896611,SRX5716467,SMARCA2,605
chr1,16896042,16896514,SRX20140861,SOX2,472
chr1,16896050,16896690,SRX5716470,SMARCA4,640
chr1,16896160,16896409,SRX5716454,SOX3,249
chr1,16896187,16896512,SRX5716464,SMARCA4,325
chr1,16896190,16896532,SRX5716451,SOX2,342
chr1,16896218,16896681,SRX5020211,SMARCA2,463
chr1,16896231,16896775,SRX5075169,SMARCA4,544
chr1,16896271,16896476,SRX5075181,SMARCA2,205
chr1,16896273,16896713,SRX5075168,SMARCA4,440
chr1,16896302,16896552,SRX5716453,SOX2,250
chr1,16896332,16896682,SRX5054309,FOSL2,350
chr1,16900868,16901126,SRX16500060,CTCF,258
chr1,16904670,16905982,SRX20140895,INTS13,1312
chr1,16904683,16904876,SRX5075176,SMARCA4,193
chr1,16904709,16904887,SRX5075174,SMARCA4,178
chr1,16904729,16904915,SRX5075168,SMARCA4,186
chr1,16904731,16904901,SRX5075170,SMARCA4,170
chr1,16904818,16905037,SRX5054307,FOSL2,219
chr1,16904872,16905877,SRX20140868,INTS10,1005
chr1,16904919,16905849,SRX20140869,INTS10,930
chr1,16904922,16905931,SRX20140867,INTS10,1009
chr1,16904932,16905904,SRX20140881,CPSF3L,972
chr1,16904953,16905732,SRX20140897,INTS13,779
chr1,16904977,16905794,SRX20140894,INTS13,817
chr1,16904977,16905916,SRX20140879,CPSF3L,939
chr1,16904978,16905856,SRX20140896,INTS13,878
chr1,16905010,16905858,SRX20140880,CPSF3L,848
chr1,16905245,16905554,SRX20140882,CPSF3L,309
chr1,16905304,16905484,SRX5075170,SMARCA4,180
chr1,16905336,16905587,SRX5075169,SMARCA4,251
chr1,16905420,16905749,SRX5075174,SMARCA4,329
chr1,16905461,16905696,SRX5716451,SOX2,235
chr1,16909860,16910136,SRX16500060,CTCF,276
chr1,16909901,16910157,SRX4174629,CTCF,256
chr1,16913687,16914660,SRX20140895,INTS13,973
chr1,16913703,16914431,SRX5075169,SMARCA4,728
chr1,16913730,16914395,SRX5075174,SMARCA4,665
chr1,16913761,16914269,SRX5075170,SMARCA4,508
chr1,16913761,16914378,SRX5075168,SMARCA4,617
chr1,16913821,16914394,SRX5075176,SMARCA4,573
chr1,16913837,16914551,SRX5075175,SMARCA4,714
chr1,16913897,16914180,SRX5716464,SMARCA4,283
chr1,16914029,16914337,SRX5716470,SMARCA4,308
chr1,16914101,16914314,SRX5716463,SMARCA4,213
chr1,16914132,16914572,SRX20140867,INTS10,440
chr1,16914190,16914451,SRX20140868,INTS10,261
chr1,16921621,16922121,SRX20140895,INTS13,500
chr1,16921644,16921831,SRX5075175,SMARCA4,187
chr1,16921734,16921946,SRX5075174,SMARCA4,212
chr1,16926579,16927181,SRX5075174,SMARCA4,602
chr1,16926606,16927105,SRX5075168,SMARCA4,499
chr1,16926620,16927024,SRX5716463,SMARCA4,404
chr1,16926644,16926928,SRX5075170,SMARCA4,284
chr1,16926668,16926973,SRX20140867,INTS10,305
chr1,16926680,16926993,SRX5716451,SOX2,313
chr1,16926700,16926957,SRX5716464,SMARCA4,257
chr1,16926709,16927003,SRX20140895,INTS13,294
chr1,16926719,16927001,SRX5716454,SOX3,282
chr1,16926763,16927113,SRX20140894,INTS13,350
chr1,16947476,16947782,SRX4174629,CTCF,306
chr1,16947487,16947788,SRX16500059,CTCF,301
chr1,16947494,16947771,SRX16500060,CTCF,277
chr1,16947503,16947841,SRX16500062,CTCF,338
chr1,16947506,16947767,SRX16500061,CTCF,261
chr1,16951614,16952066,SRX16500061,CTCF,452
chr1,16951619,16952083,SRX16500062,CTCF,464
chr1,16951629,16952120,SRX16500059,CTCF,491
chr1,16951637,16952075,SRX16500060,CTCF,438
chr1,16951674,16952039,SRX5075175,SMARCA4,365
chr1,16951679,16952075,SRX5075168,SMARCA4,396
chr1,16951699,16952021,SRX5075174,SMARCA4,322
chr1,16951701,16951939,SRX4174629,CTCF,238
chr1,16951704,16952043,SRX5075170,SMARCA4,339
chr1,16951716,16951977,SRX5716464,SMARCA4,261
chr1,16951721,16952066,SRX5075169,SMARCA4,345
chr1,16951728,16952062,SRX5075176,SMARCA4,334
chr1,16951765,16952011,SRX5716463,SMARCA4,246
chr1,16951783,16952064,SRX5716470,SMARCA4,281
chr1,16960568,16960981,SRX16500060,CTCF,413
chr1,16960605,16960941,SRX16500061,CTCF,336
chr1,16960616,16961030,SRX5075169,SMARCA4,414
chr1,16960618,16960940,SRX16500062,CTCF,322
chr1,16960619,16960981,SRX16500059,CTCF,362
chr1,16960638,16961058,SRX5075176,SMARCA4,420
chr1,16960651,16961010,SRX5075175,SMARCA4,359
chr1,16960680,16961025,SRX5075168,SMARCA4,345
chr1,16960692,16960975,SRX5075174,SMARCA4,283
chr1,16960698,16960959,SRX20140868,INTS10,261
chr1,16960701,16961003,SRX5075170,SMARCA4,302
chr1,16960733,16961093,SRX20140895,INTS13,360
chr1,16963435,16963847,SRX16500059,CTCF,412
chr1,16963491,16963821,SRX16500061,CTCF,330
chr1,16963504,16963884,SRX16500060,CTCF,380
chr1,16963513,16963901,SRX16500062,CTCF,388
chr1,16967242,16967568,SRX5020211,SMARCA2,326
chr1,16967266,16967676,SRX5075169,SMARCA4,410
chr1,16967268,16967581,SRX5020214,SMARCA2,313
chr1,16967297,16967649,SRX5075170,SMARCA4,352
chr1,16967298,16967664,SRX5716469,SMARCA4,366
chr1,16967302,16967627,SRX5075176,SMARCA4,325
chr1,16967305,16967710,SRX5716470,SMARCA4,405
chr1,16967318,16967660,SRX5075175,SMARCA4,342
chr1,16967326,16967709,SRX5716468,SMARCA2,383
chr1,16967360,16967632,SRX5716467,SMARCA2,272
chr1,16967366,16967626,SRX5075181,SMARCA2,260
chr1,16978735,16978983,SRX5075176,SMARCA4,248
chr1,16978776,16978945,SRX5075170,SMARCA4,169
chr1,16980576,16980832,SRX20140895,INTS13,256
chr1,16984639,16985167,SRX5075170,SMARCA4,528
chr1,16984668,16985100,SRX5075169,SMARCA4,432
chr1,16984677,16985140,SRX5075176,SMARCA4,463
chr1,16984773,16984962,SRX5054308,FOSL2,189
chr1,16984790,16985053,SRX5716469,SMARCA4,263
chr1,16984800,16985133,SRX5075175,SMARCA4,333
chr1,16984811,16985054,SRX5054309,FOSL2,243
chr1,16984826,16985095,SRX5716470,SMARCA4,269
chr1,16984835,16985060,SRX5716467,SMARCA2,225
chr1,16986970,16987375,SRX16500060,CTCF,405
chr1,16987025,16987282,SRX16500062,CTCF,257
chr1,16987034,16987307,SRX16500059,CTCF,273
chr1,16987049,16987354,SRX16500061,CTCF,305
chr1,17011755,17012038,SRX5075168,SMARCA4,283
chr1,17011867,17012128,SRX5075174,SMARCA4,261
chr1,17016047,17016403,SRX5716470,SMARCA4,356
chr1,17016329,17016604,SRX5054309,FOSL2,275
chr1,17016335,17016660,SRX5075170,SMARCA4,325
chr1,17016343,17016674,SRX5075176,SMARCA4,331
chr1,17016357,17016646,SRX5075169,SMARCA4,289
chr1,17016359,17016629,SRX5054308,FOSL2,270
chr1,17016386,17016619,SRX5716469,SMARCA4,233
chr1,17016389,17016680,SRX5075175,SMARCA4,291
chr1,17045961,17046521,SRX16500062,CTCF,560
chr1,17045975,17046526,SRX16500061,CTCF,551
chr1,17045990,17046532,SRX16500060,CTCF,542
chr1,17046028,17046546,SRX16500059,CTCF,518
chr1,17046057,17046332,SRX4174629,CTCF,275
chr1,17046108,17046388,SRX5075176,SMARCA4,280
chr1,17046124,17046410,SRX5075168,SMARCA4,286
chr1,17046150,17046354,SRX5075175,SMARCA4,204
chr1,17046151,17046337,SRX5075174,SMARCA4,186
chr1,17046161,17046372,SRX5075169,SMARCA4,211
chr1,17046215,17046413,SRX5075170,SMARCA4,198
chr1,17053802,17054138,SRX20140869,INTS10,336
chr1,17053808,17054468,SRX20140895,INTS13,660
chr1,17053826,17054444,SRX5075174,SMARCA4,618
chr1,17053826,17054451,SRX5075170,SMARCA4,625
chr1,17053853,17054221,SRX20140879,CPSF3L,368
chr1,17053855,17054283,SRX20140897,INTS13,428
chr1,17053860,17054260,SRX5075169,SMARCA4,400
chr1,17053868,17054230,SRX20140881,CPSF3L,362
chr1,17053879,17054464,SRX5075168,SMARCA4,585
chr1,17053893,17054232,SRX20140867,INTS10,339
chr1,17053930,17054398,SRX5075176,SMARCA4,468
chr1,17053933,17054307,SRX20140868,INTS10,374
chr1,17054002,17054422,SRX5716464,SMARCA4,420
chr1,17054029,17054234,SRX5716454,SOX3,205
chr1,17054032,17054305,SRX5054307,FOSL2,273
chr1,17054044,17054427,SRX5716463,SMARCA4,383
chr1,17054076,17054432,SRX5716470,SMARCA4,356
chr1,17054154,17054344,SRX5716451,SOX2,190
chr1,17059527,17060085,SRX16500059,CTCF,558
chr1,17059627,17060096,SRX16500060,CTCF,469
chr1,17059656,17060117,SRX16500062,CTCF,461
chr1,17059671,17060041,SRX4174629,CTCF,370
chr1,17059671,17060100,SRX16500061,CTCF,429
chr1,17059762,17059960,SRX5075174,SMARCA4,198
chr1,17059815,17059984,SRX5075170,SMARCA4,169
chr1,17060503,17060778,SRX5075168,SMARCA4,275
chr1,17060526,17060723,SRX5075174,SMARCA4,197
chr1,17063496,17063806,SRX5054308,FOSL2,310
chr1,17063517,17063818,SRX5054309,FOSL2,301
chr1,17063573,17063817,SRX5716469,SMARCA4,244
chr1,17063609,17063852,SRX5075175,SMARCA4,243
chr1,17063623,17063918,SRX5075169,SMARCA4,295
chr1,17075224,17075822,SRX16500060,CTCF,598
chr1,17075365,17075848,SRX16500059,CTCF,483
chr1,17075374,17075759,SRX16500062,CTCF,385
chr1,17075400,17075818,SRX16500061,CTCF,418
chr1,17119295,17119597,SRX5075174,SMARCA4,302
chr1,17119374,17119570,SRX5075168,SMARCA4,196
chr1,17121355,17121538,SRX5075169,SMARCA4,183
chr1,17121414,17121605,SRX5075170,SMARCA4,191
chr1,17121986,17122161,SRX5075176,SMARCA4,175
chr1,17125636,17126184,SRX16500059,CTCF,548
chr1,17125663,17126147,SRX16500061,CTCF,484
chr1,17125681,17126190,SRX16500060,CTCF,509
chr1,17125724,17126122,SRX16500062,CTCF,398
chr1,17125814,17126129,SRX4174629,CTCF,315
chr1,17128260,17128867,SRX5075174,SMARCA4,607
chr1,17128266,17128953,SRX5075168,SMARCA4,687
chr1,17128285,17128772,SRX5054309,FOSL2,487
chr1,17128297,17128836,SRX5075169,SMARCA4,539
chr1,17128316,17128808,SRX5075176,SMARCA4,492
chr1,17128324,17128776,SRX5075175,SMARCA4,452
chr1,17128331,17128730,SRX5716460,Epitope tags,399
chr1,17128343,17128817,SRX5075170,SMARCA4,474
chr1,17128345,17128752,SRX5716469,SMARCA4,407
chr1,17128353,17128688,SRX5054308,FOSL2,335
chr1,17128353,17128781,SRX5716470,SMARCA4,428
chr1,17128384,17128660,SRX5716467,SMARCA2,276
chr1,17128401,17128681,SRX5716464,SMARCA4,280
chr1,17128405,17128708,SRX5054307,FOSL2,303
chr1,17128441,17128791,SRX5716463,SMARCA4,350
chr1,17128446,17128695,SRX5716468,SMARCA2,249
chr1,17128456,17128724,SRX5020214,SMARCA2,268
chr1,17168083,17168353,SRX5075175,SMARCA4,270
chr1,17168298,17168805,SRX5075176,SMARCA4,507
chr1,17168375,17168850,SRX5716470,SMARCA4,475
chr1,17168405,17168907,SRX5075169,SMARCA4,502
chr1,17168537,17168871,SRX5075170,SMARCA4,334
chr1,17168563,17168840,SRX5054309,FOSL2,277
chr1,17168573,17168785,SRX5716469,SMARCA4,212
chr1,17168649,17168876,SRX5075175,SMARCA4,227
chr1,17189924,17190285,SRX5716470,SMARCA4,361
chr1,17189925,17190293,SRX5075176,SMARCA4,368
chr1,17189937,17190271,SRX5075175,SMARCA4,334
chr1,17189938,17190312,SRX5075170,SMARCA4,374
chr1,17189941,17190295,SRX5075169,SMARCA4,354
chr1,17190023,17190237,SRX5054309,FOSL2,214
chr1,17190028,17190287,SRX5716469,SMARCA4,259
chr1,17190032,17190253,SRX5716467,SMARCA2,221
chr1,17192448,17192776,SRX5075168,SMARCA4,328
chr1,17192468,17192727,SRX5075174,SMARCA4,259
chr1,17208074,17208320,SRX5075169,SMARCA4,246
chr1,17208116,17208362,SRX5054308,FOSL2,246
chr1,17208139,17208328,SRX5075170,SMARCA4,189
chr1,17208154,17208400,SRX5054309,FOSL2,246
chr1,17212769,17213079,SRX5075169,SMARCA4,310
chr1,17212802,17213127,SRX5075170,SMARCA4,325
chr1,17212811,17213101,SRX5716470,SMARCA4,290
chr1,17212860,17213167,SRX5075176,SMARCA4,307
chr1,17226525,17226750,SRX5075175,SMARCA4,225
chr1,17226526,17226728,SRX5075169,SMARCA4,202
chr1,17226567,17226750,SRX5054309,FOSL2,183
chr1,17233077,17233349,SRX5075169,SMARCA4,272
chr1,17236943,17237490,SRX16500061,CTCF,547
chr1,17236955,17237478,SRX16500062,CTCF,523
chr1,17236961,17237478,SRX16500059,CTCF,517
chr1,17236963,17237238,SRX5075170,SMARCA4,275
chr1,17236963,17237532,SRX16500060,CTCF,569
chr1,17237019,17237340,SRX4174629,CTCF,321
chr1,17237061,17237278,SRX5075174,SMARCA4,217
chr1,17237071,17237253,SRX5075176,SMARCA4,182
chr1,17237086,17237371,SRX5075168,SMARCA4,285
chr1,17245226,17245445,SRX5075174,SMARCA4,219
chr1,17245256,17245478,SRX5075168,SMARCA4,222
chr1,17245320,17245504,SRX5075170,SMARCA4,184
chr1,17245351,17245539,SRX5075169,SMARCA4,188
chr1,17251774,17252015,SRX5075170,SMARCA4,241
chr1,17251777,17252044,SRX5075169,SMARCA4,267
chr1,17251803,17251993,SRX5054309,FOSL2,190
chr1,17251808,17252075,SRX5075176,SMARCA4,267
chr1,17251856,17252075,SRX5075175,SMARCA4,219
chr1,17259312,17259507,SRX5054308,FOSL2,195
chr1,17274159,17274543,SRX16500061,CTCF,384
chr1,17274166,17274596,SRX16500059,CTCF,430
chr1,17274168,17274581,SRX16500060,CTCF,413
chr1,17274242,17274545,SRX16500062,CTCF,303
chr1,17287436,17287743,SRX5075170,SMARCA4,307
chr1,17287453,17287789,SRX5075169,SMARCA4,336
chr1,17287461,17287677,SRX5054308,FOSL2,216
chr1,17287465,17287754,SRX5075176,SMARCA4,289
chr1,17287467,17287743,SRX5075175,SMARCA4,276
chr1,17289840,17290052,SRX5716469,SMARCA4,212
chr1,17289865,17290201,SRX5075169,SMARCA4,336
chr1,17289928,17290167,SRX5075175,SMARCA4,239
chr1,17289946,17290140,SRX5075176,SMARCA4,194
chr1,17336065,17336577,SRX16500060,CTCF,512
chr1,17336078,17336537,SRX16500059,CTCF,459
chr1,17336095,17336560,SRX16500061,CTCF,465
chr1,17336145,17336571,SRX16500062,CTCF,426
chr1,17336158,17336337,SRX5075168,SMARCA4,179
chr1,17369543,17369743,SRX5075169,SMARCA4,200
chr1,17369551,17369761,SRX5075176,SMARCA4,210
chr1,17369572,17369866,SRX5075170,SMARCA4,294
chr1,17406002,17406645,SRX16500060,CTCF,643
chr1,17406029,17406554,SRX16500062,CTCF,525
chr1,17406073,17406607,SRX16500059,CTCF,534
chr1,17406117,17406632,SRX16500061,CTCF,515
chr1,17406129,17406343,SRX5075168,SMARCA4,214
chr1,17406175,17406458,SRX5075174,SMARCA4,283
chr1,17419722,17420246,SRX16500062,CTCF,524
chr1,17419726,17420302,SRX16500059,CTCF,576
chr1,17419745,17420268,SRX16500060,CTCF,523
chr1,17419757,17420264,SRX16500061,CTCF,507
chr1,17419759,17420239,SRX5075168,SMARCA4,480
chr1,17419818,17420186,SRX5716464,SMARCA4,368
chr1,17419834,17420200,SRX5075175,SMARCA4,366
chr1,17419834,17420233,SRX5716463,SMARCA4,399
chr1,17419840,17420253,SRX5075174,SMARCA4,413
chr1,17419861,17420222,SRX5075170,SMARCA4,361
chr1,17419878,17420235,SRX5075176,SMARCA4,357
chr1,17419884,17420226,SRX5075169,SMARCA4,342
chr1,17419887,17420181,SRX5716470,SMARCA4,294
chr1,17419903,17420263,SRX4174629,CTCF,360
chr1,17419947,17420219,SRX5716469,SMARCA4,272
chr1,17420652,17420821,SRX5075170,SMARCA4,169
chr1,17437799,17438060,SRX20140868,INTS10,261
chr1,17437809,17438394,SRX20140895,INTS13,585
chr1,17439215,17439673,SRX20140895,INTS13,458
chr1,17443418,17443686,SRX5075175,SMARCA4,268
chr1,17443428,17443685,SRX5054308,FOSL2,257
chr1,17443454,17443697,SRX5054309,FOSL2,243
chr1,17477253,17477740,SRX16500059,CTCF,487
chr1,17477270,17477763,SRX16500062,CTCF,493
chr1,17477299,17477815,SRX16500060,CTCF,516
chr1,17477314,17477799,SRX16500061,CTCF,485
chr1,17477386,17477595,SRX5075170,SMARCA4,209
chr1,17477402,17477671,SRX5075168,SMARCA4,269
chr1,17477435,17477723,SRX5075174,SMARCA4,288
chr1,17488912,17489572,SRX5075176,SMARCA4,660
chr1,17488951,17489503,SRX5075170,SMARCA4,552
chr1,17488970,17489382,SRX5716470,SMARCA4,412
chr1,17488985,17489359,SRX5716467,SMARCA2,374
chr1,17489011,17489268,SRX5075169,SMARCA4,257
chr1,17489043,17489322,SRX5716468,SMARCA2,279
chr1,17494140,17494476,SRX5054309,FOSL2,336
chr1,17494184,17494410,SRX5054308,FOSL2,226
chr1,17494190,17494653,SRX16500061,CTCF,463
chr1,17494210,17494738,SRX16500060,CTCF,528
chr1,17494211,17494699,SRX16500062,CTCF,488
chr1,17494216,17494684,SRX16500059,CTCF,468
chr1,17494233,17494551,SRX5075168,SMARCA4,318
chr1,17494235,17494576,SRX5075174,SMARCA4,341
chr1,17494355,17494542,SRX5075175,SMARCA4,187
chr1,17502214,17502719,SRX16500061,CTCF,505
chr1,17502218,17502746,SRX16500060,CTCF,528
chr1,17502227,17502703,SRX16500062,CTCF,476
chr1,17502243,17502692,SRX4174629,CTCF,449
chr1,17502246,17502778,SRX16500059,CTCF,532
chr1,17502405,17502626,SRX5075168,SMARCA4,221
chr1,17502420,17502671,SRX5075174,SMARCA4,251
chr1,17502421,17502625,SRX5716463,SMARCA4,204
chr1,17502436,17502709,SRX5075169,SMARCA4,273
chr1,17502443,17502760,SRX5716470,SMARCA4,317
chr1,17502444,17502794,SRX5075176,SMARCA4,350
chr1,17502450,17502709,SRX5716468,SMARCA2,259
chr1,17502452,17502886,SRX5075170,SMARCA4,434
chr1,17502460,17502818,SRX5075175,SMARCA4,358
chr1,17502463,17502797,SRX5716469,SMARCA4,334
chr1,17502512,17502732,SRX5020211,SMARCA2,220
chr1,17538501,17538705,SRX5075174,SMARCA4,204
chr1,17539859,17540789,SRX20140895,INTS13,930
chr1,17540244,17540427,SRX5054309,FOSL2,183
chr1,17545410,17545643,SRX5075176,SMARCA4,233
chr1,17545431,17545614,SRX5054309,FOSL2,183
chr1,17545460,17545666,SRX5075175,SMARCA4,206
chr1,17545482,17545692,SRX5075169,SMARCA4,210
chr1,17547409,17547635,SRX5075174,SMARCA4,226
chr1,17547474,17547669,SRX5075168,SMARCA4,195
chr1,17553980,17554385,SRX5075176,SMARCA4,405
chr1,17554004,17554416,SRX5075175,SMARCA4,412
chr1,17554007,17554439,SRX5075169,SMARCA4,432
chr1,17554030,17554375,SRX5054309,FOSL2,345
chr1,17554037,17554349,SRX5716469,SMARCA4,312
chr1,17554082,17554401,SRX5075170,SMARCA4,319
chr1,17554086,17554334,SRX5054308,FOSL2,248
chr1,17554130,17554318,SRX5075168,SMARCA4,188
chr1,17565530,17565712,SRX5075174,SMARCA4,182
chr1,17565546,17566051,SRX5075168,SMARCA4,505
chr1,17565570,17565764,SRX1424891,POU3F2,194
chr1,17565581,17565698,SRX1424893,POU3F2,117
chr1,17565640,17565693,SRX1424892,POU3F2,53
chr1,17565906,17566139,SRX5075174,SMARCA4,233
chr1,17569474,17569993,SRX5075169,SMARCA4,519
chr1,17569568,17570069,SRX5075176,SMARCA4,501
chr1,17569594,17570039,SRX5075170,SMARCA4,445
chr1,17569625,17570047,SRX5075175,SMARCA4,422
chr1,17569627,17570054,SRX5716470,SMARCA4,427
chr1,17569637,17570025,SRX5054309,FOSL2,388
chr1,17569654,17570010,SRX5054308,FOSL2,356
chr1,17569656,17569876,SRX5075181,SMARCA2,220
chr1,17569729,17570070,SRX5716469,SMARCA4,341
chr1,17572677,17572972,SRX16500060,CTCF,295
chr1,17573493,17573812,SRX5075174,SMARCA4,319
chr1,17573559,17573810,SRX5075168,SMARCA4,251
chr1,17587614,17587912,SRX5075175,SMARCA4,298
chr1,17587622,17588045,SRX5716470,SMARCA4,423
chr1,17587684,17587959,SRX5075169,SMARCA4,275
chr1,17587693,17588119,SRX5716469,SMARCA4,426
chr1,17587698,17587896,SRX5075181,SMARCA2,198
chr1,17587705,17587968,SRX5075170,SMARCA4,263
chr1,17587713,17588024,SRX5716468,SMARCA2,311
chr1,17587724,17587912,SRX5075176,SMARCA4,188
chr1,17606743,17607261,SRX16500061,CTCF,518
chr1,17606780,17607336,SRX16500059,CTCF,556
chr1,17606782,17607225,SRX4174629,CTCF,443
chr1,17606783,17607275,SRX16500060,CTCF,492
chr1,17606791,17607303,SRX16500062,CTCF,512
chr1,17606927,17607110,SRX5075174,SMARCA4,183
chr1,17624838,17625057,SRX5075170,SMARCA4,219
chr1,17624883,17625119,SRX5075175,SMARCA4,236
chr1,17624926,17625158,SRX5075169,SMARCA4,232
chr1,17629415,17629833,SRX16500059,CTCF,418
chr1,17629473,17629684,SRX16500062,CTCF,211
chr1,17629494,17629745,SRX16500060,CTCF,251
chr1,17636635,17636935,SRX5054309,FOSL2,300
chr1,17636674,17636907,SRX5054308,FOSL2,233
chr1,17648707,17648905,SRX5075175,SMARCA4,198
chr1,17653653,17654128,SRX16500061,CTCF,475
chr1,17653670,17654183,SRX16500059,CTCF,513
chr1,17653686,17654172,SRX16500060,CTCF,486
chr1,17653696,17654128,SRX16500062,CTCF,432
chr1,17653712,17654134,SRX4174629,CTCF,422
chr1,17653860,17654061,SRX5075169,SMARCA4,201
chr1,17653896,17654082,SRX5075176,SMARCA4,186
chr1,17661438,17662028,SRX16500061,CTCF,590
chr1,17661478,17662013,SRX16500059,CTCF,535
chr1,17661510,17662040,SRX16500060,CTCF,530
chr1,17661525,17661988,SRX16500062,CTCF,463
chr1,17661555,17661966,SRX4174629,CTCF,411
chr1,17661685,17661886,SRX5075168,SMARCA4,201
chr1,17661692,17661913,SRX5075175,SMARCA4,221
chr1,17661714,17661904,SRX5075170,SMARCA4,190
chr1,17671390,17671563,SRX5075174,SMARCA4,173
chr1,17671672,17672028,SRX16500059,CTCF,356
chr1,17671710,17672080,SRX16500060,CTCF,370
chr1,17671796,17672118,SRX16500062,CTCF,322
chr1,17675392,17676405,SRX20140895,INTS13,1013
chr1,17689693,17689868,SRX5075176,SMARCA4,175
chr1,17696452,17696855,SRX16500059,CTCF,403
chr1,17696455,17696785,SRX5716470,SMARCA4,330
chr1,17696457,17696685,SRX5075170,SMARCA4,228
chr1,17696469,17696712,SRX5075176,SMARCA4,243
chr1,17696483,17696785,SRX5075175,SMARCA4,302
chr1,17696489,17696923,SRX16500060,CTCF,434
chr1,17696530,17696719,SRX5075169,SMARCA4,189
chr1,17696549,17696786,SRX16500062,CTCF,237
chr1,17732529,17732856,SRX5054308,FOSL2,327
chr1,17732533,17732857,SRX5054309,FOSL2,324
chr1,17732534,17732819,SRX5075176,SMARCA4,285
chr1,17732546,17732858,SRX5075170,SMARCA4,312
chr1,17732548,17732805,SRX5075169,SMARCA4,257
chr1,17732581,17732815,SRX5716469,SMARCA4,234
chr1,17732583,17732807,SRX5075175,SMARCA4,224
chr1,17742673,17742970,SRX5075176,SMARCA4,297
chr1,17742706,17742954,SRX5075170,SMARCA4,248
chr1,17755136,17755371,SRX16500059,CTCF,235
chr1,17765619,17765882,SRX5075175,SMARCA4,263
chr1,17765639,17765895,SRX5075169,SMARCA4,256
chr1,17765679,17765857,SRX5075176,SMARCA4,178
chr1,17768566,17769044,SRX5075176,SMARCA4,478
chr1,17768591,17769097,SRX5075170,SMARCA4,506
chr1,17768602,17768923,SRX5075169,SMARCA4,321
chr1,17768608,17768905,SRX5054309,FOSL2,297
chr1,17768616,17769049,SRX5075175,SMARCA4,433
chr1,17768620,17768870,SRX5054308,FOSL2,250
chr1,17768628,17768875,SRX5716469,SMARCA4,247
chr1,17768644,17769070,SRX5075174,SMARCA4,426
chr1,17768675,17768903,SRX5716470,SMARCA4,228
chr1,17826054,17826509,SRX16500059,CTCF,455
chr1,17826117,17826438,SRX16500061,CTCF,321
chr1,17826130,17826481,SRX16500060,CTCF,351
chr1,17826145,17826458,SRX16500062,CTCF,313
chr1,17831683,17831907,SRX5075169,SMARCA4,224
chr1,17831688,17831893,SRX5075170,SMARCA4,205
chr1,17831695,17831919,SRX5716470,SMARCA4,224
chr1,17831695,17831922,SRX5716464,SMARCA4,227
chr1,17866537,17866773,SRX5075175,SMARCA4,236
chr1,17874290,17874525,SRX5054309,FOSL2,235
chr1,17909680,17910005,SRX16500060,CTCF,325
chr1,17922822,17923207,SRX16500059,CTCF,385
chr1,17922853,17923289,SRX16500060,CTCF,436
chr1,17922876,17923247,SRX16500062,CTCF,371
chr1,17922896,17923237,SRX16500061,CTCF,341
chr1,17922918,17923162,SRX4174629,CTCF,244
chr1,17984428,17984920,SRX16500060,CTCF,492
chr1,17984452,17984943,SRX16500059,CTCF,491
chr1,17984478,17984924,SRX16500061,CTCF,446
chr1,17984486,17984895,SRX16500062,CTCF,409
chr1,18032355,18032860,SRX20140881,CPSF3L,505
chr1,18092125,18092341,SRX5075169,SMARCA4,216
chr1,18092144,18092372,SRX5054309,FOSL2,228
chr1,18100359,18100883,SRX16500061,CTCF,524
chr1,18100373,18100931,SRX16500060,CTCF,558
chr1,18100396,18100899,SRX16500059,CTCF,503
chr1,18100414,18100908,SRX16500062,CTCF,494
chr1,18100597,18100829,SRX4174629,CTCF,232
chr1,18110202,18110669,SRX16500061,CTCF,467
chr1,18110205,18110628,SRX16500062,CTCF,423
chr1,18110216,18110593,SRX16500059,CTCF,377
chr1,18110220,18110614,SRX16500060,CTCF,394
chr1,18148968,18149309,SRX16500059,CTCF,341
chr1,18149024,18149362,SRX16500060,CTCF,338
chr1,18149062,18149393,SRX16500061,CTCF,331
chr1,18151565,18151787,SRX5054309,FOSL2,222
chr1,18217432,18217837,SRX16500059,CTCF,405
chr1,18217438,18217734,SRX16500062,CTCF,296
chr1,18217478,18217811,SRX16500060,CTCF,333
chr1,18217518,18217789,SRX16500061,CTCF,271
chr1,18232126,18232344,SRX16500062,CTCF,218
chr1,18232139,18232433,SRX16500059,CTCF,294
chr1,18232162,18232384,SRX16500061,CTCF,222
chr1,18234719,18235173,SRX16500061,CTCF,454
chr1,18234754,18235294,SRX16500059,CTCF,540
chr1,18234760,18235238,SRX16500060,CTCF,478
chr1,18234764,18235233,SRX16500062,CTCF,469
chr1,18234780,18235113,SRX4174629,CTCF,333
chr1,18237571,18237847,SRX20140869,INTS10,276
chr1,18256354,18256570,SRX5075168,SMARCA4,216
chr1,18299627,18300107,SRX16500059,CTCF,480
chr1,18299664,18300129,SRX16500060,CTCF,465
chr1,18299673,18300112,SRX16500061,CTCF,439
chr1,18299692,18300061,SRX16500062,CTCF,369
chr1,18302838,18303154,SRX16500059,CTCF,316
chr1,18302861,18303142,SRX16500060,CTCF,281
chr1,18302865,18303177,SRX16500062,CTCF,312
chr1,18302916,18303137,SRX16500061,CTCF,221
chr1,18322481,18322796,SRX16500062,CTCF,315
chr1,18322493,18322832,SRX16500059,CTCF,339
chr1,18322524,18322804,SRX16500060,CTCF,280
chr1,18373892,18374319,SRX16500059,CTCF,427
chr1,18373906,18374338,SRX16500061,CTCF,432
chr1,18373925,18374293,SRX16500062,CTCF,368
chr1,18373929,18374335,SRX16500060,CTCF,406
chr1,18399177,18399514,SRX16500061,CTCF,337
chr1,18452563,18452969,SRX20140895,INTS13,406
chr1,18476029,18476383,SRX20140881,CPSF3L,354
chr1,18486219,18486489,SRX16500059,CTCF,270
chr1,18486220,18486591,SRX16500060,CTCF,371
chr1,18486297,18486527,SRX16500061,CTCF,230
chr1,18486337,18486549,SRX16500062,CTCF,212
chr1,18530962,18531272,SRX16500060,CTCF,310
chr1,18530981,18531234,SRX16500061,CTCF,253
chr1,18556365,18556849,SRX16500059,CTCF,484
chr1,18556384,18556827,SRX16500060,CTCF,443
chr1,18556412,18556776,SRX16500062,CTCF,364
chr1,18556429,18556770,SRX16500061,CTCF,341
chr1,18556572,18556782,SRX4174629,CTCF,210
chr1,18557627,18557809,SRX5075168,SMARCA4,182
chr1,18575477,18575993,SRX16500060,CTCF,516
chr1,18575539,18575937,SRX16500059,CTCF,398
chr1,18575563,18575939,SRX16500062,CTCF,376
chr1,18575571,18575984,SRX4174629,CTCF,413
chr1,18575590,18575978,SRX16500061,CTCF,388
chr1,18575697,18575910,SRX5075174,SMARCA4,213
chr1,18575746,18575967,SRX5716463,SMARCA4,221
chr1,18581375,18581867,SRX16500061,CTCF,492
chr1,18581382,18581861,SRX16500059,CTCF,479
chr1,18581396,18581854,SRX16500060,CTCF,458
chr1,18581415,18581856,SRX16500062,CTCF,441
chr1,18583553,18583746,SRX5075169,SMARCA4,193
chr1,18592498,18592767,SRX20140895,INTS13,269
chr1,18597316,18597845,SRX16500059,CTCF,529
chr1,18597340,18597842,SRX16500062,CTCF,502
chr1,18597343,18597813,SRX16500061,CTCF,470
chr1,18597362,18597830,SRX16500060,CTCF,468
chr1,18597446,18597887,SRX4174629,CTCF,441
chr1,18631060,18631540,SRX20140895,INTS13,480
chr1,18646582,18646896,SRX20140868,INTS10,314
chr1,18657672,18658127,SRX20140895,INTS13,455
chr1,18657872,18658097,SRX5075168,SMARCA4,225
chr1,18673940,18674252,SRX16500059,CTCF,312
chr1,18674024,18674281,SRX16500061,CTCF,257
chr1,18674056,18674277,SRX16500060,CTCF,221
chr1,18674088,18674338,SRX16500062,CTCF,250
chr1,18681294,18681790,SRX16500062,CTCF,496
chr1,18681321,18681866,SRX16500060,CTCF,545
chr1,18681351,18681815,SRX16500059,CTCF,464
chr1,18681372,18681846,SRX16500061,CTCF,474
chr1,18681380,18681606,SRX4174629,CTCF,226
chr1,18681436,18681640,SRX5716463,SMARCA4,204
chr1,18681440,18681665,SRX5075168,SMARCA4,225
chr1,18681471,18681683,SRX5716464,SMARCA4,212
chr1,18702993,18703233,SRX16500060,CTCF,240
chr1,18814520,18814821,SRX5075170,SMARCA4,301
chr1,18814538,18814849,SRX5075176,SMARCA4,311
chr1,18814555,18814802,SRX5075175,SMARCA4,247
chr1,18814569,18814806,SRX5075169,SMARCA4,237
chr1,18814574,18814786,SRX5716469,SMARCA4,212
chr1,18820713,18821225,SRX16500060,CTCF,512
chr1,18820728,18821253,SRX16500059,CTCF,525
chr1,18820731,18821145,SRX4174629,CTCF,414
chr1,18820734,18821184,SRX16500061,CTCF,450
chr1,18820751,18821229,SRX16500062,CTCF,478
chr1,18820826,18821044,SRX5075170,SMARCA4,218
chr1,18849194,18849730,SRX5075170,SMARCA4,536
chr1,18849228,18849581,SRX5075176,SMARCA4,353
chr1,18849252,18849499,SRX5075175,SMARCA4,247
chr1,18849310,18849589,SRX5716470,SMARCA4,279
chr1,18875118,18875677,SRX16500059,CTCF,559
chr1,18875122,18875578,SRX16500062,CTCF,456
chr1,18875149,18875695,SRX16500061,CTCF,546
chr1,18875181,18875508,SRX4174629,CTCF,327
chr1,18875189,18875665,SRX16500060,CTCF,476
chr1,18875256,18875508,SRX5075168,SMARCA4,252
chr1,18875289,18875488,SRX5075174,SMARCA4,199
chr1,18875295,18875495,SRX5075176,SMARCA4,200
chr1,18884055,18884546,SRX16500062,CTCF,491
chr1,18884055,18884564,SRX16500061,CTCF,509
chr1,18884070,18884570,SRX16500059,CTCF,500
chr1,18884084,18884614,SRX16500060,CTCF,530
chr1,18884115,18884438,SRX4174629,CTCF,323
chr1,18884183,18884458,SRX5075168,SMARCA4,275
chr1,18884221,18884458,SRX5075174,SMARCA4,237
chr1,18890794,18891027,SRX5716470,SMARCA4,233
chr1,18890814,18891020,SRX5075170,SMARCA4,206
chr1,18890851,18891073,SRX5075169,SMARCA4,222
chr1,18902382,18902574,SRX5075170,SMARCA4,192
chr1,18902394,18903245,SRX20140895,INTS13,851
chr1,18902409,18902702,SRX5075168,SMARCA4,293
chr1,18902444,18903110,SRX5075174,SMARCA4,666
chr1,18902509,18903183,SRX20140868,INTS10,674
chr1,18902779,18902960,SRX5054307,FOSL2,181
chr1,18902780,18903188,SRX20140897,INTS13,408
chr1,18902817,18903106,SRX20140896,INTS13,289
chr1,18902827,18903233,SRX20140881,CPSF3L,406
chr1,18902871,18903137,SRX20140869,INTS10,266
chr1,18902876,18903238,SRX20140867,INTS10,362
chr1,18902894,18903160,SRX5075168,SMARCA4,266
chr1,18902943,18903118,SRX5075176,SMARCA4,175
chr1,18902970,18903205,SRX20140879,CPSF3L,235
chr1,18906883,18907497,SRX16500060,CTCF,614
chr1,18906884,18907513,SRX4174629,CTCF,629
chr1,18906887,18907531,SRX16500059,CTCF,644
chr1,18906926,18907476,SRX16500061,CTCF,550
chr1,18906933,18907458,SRX16500062,CTCF,525
chr1,18907076,18907276,SRX5075170,SMARCA4,200
chr1,18907120,18907379,SRX5075176,SMARCA4,259
chr1,18912983,18913535,SRX16500060,CTCF,552
chr1,18912990,18913400,SRX4174629,CTCF,410
chr1,18913002,18913567,SRX16500059,CTCF,565
chr1,18913042,18913522,SRX16500062,CTCF,480
chr1,18913053,18913542,SRX16500061,CTCF,489
chr1,18913095,18913453,SRX5075174,SMARCA4,358
chr1,18913117,18913392,SRX5075170,SMARCA4,275
chr1,18913119,18913396,SRX5075176,SMARCA4,277
chr1,18913120,18913395,SRX5075168,SMARCA4,275
chr1,18922256,18922639,SRX5075170,SMARCA4,383
chr1,18922289,18922636,SRX5716469,SMARCA4,347
chr1,18922305,18922630,SRX5075169,SMARCA4,325
chr1,18922316,18922718,SRX5075176,SMARCA4,402
chr1,18922318,18922633,SRX5075168,SMARCA4,315
chr1,18922320,18922671,SRX5716470,SMARCA4,351
chr1,18922332,18922598,SRX5075174,SMARCA4,266
chr1,18922346,18922663,SRX5075175,SMARCA4,317
chr1,18922350,18922621,SRX5716467,SMARCA2,271
chr1,18922372,18922642,SRX5020211,SMARCA2,270
chr1,18926502,18926964,SRX5075170,SMARCA4,462
chr1,18926602,18927001,SRX5075176,SMARCA4,399
chr1,18926629,18926992,SRX5054309,FOSL2,363
chr1,18926630,18926974,SRX5075175,SMARCA4,344
chr1,18926642,18926915,SRX5716469,SMARCA4,273
chr1,18926648,18926940,SRX5075169,SMARCA4,292
chr1,18926662,18926902,SRX5075168,SMARCA4,240
chr1,18926664,18926953,SRX5054308,FOSL2,289
chr1,18926709,18927027,SRX5075174,SMARCA4,318
chr1,18941202,18941604,SRX5075170,SMARCA4,402
chr1,18941231,18941587,SRX5075176,SMARCA4,356
chr1,18941284,18941540,SRX5716470,SMARCA4,256
chr1,18941308,18941528,SRX5716469,SMARCA4,220
chr1,18941316,18941530,SRX5075169,SMARCA4,214
chr1,18949715,18949928,SRX5075174,SMARCA4,213
chr1,18949793,18950029,SRX5075168,SMARCA4,236
chr1,18949904,18950112,SRX5075169,SMARCA4,208
chr1,18949963,18950322,SRX20140895,INTS13,359
chr1,18950007,18950253,SRX5075174,SMARCA4,246
chr1,18956283,18957094,SRX20140895,INTS13,811
chr1,18956381,18956724,SRX20140867,INTS10,343
chr1,18956470,18957047,SRX5075174,SMARCA4,577
chr1,18956495,18957081,SRX5075168,SMARCA4,586
chr1,18956498,18956996,SRX5075176,SMARCA4,498
chr1,18956612,18957031,SRX5075170,SMARCA4,419
chr1,18956658,18956911,SRX5054307,FOSL2,253
chr1,18956670,18956953,SRX5054308,FOSL2,283
chr1,18956696,18956933,SRX5716463,SMARCA4,237
chr1,18956712,18957061,SRX5716470,SMARCA4,349
chr1,18956765,18956973,SRX5716464,SMARCA4,208
chr1,18956811,18957062,SRX5075169,SMARCA4,251
chr1,18956830,18957023,SRX5075175,SMARCA4,193
chr1,18965513,18966278,SRX5075168,SMARCA4,765
chr1,18965708,18966285,SRX5075174,SMARCA4,577
chr1,18965778,18966127,SRX5075169,SMARCA4,349
chr1,18965788,18966024,SRX5054309,FOSL2,236
chr1,18965801,18966129,SRX20140867,INTS10,328
chr1,18965820,18966089,SRX5075176,SMARCA4,269
chr1,18965841,18966192,SRX5075175,SMARCA4,351
chr1,18965849,18966102,SRX5716470,SMARCA4,253
chr1,18965862,18966131,SRX5716463,SMARCA4,269
chr1,18965878,18966092,SRX5075170,SMARCA4,214
chr1,18972051,18972328,SRX5054309,FOSL2,277
chr1,18972058,18972317,SRX5054308,FOSL2,259
chr1,19009940,19010128,SRX5075168,SMARCA4,188
chr1,19010033,19010214,SRX5075174,SMARCA4,181
chr1,19010970,19011511,SRX5075175,SMARCA4,541
chr1,19010974,19011518,SRX5075169,SMARCA4,544
chr1,19010993,19011495,SRX5075170,SMARCA4,502
chr1,19011010,19011457,SRX5075176,SMARCA4,447
chr1,19011024,19011280,SRX20140895,INTS13,256
chr1,19011028,19011502,SRX5075168,SMARCA4,474
chr1,19011047,19011448,SRX5716470,SMARCA4,401
chr1,19011050,19011406,SRX5054308,FOSL2,356
chr1,19011051,19011490,SRX5054309,FOSL2,439
chr1,19011063,19011458,SRX5075174,SMARCA4,395
chr1,19011073,19011405,SRX5020214,SMARCA2,332
chr1,19011077,19011376,SRX5716468,SMARCA2,299
chr1,19011083,19011464,SRX5716469,SMARCA4,381
chr1,19011120,19011482,SRX5716467,SMARCA2,362
chr1,19011135,19011326,SRX5054307,FOSL2,191
chr1,19011140,19011434,SRX5020211,SMARCA2,294
chr1,19011205,19011384,SRX5075182,SMARCA2,179
chr1,19012443,19012616,SRX5075174,SMARCA4,173
chr1,19028066,19028416,SRX20140895,INTS13,350
chr1,19028104,19028294,SRX5075168,SMARCA4,190
chr1,19028200,19028386,SRX5075174,SMARCA4,186
chr1,19045428,19045618,SRX5075169,SMARCA4,190
chr1,19045443,19045612,SRX5075170,SMARCA4,169
chr1,19045443,19045623,SRX5054308,FOSL2,180
chr1,19052453,19052737,SRX20140881,CPSF3L,284
chr1,19052467,19052892,SRX5075168,SMARCA4,425
chr1,19052472,19052841,SRX5075174,SMARCA4,369
chr1,19052478,19052829,SRX5716463,SMARCA4,351
chr1,19052480,19052754,SRX20140867,INTS10,274
chr1,19052529,19052800,SRX5716464,SMARCA4,271
chr1,19055813,19056002,SRX5075174,SMARCA4,189
chr1,19055842,19056021,SRX5075168,SMARCA4,179
chr1,19066950,19067391,SRX5075168,SMARCA4,441
chr1,19066978,19067402,SRX20140895,INTS13,424
chr1,19067016,19067326,SRX5716463,SMARCA4,310
chr1,19067075,19067371,SRX5075174,SMARCA4,296
chr1,19067169,19067509,SRX20140867,INTS10,340
chr1,19067231,19067580,SRX5075170,SMARCA4,349
chr1,19091718,19091929,SRX5716470,SMARCA4,211
chr1,19096235,19096572,SRX16500060,CTCF,337
chr1,19096238,19096605,SRX16500059,CTCF,367
chr1,19096291,19096607,SRX16500061,CTCF,316
chr1,19096295,19096545,SRX16500062,CTCF,250
chr1,19163278,19163642,SRX5075170,SMARCA4,364
chr1,19163316,19163506,SRX5075169,SMARCA4,190
chr1,19163342,19163628,SRX5075176,SMARCA4,286
chr1,19209939,19210659,SRX20140895,INTS13,720
chr1,19209996,19210543,SRX20140867,INTS10,547
chr1,19210048,19210552,SRX20140869,INTS10,504
chr1,19210052,19210578,SRX20140897,INTS13,526
chr1,19210054,19210580,SRX20140868,INTS10,526
chr1,19210126,19210604,SRX20140879,CPSF3L,478
chr1,19210136,19210517,SRX5075170,SMARCA4,381
chr1,19210146,19210534,SRX20140896,INTS13,388
chr1,19210150,19210539,SRX5075168,SMARCA4,389
chr1,19210165,19210564,SRX20140881,CPSF3L,399
chr1,19210167,19210460,SRX20140894,INTS13,293
chr1,19210177,19210606,SRX5075174,SMARCA4,429
chr1,19210213,19210413,SRX5075175,SMARCA4,200
chr1,19241204,19241669,SRX16500062,CTCF,465
chr1,19241204,19241692,SRX16500061,CTCF,488
chr1,19241204,19241701,SRX16500059,CTCF,497
chr1,19241217,19241678,SRX16500060,CTCF,461
chr1,19241267,19241544,SRX5075174,SMARCA4,277
chr1,19241317,19241560,SRX4174629,CTCF,243
chr1,19241329,19241576,SRX5075168,SMARCA4,247
chr1,19251290,19252054,SRX20140895,INTS13,764
chr1,19251324,19251824,SRX5075174,SMARCA4,500
chr1,19251352,19251772,SRX5075176,SMARCA4,420
chr1,19251353,19252010,SRX20140897,INTS13,657
chr1,19251371,19251820,SRX20140879,CPSF3L,449
chr1,19251377,19251765,SRX5075169,SMARCA4,388
chr1,19251392,19251767,SRX20140894,INTS13,375
chr1,19251400,19251975,SRX20140868,INTS10,575
chr1,19251408,19251859,SRX20140881,CPSF3L,451
chr1,19251432,19251896,SRX20140867,INTS10,464
chr1,19251464,19251739,SRX5075168,SMARCA4,275
chr1,19251467,19251869,SRX20140869,INTS10,402
chr1,19309385,19309639,SRX5054308,FOSL2,254
chr1,19309396,19309607,SRX5054309,FOSL2,211
chr1,19309397,19309648,SRX5075170,SMARCA4,251
chr1,19311764,19312690,SRX20140895,INTS13,926
chr1,19311833,19312526,SRX20140867,INTS10,693
chr1,19311836,19312400,SRX5075168,SMARCA4,564
chr1,19311850,19312106,SRX20140879,CPSF3L,256
chr1,19311857,19312094,SRX5716470,SMARCA4,237
chr1,19311866,19312437,SRX5075174,SMARCA4,571
chr1,19311898,19312396,SRX20140868,INTS10,498
chr1,19311900,19312322,SRX5716464,SMARCA4,422
chr1,19311903,19312101,SRX5075169,SMARCA4,198
chr1,19311904,19312376,SRX5075176,SMARCA4,472
chr1,19311950,19312361,SRX5075170,SMARCA4,411
chr1,19312022,19312247,SRX5075175,SMARCA4,225
chr1,19312211,19312499,SRX20140897,INTS13,288
chr1,19312565,19312777,SRX5075168,SMARCA4,212
chr1,19312645,19312854,SRX5075169,SMARCA4,209
chr1,19315389,19315576,SRX5054309,FOSL2,187
chr1,19341451,19341869,SRX16500059,CTCF,418
chr1,19341461,19341834,SRX16500061,CTCF,373
chr1,19341483,19341890,SRX16500060,CTCF,407
chr1,19341490,19341805,SRX5075174,SMARCA4,315
chr1,19341497,19341876,SRX16500062,CTCF,379
chr1,19341503,19341783,SRX5075168,SMARCA4,280
chr1,19341506,19341709,SRX5075169,SMARCA4,203
chr1,19341522,19341763,SRX5075176,SMARCA4,241
chr1,19341535,19341798,SRX5075170,SMARCA4,263
chr1,19341543,19341767,SRX5716464,SMARCA4,224
chr1,19344314,19344733,SRX16500059,CTCF,419
chr1,19344336,19344706,SRX16500060,CTCF,370
chr1,19344339,19344699,SRX16500062,CTCF,360
chr1,19344341,19344700,SRX16500061,CTCF,359
chr1,19374227,19374700,SRX16500060,CTCF,473
chr1,19374282,19374808,SRX16500059,CTCF,526
chr1,19374331,19374698,SRX16500061,CTCF,367
chr1,19374369,19374750,SRX16500062,CTCF,381
chr1,19384244,19384442,SRX5075170,SMARCA4,198
chr1,19384249,19384424,SRX5075176,SMARCA4,175
chr1,19385943,19386288,SRX5075170,SMARCA4,345
chr1,19386059,19386239,SRX5075169,SMARCA4,180
chr1,19390954,19391658,SRX5075170,SMARCA4,704
chr1,19391019,19391635,SRX5075176,SMARCA4,616
chr1,19391048,19391309,SRX5716469,SMARCA4,261
chr1,19391048,19391587,SRX5075169,SMARCA4,539
chr1,19391077,19391396,SRX5716467,SMARCA2,319
chr1,19391089,19391364,SRX5020214,SMARCA2,275
chr1,19391100,19391349,SRX5054308,FOSL2,249
chr1,19391100,19391491,SRX5716470,SMARCA4,391
chr1,19391116,19391355,SRX5020211,SMARCA2,239
chr1,19391170,19391417,SRX5054309,FOSL2,247
chr1,19391191,19391695,SRX5075175,SMARCA4,504
chr1,19391254,19391774,SRX16500059,CTCF,520
chr1,19391273,19391816,SRX16500060,CTCF,543
chr1,19391289,19391613,SRX5075168,SMARCA4,324
chr1,19391298,19391631,SRX5075174,SMARCA4,333
chr1,19391309,19391750,SRX16500062,CTCF,441
chr1,19391321,19391757,SRX16500061,CTCF,436
chr1,19398547,19398758,SRX5054309,FOSL2,211
chr1,19405352,19405632,SRX16500061,CTCF,280
chr1,19405669,19406282,SRX5075170,SMARCA4,613
chr1,19405672,19406332,SRX5075176,SMARCA4,660
chr1,19405681,19406328,SRX5716470,SMARCA4,647
chr1,19405713,19406469,SRX20140895,INTS13,756
chr1,19405821,19406360,SRX20140868,INTS10,539
chr1,19405826,19406413,SRX5075174,SMARCA4,587
chr1,19405838,19406165,SRX5716467,SMARCA2,327
chr1,19405866,19406220,SRX5075175,SMARCA4,354
chr1,19405879,19406224,SRX5075169,SMARCA4,345
chr1,19405926,19406126,SRX5716451,SOX2,200
chr1,19405956,19406515,SRX5075168,SMARCA4,559
chr1,19405959,19406268,SRX20140867,INTS10,309
chr1,19406108,19406382,SRX5716468,SMARCA2,274
chr1,19414633,19415158,SRX5075170,SMARCA4,525
chr1,19414821,19415104,SRX5075176,SMARCA4,283
chr1,19417114,19417433,SRX5075176,SMARCA4,319
chr1,19417164,19417461,SRX5075170,SMARCA4,297
chr1,19423097,19423394,SRX5075176,SMARCA4,297
chr1,19430170,19430524,SRX5075170,SMARCA4,354
chr1,19430177,19430506,SRX5054309,FOSL2,329
chr1,19430193,19430494,SRX5075169,SMARCA4,301
chr1,19430202,19430541,SRX5054308,FOSL2,339
chr1,19430211,19430465,SRX5075175,SMARCA4,254
chr1,19430219,19430487,SRX5075176,SMARCA4,268
chr1,19430221,19430432,SRX5716470,SMARCA4,211
chr1,19430234,19430455,SRX5716469,SMARCA4,221
chr1,19439894,19440141,SRX16500060,CTCF,247
chr1,19439902,19440213,SRX16500059,CTCF,311
chr1,19439932,19440175,SRX16500061,CTCF,243
chr1,19440530,19440766,SRX5054309,FOSL2,236
chr1,19440534,19440767,SRX5054308,FOSL2,233
chr1,19440577,19440769,SRX5075169,SMARCA4,192
chr1,19448819,19449279,SRX5075170,SMARCA4,460
chr1,19448901,19449243,SRX5075176,SMARCA4,342
chr1,19448922,19449190,SRX5075175,SMARCA4,268
chr1,19448945,19449168,SRX5716470,SMARCA4,223
chr1,19448956,19449170,SRX5716468,SMARCA2,214
chr1,19448968,19449238,SRX5075169,SMARCA4,270
chr1,19450736,19451177,SRX5054309,FOSL2,441
chr1,19450751,19451131,SRX5075169,SMARCA4,380
chr1,19450764,19451148,SRX5020211,SMARCA2,384
chr1,19450764,19451175,SRX5075176,SMARCA4,411
chr1,19450764,19451214,SRX5075170,SMARCA4,450
chr1,19450767,19451142,SRX5075175,SMARCA4,375
chr1,19450768,19451169,SRX5054308,FOSL2,401
chr1,19450773,19451108,SRX5075182,SMARCA2,335
chr1,19450790,19451115,SRX5716459,Epitope tags,325
chr1,19450792,19451133,SRX5716467,SMARCA2,341
chr1,19450814,19451151,SRX5020214,SMARCA2,337
chr1,19450820,19451113,SRX5716470,SMARCA4,293
chr1,19450821,19451032,SRX5716468,SMARCA2,211
chr1,19450829,19451078,SRX5075181,SMARCA2,249
chr1,19450837,19451153,SRX5716469,SMARCA4,316
chr1,19456849,19457059,SRX5075176,SMARCA4,210
chr1,19456921,19457217,SRX5075169,SMARCA4,296
chr1,19461431,19461558,SRX1424891,POU3F2,127
chr1,19461491,19461540,SRX1424892,POU3F2,49
chr1,19469417,19469696,SRX5054308,FOSL2,279
chr1,19469424,19469709,SRX5054309,FOSL2,285
chr1,19469440,19469694,SRX5075176,SMARCA4,254
chr1,19469456,19469714,SRX5075170,SMARCA4,258
chr1,19469456,19469720,SRX5075169,SMARCA4,264
chr1,19469497,19469726,SRX5075175,SMARCA4,229
chr1,19485034,19486134,SRX20140895,INTS13,1100
chr1,19485202,19486088,SRX20140867,INTS10,886
chr1,19485208,19485525,SRX20140868,INTS10,317
chr1,19485513,19485701,SRX5075175,SMARCA4,188
chr1,19485516,19485755,SRX5054308,FOSL2,239
chr1,19485519,19486177,SRX5075174,SMARCA4,658
chr1,19485540,19485768,SRX5054307,FOSL2,228
chr1,19485567,19486128,SRX5075168,SMARCA4,561
chr1,19485578,19486119,SRX20140868,INTS10,541
chr1,19485744,19485958,SRX5075170,SMARCA4,214
chr1,19485760,19486024,SRX5716470,SMARCA4,264
chr1,19485765,19486148,SRX5075176,SMARCA4,383
chr1,19487722,19488222,SRX16500059,CTCF,500
chr1,19487738,19488176,SRX16500060,CTCF,438
chr1,19487760,19488181,SRX16500061,CTCF,421
chr1,19487800,19488161,SRX16500062,CTCF,361
chr1,19494979,19495202,SRX5716470,SMARCA4,223
chr1,19496099,19496675,SRX5716469,SMARCA4,576
chr1,19496122,19496678,SRX5075175,SMARCA4,556
chr1,19496131,19496630,SRX5075170,SMARCA4,499
chr1,19496143,19496696,SRX5075176,SMARCA4,553
chr1,19496152,19496667,SRX5716470,SMARCA4,515
chr1,19496155,19496594,SRX5020211,SMARCA2,439
chr1,19496231,19496647,SRX5716467,SMARCA2,416
chr1,19496239,19496757,SRX5075169,SMARCA4,518
chr1,19496259,19496735,SRX5054308,FOSL2,476
chr1,19496281,19496600,SRX5716468,SMARCA2,319
chr1,19496306,19496568,SRX5075181,SMARCA2,262
chr1,19496355,19496605,SRX5716459,Epitope tags,250
chr1,19504982,19505396,SRX5054308,FOSL2,414
chr1,19504995,19505312,SRX5054309,FOSL2,317
chr1,19504997,19505364,SRX5075175,SMARCA4,367
chr1,19505007,19505284,SRX5075176,SMARCA4,277
chr1,19505035,19505274,SRX5716469,SMARCA4,239
chr1,19505035,19505388,SRX5020211,SMARCA2,353
chr1,19505039,19505275,SRX5020214,SMARCA2,236
chr1,19505098,19505468,SRX5075170,SMARCA4,370
chr1,19508875,19509291,SRX5054309,FOSL2,416
chr1,19508986,19509271,SRX5020211,SMARCA2,285
chr1,19509040,19509226,SRX5054308,FOSL2,186
chr1,19529761,19530135,SRX5075176,SMARCA4,374
chr1,19529831,19530125,SRX5075170,SMARCA4,294
chr1,19529859,19530166,SRX5716469,SMARCA4,307
chr1,19529861,19530061,SRX5075169,SMARCA4,200
chr1,19559686,19559970,SRX5054309,FOSL2,284
chr1,19559767,19559987,SRX5054308,FOSL2,220
chr1,19563685,19564153,SRX5075170,SMARCA4,468
chr1,19563716,19564183,SRX5075176,SMARCA4,467
chr1,19577018,19577348,SRX5075176,SMARCA4,330
chr1,19577054,19577429,SRX5075170,SMARCA4,375
chr1,19577063,19577358,SRX5054309,FOSL2,295
chr1,19577112,19577387,SRX5054308,FOSL2,275
chr1,19577150,19577460,SRX5075169,SMARCA4,310
chr1,19582213,19582630,SRX16500059,CTCF,417
chr1,19582272,19582624,SRX16500060,CTCF,352
chr1,19582274,19582638,SRX16500062,CTCF,364
chr1,19582280,19582664,SRX16500061,CTCF,384
chr1,19596563,19597242,SRX5075174,SMARCA4,679
chr1,19596595,19596858,SRX5075170,SMARCA4,263
chr1,19596631,19596878,SRX5716470,SMARCA4,247
chr1,19596696,19597443,SRX20140895,INTS13,747
chr1,19596719,19597150,SRX5075168,SMARCA4,431
chr1,19596849,19597314,SRX20140867,INTS10,465
chr1,19596855,19597131,SRX5075176,SMARCA4,276
chr1,19596906,19597331,SRX20140869,INTS10,425
chr1,19596916,19597186,SRX20140897,INTS13,270
chr1,19596932,19597238,SRX5075170,SMARCA4,306
chr1,19597005,19597243,SRX20140879,CPSF3L,238
chr1,19620841,19621173,SRX5075176,SMARCA4,332
chr1,19620851,19621112,SRX5075170,SMARCA4,261
chr1,19620869,19621099,SRX5075175,SMARCA4,230
chr1,19622281,19622477,SRX5075169,SMARCA4,196
chr1,19633395,19633655,SRX5020214,SMARCA2,260
chr1,19640446,19641115,SRX5075170,SMARCA4,669
chr1,19640461,19641129,SRX5075176,SMARCA4,668
chr1,19640474,19641100,SRX5075169,SMARCA4,626
chr1,19640487,19640890,SRX5716469,SMARCA4,403
chr1,19640491,19640952,SRX5716470,SMARCA4,461
chr1,19640498,19640994,SRX5716467,SMARCA2,496
chr1,19640513,19640883,SRX5020211,SMARCA2,370
chr1,19640517,19640922,SRX5075175,SMARCA4,405
chr1,19640519,19640909,SRX5716468,SMARCA2,390
chr1,19640559,19640864,SRX5075181,SMARCA2,305
chr1,19640585,19640858,SRX5054309,FOSL2,273
chr1,19651137,19651379,SRX4174629,CTCF,242
chr1,19651197,19651438,SRX16500059,CTCF,241
chr1,19651223,19651447,SRX16500062,CTCF,224
chr1,19653572,19654094,SRX16500060,CTCF,522
chr1,19653607,19654070,SRX16500059,CTCF,463
chr1,19653617,19654081,SRX16500062,CTCF,464
chr1,19653657,19654054,SRX16500061,CTCF,397
chr1,19653692,19654108,SRX5075174,SMARCA4,416
chr1,19653698,19653995,SRX4174629,CTCF,297
chr1,19653706,19653965,SRX5716470,SMARCA4,259
chr1,19653708,19654106,SRX5716463,SMARCA4,398
chr1,19653710,19653980,SRX5075169,SMARCA4,270
chr1,19653726,19654086,SRX5075168,SMARCA4,360
chr1,19653732,19653998,SRX5075170,SMARCA4,266
chr1,19653737,19654006,SRX5075176,SMARCA4,269
chr1,19653839,19654166,SRX20140895,INTS13,327
chr1,19659690,19660050,SRX5716470,SMARCA4,360
chr1,19659698,19660072,SRX5075168,SMARCA4,374
chr1,19659722,19660177,SRX5075174,SMARCA4,455
chr1,19659737,19660047,SRX5075176,SMARCA4,310
chr1,19659745,19660072,SRX5716463,SMARCA4,327
chr1,19659759,19660242,SRX16500060,CTCF,483
chr1,19659762,19660042,SRX5075170,SMARCA4,280
chr1,19659784,19660295,SRX16500061,CTCF,511
chr1,19659805,19660325,SRX16500059,CTCF,520
chr1,19659835,19660242,SRX16500062,CTCF,407
chr1,19661718,19662211,SRX16500061,CTCF,493
chr1,19661727,19662174,SRX16500059,CTCF,447
chr1,19661732,19662193,SRX16500060,CTCF,461
chr1,19661748,19662193,SRX16500062,CTCF,445
chr1,19661812,19662068,SRX5075174,SMARCA4,256
chr1,19661828,19662029,SRX5075170,SMARCA4,201
chr1,19661835,19662046,SRX5075168,SMARCA4,211
chr1,19661851,19662026,SRX5075176,SMARCA4,175
chr1,19676464,19676693,SRX5716470,SMARCA4,229
chr1,19676479,19676670,SRX5075169,SMARCA4,191
chr1,19676490,19676711,SRX5075168,SMARCA4,221
chr1,19676497,19676757,SRX5075170,SMARCA4,260
chr1,19676508,19676719,SRX5075174,SMARCA4,211
chr1,19676510,19676697,SRX5075175,SMARCA4,187
chr1,19676539,19676720,SRX5075176,SMARCA4,181
chr1,19682247,19682471,SRX5075174,SMARCA4,224
chr1,19682261,19682572,SRX5075168,SMARCA4,311
chr1,19682280,19682563,SRX5054308,FOSL2,283
chr1,19682322,19682549,SRX5054309,FOSL2,227
chr1,19682324,19682516,SRX5075170,SMARCA4,192
chr1,19682345,19682541,SRX5075176,SMARCA4,196
chr1,19704238,19704470,SRX5075174,SMARCA4,232
chr1,19704424,19704961,SRX16500059,CTCF,537
chr1,19704447,19705008,SRX16500060,CTCF,561
chr1,19704452,19704974,SRX16500062,CTCF,522
chr1,19704497,19704947,SRX16500061,CTCF,450
chr1,19704522,19704887,SRX5075168,SMARCA4,365
chr1,19704526,19704880,SRX5075174,SMARCA4,354
chr1,19704555,19704802,SRX5075176,SMARCA4,247
chr1,19704584,19704882,SRX5716463,SMARCA4,298
chr1,19704595,19704837,SRX5716464,SMARCA4,242
chr1,19704597,19704779,SRX5075170,SMARCA4,182
chr1,19704612,19704954,SRX4174629,CTCF,342
chr1,19704618,19704829,SRX5716470,SMARCA4,211
chr1,19715490,19716162,SRX16500059,CTCF,672
chr1,19715554,19715988,SRX5075168,SMARCA4,434
chr1,19715564,19715968,SRX5075174,SMARCA4,404
chr1,19715566,19716089,SRX16500062,CTCF,523
chr1,19715568,19716122,SRX16500060,CTCF,554
chr1,19715574,19716059,SRX4174629,CTCF,485
chr1,19715576,19716076,SRX16500061,CTCF,500
chr1,19715582,19715944,SRX5075170,SMARCA4,362
chr1,19715592,19715964,SRX5716463,SMARCA4,372
chr1,19715620,19715937,SRX5716464,SMARCA4,317
chr1,19715638,19715926,SRX5075176,SMARCA4,288
chr1,19715667,19715916,SRX5716470,SMARCA4,249
chr1,19715717,19715904,SRX5075169,SMARCA4,187
chr1,19715720,19715932,SRX5716469,SMARCA4,212
chr1,19715726,19715921,SRX5075175,SMARCA4,195
chr1,19735705,19736174,SRX5075169,SMARCA4,469
chr1,19735786,19736195,SRX5075176,SMARCA4,409
chr1,19735858,19736292,SRX5075170,SMARCA4,434
chr1,19735869,19736150,SRX5716467,SMARCA2,281
chr1,19735883,19736152,SRX5054308,FOSL2,269
chr1,19735884,19736178,SRX5716469,SMARCA4,294
chr1,19735888,19736210,SRX5075175,SMARCA4,322
chr1,19735925,19736139,SRX5054309,FOSL2,214
chr1,19737400,19737643,SRX16500062,CTCF,243
chr1,19737433,19737668,SRX16500059,CTCF,235
chr1,19737468,19737681,SRX5075174,SMARCA4,213
chr1,19737470,19737691,SRX16500060,CTCF,221
chr1,19737507,19737615,SRX1424893,POU3F2,108
chr1,19737511,19737607,SRX1424891,POU3F2,96
chr1,19737519,19737756,SRX5075168,SMARCA4,237
chr1,19737535,19737634,SRX1424892,POU3F2,99
chr1,19737543,19737596,SRX1424894,POU3F2,53
chr1,19758289,19758668,SRX5716470,SMARCA4,379
chr1,19758298,19758663,SRX5075175,SMARCA4,365
chr1,19758303,19758637,SRX5054309,FOSL2,334
chr1,19758310,19758620,SRX5075170,SMARCA4,310
chr1,19758333,19758633,SRX5020211,SMARCA2,300
chr1,19758346,19758636,SRX5716469,SMARCA4,290
chr1,19758351,19758621,SRX5054308,FOSL2,270
chr1,19758358,19758692,SRX5075169,SMARCA4,334
chr1,19758404,19758639,SRX5075176,SMARCA4,235
chr1,19762040,19762684,SRX16500059,CTCF,644
chr1,19762090,19762620,SRX16500060,CTCF,530
chr1,19762156,19762546,SRX16500061,CTCF,390
chr1,19762212,19762523,SRX16500062,CTCF,311
chr1,19765601,19766001,SRX5075169,SMARCA4,400
chr1,19765606,19766012,SRX5075170,SMARCA4,406
chr1,19765614,19766023,SRX5075174,SMARCA4,409
chr1,19765615,19765988,SRX5054309,FOSL2,373
chr1,19765618,19765994,SRX5075175,SMARCA4,376
chr1,19765622,19766035,SRX5075168,SMARCA4,413
chr1,19765636,19765975,SRX5054308,FOSL2,339
chr1,19765636,19765990,SRX5075176,SMARCA4,354
chr1,19765662,19765988,SRX5716469,SMARCA4,326
chr1,19765705,19765981,SRX5020214,SMARCA2,276
chr1,19799717,19800034,SRX5075175,SMARCA4,317
chr1,19800061,19800552,SRX5075169,SMARCA4,491
chr1,19800134,19800379,SRX5716470,SMARCA4,245
chr1,19800150,19800480,SRX5075175,SMARCA4,330
chr1,19800193,19800559,SRX5075176,SMARCA4,366
chr1,19800343,19800529,SRX5075170,SMARCA4,186
chr1,19811294,19811515,SRX16500062,CTCF,221
chr1,19877951,19878063,SRX1424891,POU3F2,112
chr1,19878008,19878064,SRX1424894,POU3F2,56
chr1,19881949,19882608,SRX16500060,CTCF,659
chr1,19881955,19882572,SRX16500059,CTCF,617
chr1,19881973,19882553,SRX16500061,CTCF,580
chr1,19881996,19882452,SRX4174629,CTCF,456
chr1,19882000,19882444,SRX5716464,SMARCA4,444
chr1,19882004,19882580,SRX16500062,CTCF,576
chr1,19882067,19882557,SRX5075174,SMARCA4,490
chr1,19882072,19882457,SRX5716463,SMARCA4,385
chr1,19882072,19882810,SRX5075176,SMARCA4,738
chr1,19882097,19882489,SRX5075168,SMARCA4,392
chr1,19882099,19882643,SRX5075170,SMARCA4,544
chr1,19882102,19882882,SRX5075169,SMARCA4,780
chr1,19882107,19882794,SRX20140895,INTS13,687
chr1,19882127,19882694,SRX5075175,SMARCA4,567
chr1,19882152,19882704,SRX5716470,SMARCA4,552
chr1,19882164,19882373,SRX5716454,SOX3,209
chr1,19882164,19882429,SRX5716451,SOX2,265
chr1,19882199,19882627,SRX20140897,INTS13,428
chr1,19882217,19882643,SRX20140867,INTS10,426
chr1,19882326,19882664,SRX20140868,INTS10,338
chr1,19882598,19882849,SRX5716469,SMARCA4,251
chr1,19892771,19893009,SRX5054308,FOSL2,238
chr1,19917894,19918443,SRX16500059,CTCF,549
chr1,19917926,19918549,SRX4174629,CTCF,623
chr1,19917965,19918401,SRX16500060,CTCF,436
chr1,19917972,19918399,SRX16500062,CTCF,427
chr1,19917979,19918421,SRX16500061,CTCF,442
chr1,19918075,19918296,SRX5716470,SMARCA4,221
chr1,19936481,19936666,SRX5075174,SMARCA4,185
chr1,19974757,19975158,SRX16500059,CTCF,401
chr1,19974770,19975164,SRX16500060,CTCF,394
chr1,19974796,19975138,SRX16500061,CTCF,342
chr1,19974799,19975118,SRX16500062,CTCF,319
chr1,20100877,20101268,SRX16500059,CTCF,391
chr1,20100888,20101273,SRX16500060,CTCF,385
chr1,20100921,20101291,SRX16500061,CTCF,370
chr1,20100941,20101256,SRX16500062,CTCF,315
chr1,20108410,20108751,SRX5075168,SMARCA4,341
chr1,20108411,20108784,SRX5075174,SMARCA4,373
chr1,20108569,20108764,SRX5716451,SOX2,195
chr1,20152222,20152770,SRX16500060,CTCF,548
chr1,20152255,20152782,SRX16500059,CTCF,527
chr1,20152267,20152751,SRX16500061,CTCF,484
chr1,20152268,20152762,SRX16500062,CTCF,494
chr1,20152314,20152660,SRX4174629,CTCF,346
chr1,20152368,20152597,SRX5716464,SMARCA4,229
chr1,20152371,20152572,SRX5075168,SMARCA4,201
chr1,20152371,20152603,SRX5075174,SMARCA4,232
chr1,20165508,20165718,SRX16500062,CTCF,210
chr1,20195134,20195563,SRX16500060,CTCF,429
chr1,20195167,20195586,SRX16500059,CTCF,419
chr1,20195177,20195603,SRX16500061,CTCF,426
chr1,20195228,20195600,SRX16500062,CTCF,372
chr1,20212708,20213254,SRX16500059,CTCF,546
chr1,20212744,20213245,SRX16500061,CTCF,501
chr1,20212750,20213258,SRX16500060,CTCF,508
chr1,20212770,20213247,SRX16500062,CTCF,477
chr1,20212855,20213172,SRX5075168,SMARCA4,317
chr1,20212885,20213180,SRX5075174,SMARCA4,295
chr1,20212900,20213127,SRX5716470,SMARCA4,227
chr1,20212930,20213165,SRX5075176,SMARCA4,235
chr1,20213016,20213270,SRX4174629,CTCF,254
chr1,20233267,20233477,SRX4174629,CTCF,210
chr1,20233375,20233687,SRX16500060,CTCF,312
chr1,20233406,20233778,SRX16500059,CTCF,372
chr1,20233429,20233728,SRX16500061,CTCF,299
chr1,20233458,20233740,SRX16500062,CTCF,282
chr1,20255871,20256122,SRX5054308,FOSL2,251
chr1,20271536,20271781,SRX16500060,CTCF,245
chr1,20290747,20290922,SRX5075174,SMARCA4,175
chr1,20361747,20362251,SRX16500060,CTCF,504
chr1,20361784,20362170,SRX16500062,CTCF,386
chr1,20361796,20362206,SRX16500059,CTCF,410
chr1,20361812,20362180,SRX16500061,CTCF,368
chr1,20361903,20362141,SRX4174629,CTCF,238
chr1,20367113,20367492,SRX16500060,CTCF,379
chr1,20367115,20367534,SRX16500059,CTCF,419
chr1,20367120,20367495,SRX16500061,CTCF,375
chr1,20367139,20367516,SRX16500062,CTCF,377
chr1,20376758,20377308,SRX16500062,CTCF,550
chr1,20376830,20377301,SRX16500061,CTCF,471
chr1,20376833,20377318,SRX16500059,CTCF,485
chr1,20376837,20377342,SRX16500060,CTCF,505
chr1,20376957,20377279,SRX5075174,SMARCA4,322
chr1,20376988,20377219,SRX4174629,CTCF,231
chr1,20406179,20406478,SRX5075176,SMARCA4,299
chr1,20406208,20406428,SRX5716470,SMARCA4,220
chr1,20406211,20406423,SRX5716469,SMARCA4,212
chr1,20406228,20406428,SRX5020211,SMARCA2,200
chr1,20406242,20406486,SRX5075175,SMARCA4,244
chr1,20406265,20406507,SRX5075169,SMARCA4,242
chr1,20406287,20406466,SRX5075182,SMARCA2,179
chr1,20406291,20406460,SRX5075170,SMARCA4,169
chr1,20406298,20406481,SRX5054309,FOSL2,183
chr1,20411245,20411510,SRX5075169,SMARCA4,265
chr1,20411256,20411485,SRX5075170,SMARCA4,229
chr1,20411266,20411530,SRX5054309,FOSL2,264
chr1,20411266,20411545,SRX5075176,SMARCA4,279
chr1,20411306,20411538,SRX5075175,SMARCA4,232
chr1,20426858,20427237,SRX5075175,SMARCA4,379
chr1,20426935,20427228,SRX5054309,FOSL2,293
chr1,20426947,20427227,SRX5075170,SMARCA4,280
chr1,20426970,20427188,SRX5054308,FOSL2,218
chr1,20426970,20427264,SRX5075176,SMARCA4,294
chr1,20426975,20427229,SRX5075169,SMARCA4,254
chr1,20430290,20430790,SRX16500059,CTCF,500
chr1,20430351,20430860,SRX16500061,CTCF,509
chr1,20430376,20430800,SRX16500062,CTCF,424
chr1,20430402,20430799,SRX16500060,CTCF,397
chr1,20430420,20430650,SRX4174629,CTCF,230
chr1,20440720,20441165,SRX20140895,INTS13,445
chr1,20440873,20441052,SRX5075168,SMARCA4,179
chr1,20448585,20449104,SRX5075174,SMARCA4,519
chr1,20448599,20449015,SRX5075168,SMARCA4,416
chr1,20448668,20448928,SRX5716451,SOX2,260
chr1,20448698,20448997,SRX5716463,SMARCA4,299
chr1,20448743,20448971,SRX5716454,SOX3,228
chr1,20476552,20476747,SRX5075174,SMARCA4,195
chr1,20486421,20486966,SRX20140895,INTS13,545
chr1,20486685,20486977,SRX5075168,SMARCA4,292
chr1,20493693,20494515,SRX16500060,CTCF,822
chr1,20493727,20494220,SRX16500061,CTCF,493
chr1,20493734,20494432,SRX16500059,CTCF,698
chr1,20493757,20494189,SRX16500062,CTCF,432
chr1,20493787,20494493,SRX4174629,CTCF,706
chr1,20493821,20494087,SRX5075174,SMARCA4,266
chr1,20493860,20494086,SRX5075168,SMARCA4,226
chr1,20493872,20494088,SRX5075170,SMARCA4,216
chr1,20494319,20494665,SRX5075170,SMARCA4,346
chr1,20494385,20494660,SRX5075175,SMARCA4,275
chr1,20496321,20496560,SRX5054309,FOSL2,239
chr1,20507821,20508457,SRX20140895,INTS13,636
chr1,20507919,20508291,SRX20140868,INTS10,372
chr1,20507934,20508503,SRX20140869,INTS10,569
chr1,20507966,20508458,SRX5075168,SMARCA4,492
chr1,20507990,20508477,SRX5075174,SMARCA4,487
chr1,20508114,20508435,SRX5716463,SMARCA4,321
chr1,20508216,20508424,SRX5716464,SMARCA4,208
chr1,20522191,20522791,SRX16500060,CTCF,600
chr1,20522214,20522793,SRX16500061,CTCF,579
chr1,20522243,20522780,SRX16500059,CTCF,537
chr1,20522268,20522788,SRX16500062,CTCF,520
chr1,20522338,20522583,SRX5075174,SMARCA4,245
chr1,20522355,20522675,SRX4174629,CTCF,320
chr1,20522365,20522596,SRX5075168,SMARCA4,231
chr1,20522382,20522579,SRX5075176,SMARCA4,197
chr1,20522385,20522572,SRX5075169,SMARCA4,187
chr1,20522428,20522645,SRX5075170,SMARCA4,217
chr1,20575180,20575613,SRX16500060,CTCF,433
chr1,20575207,20575646,SRX16500059,CTCF,439
chr1,20575217,20575615,SRX16500062,CTCF,398
chr1,20575220,20575615,SRX16500061,CTCF,395
chr1,20589393,20590049,SRX5075176,SMARCA4,656
chr1,20589395,20589632,SRX5075170,SMARCA4,237
chr1,20589755,20589970,SRX5075169,SMARCA4,215
chr1,20589887,20590086,SRX5075170,SMARCA4,199
chr1,20613807,20614218,SRX5075176,SMARCA4,411
chr1,20613811,20614221,SRX5075169,SMARCA4,410
chr1,20613847,20614200,SRX5075170,SMARCA4,353
chr1,20613872,20614233,SRX5075175,SMARCA4,361
chr1,20613884,20614165,SRX5716469,SMARCA4,281
chr1,20613897,20614206,SRX5054309,FOSL2,309
chr1,20613905,20614187,SRX5716470,SMARCA4,282
chr1,20613926,20614173,SRX5716467,SMARCA2,247
chr1,20627562,20627731,SRX5075170,SMARCA4,169
chr1,20633044,20633396,SRX4174629,CTCF,352
chr1,20633077,20633588,SRX16500060,CTCF,511
chr1,20633082,20633614,SRX16500059,CTCF,532
chr1,20633117,20633583,SRX16500061,CTCF,466
chr1,20633126,20633580,SRX16500062,CTCF,454
chr1,20633188,20633562,SRX5075168,SMARCA4,374
chr1,20633208,20633578,SRX5075174,SMARCA4,370
chr1,20633210,20633497,SRX5075170,SMARCA4,287
chr1,20633220,20633456,SRX5716463,SMARCA4,236
chr1,20633262,20633519,SRX5075176,SMARCA4,257
chr1,20633265,20633578,SRX5716464,SMARCA4,313
chr1,20633300,20633709,SRX5075169,SMARCA4,409
chr1,20633625,20633937,SRX20140895,INTS13,312
chr1,20640021,20640643,SRX16500059,CTCF,622
chr1,20640042,20640557,SRX16500062,CTCF,515
chr1,20640053,20640590,SRX16500061,CTCF,537
chr1,20640062,20640611,SRX16500060,CTCF,549
chr1,20640162,20640365,SRX5075168,SMARCA4,203
chr1,20640244,20640519,SRX4174629,CTCF,275
chr1,20661138,20661846,SRX20140895,INTS13,708
chr1,20661213,20661884,SRX5075176,SMARCA4,671
chr1,20661219,20661639,SRX20140868,INTS10,420
chr1,20661249,20661882,SRX5075168,SMARCA4,633
chr1,20661302,20661575,SRX5075170,SMARCA4,273
chr1,20661394,20661670,SRX5054307,FOSL2,276
chr1,20661410,20661919,SRX5075174,SMARCA4,509
chr1,20661413,20661653,SRX5716454,SOX3,240
chr1,20661505,20661695,SRX5716451,SOX2,190
chr1,20661604,20661833,SRX5075175,SMARCA4,229
chr1,20661717,20661922,SRX5075169,SMARCA4,205
chr1,20696311,20697212,SRX16500059,CTCF,901
chr1,20696328,20697196,SRX16500060,CTCF,868
chr1,20696356,20697181,SRX16500062,CTCF,825
chr1,20696371,20697173,SRX16500061,CTCF,802
chr1,20696417,20696993,SRX4174629,CTCF,576
chr1,20696429,20697202,SRX5075174,SMARCA4,773
chr1,20696482,20696977,SRX5716470,SMARCA4,495
chr1,20696506,20697239,SRX5075176,SMARCA4,733
chr1,20696517,20697047,SRX20140868,INTS10,530
chr1,20696522,20697216,SRX5075168,SMARCA4,694
chr1,20696526,20697226,SRX5075169,SMARCA4,700
chr1,20696541,20696772,SRX5075175,SMARCA4,231
chr1,20696570,20697253,SRX5075170,SMARCA4,683
chr1,20696690,20697296,SRX20140895,INTS13,606
chr1,20696699,20697197,SRX5716469,SMARCA4,498
chr1,20696745,20697169,SRX5716463,SMARCA4,424
chr1,20696831,20697210,SRX20140897,INTS13,379
chr1,20696851,20697135,SRX5075175,SMARCA4,284
chr1,20696939,20697144,SRX5716464,SMARCA4,205
chr1,20698506,20698808,SRX5054308,FOSL2,302
chr1,20698509,20698745,SRX5054309,FOSL2,236
chr1,20698558,20698765,SRX5075168,SMARCA4,207
chr1,20698578,20698764,SRX5075176,SMARCA4,186
chr1,20698591,20698782,SRX5075174,SMARCA4,191
chr1,20702492,20702711,SRX16500061,CTCF,219
chr1,20702498,20702740,SRX16500059,CTCF,242
chr1,20702525,20702750,SRX16500060,CTCF,225
chr1,20705451,20705631,SRX5075174,SMARCA4,180
chr1,20711259,20711859,SRX5075168,SMARCA4,600
chr1,20711278,20711635,SRX5716463,SMARCA4,357
chr1,20711308,20711767,SRX5075174,SMARCA4,459
chr1,20711407,20711619,SRX5716464,SMARCA4,212
chr1,20711686,20712135,SRX16500060,CTCF,449
chr1,20711725,20711967,SRX16500062,CTCF,242
chr1,20711745,20712004,SRX16500061,CTCF,259
chr1,20711761,20712064,SRX16500059,CTCF,303
chr1,20717430,20717984,SRX20140895,INTS13,554
chr1,20717589,20718075,SRX5075174,SMARCA4,486
chr1,20717596,20718261,SRX5075168,SMARCA4,665
chr1,20717699,20717911,SRX5075175,SMARCA4,212
chr1,20717896,20718280,SRX5716470,SMARCA4,384
chr1,20717905,20718265,SRX5075169,SMARCA4,360
chr1,20717984,20718247,SRX5716469,SMARCA4,263
chr1,20718015,20718305,SRX5075176,SMARCA4,290
chr1,20718036,20718284,SRX5075170,SMARCA4,248
chr1,20731971,20732389,SRX20140895,INTS13,418
chr1,20732070,20732369,SRX5075168,SMARCA4,299
chr1,20732125,20732425,SRX5075174,SMARCA4,300
chr1,20732911,20733267,SRX16500059,CTCF,356
chr1,20732968,20733335,SRX16500061,CTCF,367
chr1,20733034,20733436,SRX5054309,FOSL2,402
chr1,20733074,20733337,SRX16500060,CTCF,263
chr1,20733079,20733408,SRX5075176,SMARCA4,329
chr1,20733101,20733398,SRX5075170,SMARCA4,297
chr1,20733114,20733443,SRX5075175,SMARCA4,329
chr1,20733126,20733388,SRX5716469,SMARCA4,262
chr1,20733127,20733422,SRX5075169,SMARCA4,295
chr1,20733139,20733440,SRX5054308,FOSL2,301
chr1,20733155,20733390,SRX5075174,SMARCA4,235
chr1,20733158,20733441,SRX5716470,SMARCA4,283
chr1,20733161,20733376,SRX5054307,FOSL2,215
chr1,20733184,20733367,SRX5075168,SMARCA4,183
chr1,20739226,20739471,SRX5075176,SMARCA4,245
chr1,20739248,20739458,SRX5075175,SMARCA4,210
chr1,20751635,20752016,SRX5075168,SMARCA4,381
chr1,20751683,20752061,SRX5075174,SMARCA4,378
chr1,20751692,20751934,SRX5716463,SMARCA4,242
chr1,20786212,20787334,SRX20140895,INTS13,1122
chr1,20786353,20787280,SRX20140868,INTS10,927
chr1,20786438,20786762,SRX20140897,INTS13,324
chr1,20786439,20787548,SRX20140867,INTS10,1109
chr1,20786464,20786818,SRX5075170,SMARCA4,354
chr1,20786471,20786732,SRX20140881,CPSF3L,261
chr1,20786473,20786926,SRX5075176,SMARCA4,453
chr1,20786520,20787255,SRX5075168,SMARCA4,735
chr1,20786565,20786815,SRX5054309,FOSL2,250
chr1,20786580,20787046,SRX5075174,SMARCA4,466
chr1,20786592,20786774,SRX5075169,SMARCA4,182
chr1,20786773,20787043,SRX5716451,SOX2,270
chr1,20786896,20787254,SRX20140897,INTS13,358
chr1,20786936,20787510,SRX20140896,INTS13,574
chr1,20787026,20787338,SRX20140869,INTS10,312
chr1,20787440,20787687,SRX5075176,SMARCA4,247
chr1,20787465,20787702,SRX5075170,SMARCA4,237
chr1,20787500,20787745,SRX5075169,SMARCA4,245
chr1,20792243,20792476,SRX5054308,FOSL2,233
chr1,20792252,20792536,SRX5716470,SMARCA4,284
chr1,20792270,20792485,SRX5716467,SMARCA2,215
chr1,20792272,20792584,SRX5075175,SMARCA4,312
chr1,20792296,20792547,SRX5716469,SMARCA4,251
chr1,20792297,20792485,SRX5075170,SMARCA4,188
chr1,20792306,20792501,SRX5075176,SMARCA4,195
chr1,20847567,20847842,SRX5054308,FOSL2,275
chr1,20847587,20847836,SRX5054309,FOSL2,249
chr1,20847631,20847826,SRX5075176,SMARCA4,195
chr1,20847645,20847814,SRX5075170,SMARCA4,169
chr1,20871477,20871748,SRX5716470,SMARCA4,271
chr1,20921302,20921690,SRX5075174,SMARCA4,388
chr1,20921349,20921701,SRX5075168,SMARCA4,352
chr1,20950342,20950586,SRX5075168,SMARCA4,244
chr1,20962649,20962897,SRX5075176,SMARCA4,248
chr1,20962675,20962904,SRX5075170,SMARCA4,229
chr1,20981980,20982312,SRX16500060,CTCF,332
chr1,20982416,20982654,SRX5054309,FOSL2,238
chr1,20982433,20982625,SRX5075175,SMARCA4,192
chr1,20982488,20982668,SRX5075169,SMARCA4,180
chr1,20992754,20992975,SRX5716467,SMARCA2,221
chr1,20992810,20993052,SRX5075170,SMARCA4,242
chr1,20994263,20994481,SRX5075174,SMARCA4,218
chr1,21012873,21013318,SRX5075176,SMARCA4,445
chr1,21012930,21013203,SRX5716470,SMARCA4,273
chr1,21012961,21013374,SRX5075170,SMARCA4,413
chr1,21013012,21013245,SRX5075175,SMARCA4,233
chr1,21013025,21013254,SRX5716469,SMARCA4,229
chr1,21013043,21013351,SRX5075169,SMARCA4,308
chr1,21022129,21022614,SRX5716460,Epitope tags,485
chr1,21022144,21022848,SRX5716470,SMARCA4,704
chr1,21022153,21022830,SRX5075176,SMARCA4,677
chr1,21022170,21022831,SRX5716469,SMARCA4,661
chr1,21022176,21022726,SRX5075169,SMARCA4,550
chr1,21022186,21022874,SRX5075170,SMARCA4,688
chr1,21022205,21022697,SRX5716467,SMARCA2,492
chr1,21022222,21022644,SRX5054309,FOSL2,422
chr1,21022227,21022720,SRX5020211,SMARCA2,493
chr1,21022233,21022674,SRX5020214,SMARCA2,441
chr1,21022248,21022782,SRX5075175,SMARCA4,534
chr1,21022250,21022656,SRX5075181,SMARCA2,406
chr1,21022270,21022657,SRX5716468,SMARCA2,387
chr1,21022280,21022713,SRX5054308,FOSL2,433
chr1,21022292,21022518,SRX5075174,SMARCA4,226
chr1,21022322,21022582,SRX5075182,SMARCA2,260
chr1,21022345,21022550,SRX5075168,SMARCA4,205
chr1,21043230,21043636,SRX5075169,SMARCA4,406
chr1,21043337,21043582,SRX5075170,SMARCA4,245
chr1,21043381,21043593,SRX5716469,SMARCA4,212
chr1,21043400,21043600,SRX5075176,SMARCA4,200
chr1,21050164,21050364,SRX5020211,SMARCA2,200
chr1,21059100,21059289,SRX5075176,SMARCA4,189
chr1,21059107,21059301,SRX5075169,SMARCA4,194
chr1,21066731,21066911,SRX5054308,FOSL2,180
chr1,21069553,21069885,SRX5075176,SMARCA4,332
chr1,21069606,21069888,SRX5075174,SMARCA4,282
chr1,21069610,21069891,SRX5075170,SMARCA4,281
chr1,21069643,21069880,SRX5075168,SMARCA4,237
chr1,21069654,21069908,SRX5075169,SMARCA4,254
chr1,21069678,21069865,SRX5075175,SMARCA4,187
chr1,21090603,21090782,SRX5075170,SMARCA4,179
chr1,21091063,21091407,SRX5075176,SMARCA4,344
chr1,21091066,21091463,SRX5075169,SMARCA4,397
chr1,21091069,21091405,SRX5075170,SMARCA4,336
chr1,21091077,21091404,SRX5054309,FOSL2,327
chr1,21091099,21091432,SRX5075175,SMARCA4,333
chr1,21091101,21091401,SRX5054308,FOSL2,300
chr1,21091108,21091323,SRX5716467,SMARCA2,215
chr1,21091137,21091376,SRX5075168,SMARCA4,239
chr1,21091157,21091382,SRX5075174,SMARCA4,225
chr1,21091169,21091381,SRX5716469,SMARCA4,212
chr1,21115127,21115351,SRX5075170,SMARCA4,224
chr1,21117429,21117892,SRX5075168,SMARCA4,463
chr1,21117498,21117941,SRX5075174,SMARCA4,443
chr1,21124915,21125095,SRX5075169,SMARCA4,180
chr1,21149383,21149638,SRX5075174,SMARCA4,255
chr1,21149394,21149585,SRX5075168,SMARCA4,191
chr1,21149795,21150324,SRX5075169,SMARCA4,529
chr1,21149812,21150295,SRX5716469,SMARCA4,483
chr1,21149826,21150294,SRX5075175,SMARCA4,468
chr1,21149851,21150299,SRX5716470,SMARCA4,448
chr1,21149855,21150262,SRX5054309,FOSL2,407
chr1,21149865,21150257,SRX5075170,SMARCA4,392
chr1,21149875,21150202,SRX5054308,FOSL2,327
chr1,21149891,21150323,SRX5075176,SMARCA4,432
chr1,21149898,21150121,SRX5075182,SMARCA2,223
chr1,21149898,21150229,SRX5020211,SMARCA2,331
chr1,21149920,21150208,SRX5020214,SMARCA2,288
chr1,21149922,21150178,SRX5716468,SMARCA2,256
chr1,21149936,21150221,SRX5716467,SMARCA2,285
chr1,21149942,21150179,SRX5075181,SMARCA2,237
chr1,21150068,21150279,SRX5075168,SMARCA4,211
chr1,21165103,21165309,SRX5075170,SMARCA4,206
chr1,21165720,21165973,SRX5054309,FOSL2,253
chr1,21171029,21171216,SRX5075175,SMARCA4,187
chr1,21171050,21171270,SRX5075169,SMARCA4,220
chr1,21171056,21171276,SRX5075170,SMARCA4,220
chr1,21176572,21177367,SRX20140895,INTS13,795
chr1,21176609,21176872,SRX20140867,INTS10,263
chr1,21176652,21176912,SRX20140879,CPSF3L,260
chr1,21176667,21176948,SRX20140868,INTS10,281
chr1,21176683,21177307,SRX5075168,SMARCA4,624
chr1,21176723,21177208,SRX5075170,SMARCA4,485
chr1,21176727,21177319,SRX20140897,INTS13,592
chr1,21176748,21177345,SRX5075174,SMARCA4,597
chr1,21176972,21177193,SRX5716463,SMARCA4,221
chr1,21177024,21177316,SRX5075176,SMARCA4,292
chr1,21195058,21195669,SRX16500059,CTCF,611
chr1,21195118,21195409,SRX4174629,CTCF,291
chr1,21195125,21195701,SRX16500061,CTCF,576
chr1,21195132,21195421,SRX5075169,SMARCA4,289
chr1,21195146,21195656,SRX16500062,CTCF,510
chr1,21195147,21195652,SRX16500060,CTCF,505
chr1,21195149,21195473,SRX5075168,SMARCA4,324
chr1,21195165,21195443,SRX5716469,SMARCA4,278
chr1,21195180,21195465,SRX5075174,SMARCA4,285
chr1,21195203,21195434,SRX5716464,SMARCA4,231
chr1,21195208,21195501,SRX5075176,SMARCA4,293
chr1,21195225,21195394,SRX5075170,SMARCA4,169
chr1,21199042,21199249,SRX5716463,SMARCA4,207
chr1,21199080,21199305,SRX5716454,SOX3,225
chr1,21216881,21217183,SRX16500062,CTCF,302
chr1,21216894,21217270,SRX16500060,CTCF,376
chr1,21216901,21217247,SRX16500061,CTCF,346
chr1,21216903,21217293,SRX16500059,CTCF,390
chr1,21217915,21218240,SRX16500061,CTCF,325
chr1,21217930,21218223,SRX16500060,CTCF,293
chr1,21217947,21218193,SRX16500059,CTCF,246
chr1,21217957,21218235,SRX16500062,CTCF,278
chr1,21229330,21229613,SRX5075175,SMARCA4,283
chr1,21229348,21229528,SRX5075169,SMARCA4,180
chr1,21229420,21229618,SRX5054309,FOSL2,198
chr1,21229617,21229809,SRX5075169,SMARCA4,192
chr1,21231897,21232391,SRX16500059,CTCF,494
chr1,21231917,21232407,SRX16500060,CTCF,490
chr1,21231937,21232326,SRX4174629,CTCF,389
chr1,21231952,21232415,SRX16500062,CTCF,463
chr1,21231953,21232393,SRX16500061,CTCF,440
chr1,21232020,21232287,SRX5075168,SMARCA4,267
chr1,21232034,21232299,SRX5075174,SMARCA4,265
chr1,21238258,21238612,SRX5075168,SMARCA4,354
chr1,21238305,21238577,SRX20140867,INTS10,272
chr1,21238327,21238760,SRX5075174,SMARCA4,433
chr1,21245073,21245313,SRX16500062,CTCF,240
chr1,21245096,21245350,SRX16500059,CTCF,254
chr1,21245127,21245448,SRX16500061,CTCF,321
chr1,21252117,21252532,SRX5716469,SMARCA4,415
chr1,21252152,21252528,SRX5054308,FOSL2,376
chr1,21252189,21252563,SRX5075170,SMARCA4,374
chr1,21252198,21252530,SRX5075176,SMARCA4,332
chr1,21252205,21252509,SRX5054309,FOSL2,304
chr1,21252206,21252531,SRX5716470,SMARCA4,325
chr1,21252206,21252579,SRX5075169,SMARCA4,373
chr1,21252210,21252449,SRX5716467,SMARCA2,239
chr1,21252229,21252535,SRX5020211,SMARCA2,306
chr1,21252244,21252540,SRX5075175,SMARCA4,296
chr1,21254085,21254848,SRX5075176,SMARCA4,763
chr1,21254231,21254446,SRX5716467,SMARCA2,215
chr1,21254262,21254795,SRX5075170,SMARCA4,533
chr1,21255082,21255601,SRX16500060,CTCF,519
chr1,21255088,21255606,SRX16500061,CTCF,518
chr1,21255088,21255613,SRX16500059,CTCF,525
chr1,21255145,21255608,SRX16500062,CTCF,463
chr1,21255231,21255573,SRX4174629,CTCF,342
chr1,21255314,21255582,SRX5075168,SMARCA4,268
chr1,21255347,21255636,SRX5075174,SMARCA4,289
chr1,21260779,21261010,SRX5716468,SMARCA2,231
chr1,21260788,21261207,SRX5075170,SMARCA4,419
chr1,21260790,21261093,SRX5075176,SMARCA4,303
chr1,21260836,21261033,SRX5075169,SMARCA4,197
chr1,21261681,21262525,SRX5075174,SMARCA4,844
chr1,21261706,21262468,SRX5075168,SMARCA4,762
chr1,21261798,21262166,SRX5075169,SMARCA4,368
chr1,21261821,21262140,SRX5054309,FOSL2,319
chr1,21261854,21262176,SRX5075175,SMARCA4,322
chr1,21261861,21262059,SRX5075176,SMARCA4,198
chr1,21261863,21262163,SRX5054308,FOSL2,300
chr1,21261867,21262075,SRX5075170,SMARCA4,208
chr1,21261900,21262223,SRX5716469,SMARCA4,323
chr1,21262876,21263051,SRX5075176,SMARCA4,175
chr1,21267471,21267679,SRX5054308,FOSL2,208
chr1,21270081,21270571,SRX16500062,CTCF,490
chr1,21270138,21270624,SRX16500059,CTCF,486
chr1,21270142,21270618,SRX16500060,CTCF,476
chr1,21270174,21270575,SRX16500061,CTCF,401
chr1,21270371,21270628,SRX4174629,CTCF,257
chr1,21279562,21279761,SRX5075169,SMARCA4,199
chr1,21295057,21295354,SRX5054309,FOSL2,297
chr1,21295074,21295318,SRX5054308,FOSL2,244
chr1,21299898,21300094,SRX5075176,SMARCA4,196
chr1,21303373,21303668,SRX5075170,SMARCA4,295
chr1,21303383,21303674,SRX5075169,SMARCA4,291
chr1,21303415,21303716,SRX5716470,SMARCA4,301
chr1,21303419,21303636,SRX5716467,SMARCA2,217
chr1,21303439,21303626,SRX5075175,SMARCA4,187
chr1,21303449,21303780,SRX5075176,SMARCA4,331
chr1,21308800,21309105,SRX5075170,SMARCA4,305
chr1,21308835,21309140,SRX5075176,SMARCA4,305
chr1,21308870,21309088,SRX5716467,SMARCA2,218
chr1,21308889,21309105,SRX5075175,SMARCA4,216
chr1,21308920,21309160,SRX5716468,SMARCA2,240
chr1,21313227,21313422,SRX5075176,SMARCA4,195
chr1,21313244,21313431,SRX5075174,SMARCA4,187
chr1,21314308,21314635,SRX5075170,SMARCA4,327
chr1,21314399,21314707,SRX5075176,SMARCA4,308
chr1,21314479,21314752,SRX5075168,SMARCA4,273
chr1,21318791,21318978,SRX5054308,FOSL2,187
chr1,21323134,21323342,SRX5075170,SMARCA4,208
chr1,21324226,21325064,SRX5075169,SMARCA4,838
chr1,21324266,21325044,SRX5075176,SMARCA4,778
chr1,21324282,21325048,SRX5075170,SMARCA4,766
chr1,21324300,21324938,SRX5075175,SMARCA4,638
chr1,21324394,21324868,SRX5075174,SMARCA4,474
chr1,21324434,21324973,SRX5716469,SMARCA4,539
chr1,21324447,21324766,SRX5075168,SMARCA4,319
chr1,21324459,21324987,SRX5054308,FOSL2,528
chr1,21324462,21325009,SRX5054309,FOSL2,547
chr1,21324463,21324936,SRX5716470,SMARCA4,473
chr1,21324510,21324792,SRX5716468,SMARCA2,282
chr1,21324518,21324817,SRX5716467,SMARCA2,299
chr1,21324521,21324898,SRX5020211,SMARCA2,377
chr1,21324529,21324761,SRX5020214,SMARCA2,232
chr1,21324534,21324762,SRX5075182,SMARCA2,228
chr1,21324539,21324765,SRX5054307,FOSL2,226
chr1,21324551,21324891,SRX5716459,Epitope tags,340
chr1,21324588,21324962,SRX5716460,Epitope tags,374
chr1,21334259,21334586,SRX5716469,SMARCA4,327
chr1,21334265,21334666,SRX5075175,SMARCA4,401
chr1,21334265,21334926,SRX5075169,SMARCA4,661
chr1,21334625,21335156,SRX16500060,CTCF,531
chr1,21334662,21335118,SRX16500061,CTCF,456
chr1,21334671,21335158,SRX16500059,CTCF,487
chr1,21334678,21335158,SRX16500062,CTCF,480
chr1,21334787,21334965,SRX5075174,SMARCA4,178
chr1,21345165,21345642,SRX5075175,SMARCA4,477
chr1,21345200,21345977,SRX20140895,INTS13,777
chr1,21345256,21345529,SRX5075169,SMARCA4,273
chr1,21345272,21345908,SRX20140868,INTS10,636
chr1,21345308,21345861,SRX20140867,INTS10,553
chr1,21345323,21345709,SRX5075168,SMARCA4,386
chr1,21345330,21345795,SRX5075174,SMARCA4,465
chr1,21345396,21345847,SRX5075170,SMARCA4,451
chr1,21345494,21345674,SRX5054307,FOSL2,180
chr1,21345515,21345826,SRX5075176,SMARCA4,311
chr1,21368406,21368933,SRX16500059,CTCF,527
chr1,21368443,21368876,SRX16500062,CTCF,433
chr1,21368445,21368793,SRX5075176,SMARCA4,348
chr1,21368445,21368876,SRX16500061,CTCF,431
chr1,21368450,21368891,SRX16500060,CTCF,441
chr1,21368469,21368893,SRX4174629,CTCF,424
chr1,21368520,21368777,SRX5075174,SMARCA4,257
chr1,21368521,21368795,SRX5075170,SMARCA4,274
chr1,21368526,21368770,SRX5075168,SMARCA4,244
chr1,21368542,21368739,SRX5075169,SMARCA4,197
chr1,21368555,21368757,SRX5075175,SMARCA4,202
chr1,21370560,21370895,SRX16500059,CTCF,335
chr1,21370566,21370848,SRX16500062,CTCF,282
chr1,21370568,21370934,SRX16500060,CTCF,366
chr1,21370576,21370871,SRX16500061,CTCF,295
chr1,21397815,21398232,SRX5075174,SMARCA4,417
chr1,21397838,21398190,SRX5075168,SMARCA4,352
chr1,21439824,21440351,SRX5075174,SMARCA4,527
chr1,21439831,21440281,SRX5075168,SMARCA4,450
chr1,21439844,21440136,SRX20140895,INTS13,292
chr1,21439849,21440206,SRX5075176,SMARCA4,357
chr1,21440126,21440347,SRX5716470,SMARCA4,221
chr1,21440260,21440534,SRX5716469,SMARCA4,274
chr1,21440424,21440616,SRX5075176,SMARCA4,192
chr1,21440499,21440686,SRX5075175,SMARCA4,187
chr1,21440541,21440806,SRX5075169,SMARCA4,265
chr1,21440582,21440836,SRX5075168,SMARCA4,254
chr1,21440672,21440886,SRX5075174,SMARCA4,214
chr1,21451061,21451563,SRX5716469,SMARCA4,502
chr1,21451094,21451605,SRX5075175,SMARCA4,511
chr1,21451144,21451605,SRX5716470,SMARCA4,461
chr1,21451155,21451548,SRX5075176,SMARCA4,393
chr1,21451158,21451533,SRX5075170,SMARCA4,375
chr1,21451166,21451508,SRX5716467,SMARCA2,342
chr1,21451168,21451525,SRX5054309,FOSL2,357
chr1,21451191,21451576,SRX5075169,SMARCA4,385
chr1,21451198,21451510,SRX5054308,FOSL2,312
chr1,21451214,21451432,SRX5020211,SMARCA2,218
chr1,21468651,21468886,SRX16500059,CTCF,235
chr1,21468683,21468904,SRX16500060,CTCF,221
chr1,21468714,21468933,SRX16500061,CTCF,219
chr1,21490639,21491041,SRX5075169,SMARCA4,402
chr1,21490765,21491087,SRX5075170,SMARCA4,322
chr1,21490766,21490972,SRX5054309,FOSL2,206
chr1,21490772,21491031,SRX5075175,SMARCA4,259
chr1,21490777,21491017,SRX5075176,SMARCA4,240
chr1,21490796,21491138,SRX16500060,CTCF,342
chr1,21490806,21491018,SRX5716469,SMARCA4,212
chr1,21490823,21491104,SRX16500062,CTCF,281
chr1,21490836,21491054,SRX5075174,SMARCA4,218
chr1,21490868,21491200,SRX16500059,CTCF,332
chr1,21490878,21491057,SRX5075168,SMARCA4,179
chr1,21490900,21491181,SRX16500061,CTCF,281
chr1,21491923,21492209,SRX5075176,SMARCA4,286
chr1,21491934,21492238,SRX5716470,SMARCA4,304
chr1,21491959,21492147,SRX5075175,SMARCA4,188
chr1,21491984,21492193,SRX5075170,SMARCA4,209
chr1,21491984,21492226,SRX5716469,SMARCA4,242
chr1,21491991,21492286,SRX5075169,SMARCA4,295
chr1,21508952,21509212,SRX20140895,INTS13,260
chr1,21509023,21509303,SRX16500060,CTCF,280
chr1,21509032,21509282,SRX16500061,CTCF,250
chr1,21509088,21509292,SRX5075174,SMARCA4,204
chr1,21509090,21509306,SRX5075168,SMARCA4,216
chr1,21509090,21509327,SRX16500062,CTCF,237
chr1,21509099,21509283,SRX5075176,SMARCA4,184
chr1,21509117,21509327,SRX5075170,SMARCA4,210
chr1,21509256,21509733,SRX20140895,INTS13,477
chr1,21509348,21509617,SRX20140868,INTS10,269
chr1,21509479,21509824,SRX20140879,CPSF3L,345
chr1,21511930,21512332,SRX5075175,SMARCA4,402
chr1,21511932,21512382,SRX5716459,Epitope tags,450
chr1,21511959,21512299,SRX5716470,SMARCA4,340
chr1,21511994,21512302,SRX5716467,SMARCA2,308
chr1,21511999,21512353,SRX5716469,SMARCA4,354
chr1,21512030,21512243,SRX5075170,SMARCA4,213
chr1,21512033,21512233,SRX5020211,SMARCA2,200
chr1,21512039,21512267,SRX5075176,SMARCA4,228
chr1,21512041,21512279,SRX5075169,SMARCA4,238
chr1,21512050,21512320,SRX5020214,SMARCA2,270
chr1,21512051,21512300,SRX5054309,FOSL2,249
chr1,21512146,21512340,SRX5075181,SMARCA2,194
chr1,21520984,21521244,SRX5075169,SMARCA4,260
chr1,21520992,21521218,SRX5075176,SMARCA4,226
chr1,21521002,21521220,SRX5075175,SMARCA4,218
chr1,21530455,21530685,SRX5054309,FOSL2,230
chr1,21534755,21535159,SRX16500059,CTCF,404
chr1,21534792,21535134,SRX16500062,CTCF,342
chr1,21534826,21535127,SRX16500061,CTCF,301
chr1,21534879,21535227,SRX16500060,CTCF,348
chr1,21534900,21535119,SRX5075176,SMARCA4,219
chr1,21534934,21535116,SRX5075170,SMARCA4,182
chr1,21539942,21540197,SRX16500060,CTCF,255
chr1,21541937,21542266,SRX5716470,SMARCA4,329
chr1,21541957,21542175,SRX5716467,SMARCA2,218
chr1,21542010,21542202,SRX5075169,SMARCA4,192
chr1,21552671,21553186,SRX5075169,SMARCA4,515
chr1,21552709,21553154,SRX5075176,SMARCA4,445
chr1,21552719,21553144,SRX5716469,SMARCA4,425
chr1,21552749,21553209,SRX5075175,SMARCA4,460
chr1,21552765,21553179,SRX5716467,SMARCA2,414
chr1,21552766,21553267,SRX5716470,SMARCA4,501
chr1,21552770,21553146,SRX5075170,SMARCA4,376
chr1,21552797,21553166,SRX5054309,FOSL2,369
chr1,21552798,21553117,SRX5020214,SMARCA2,319
chr1,21552816,21553114,SRX5054308,FOSL2,298
chr1,21552821,21553145,SRX5020211,SMARCA2,324
chr1,21552839,21553154,SRX5716468,SMARCA2,315
chr1,21552890,21553091,SRX5075182,SMARCA2,201
chr1,21553494,21553819,SRX5075169,SMARCA4,325
chr1,21553742,21553925,SRX5054308,FOSL2,183
chr1,21573980,21574415,SRX16500061,CTCF,435
chr1,21574032,21574466,SRX16500059,CTCF,434
chr1,21574051,21574498,SRX16500060,CTCF,447
chr1,21574073,21574423,SRX16500062,CTCF,350
chr1,21574088,21574358,SRX4174629,CTCF,270
chr1,21574117,21574376,SRX5716470,SMARCA4,259
chr1,21574124,21574503,SRX5075176,SMARCA4,379
chr1,21574140,21574355,SRX5075168,SMARCA4,215
chr1,21574142,21574536,SRX5075170,SMARCA4,394
chr1,21574176,21574448,SRX5075174,SMARCA4,272
chr1,21574176,21574477,SRX5716469,SMARCA4,301
chr1,21574563,21574867,SRX20140895,INTS13,304
chr1,21586837,21587285,SRX5075169,SMARCA4,448
chr1,21586894,21587081,SRX5075168,SMARCA4,187
chr1,21586899,21587244,SRX5075170,SMARCA4,345
chr1,21586916,21587165,SRX5075176,SMARCA4,249
chr1,21586933,21587188,SRX5054308,FOSL2,255
chr1,21586942,21587210,SRX5716469,SMARCA4,268
chr1,21586961,21587160,SRX5054309,FOSL2,199
chr1,21587046,21587301,SRX5075175,SMARCA4,255
chr1,21595499,21595947,SRX16500062,CTCF,448
chr1,21595534,21595983,SRX16500061,CTCF,449
chr1,21595541,21595947,SRX16500060,CTCF,406
chr1,21595572,21596091,SRX16500059,CTCF,519
chr1,21607793,21607997,SRX5716463,SMARCA4,204
chr1,21647873,21648136,SRX5716454,SOX3,263
chr1,21647899,21648206,SRX5075176,SMARCA4,307
chr1,21647928,21648190,SRX5075168,SMARCA4,262
chr1,21647930,21648213,SRX5716463,SMARCA4,283
chr1,21647943,21648198,SRX5075174,SMARCA4,255
chr1,21647969,21648180,SRX5075170,SMARCA4,211
chr1,21647991,21648191,SRX5075169,SMARCA4,200
chr1,21651620,21651827,SRX5075168,SMARCA4,207
chr1,21651706,21651947,SRX5075174,SMARCA4,241
chr1,21651746,21652068,SRX20140895,INTS13,322
chr1,21658985,21659523,SRX16500060,CTCF,538
chr1,21659016,21659494,SRX16500062,CTCF,478
chr1,21659026,21659492,SRX16500061,CTCF,466
chr1,21659026,21659517,SRX16500059,CTCF,491
chr1,21659050,21659398,SRX4174629,CTCF,348
chr1,21659116,21659519,SRX5716470,SMARCA4,403
chr1,21659119,21659494,SRX5075174,SMARCA4,375
chr1,21659122,21659488,SRX5716463,SMARCA4,366
chr1,21659132,21659546,SRX5075176,SMARCA4,414
chr1,21659142,21659568,SRX5075168,SMARCA4,426
chr1,21659175,21659533,SRX5075170,SMARCA4,358
chr1,21659177,21659524,SRX5075169,SMARCA4,347
chr1,21659186,21659513,SRX5075175,SMARCA4,327
chr1,21659200,21659509,SRX5716464,SMARCA4,309
chr1,21659206,21659509,SRX5716469,SMARCA4,303
chr1,21659295,21659489,SRX5075181,SMARCA2,194
chr1,21669132,21669555,SRX20140895,INTS13,423
chr1,21669245,21669459,SRX5075174,SMARCA4,214
chr1,21673348,21673709,SRX5075169,SMARCA4,361
chr1,21694577,21694617,SRX1424891,POU3F2,40
chr1,21703268,21703674,SRX16500061,CTCF,406
chr1,21703272,21703727,SRX16500060,CTCF,455
chr1,21703297,21703761,SRX16500059,CTCF,464
chr1,21703381,21703687,SRX16500062,CTCF,306
chr1,21703384,21703702,SRX4174629,CTCF,318
chr1,21725854,21726419,SRX5075168,SMARCA4,565
chr1,21725879,21726440,SRX5716463,SMARCA4,561
chr1,21725983,21726421,SRX5075174,SMARCA4,438
chr1,21726025,21726257,SRX5716451,SOX2,232
chr1,21764616,21765321,SRX5075169,SMARCA4,705
chr1,21764675,21765316,SRX5075176,SMARCA4,641
chr1,21764683,21765322,SRX5075175,SMARCA4,639
chr1,21764697,21765132,SRX5075174,SMARCA4,435
chr1,21764715,21765254,SRX5716468,SMARCA2,539
chr1,21764724,21765011,SRX5075168,SMARCA4,287
chr1,21764728,21765273,SRX5075170,SMARCA4,545
chr1,21764729,21765310,SRX5716467,SMARCA2,581
chr1,21764731,21765120,SRX5054309,FOSL2,389
chr1,21764734,21765294,SRX5716470,SMARCA4,560
chr1,21764746,21765089,SRX5075181,SMARCA2,343
chr1,21764767,21765389,SRX5716469,SMARCA4,622
chr1,21764782,21765198,SRX5716460,Epitope tags,416
chr1,21764996,21765206,SRX5020214,SMARCA2,210
chr1,21781903,21782113,SRX5075175,SMARCA4,210
chr1,21782724,21783773,SRX20140895,INTS13,1049
chr1,21782941,21783163,SRX5716463,SMARCA4,222
chr1,21782976,21783452,SRX5075168,SMARCA4,476
chr1,21783031,21783254,SRX5075176,SMARCA4,223
chr1,21783040,21783481,SRX5075174,SMARCA4,441
chr1,21783103,21783693,SRX20140881,CPSF3L,590
chr1,21783112,21783625,SRX20140897,INTS13,513
chr1,21783121,21783540,SRX20140867,INTS10,419
chr1,21783179,21783698,SRX20140879,CPSF3L,519
chr1,21783183,21783578,SRX20140868,INTS10,395
chr1,21783240,21783491,SRX5716469,SMARCA4,251
chr1,21783262,21783480,SRX5716470,SMARCA4,218
chr1,21783269,21783692,SRX20140869,INTS10,423
chr1,21783292,21783654,SRX20140894,INTS13,362
chr1,21783316,21783616,SRX5075176,SMARCA4,300
chr1,21783508,21783883,SRX5075168,SMARCA4,375
chr1,21783700,21783896,SRX5075174,SMARCA4,196
chr1,21814389,21814940,SRX16500059,CTCF,551
chr1,21814422,21814927,SRX16500062,CTCF,505
chr1,21814424,21814917,SRX16500060,CTCF,493
chr1,21814463,21814881,SRX16500061,CTCF,418
chr1,21816934,21817183,SRX5075169,SMARCA4,249
chr1,21816989,21817172,SRX5054309,FOSL2,183
chr1,21816990,21817199,SRX5075176,SMARCA4,209
chr1,21817020,21817200,SRX5054308,FOSL2,180
chr1,21866018,21866260,SRX16500059,CTCF,242
chr1,21866022,21866284,SRX16500061,CTCF,262
chr1,21866060,21866332,SRX16500060,CTCF,272
chr1,21869840,21870185,SRX5075169,SMARCA4,345
chr1,21869879,21870166,SRX5075175,SMARCA4,287
chr1,21869892,21870136,SRX5054309,FOSL2,244
chr1,21869894,21870159,SRX5075176,SMARCA4,265
chr1,21869896,21870153,SRX5054308,FOSL2,257
chr1,21869906,21870170,SRX5075170,SMARCA4,264
chr1,21869918,21870181,SRX5716469,SMARCA4,263
chr1,21869921,21870134,SRX5716470,SMARCA4,213
chr1,21909944,21910186,SRX5075174,SMARCA4,242
chr1,21910068,21910354,SRX5075168,SMARCA4,286
chr1,21911696,21912041,SRX5075176,SMARCA4,345
chr1,21911752,21912053,SRX5716470,SMARCA4,301
chr1,21911775,21912081,SRX5716469,SMARCA4,306
chr1,21911821,21912032,SRX5716468,SMARCA2,211
chr1,21919490,21919832,SRX5075169,SMARCA4,342
chr1,21919526,21919780,SRX5075176,SMARCA4,254
chr1,21919529,21919814,SRX5054308,FOSL2,285
chr1,21919537,21919783,SRX5075170,SMARCA4,246
chr1,21919548,21919818,SRX5075175,SMARCA4,270
chr1,21919554,21919761,SRX5054309,FOSL2,207
chr1,21931128,21931484,SRX5075175,SMARCA4,356
chr1,21931164,21931455,SRX5075169,SMARCA4,291
chr1,21931211,21931484,SRX5716469,SMARCA4,273
chr1,21937019,21937828,SRX20140895,INTS13,809
chr1,21937068,21937457,SRX20140867,INTS10,389
chr1,21937375,21937696,SRX5075168,SMARCA4,321
chr1,21937380,21937865,SRX5075174,SMARCA4,485
chr1,21937385,21937687,SRX5075176,SMARCA4,302
chr1,21937489,21937717,SRX5075170,SMARCA4,228
chr1,21939608,21940012,SRX5075176,SMARCA4,404
chr1,21939627,21939962,SRX5075169,SMARCA4,335
chr1,21939636,21939979,SRX5075170,SMARCA4,343
chr1,21939640,21940040,SRX5075175,SMARCA4,400
chr1,21939687,21939984,SRX5054309,FOSL2,297
chr1,21939699,21939963,SRX5716469,SMARCA4,264
chr1,21944272,21944785,SRX5075174,SMARCA4,513
chr1,21944325,21944865,SRX20140895,INTS13,540
chr1,21944339,21944795,SRX5075168,SMARCA4,456
chr1,21944400,21944621,SRX5716451,SOX2,221
chr1,21944400,21944640,SRX5716463,SMARCA4,240
chr1,21944423,21944689,SRX5716454,SOX3,266
chr1,21944423,21944723,SRX5716464,SMARCA4,300
chr1,21944455,21944827,SRX20140868,INTS10,372
chr1,21956841,21957064,SRX5075176,SMARCA4,223
chr1,21963884,21964387,SRX16500059,CTCF,503
chr1,21963910,21964420,SRX16500062,CTCF,510
chr1,21963915,21964410,SRX16500060,CTCF,495
chr1,21963917,21964374,SRX16500061,CTCF,457
chr1,21963965,21964232,SRX5075174,SMARCA4,267
chr1,21963994,21964300,SRX5075168,SMARCA4,306
chr1,21964005,21964246,SRX5075170,SMARCA4,241
chr1,21964017,21964254,SRX5075176,SMARCA4,237
chr1,21964042,21964355,SRX4174629,CTCF,313
chr1,21980545,21980820,SRX16500059,CTCF,275
chr1,21980545,21980852,SRX16500060,CTCF,307
chr1,21980574,21980788,SRX16500062,CTCF,214
chr1,21980591,21980840,SRX16500061,CTCF,249
chr1,22005148,22005595,SRX16500060,CTCF,447
chr1,22005160,22005560,SRX16500061,CTCF,400
chr1,22005164,22005603,SRX16500059,CTCF,439
chr1,22005202,22005541,SRX16500062,CTCF,339
chr1,22018987,22019583,SRX5075176,SMARCA4,596
chr1,22019017,22019513,SRX5716470,SMARCA4,496
chr1,22019053,22019582,SRX5075169,SMARCA4,529
chr1,22019054,22019575,SRX5075170,SMARCA4,521
chr1,22019058,22019557,SRX5716469,SMARCA4,499
chr1,22019081,22019572,SRX5075175,SMARCA4,491
chr1,22019092,22019492,SRX5020214,SMARCA2,400
chr1,22019093,22019513,SRX5054309,FOSL2,420
chr1,22019098,22019493,SRX5054308,FOSL2,395
chr1,22019135,22019394,SRX5716468,SMARCA2,259
chr1,22019138,22019411,SRX5020211,SMARCA2,273
chr1,22019145,22019453,SRX5716467,SMARCA2,308
chr1,22019197,22019408,SRX5075181,SMARCA2,211
chr1,22019202,22019422,SRX5075174,SMARCA4,220
chr1,22019218,22019536,SRX5075168,SMARCA4,318
chr1,22019232,22019441,SRX5075182,SMARCA2,209
chr1,22022793,22023299,SRX16500059,CTCF,506
chr1,22022827,22023265,SRX16500061,CTCF,438
chr1,22022840,22023289,SRX16500060,CTCF,449
chr1,22022856,22023252,SRX16500062,CTCF,396
chr1,22022919,22023133,SRX5075174,SMARCA4,214
chr1,22024958,22025437,SRX5075170,SMARCA4,479
chr1,22025166,22025805,SRX20140895,INTS13,639
chr1,22025174,22025675,SRX5075176,SMARCA4,501
chr1,22025238,22025591,SRX5075174,SMARCA4,353
chr1,22025256,22025622,SRX5075168,SMARCA4,366
chr1,22025257,22025838,SRX20140869,INTS10,581
chr1,22025274,22025557,SRX20140868,INTS10,283
chr1,22025825,22026111,SRX5054308,FOSL2,286
chr1,22025828,22026056,SRX5075169,SMARCA4,228
chr1,22025833,22026097,SRX5054309,FOSL2,264
chr1,22025842,22026050,SRX5075175,SMARCA4,208
chr1,22025940,22026132,SRX5075170,SMARCA4,192
chr1,22039719,22039955,SRX5075174,SMARCA4,236
chr1,22039732,22040125,SRX5716470,SMARCA4,393
chr1,22039799,22040120,SRX5075168,SMARCA4,321
chr1,22039808,22040044,SRX5716469,SMARCA4,236
chr1,22039814,22040146,SRX5075170,SMARCA4,332
chr1,22039889,22040186,SRX5075176,SMARCA4,297
chr1,22039891,22040078,SRX5075175,SMARCA4,187
chr1,22044616,22045309,SRX5075169,SMARCA4,693
chr1,22044646,22045413,SRX5075176,SMARCA4,767
chr1,22044647,22044997,SRX5054308,FOSL2,350
chr1,22044664,22045347,SRX5054309,FOSL2,683
chr1,22044676,22045318,SRX5716469,SMARCA4,642
chr1,22044680,22045402,SRX5075170,SMARCA4,722
chr1,22044712,22045285,SRX5716467,SMARCA2,573
chr1,22044715,22045279,SRX5075175,SMARCA4,564
chr1,22044735,22045240,SRX5075181,SMARCA2,505
chr1,22044745,22045362,SRX5716470,SMARCA4,617
chr1,22044752,22045213,SRX5716468,SMARCA2,461
chr1,22044896,22045165,SRX5716459,Epitope tags,269
chr1,22045032,22045319,SRX5020211,SMARCA2,287
chr1,22052400,22052853,SRX5075168,SMARCA4,453
chr1,22052449,22052863,SRX5075174,SMARCA4,414
chr1,22052450,22052835,SRX5075176,SMARCA4,385
chr1,22052483,22052742,SRX5716463,SMARCA4,259
chr1,22052488,22052897,SRX5716464,SMARCA4,409
chr1,22052509,22052714,SRX5716454,SOX3,205
chr1,22052523,22052703,SRX5054308,FOSL2,180
chr1,22052549,22052742,SRX5075169,SMARCA4,193
chr1,22052550,22052786,SRX5075170,SMARCA4,236
chr1,22052551,22053560,SRX20140895,INTS13,1009
chr1,22052596,22052921,SRX20140897,INTS13,325
chr1,22052617,22053478,SRX20140867,INTS10,861
chr1,22052711,22053392,SRX20140868,INTS10,681
chr1,22052749,22053465,SRX20140869,INTS10,716
chr1,22053096,22053493,SRX20140897,INTS13,397
chr1,22053279,22053473,SRX5075174,SMARCA4,194
chr1,22053308,22053495,SRX5075169,SMARCA4,187
chr1,22077769,22078027,SRX5075176,SMARCA4,258
chr1,22077823,22078047,SRX5716469,SMARCA4,224
chr1,22077859,22078045,SRX5075170,SMARCA4,186
chr1,22092429,22092638,SRX5075170,SMARCA4,209
chr1,22092466,22092646,SRX5054308,FOSL2,180
chr1,22105538,22106114,SRX16500062,CTCF,576
chr1,22105545,22106083,SRX16500059,CTCF,538
chr1,22105553,22106098,SRX16500060,CTCF,545
chr1,22105613,22106130,SRX16500061,CTCF,517
chr1,22105661,22105999,SRX4174629,CTCF,338
chr1,22105711,22105934,SRX5075174,SMARCA4,223
chr1,22114472,22114895,SRX5075169,SMARCA4,423
chr1,22114475,22114962,SRX5075176,SMARCA4,487
chr1,22114550,22114787,SRX5716469,SMARCA4,237
chr1,22114627,22114907,SRX5075170,SMARCA4,280
chr1,22114673,22115029,SRX5075175,SMARCA4,356
chr1,22114692,22114907,SRX5716467,SMARCA2,215
chr1,22131816,22132328,SRX16500059,CTCF,512
chr1,22131842,22132440,SRX16500062,CTCF,598
chr1,22131843,22132367,SRX16500060,CTCF,524
chr1,22131855,22132340,SRX16500061,CTCF,485
chr1,22132010,22132266,SRX4174629,CTCF,256
chr1,22137083,22137448,SRX5075170,SMARCA4,365
chr1,22141640,22141920,SRX5075174,SMARCA4,280
chr1,22141706,22141899,SRX5075168,SMARCA4,193
chr1,22143322,22143738,SRX16500060,CTCF,416
chr1,22143349,22143676,SRX16500059,CTCF,327
chr1,22143375,22143672,SRX16500062,CTCF,297
chr1,22143392,22143651,SRX16500061,CTCF,259
chr1,22208234,22208723,SRX16500059,CTCF,489
chr1,22208287,22208686,SRX16500060,CTCF,399
chr1,22208311,22208680,SRX16500061,CTCF,369
chr1,22208315,22208897,SRX16500062,CTCF,582
chr1,22208610,22209093,SRX20140868,INTS10,483
chr1,22208648,22209136,SRX20140881,CPSF3L,488
chr1,22208652,22209192,SRX20140895,INTS13,540
chr1,22208860,22209157,SRX20140867,INTS10,297
chr1,22229703,22229882,SRX5075168,SMARCA4,179
chr1,22250688,22251116,SRX5075174,SMARCA4,428
chr1,22250799,22251092,SRX5054307,FOSL2,293
chr1,22250812,22251052,SRX5075168,SMARCA4,240
chr1,22250859,22251079,SRX5075170,SMARCA4,220
chr1,22250864,22251073,SRX5054308,FOSL2,209
chr1,22259554,22259760,SRX5075174,SMARCA4,206
chr1,22259621,22259843,SRX5075170,SMARCA4,222
chr1,22275726,22276296,SRX16500060,CTCF,570
chr1,22275751,22276274,SRX16500059,CTCF,523
chr1,22275785,22276244,SRX16500061,CTCF,459
chr1,22275792,22276249,SRX16500062,CTCF,457
chr1,22275911,22276084,SRX5075174,SMARCA4,173
chr1,22275927,22276189,SRX4174629,CTCF,262
chr1,22317256,22317699,SRX16500060,CTCF,443
chr1,22317279,22317770,SRX16500059,CTCF,491
chr1,22317293,22317701,SRX16500061,CTCF,408
chr1,22317310,22317659,SRX16500062,CTCF,349
chr1,22318430,22318883,SRX20140895,INTS13,453
chr1,22318529,22318945,SRX5075174,SMARCA4,416
chr1,22318545,22318839,SRX5075176,SMARCA4,294
chr1,22318567,22318877,SRX5075168,SMARCA4,310
chr1,22341858,22342432,SRX5075176,SMARCA4,574
chr1,22341909,22342405,SRX5075170,SMARCA4,496
chr1,22341947,22342270,SRX5075174,SMARCA4,323
chr1,22341964,22342381,SRX5075168,SMARCA4,417
chr1,22342021,22342392,SRX5075169,SMARCA4,371
chr1,22342026,22342453,SRX5716470,SMARCA4,427
chr1,22342030,22342359,SRX5075175,SMARCA4,329
chr1,22342057,22342409,SRX5716469,SMARCA4,352
chr1,22342097,22342313,SRX5716468,SMARCA2,216
chr1,22342097,22342440,SRX5716467,SMARCA2,343
chr1,22387924,22388107,SRX5054309,FOSL2,183
chr1,22389080,22389397,SRX5054309,FOSL2,317
chr1,22398877,22399141,SRX5716459,Epitope tags,264
chr1,22398977,22399318,SRX5075169,SMARCA4,341
chr1,22398997,22399253,SRX5716469,SMARCA4,256
chr1,22399063,22399347,SRX5054308,FOSL2,284
chr1,22416538,22416993,SRX16500060,CTCF,455
chr1,22416544,22416984,SRX16500059,CTCF,440
chr1,22416549,22416997,SRX16500061,CTCF,448
chr1,22416550,22416971,SRX16500062,CTCF,421
chr1,22416562,22416966,SRX4174629,CTCF,404
chr1,22416602,22416844,SRX5075176,SMARCA4,242
chr1,22416624,22416887,SRX5075168,SMARCA4,263
chr1,22416633,22416834,SRX5075170,SMARCA4,201
chr1,22416637,22416857,SRX5075174,SMARCA4,220
chr1,22418875,22419194,SRX5054309,FOSL2,319
chr1,22418878,22419327,SRX5716469,SMARCA4,449
chr1,22418881,22419196,SRX5054308,FOSL2,315
chr1,22418917,22419204,SRX5075175,SMARCA4,287
chr1,22418920,22419253,SRX5075169,SMARCA4,333
chr1,22418927,22419334,SRX5075170,SMARCA4,407
chr1,22418971,22419352,SRX5075176,SMARCA4,381
chr1,22420413,22420807,SRX16500059,CTCF,394
chr1,22420441,22420810,SRX16500061,CTCF,369
chr1,22420467,22420801,SRX16500060,CTCF,334
chr1,22420491,22420793,SRX16500062,CTCF,302
chr1,22420526,22420736,SRX4174629,CTCF,210
chr1,22428639,22429019,SRX20140895,INTS13,380
chr1,22447642,22447931,SRX5075169,SMARCA4,289
chr1,22447675,22447909,SRX5075176,SMARCA4,234
chr1,22447685,22447854,SRX5075170,SMARCA4,169
chr1,22447728,22447954,SRX5075175,SMARCA4,226
chr1,22451496,22452399,SRX20140895,INTS13,903
chr1,22451499,22452098,SRX20140894,INTS13,599
chr1,22451577,22452073,SRX20140897,INTS13,496
chr1,22451597,22452048,SRX20140896,INTS13,451
chr1,22451640,22452056,SRX5075168,SMARCA4,416
chr1,22451657,22451996,SRX5075170,SMARCA4,339
chr1,22451658,22452095,SRX20140868,INTS10,437
chr1,22451692,22451997,SRX5716451,SOX2,305
chr1,22451695,22452056,SRX5075176,SMARCA4,361
chr1,22451697,22452135,SRX5075174,SMARCA4,438
chr1,22451706,22452068,SRX20140867,INTS10,362
chr1,22451742,22451953,SRX5716470,SMARCA4,211
chr1,22451759,22452023,SRX20140881,CPSF3L,264
chr1,22451768,22452144,SRX20140879,CPSF3L,376
chr1,22451797,22452394,SRX20140869,INTS10,597
chr1,22451840,22452045,SRX5716454,SOX3,205
chr1,22451864,22452073,SRX5716463,SMARCA4,209
chr1,22457412,22457657,SRX5075170,SMARCA4,245
chr1,22457436,22457633,SRX5075176,SMARCA4,197
chr1,22500469,22500924,SRX5075169,SMARCA4,455
chr1,22500492,22500916,SRX5075174,SMARCA4,424
chr1,22500544,22500919,SRX5075176,SMARCA4,375
chr1,22500547,22500905,SRX5075170,SMARCA4,358
chr1,22500567,22500907,SRX5075168,SMARCA4,340
chr1,22500573,22500858,SRX5075175,SMARCA4,285
chr1,22500579,22500850,SRX5716469,SMARCA4,271
chr1,22500584,22500811,SRX5716463,SMARCA4,227
chr1,22500603,22500846,SRX5716451,SOX2,243
chr1,22500604,22500877,SRX5054309,FOSL2,273
chr1,22500606,22500854,SRX5716470,SMARCA4,248
chr1,22500649,22500912,SRX5054308,FOSL2,263
chr1,22518006,22518218,SRX5716469,SMARCA4,212
chr1,22518035,22518230,SRX5075176,SMARCA4,195
chr1,22527946,22528244,SRX16500059,CTCF,298
chr1,22527957,22528241,SRX16500060,CTCF,284
chr1,22557330,22557821,SRX5075176,SMARCA4,491
chr1,22557335,22557742,SRX5075170,SMARCA4,407
chr1,22557340,22557685,SRX5075175,SMARCA4,345
chr1,22557341,22557620,SRX5716469,SMARCA4,279
chr1,22557341,22557670,SRX5716470,SMARCA4,329
chr1,22557395,22557639,SRX5716467,SMARCA2,244
chr1,22557400,22557700,SRX5054309,FOSL2,300
chr1,22557406,22557674,SRX5075169,SMARCA4,268
chr1,22557436,22557616,SRX5054308,FOSL2,180
chr1,22557487,22557681,SRX5075181,SMARCA2,194
chr1,22611476,22611819,SRX5716470,SMARCA4,343
chr1,22611500,22611784,SRX5075168,SMARCA4,284
chr1,22611509,22611780,SRX5075174,SMARCA4,271
chr1,22611530,22611757,SRX5716464,SMARCA4,227
chr1,22611535,22611747,SRX5075170,SMARCA4,212
chr1,22611556,22611755,SRX5075169,SMARCA4,199
chr1,22641949,22642479,SRX16500061,CTCF,530
chr1,22641962,22642428,SRX16500062,CTCF,466
chr1,22641987,22642478,SRX16500060,CTCF,491
chr1,22641996,22642514,SRX16500059,CTCF,518
chr1,22642028,22642448,SRX4174629,CTCF,420
chr1,22642049,22642254,SRX5075168,SMARCA4,205
chr1,22642078,22642305,SRX5075174,SMARCA4,227
chr1,22654726,22654970,SRX16500061,CTCF,244
chr1,22665684,22666209,SRX16500059,CTCF,525
chr1,22665720,22666140,SRX16500062,CTCF,420
chr1,22665720,22666228,SRX16500060,CTCF,508
chr1,22665751,22666141,SRX16500061,CTCF,390
chr1,22665818,22665998,SRX5075168,SMARCA4,180
chr1,22665894,22666124,SRX4174629,CTCF,230
chr1,22673489,22673822,SRX5075174,SMARCA4,333
chr1,22673492,22673793,SRX5075168,SMARCA4,301
chr1,22673493,22674120,SRX20140895,INTS13,627
chr1,22673965,22674478,SRX4174629,CTCF,513
chr1,22674031,22674521,SRX16500060,CTCF,490
chr1,22674045,22674544,SRX16500062,CTCF,499
chr1,22674061,22674555,SRX16500059,CTCF,494
chr1,22674098,22674572,SRX16500061,CTCF,474
chr1,22674200,22674419,SRX5075174,SMARCA4,219
chr1,22674259,22674454,SRX5075176,SMARCA4,195
chr1,22674282,22674473,SRX5075168,SMARCA4,191
chr1,22689500,22689771,SRX5075175,SMARCA4,271
chr1,22689508,22689776,SRX5075169,SMARCA4,268
chr1,22689513,22689903,SRX5075174,SMARCA4,390
chr1,22689532,22689830,SRX5075170,SMARCA4,298
chr1,22689551,22689874,SRX5075168,SMARCA4,323
chr1,22689552,22689828,SRX5075176,SMARCA4,276
chr1,22689564,22689776,SRX5716469,SMARCA4,212
chr1,22691047,22691315,SRX5075168,SMARCA4,268
chr1,22691048,22691365,SRX5075174,SMARCA4,317
chr1,22704350,22704853,SRX16500060,CTCF,503
chr1,22704361,22704834,SRX16500059,CTCF,473
chr1,22704363,22704828,SRX16500062,CTCF,465
chr1,22704372,22704841,SRX16500061,CTCF,469
chr1,22704471,22704864,SRX5075168,SMARCA4,393
chr1,22704504,22704835,SRX5716463,SMARCA4,331
chr1,22704506,22704812,SRX5075170,SMARCA4,306
chr1,22704506,22704862,SRX5075174,SMARCA4,356
chr1,22704530,22704848,SRX5075169,SMARCA4,318
chr1,22704531,22704785,SRX5716464,SMARCA4,254
chr1,22704534,22704802,SRX5075175,SMARCA4,268
chr1,22704538,22704842,SRX5054309,FOSL2,304
chr1,22704544,22704819,SRX5716469,SMARCA4,275
chr1,22704548,22704860,SRX5075176,SMARCA4,312
chr1,22704549,22704896,SRX4174629,CTCF,347
chr1,22704553,22704875,SRX5054308,FOSL2,322
chr1,22704619,22704804,SRX5054307,FOSL2,185
chr1,22709238,22709537,SRX16500060,CTCF,299
chr1,22709274,22709544,SRX16500059,CTCF,270
chr1,22709290,22709589,SRX16500061,CTCF,299
chr1,22710147,22710567,SRX20140895,INTS13,420
chr1,22710317,22710509,SRX5075174,SMARCA4,192
chr1,22710652,22711054,SRX20140867,INTS10,402
chr1,22712678,22712951,SRX5075176,SMARCA4,273
chr1,22712729,22712968,SRX5075175,SMARCA4,239
chr1,22712734,22712939,SRX5054308,FOSL2,205
chr1,22712758,22712969,SRX5075170,SMARCA4,211
chr1,22736411,22736918,SRX20140895,INTS13,507
chr1,22739663,22740087,SRX5075176,SMARCA4,424
chr1,22739680,22740080,SRX5075175,SMARCA4,400
chr1,22739681,22740066,SRX5075169,SMARCA4,385
chr1,22739690,22740052,SRX5075170,SMARCA4,362
chr1,22739700,22739975,SRX5054309,FOSL2,275
chr1,22739702,22740020,SRX5716467,SMARCA2,318
chr1,22739710,22740091,SRX5716470,SMARCA4,381
chr1,22739718,22740005,SRX5054308,FOSL2,287
chr1,22739743,22740076,SRX5716469,SMARCA4,333
chr1,22739745,22739976,SRX5020211,SMARCA2,231
chr1,22739751,22740059,SRX5716468,SMARCA2,308
chr1,22739778,22740155,SRX5716459,Epitope tags,377
chr1,22747395,22747694,SRX5075175,SMARCA4,299
chr1,22747423,22747711,SRX5075169,SMARCA4,288
chr1,22747465,22747668,SRX5075176,SMARCA4,203
chr1,22750334,22750669,SRX5075170,SMARCA4,335
chr1,22750349,22750692,SRX5075169,SMARCA4,343
chr1,22750360,22750675,SRX5075176,SMARCA4,315
chr1,22750380,22750619,SRX5054308,FOSL2,239
chr1,22750385,22750633,SRX5075175,SMARCA4,248
chr1,22750386,22750663,SRX5054309,FOSL2,277
chr1,22750388,22750623,SRX5075174,SMARCA4,235
chr1,22750394,22750650,SRX5716469,SMARCA4,256
chr1,22750404,22750639,SRX5716467,SMARCA2,235
chr1,22753613,22754009,SRX5075176,SMARCA4,396
chr1,22753618,22753977,SRX5075170,SMARCA4,359
chr1,22753636,22753925,SRX5075175,SMARCA4,289
chr1,22753642,22754016,SRX5075169,SMARCA4,374
chr1,22771930,22772277,SRX5075168,SMARCA4,347
chr1,22771969,22772231,SRX5075174,SMARCA4,262
chr1,22775540,22775731,SRX5075170,SMARCA4,191
chr1,22775552,22775732,SRX5075169,SMARCA4,180
chr1,22775559,22775740,SRX5075176,SMARCA4,181
chr1,22776303,22776536,SRX5075176,SMARCA4,233
chr1,22782538,22782820,SRX20140895,INTS13,282
chr1,22788227,22788533,SRX5075176,SMARCA4,306
chr1,22788283,22788524,SRX5075170,SMARCA4,241
chr1,22794706,22794971,SRX5075169,SMARCA4,265
chr1,22794735,22794996,SRX5075170,SMARCA4,261
chr1,22794746,22795068,SRX5075176,SMARCA4,322
chr1,22794752,22795043,SRX5716470,SMARCA4,291
chr1,22794812,22795077,SRX5075175,SMARCA4,265
chr1,22799908,22800102,SRX5075174,SMARCA4,194
chr1,22801548,22802038,SRX20140895,INTS13,490
chr1,22801748,22802015,SRX5075168,SMARCA4,267
chr1,22801759,22802094,SRX5075174,SMARCA4,335
chr1,22801760,22802004,SRX5716451,SOX2,244
chr1,22801784,22801988,SRX5716463,SMARCA4,204
chr1,22808780,22809370,SRX5075170,SMARCA4,590
chr1,22808815,22809434,SRX5075176,SMARCA4,619
chr1,22808833,22809254,SRX5075175,SMARCA4,421
chr1,22808873,22809353,SRX5075169,SMARCA4,480
chr1,22815492,22815712,SRX5075176,SMARCA4,220
chr1,22825778,22825992,SRX5075176,SMARCA4,214
chr1,22832086,22832362,SRX5075175,SMARCA4,276
chr1,22832090,22832347,SRX5716469,SMARCA4,257
chr1,22832106,22832375,SRX5075169,SMARCA4,269
chr1,22832113,22832325,SRX5075174,SMARCA4,212
chr1,22832118,22832293,SRX5075176,SMARCA4,175
chr1,22832129,22832318,SRX5075170,SMARCA4,189
chr1,22832135,22832321,SRX5054309,FOSL2,186
chr1,22835934,22836206,SRX5075176,SMARCA4,272
chr1,22835969,22836186,SRX5054309,FOSL2,217
chr1,22835989,22836197,SRX5054308,FOSL2,208
chr1,22836001,22836188,SRX5075175,SMARCA4,187
chr1,22836015,22836213,SRX5075170,SMARCA4,198
chr1,22836103,22836352,SRX5075174,SMARCA4,249
chr1,22848444,22848677,SRX5075176,SMARCA4,233
chr1,22850770,22851018,SRX5075170,SMARCA4,248
chr1,22850782,22851028,SRX5075176,SMARCA4,246
chr1,22850829,22851013,SRX5075169,SMARCA4,184
chr1,22861989,22862517,SRX16500059,CTCF,528
chr1,22862008,22862408,SRX4174629,CTCF,400
chr1,22862016,22862534,SRX16500060,CTCF,518
chr1,22862041,22862508,SRX16500062,CTCF,467
chr1,22862054,22862440,SRX5075168,SMARCA4,386
chr1,22862073,22862576,SRX16500061,CTCF,503
chr1,22862095,22862323,SRX5075170,SMARCA4,228
chr1,22870517,22870781,SRX5075169,SMARCA4,264
chr1,22870563,22870781,SRX5075176,SMARCA4,218
chr1,22870597,22870824,SRX5075170,SMARCA4,227
chr1,22876545,22877223,SRX5075170,SMARCA4,678
chr1,22876587,22877149,SRX5075169,SMARCA4,562
chr1,22876602,22876825,SRX5716470,SMARCA4,223
chr1,22876650,22877127,SRX5075176,SMARCA4,477
chr1,22876832,22877179,SRX5716469,SMARCA4,347
chr1,22876876,22877181,SRX5075175,SMARCA4,305
chr1,22876949,22877167,SRX5054308,FOSL2,218
chr1,22886344,22886557,SRX5075169,SMARCA4,213
chr1,22886350,22886530,SRX5075170,SMARCA4,180
chr1,22886351,22886534,SRX5054309,FOSL2,183
chr1,22886353,22886530,SRX5075176,SMARCA4,177
chr1,22886383,22886607,SRX5716470,SMARCA4,224
chr1,22888723,22889053,SRX5075169,SMARCA4,330
chr1,22888733,22889045,SRX5075175,SMARCA4,312
chr1,22888739,22889011,SRX5075176,SMARCA4,272
chr1,22888761,22888990,SRX5054309,FOSL2,229
chr1,22888761,22889029,SRX5054308,FOSL2,268
chr1,22888769,22888999,SRX5075170,SMARCA4,230
chr1,22889118,22889600,SRX16500062,CTCF,482
chr1,22889153,22889642,SRX16500060,CTCF,489
chr1,22889174,22889658,SRX16500059,CTCF,484
chr1,22889205,22889652,SRX16500061,CTCF,447
chr1,22889266,22889718,SRX4174629,CTCF,452
chr1,22889337,22889516,SRX5075168,SMARCA4,179
chr1,22922686,22922882,SRX5075175,SMARCA4,196
chr1,22922696,22922964,SRX5075176,SMARCA4,268
chr1,22922732,22922940,SRX5054308,FOSL2,208
chr1,22922738,22922995,SRX5075170,SMARCA4,257
chr1,22930274,22930730,SRX16500059,CTCF,456
chr1,22930280,22930771,SRX16500062,CTCF,491
chr1,22930283,22930730,SRX16500060,CTCF,447
chr1,22930289,22930765,SRX16500061,CTCF,476
chr1,22930326,22930600,SRX5075174,SMARCA4,274
chr1,22930350,22930693,SRX4174629,CTCF,343
chr1,22949766,22949981,SRX5716467,SMARCA2,215
chr1,22949793,22950020,SRX5075169,SMARCA4,227
chr1,22949798,22950027,SRX5075170,SMARCA4,229
chr1,22964078,22964678,SRX16500062,CTCF,600
chr1,22964102,22964671,SRX16500060,CTCF,569
chr1,22964161,22964660,SRX16500061,CTCF,499
chr1,22964162,22964646,SRX16500059,CTCF,484
chr1,22964242,22964471,SRX5075174,SMARCA4,229
chr1,22964251,22964493,SRX5075168,SMARCA4,242
chr1,22964294,22964552,SRX4174629,CTCF,258
chr1,22969234,22969494,SRX5716469,SMARCA4,260
chr1,22969242,22969562,SRX5075175,SMARCA4,320
chr1,22969267,22969447,SRX5054308,FOSL2,180
chr1,22969267,22969640,SRX5075170,SMARCA4,373
chr1,22969273,22969673,SRX5075176,SMARCA4,400
chr1,22969297,22969558,SRX5075169,SMARCA4,261
chr1,22969377,22969611,SRX5716467,SMARCA2,234
chr1,22976353,22977012,SRX16500059,CTCF,659
chr1,22976392,22977017,SRX16500060,CTCF,625
chr1,22976412,22977012,SRX16500061,CTCF,600
chr1,22976430,22976673,SRX5716469,SMARCA4,243
chr1,22976453,22976914,SRX16500062,CTCF,461
chr1,22976478,22977015,SRX4174629,CTCF,537
chr1,22976493,22976800,SRX5075170,SMARCA4,307
chr1,22976499,22976781,SRX5075174,SMARCA4,282
chr1,22976546,22976810,SRX5075176,SMARCA4,264
chr1,22976553,22976732,SRX5075168,SMARCA4,179
chr1,22978375,22978571,SRX5075175,SMARCA4,196
chr1,22978411,22978607,SRX5075169,SMARCA4,196
chr1,22978412,22978648,SRX5054309,FOSL2,236
chr1,23010764,23011156,SRX5716470,SMARCA4,392
chr1,23010791,23011073,SRX5075175,SMARCA4,282
chr1,23010794,23011166,SRX5075169,SMARCA4,372
chr1,23010808,23011114,SRX5716469,SMARCA4,306
chr1,23010843,23011117,SRX5075176,SMARCA4,274
chr1,23010856,23011080,SRX5054308,FOSL2,224
chr1,23010871,23011040,SRX5075170,SMARCA4,169
chr1,23010874,23011057,SRX5054309,FOSL2,183
chr1,23013883,23014069,SRX5075174,SMARCA4,186
chr1,23019099,23019637,SRX5075174,SMARCA4,538
chr1,23019103,23019574,SRX20140879,CPSF3L,471
chr1,23019103,23020182,SRX20140895,INTS13,1079
chr1,23019104,23019638,SRX5075176,SMARCA4,534
chr1,23019142,23020054,SRX20140868,INTS10,912
chr1,23019146,23019727,SRX5716469,SMARCA4,581
chr1,23019147,23019635,SRX5075168,SMARCA4,488
chr1,23019155,23019639,SRX5075169,SMARCA4,484
chr1,23019171,23019672,SRX5075170,SMARCA4,501
chr1,23019182,23019787,SRX20140869,INTS10,605
chr1,23019190,23019661,SRX5716464,SMARCA4,471
chr1,23019200,23019465,SRX5716463,SMARCA4,265
chr1,23019206,23019702,SRX20140897,INTS13,496
chr1,23019206,23019777,SRX20140867,INTS10,571
chr1,23019208,23019702,SRX5716470,SMARCA4,494
chr1,23019219,23019492,SRX5075175,SMARCA4,273
chr1,23081489,23081710,SRX16500060,CTCF,221
chr1,23081501,23081711,SRX16500062,CTCF,210
chr1,23098626,23099147,SRX16500060,CTCF,521
chr1,23098658,23099169,SRX16500059,CTCF,511
chr1,23098674,23099152,SRX16500061,CTCF,478
chr1,23098707,23099087,SRX16500062,CTCF,380
chr1,23098759,23099138,SRX4174629,CTCF,379
chr1,23098780,23099078,SRX5075168,SMARCA4,298
chr1,23098794,23098998,SRX5716463,SMARCA4,204
chr1,23098870,23099044,SRX5075170,SMARCA4,174
chr1,23098884,23099100,SRX5075174,SMARCA4,216
chr1,23100068,23100636,SRX5075176,SMARCA4,568
chr1,23100085,23100580,SRX5075169,SMARCA4,495
chr1,23100092,23100524,SRX5075175,SMARCA4,432
chr1,23100093,23100603,SRX5716470,SMARCA4,510
chr1,23100097,23100633,SRX5075170,SMARCA4,536
chr1,23100180,23100591,SRX5716469,SMARCA4,411
chr1,23100199,23100547,SRX5716467,SMARCA2,348
chr1,23102285,23102622,SRX5075169,SMARCA4,337
chr1,23102301,23102489,SRX5075170,SMARCA4,188
chr1,23102301,23102571,SRX5075175,SMARCA4,270
chr1,23102308,23102516,SRX5075176,SMARCA4,208
chr1,23102313,23102542,SRX5054309,FOSL2,229
chr1,23122547,23122795,SRX5075176,SMARCA4,248
chr1,23154353,23154574,SRX5054309,FOSL2,221
chr1,23167655,23168061,SRX5075169,SMARCA4,406
chr1,23167749,23167943,SRX5075168,SMARCA4,194
chr1,23167764,23168007,SRX5716469,SMARCA4,243
chr1,23167778,23168043,SRX5075174,SMARCA4,265
chr1,23168530,23168988,SRX20140895,INTS13,458
chr1,23168562,23168888,SRX20140868,INTS10,326
chr1,23168573,23168914,SRX20140867,INTS10,341
chr1,23168619,23168893,SRX20140881,CPSF3L,274
chr1,23168741,23169106,SRX5075168,SMARCA4,365
chr1,23168749,23169050,SRX5075170,SMARCA4,301
chr1,23168764,23169088,SRX5075174,SMARCA4,324
chr1,23168814,23169081,SRX5075169,SMARCA4,267
chr1,23168850,23169053,SRX5075176,SMARCA4,203
chr1,23169698,23169936,SRX5075175,SMARCA4,238
chr1,23169757,23170019,SRX5075170,SMARCA4,262
chr1,23177489,23178000,SRX5075168,SMARCA4,511
chr1,23177538,23177999,SRX5075174,SMARCA4,461
chr1,23177551,23178119,SRX5075170,SMARCA4,568
chr1,23177564,23178101,SRX5075169,SMARCA4,537
chr1,23177591,23178167,SRX5075176,SMARCA4,576
chr1,23177599,23178116,SRX5075175,SMARCA4,517
chr1,23177644,23178101,SRX5716469,SMARCA4,457
chr1,23177656,23177895,SRX5716464,SMARCA4,239
chr1,23177656,23178022,SRX20140895,INTS13,366
chr1,23177675,23178043,SRX5716467,SMARCA2,368
chr1,23177677,23178018,SRX5716470,SMARCA4,341
chr1,23178887,23179379,SRX16500059,CTCF,492
chr1,23178936,23179192,SRX16500061,CTCF,256
chr1,23184572,23185109,SRX16500062,CTCF,537
chr1,23184582,23184909,SRX4174629,CTCF,327
chr1,23184582,23185108,SRX16500059,CTCF,526
chr1,23184584,23185097,SRX16500061,CTCF,513
chr1,23184630,23185128,SRX16500060,CTCF,498
chr1,23184674,23184940,SRX5075168,SMARCA4,266
chr1,23184684,23184967,SRX5075174,SMARCA4,283
chr1,23188902,23189226,SRX5054308,FOSL2,324
chr1,23188903,23189225,SRX5075169,SMARCA4,322
chr1,23188912,23189252,SRX5054309,FOSL2,340
chr1,23188937,23189235,SRX5075176,SMARCA4,298
chr1,23188945,23189260,SRX5075175,SMARCA4,315
chr1,23188954,23189262,SRX5075170,SMARCA4,308
chr1,23188956,23189324,SRX5716469,SMARCA4,368
chr1,23188962,23189233,SRX5075174,SMARCA4,271
chr1,23188978,23189193,SRX5716467,SMARCA2,215
chr1,23188979,23189213,SRX5075168,SMARCA4,234
chr1,23194360,23194741,SRX5716470,SMARCA4,381
chr1,23194361,23195001,SRX5075175,SMARCA4,640
chr1,23194381,23195005,SRX5075176,SMARCA4,624
chr1,23194392,23194768,SRX5716469,SMARCA4,376
chr1,23194400,23194874,SRX5075169,SMARCA4,474
chr1,23194436,23194701,SRX5075170,SMARCA4,265
chr1,23194533,23194748,SRX5716467,SMARCA2,215
chr1,23198399,23198679,SRX5075170,SMARCA4,280
chr1,23198441,23198633,SRX5075169,SMARCA4,192
chr1,23198442,23198730,SRX5054309,FOSL2,288
chr1,23198450,23198703,SRX5075175,SMARCA4,253
chr1,23198499,23198729,SRX5075176,SMARCA4,230
chr1,23198509,23198774,SRX5054308,FOSL2,265
chr1,23202356,23202570,SRX5075170,SMARCA4,214
chr1,23202426,23202649,SRX5075169,SMARCA4,223
chr1,23202452,23202658,SRX5075175,SMARCA4,206
chr1,23216674,23217230,SRX16500059,CTCF,556
chr1,23216676,23217205,SRX16500061,CTCF,529
chr1,23216679,23217209,SRX16500060,CTCF,530
chr1,23216701,23217183,SRX16500062,CTCF,482
chr1,23216719,23216949,SRX4174629,CTCF,230
chr1,23216770,23217074,SRX5075174,SMARCA4,304
chr1,23216816,23217162,SRX5075168,SMARCA4,346
chr1,23216872,23217295,SRX5075175,SMARCA4,423
chr1,23225081,23225309,SRX5075170,SMARCA4,228
chr1,23225249,23225451,SRX5075176,SMARCA4,202
chr1,23249617,23250180,SRX5075176,SMARCA4,563
chr1,23249702,23250153,SRX5716469,SMARCA4,451
chr1,23249706,23250174,SRX5716470,SMARCA4,468
chr1,23249761,23250091,SRX5075169,SMARCA4,330
chr1,23249762,23250345,SRX5075170,SMARCA4,583
chr1,23249801,23250239,SRX5075175,SMARCA4,438
chr1,23249821,23250259,SRX5716467,SMARCA2,438
chr1,23249834,23250087,SRX5075181,SMARCA2,253
chr1,23249852,23250140,SRX5020211,SMARCA2,288
chr1,23249867,23250200,SRX5716468,SMARCA2,333
chr1,23263441,23263731,SRX20140895,INTS13,290
chr1,23273527,23273726,SRX5075176,SMARCA4,199
chr1,23273529,23273756,SRX5075169,SMARCA4,227
chr1,23273557,23273738,SRX5075170,SMARCA4,181
chr1,23283046,23283263,SRX5075169,SMARCA4,217
chr1,23283048,23283310,SRX5075176,SMARCA4,262
chr1,23283053,23283270,SRX5075175,SMARCA4,217
chr1,23283070,23283317,SRX5054308,FOSL2,247
chr1,23283076,23283317,SRX5075170,SMARCA4,241
chr1,23283084,23283313,SRX5054309,FOSL2,229
chr1,23343756,23344994,SRX20140895,INTS13,1238
chr1,23343774,23344912,SRX20140868,INTS10,1138
chr1,23343933,23344853,SRX20140867,INTS10,920
chr1,23344034,23344357,SRX20140869,INTS10,323
chr1,23344303,23344953,SRX20140897,INTS13,650
chr1,23344349,23344659,SRX5054307,FOSL2,310
chr1,23344394,23344629,SRX5716451,SOX2,235
chr1,23344404,23344881,SRX5075174,SMARCA4,477
chr1,23344432,23344637,SRX5716454,SOX3,205
chr1,23344535,23344781,SRX5075176,SMARCA4,246
chr1,23344538,23344986,SRX5075170,SMARCA4,448
chr1,23344552,23344903,SRX5075168,SMARCA4,351
chr1,23344619,23344913,SRX5716470,SMARCA4,294
chr1,23344696,23345048,SRX5075169,SMARCA4,352
chr1,23344752,23345129,SRX5075175,SMARCA4,377
chr1,23356488,23356976,SRX20140895,INTS13,488
chr1,23356662,23356860,SRX5075168,SMARCA4,198
chr1,23368010,23368404,SRX20140895,INTS13,394
chr1,23368086,23368467,SRX5075174,SMARCA4,381
chr1,23368135,23368339,SRX5716463,SMARCA4,204
chr1,23368160,23368457,SRX5075168,SMARCA4,297
chr1,23368313,23368522,SRX5054307,FOSL2,209
chr1,23368511,23369243,SRX20140895,INTS13,732
chr1,23368650,23369104,SRX20140868,INTS10,454
chr1,23368702,23369149,SRX20140867,INTS10,447
chr1,23368762,23369109,SRX5075174,SMARCA4,347
chr1,23368767,23369169,SRX20140897,INTS13,402
chr1,23368868,23369218,SRX16500060,CTCF,350
chr1,23368919,23369100,SRX5075168,SMARCA4,181
chr1,23368933,23369176,SRX16500059,CTCF,243
chr1,23369723,23369934,SRX5716470,SMARCA4,211
chr1,23369727,23369965,SRX5075175,SMARCA4,238
chr1,23369741,23370067,SRX5075176,SMARCA4,326
chr1,23369787,23370087,SRX5075169,SMARCA4,300
chr1,23369796,23370082,SRX5716469,SMARCA4,286
chr1,23369806,23370121,SRX5075170,SMARCA4,315
chr1,23371072,23371422,SRX5075176,SMARCA4,350
chr1,23371161,23371429,SRX5075170,SMARCA4,268
chr1,23371244,23371452,SRX5075175,SMARCA4,208
chr1,23377108,23377790,SRX5075174,SMARCA4,682
chr1,23377148,23377615,SRX20140867,INTS10,467
chr1,23377182,23377734,SRX5075170,SMARCA4,552
chr1,23377234,23377740,SRX5075176,SMARCA4,506
chr1,23377268,23377655,SRX5716470,SMARCA4,387
chr1,23377279,23377712,SRX5075175,SMARCA4,433
chr1,23377281,23377771,SRX5075168,SMARCA4,490
chr1,23377357,23377628,SRX20140879,CPSF3L,271
chr1,23377405,23377735,SRX5075169,SMARCA4,330
chr1,23377451,23377699,SRX5054309,FOSL2,248
chr1,23377469,23377682,SRX5054307,FOSL2,213
chr1,23377482,23377742,SRX5054308,FOSL2,260
chr1,23384821,23385054,SRX5075170,SMARCA4,233
chr1,23393637,23393865,SRX5054309,FOSL2,228
chr1,23393687,23393984,SRX5075175,SMARCA4,297
chr1,23393718,23393899,SRX5075169,SMARCA4,181
chr1,23393738,23393923,SRX5075170,SMARCA4,185
chr1,23394077,23394294,SRX5075170,SMARCA4,217
chr1,23394182,23394478,SRX5054308,FOSL2,296
chr1,23394237,23394463,SRX5054309,FOSL2,226
chr1,23394280,23394467,SRX5075175,SMARCA4,187
chr1,23394530,23395143,SRX5075175,SMARCA4,613
chr1,23394633,23395103,SRX5075170,SMARCA4,470
chr1,23394714,23395100,SRX5075169,SMARCA4,386
chr1,23394742,23395131,SRX5716470,SMARCA4,389
chr1,23394764,23395340,SRX5075174,SMARCA4,576
chr1,23394819,23395460,SRX5075168,SMARCA4,641
chr1,23394827,23395265,SRX5075176,SMARCA4,438
chr1,23394831,23395281,SRX5716463,SMARCA4,450
chr1,23394833,23395107,SRX5716469,SMARCA4,274
chr1,23402965,23403267,SRX5075174,SMARCA4,302
chr1,23402967,23403279,SRX5075168,SMARCA4,312
chr1,23402993,23403311,SRX5054309,FOSL2,318
chr1,23403004,23403324,SRX5054308,FOSL2,320
chr1,23403005,23403255,SRX5075169,SMARCA4,250
chr1,23403021,23403208,SRX5075175,SMARCA4,187
chr1,23403056,23403270,SRX5075170,SMARCA4,214
chr1,23403665,23403968,SRX5716460,Epitope tags,303
chr1,23403744,23404182,SRX5075169,SMARCA4,438
chr1,23403764,23404129,SRX5716469,SMARCA4,365
chr1,23403771,23404217,SRX5075176,SMARCA4,446
chr1,23403778,23404086,SRX5716467,SMARCA2,308
chr1,23403785,23404201,SRX5075170,SMARCA4,416
chr1,23403802,23404138,SRX5716470,SMARCA4,336
chr1,23403816,23404399,SRX16500060,CTCF,583
chr1,23403847,23404418,SRX16500059,CTCF,571
chr1,23403863,23404205,SRX5075175,SMARCA4,342
chr1,23403882,23404303,SRX5075174,SMARCA4,421
chr1,23403897,23404407,SRX16500061,CTCF,510
chr1,23403912,23404395,SRX16500062,CTCF,483
chr1,23403947,23404282,SRX4174629,CTCF,335
chr1,23403973,23404282,SRX5075168,SMARCA4,309
chr1,23411403,23412103,SRX5054309,FOSL2,700
chr1,23411575,23412076,SRX5075169,SMARCA4,501
chr1,23411597,23412067,SRX5075170,SMARCA4,470
chr1,23411621,23411999,SRX5075175,SMARCA4,378
chr1,23411633,23411955,SRX5716470,SMARCA4,322
chr1,23411644,23411922,SRX5716467,SMARCA2,278
chr1,23411650,23411962,SRX5075176,SMARCA4,312
chr1,23411656,23411986,SRX5054308,FOSL2,330
chr1,23411669,23411912,SRX5075181,SMARCA2,243
chr1,23411677,23411977,SRX5716469,SMARCA4,300
chr1,23411690,23411972,SRX5020211,SMARCA2,282
chr1,23411732,23411982,SRX5020214,SMARCA2,250
chr1,23470649,23471149,SRX5075170,SMARCA4,500
chr1,23470663,23470995,SRX5075175,SMARCA4,332
chr1,23470687,23471082,SRX5075169,SMARCA4,395
chr1,23470703,23471069,SRX5716470,SMARCA4,366
chr1,23470714,23471079,SRX5716467,SMARCA2,365
chr1,23470715,23471089,SRX5075176,SMARCA4,374
chr1,23470722,23471086,SRX5716468,SMARCA2,364
chr1,23475353,23475680,SRX5075169,SMARCA4,327
chr1,23475367,23475666,SRX5054309,FOSL2,299
chr1,23475381,23475618,SRX5075176,SMARCA4,237
chr1,23475393,23475621,SRX5054308,FOSL2,228
chr1,23475395,23475594,SRX5075170,SMARCA4,199
chr1,23478984,23479433,SRX5716470,SMARCA4,449
chr1,23478988,23479352,SRX5075170,SMARCA4,364
chr1,23479078,23479349,SRX5716467,SMARCA2,271
chr1,23479098,23479366,SRX5075176,SMARCA4,268
chr1,23479105,23479317,SRX5716468,SMARCA2,212
chr1,23483418,23484110,SRX16500060,CTCF,692
chr1,23483612,23484187,SRX16500062,CTCF,575
chr1,23483851,23484402,SRX20140895,INTS13,551
chr1,23484024,23484865,SRX5075174,SMARCA4,841
chr1,23484077,23484894,SRX5075168,SMARCA4,817
chr1,23484146,23484622,SRX5075170,SMARCA4,476
chr1,23484297,23484682,SRX5075176,SMARCA4,385
chr1,23484428,23484648,SRX5716469,SMARCA4,220
chr1,23496895,23497489,SRX16500060,CTCF,594
chr1,23496923,23497493,SRX16500061,CTCF,570
chr1,23496950,23497499,SRX16500059,CTCF,549
chr1,23497012,23497500,SRX16500062,CTCF,488
chr1,23497098,23497405,SRX5075168,SMARCA4,307
chr1,23497109,23497400,SRX5075174,SMARCA4,291
chr1,23497133,23497380,SRX4174629,CTCF,247
chr1,23497134,23497334,SRX5075170,SMARCA4,200
chr1,23497140,23497427,SRX5075176,SMARCA4,287
chr1,23497163,23497403,SRX5716470,SMARCA4,240
chr1,23497168,23497416,SRX5075169,SMARCA4,248
chr1,23500554,23500772,SRX5075168,SMARCA4,218
chr1,23528677,23528854,SRX5075170,SMARCA4,177
chr1,23530682,23531230,SRX20140895,INTS13,548
chr1,23530938,23531199,SRX20140868,INTS10,261
chr1,23531342,23531642,SRX5075174,SMARCA4,300
chr1,23531410,23531596,SRX5075170,SMARCA4,186
chr1,23537497,23537914,SRX5075170,SMARCA4,417
chr1,23537582,23537859,SRX5054308,FOSL2,277
chr1,23537585,23537904,SRX5716470,SMARCA4,319
chr1,23537589,23537940,SRX5075175,SMARCA4,351
chr1,23537600,23537897,SRX5020211,SMARCA2,297
chr1,23537601,23537916,SRX5075176,SMARCA4,315
chr1,23537616,23537900,SRX5716467,SMARCA2,284
chr1,23537618,23537872,SRX5054309,FOSL2,254
chr1,23537623,23537928,SRX5075169,SMARCA4,305
chr1,23537628,23537903,SRX5716469,SMARCA4,275
chr1,23539708,23540195,SRX16500060,CTCF,487
chr1,23539719,23540210,SRX16500059,CTCF,491
chr1,23539729,23540130,SRX5075168,SMARCA4,401
chr1,23539737,23540179,SRX16500062,CTCF,442
chr1,23539750,23540095,SRX5716464,SMARCA4,345
chr1,23539754,23540166,SRX16500061,CTCF,412
chr1,23539774,23540142,SRX5075174,SMARCA4,368
chr1,23539794,23540143,SRX5075170,SMARCA4,349
chr1,23539798,23540039,SRX5716470,SMARCA4,241
chr1,23539805,23540054,SRX4174629,CTCF,249
chr1,23539810,23540033,SRX5716463,SMARCA4,223
chr1,23539842,23540080,SRX5075169,SMARCA4,238
chr1,23539850,23540163,SRX5075176,SMARCA4,313
chr1,23539879,23540160,SRX5716469,SMARCA4,281
chr1,23544644,23545143,SRX16500061,CTCF,499
chr1,23544662,23545188,SRX16500059,CTCF,526
chr1,23544668,23545206,SRX16500062,CTCF,538
chr1,23544676,23545185,SRX16500060,CTCF,509
chr1,23544686,23545051,SRX4174629,CTCF,365
chr1,23544801,23545115,SRX5075176,SMARCA4,314
chr1,23544812,23545109,SRX5075168,SMARCA4,297
chr1,23544819,23545056,SRX5075170,SMARCA4,237
chr1,23544834,23545054,SRX5075174,SMARCA4,220
chr1,23554419,23555286,SRX20140895,INTS13,867
chr1,23554471,23554653,SRX5075168,SMARCA4,182
chr1,23554483,23554979,SRX5716470,SMARCA4,496
chr1,23554593,23555243,SRX5075169,SMARCA4,650
chr1,23554615,23555225,SRX5075170,SMARCA4,610
chr1,23554637,23555197,SRX5075176,SMARCA4,560
chr1,23554659,23555176,SRX5075175,SMARCA4,517
chr1,23554686,23555014,SRX5716467,SMARCA2,328
chr1,23554697,23555301,SRX5075174,SMARCA4,604
chr1,23554755,23555113,SRX5716468,SMARCA2,358
chr1,23554788,23555089,SRX5716464,SMARCA4,301
chr1,23554794,23555183,SRX5075168,SMARCA4,389
chr1,23554945,23555293,SRX20140897,INTS13,348
chr1,23555956,23556209,SRX5716469,SMARCA4,253
chr1,23559255,23559731,SRX20140881,CPSF3L,476
chr1,23559265,23559695,SRX20140867,INTS10,430
chr1,23559287,23559741,SRX20140897,INTS13,454
chr1,23559307,23559712,SRX20140879,CPSF3L,405
chr1,23559336,23559633,SRX20140896,INTS13,297
chr1,23559434,23559775,SRX20140895,INTS13,341
chr1,23562094,23562575,SRX5075175,SMARCA4,481
chr1,23562110,23562712,SRX5716470,SMARCA4,602
chr1,23562139,23562740,SRX5075176,SMARCA4,601
chr1,23562142,23562738,SRX5075168,SMARCA4,596
chr1,23562154,23562699,SRX5716469,SMARCA4,545
chr1,23562164,23562752,SRX5075174,SMARCA4,588
chr1,23562167,23562643,SRX5075169,SMARCA4,476
chr1,23562170,23562559,SRX5716468,SMARCA2,389
chr1,23562187,23562503,SRX20140881,CPSF3L,316
chr1,23562195,23562465,SRX20140867,INTS10,270
chr1,23562221,23562713,SRX5075170,SMARCA4,492
chr1,23562227,23562452,SRX5716454,SOX3,225
chr1,23562231,23562574,SRX5716467,SMARCA2,343
chr1,23562239,23562532,SRX5716451,SOX2,293
chr1,23562244,23562693,SRX5020211,SMARCA2,449
chr1,23562253,23562721,SRX5716464,SMARCA4,468
chr1,23562254,23562653,SRX5716463,SMARCA4,399
chr1,23562291,23562545,SRX5054309,FOSL2,254
chr1,23562301,23562556,SRX5075181,SMARCA2,255
chr1,23562309,23562590,SRX5054308,FOSL2,281
chr1,23562368,23562547,SRX5054307,FOSL2,179
chr1,23568116,23568935,SRX20140895,INTS13,819
chr1,23568122,23568606,SRX5075170,SMARCA4,484
chr1,23568132,23568631,SRX5716470,SMARCA4,499
chr1,23568139,23568418,SRX5075174,SMARCA4,279
chr1,23568155,23568604,SRX5075168,SMARCA4,449
chr1,23568171,23568606,SRX5075169,SMARCA4,435
chr1,23568202,23568401,SRX5716451,SOX2,199
chr1,23568242,23568447,SRX5716454,SOX3,205
chr1,23568265,23568890,SRX20140868,INTS10,625
chr1,23568267,23568553,SRX5075176,SMARCA4,286
chr1,23576976,23577463,SRX5716460,Epitope tags,487
chr1,23577015,23577658,SRX5716469,SMARCA4,643
chr1,23577080,23577484,SRX5716470,SMARCA4,404
chr1,23577082,23577682,SRX5075175,SMARCA4,600
chr1,23577086,23577625,SRX5075176,SMARCA4,539
chr1,23577091,23577650,SRX5075170,SMARCA4,559
chr1,23577093,23577589,SRX5054309,FOSL2,496
chr1,23577095,23577589,SRX5054308,FOSL2,494
chr1,23577100,23577631,SRX5075169,SMARCA4,531
chr1,23577124,23577539,SRX5716467,SMARCA2,415
chr1,23577132,23577439,SRX5020214,SMARCA2,307
chr1,23577163,23577400,SRX5716468,SMARCA2,237
chr1,23577175,23577424,SRX5075181,SMARCA2,249
chr1,23577217,23577612,SRX5020211,SMARCA2,395
chr1,23585552,23585921,SRX5075169,SMARCA4,369
chr1,23585558,23585898,SRX5075175,SMARCA4,340
chr1,23585587,23585954,SRX5054309,FOSL2,367
chr1,23585601,23585906,SRX5075170,SMARCA4,305
chr1,23585614,23585903,SRX5716469,SMARCA4,289
chr1,23585618,23585846,SRX5716467,SMARCA2,228
chr1,23585622,23585945,SRX5054308,FOSL2,323
chr1,23585631,23585890,SRX5020214,SMARCA2,259
chr1,23585635,23585924,SRX5075176,SMARCA4,289
chr1,23593600,23593872,SRX5054308,FOSL2,272
chr1,23593602,23593812,SRX5075170,SMARCA4,210
chr1,23597771,23597984,SRX5075174,SMARCA4,213
chr1,23598376,23598746,SRX20140895,INTS13,370
chr1,23598458,23598681,SRX5075169,SMARCA4,223
chr1,23598483,23599022,SRX5075174,SMARCA4,539
chr1,23598524,23598949,SRX5075168,SMARCA4,425
chr1,23598615,23598805,SRX5075170,SMARCA4,190
chr1,23634904,23635336,SRX16500062,CTCF,432
chr1,23634916,23635345,SRX16500060,CTCF,429
chr1,23634925,23635339,SRX16500059,CTCF,414
chr1,23634958,23635309,SRX5075174,SMARCA4,351
chr1,23634961,23635319,SRX16500061,CTCF,358
chr1,23634999,23635342,SRX5075168,SMARCA4,343
chr1,23635042,23635224,SRX5075170,SMARCA4,182
chr1,23635044,23635270,SRX5075176,SMARCA4,226
chr1,23635167,23635400,SRX5716469,SMARCA4,233
chr1,23637279,23637813,SRX16500061,CTCF,534
chr1,23637295,23637834,SRX16500059,CTCF,539
chr1,23637349,23637851,SRX16500060,CTCF,502
chr1,23637369,23637723,SRX5075174,SMARCA4,354
chr1,23637389,23637830,SRX16500062,CTCF,441
chr1,23637444,23637780,SRX4174629,CTCF,336
chr1,23637449,23637674,SRX5716470,SMARCA4,225
chr1,23637461,23637721,SRX5075176,SMARCA4,260
chr1,23637470,23637715,SRX5075170,SMARCA4,245
chr1,23637473,23637676,SRX5075169,SMARCA4,203
chr1,23637505,23637717,SRX5716464,SMARCA4,212
chr1,23638883,23639233,SRX5075176,SMARCA4,350
chr1,23638886,23639207,SRX5075170,SMARCA4,321
chr1,23657632,23658108,SRX16500059,CTCF,476
chr1,23657636,23658105,SRX16500060,CTCF,469
chr1,23657645,23658131,SRX16500062,CTCF,486
chr1,23657661,23658023,SRX5075168,SMARCA4,362
chr1,23657674,23658135,SRX16500061,CTCF,461
chr1,23657678,23658031,SRX5075174,SMARCA4,353
chr1,23657719,23657938,SRX5075170,SMARCA4,219
chr1,23657723,23658010,SRX5716463,SMARCA4,287
chr1,23657752,23657992,SRX5075176,SMARCA4,240
chr1,23657754,23658060,SRX5716464,SMARCA4,306
chr1,23657779,23657990,SRX5716470,SMARCA4,211
chr1,23665212,23665620,SRX16500059,CTCF,408
chr1,23665236,23665638,SRX16500060,CTCF,402
chr1,23665246,23665629,SRX16500061,CTCF,383
chr1,23665293,23665651,SRX16500062,CTCF,358
chr1,23673103,23673411,SRX5716470,SMARCA4,308
chr1,23673115,23673433,SRX5075170,SMARCA4,318
chr1,23673133,23673341,SRX5075175,SMARCA4,208
chr1,23673138,23673411,SRX5075169,SMARCA4,273
chr1,23673139,23673418,SRX5075168,SMARCA4,279
chr1,23673147,23673414,SRX5075176,SMARCA4,267
chr1,23673166,23673442,SRX5075174,SMARCA4,276
chr1,23691305,23691878,SRX16500059,CTCF,573
chr1,23691347,23691833,SRX16500061,CTCF,486
chr1,23691415,23691952,SRX16500062,CTCF,537
chr1,23691432,23691918,SRX16500060,CTCF,486
chr1,23691454,23691793,SRX5716470,SMARCA4,339
chr1,23691477,23691947,SRX5075176,SMARCA4,470
chr1,23691500,23691907,SRX5075168,SMARCA4,407
chr1,23691502,23691925,SRX5075174,SMARCA4,423
chr1,23691507,23691918,SRX5716469,SMARCA4,411
chr1,23691530,23691836,SRX5716463,SMARCA4,306
chr1,23691533,23691825,SRX5075175,SMARCA4,292
chr1,23691539,23691903,SRX5075170,SMARCA4,364
chr1,23691569,23691754,SRX5075169,SMARCA4,185
chr1,23691601,23692200,SRX20140895,INTS13,599
chr1,23691604,23692129,SRX20140879,CPSF3L,525
chr1,23691618,23692123,SRX20140894,INTS13,505
chr1,23691635,23692051,SRX20140896,INTS13,416
chr1,23691635,23692093,SRX20140897,INTS13,458
chr1,23691639,23692063,SRX20140867,INTS10,424
chr1,23691644,23691871,SRX5716464,SMARCA4,227
chr1,23691645,23692130,SRX20140868,INTS10,485
chr1,23691696,23692171,SRX20140881,CPSF3L,475
chr1,23691745,23691988,SRX20140880,CPSF3L,243
chr1,23691773,23692113,SRX20140869,INTS10,340
chr1,23718423,23718877,SRX16500059,CTCF,454
chr1,23718497,23718881,SRX16500060,CTCF,384
chr1,23718504,23718776,SRX5075174,SMARCA4,272
chr1,23718504,23718873,SRX16500062,CTCF,369
chr1,23718537,23718781,SRX5075170,SMARCA4,244
chr1,23718545,23718854,SRX16500061,CTCF,309
chr1,23718548,23718795,SRX5075176,SMARCA4,247
chr1,23718557,23718781,SRX5075168,SMARCA4,224
chr1,23719504,23719767,SRX5054308,FOSL2,263
chr1,23743029,23743260,SRX5075175,SMARCA4,231
chr1,23743030,23743704,SRX20140868,INTS10,674
chr1,23743036,23743859,SRX20140895,INTS13,823
chr1,23743125,23743521,SRX5075174,SMARCA4,396
chr1,23743128,23743366,SRX5075176,SMARCA4,238
chr1,23743139,23743629,SRX20140867,INTS10,490
chr1,23743181,23743617,SRX5075168,SMARCA4,436
chr1,23743197,23743495,SRX5075170,SMARCA4,298
chr1,23745472,23745854,SRX16500059,CTCF,382
chr1,23745521,23745916,SRX16500061,CTCF,395
chr1,23745618,23745878,SRX16500062,CTCF,260
chr1,23751262,23751849,SRX16500059,CTCF,587
chr1,23751281,23751728,SRX16500060,CTCF,447
chr1,23751298,23751722,SRX16500062,CTCF,424
chr1,23751361,23751729,SRX16500061,CTCF,368
chr1,23772072,23772550,SRX16500060,CTCF,478
chr1,23772098,23772555,SRX16500062,CTCF,457
chr1,23772100,23772520,SRX16500061,CTCF,420
chr1,23772102,23772607,SRX16500059,CTCF,505
chr1,23772159,23772464,SRX5075176,SMARCA4,305
chr1,23772163,23772475,SRX5075168,SMARCA4,312
chr1,23772176,23772433,SRX5075174,SMARCA4,257
chr1,23772208,23772448,SRX5716463,SMARCA4,240
chr1,23772240,23772454,SRX5075170,SMARCA4,214
chr1,23772279,23772513,SRX4174629,CTCF,234
chr1,23777997,23778303,SRX20140897,INTS13,306
chr1,23778125,23778667,SRX5075174,SMARCA4,542
chr1,23778158,23778623,SRX5075168,SMARCA4,465
chr1,23778236,23778628,SRX20140867,INTS10,392
chr1,23778361,23778605,SRX20140897,INTS13,244
chr1,23778363,23778591,SRX5075176,SMARCA4,228
chr1,23778403,23778727,SRX20140895,INTS13,324
chr1,23778419,23778611,SRX5075170,SMARCA4,192
chr1,23779805,23780177,SRX5054309,FOSL2,372
chr1,23790046,23790438,SRX5075169,SMARCA4,392
chr1,23790132,23790394,SRX5054308,FOSL2,262
chr1,23790174,23790414,SRX5054309,FOSL2,240
chr1,23790184,23790432,SRX5716469,SMARCA4,248
chr1,23790206,23790393,SRX5075170,SMARCA4,187
chr1,23790210,23790431,SRX5075175,SMARCA4,221
chr1,23790862,23791331,SRX5075168,SMARCA4,469
chr1,23790944,23791329,SRX20140895,INTS13,385
chr1,23790949,23791172,SRX5075170,SMARCA4,223
chr1,23790961,23791240,SRX5075176,SMARCA4,279
chr1,23790964,23791271,SRX5075174,SMARCA4,307
chr1,23791068,23791318,SRX5716470,SMARCA4,250
chr1,23800124,23800303,SRX5075168,SMARCA4,179
chr1,23800291,23801178,SRX20140895,INTS13,887
chr1,23800459,23800680,SRX20140867,INTS10,221
chr1,23800558,23801083,SRX5075174,SMARCA4,525
chr1,23800659,23801041,SRX5075176,SMARCA4,382
chr1,23800673,23801038,SRX20140868,INTS10,365
chr1,23800708,23801056,SRX5075168,SMARCA4,348
chr1,23800731,23800971,SRX5054309,FOSL2,240
chr1,23800739,23801048,SRX20140867,INTS10,309
chr1,23800769,23801032,SRX5716463,SMARCA4,263
chr1,23800795,23801073,SRX5075175,SMARCA4,278
chr1,23800799,23800995,SRX5075170,SMARCA4,196
chr1,23800818,23801062,SRX5716470,SMARCA4,244
chr1,23800863,23801099,SRX5075169,SMARCA4,236
chr1,23809750,23809988,SRX16500062,CTCF,238
chr1,23809755,23810063,SRX16500060,CTCF,308
chr1,23809758,23810009,SRX16500061,CTCF,251
chr1,23809765,23810071,SRX16500059,CTCF,306
chr1,23809783,23810002,SRX5075168,SMARCA4,219
chr1,23809791,23810042,SRX5075174,SMARCA4,251
chr1,23810764,23811128,SRX16500060,CTCF,364
chr1,23810767,23811041,SRX16500059,CTCF,274
chr1,23810790,23811118,SRX16500062,CTCF,328
chr1,23810812,23811070,SRX16500061,CTCF,258
chr1,23810853,23811071,SRX5075174,SMARCA4,218
chr1,23810867,23811125,SRX5075168,SMARCA4,258
chr1,23825082,23825554,SRX20140868,INTS10,472
chr1,23825142,23825708,SRX20140895,INTS13,566
chr1,23825152,23825530,SRX20140869,INTS10,378
chr1,23825158,23825678,SRX20140897,INTS13,520
chr1,23825168,23825719,SRX5075174,SMARCA4,551
chr1,23825188,23825731,SRX5075168,SMARCA4,543
chr1,23825191,23825673,SRX5075170,SMARCA4,482
chr1,23825195,23825587,SRX20140867,INTS10,392
chr1,23825204,23825514,SRX20140896,INTS13,310
chr1,23825220,23825695,SRX5075176,SMARCA4,475
chr1,23825266,23825638,SRX5716469,SMARCA4,372
chr1,23825285,23825720,SRX5075169,SMARCA4,435
chr1,23825293,23825619,SRX5075175,SMARCA4,326
chr1,23825309,23825619,SRX5716464,SMARCA4,310
chr1,23825359,23825671,SRX5716470,SMARCA4,312
chr1,23867880,23868262,SRX5075169,SMARCA4,382
chr1,23867991,23868590,SRX5075168,SMARCA4,599
chr1,23868029,23868609,SRX5075174,SMARCA4,580
chr1,23868069,23868516,SRX5075175,SMARCA4,447
chr1,23868070,23868471,SRX20140895,INTS13,401
chr1,23868106,23868387,SRX20140897,INTS13,281
chr1,23868120,23868539,SRX5075170,SMARCA4,419
chr1,23868188,23868795,SRX16500059,CTCF,607
chr1,23868211,23868837,SRX16500060,CTCF,626
chr1,23868221,23868536,SRX5716463,SMARCA4,315
chr1,23868223,23868526,SRX5075176,SMARCA4,303
chr1,23868229,23868712,SRX16500061,CTCF,483
chr1,23868240,23868691,SRX16500062,CTCF,451
chr1,23868264,23868535,SRX5716464,SMARCA4,271
chr1,23868283,23868473,SRX5054307,FOSL2,190
chr1,23868353,23868662,SRX4174629,CTCF,309
chr1,23907768,23908088,SRX5716469,SMARCA4,320
chr1,23907776,23907971,SRX5075169,SMARCA4,195
chr1,23907792,23908045,SRX5054308,FOSL2,253
chr1,23907797,23908074,SRX5054309,FOSL2,277
chr1,23907855,23908060,SRX5075175,SMARCA4,205
chr1,23916855,23917076,SRX16500060,CTCF,221
chr1,23949133,23949536,SRX16500059,CTCF,403
chr1,23949147,23949477,SRX16500060,CTCF,330
chr1,23949167,23949442,SRX16500062,CTCF,275
chr1,23949187,23949486,SRX16500061,CTCF,299
chr1,23951559,23951949,SRX5075175,SMARCA4,390
chr1,23951592,23951961,SRX5075174,SMARCA4,369
chr1,23951608,23951942,SRX5075169,SMARCA4,334
chr1,23951617,23951866,SRX5075168,SMARCA4,249
chr1,23951625,23951915,SRX5716469,SMARCA4,290
chr1,23951644,23951897,SRX5054309,FOSL2,253
chr1,23951681,23951851,SRX5075170,SMARCA4,170
chr1,23951713,23951902,SRX5054308,FOSL2,189
chr1,23956281,23956321,SRX1424894,POU3F2,40
chr1,23958930,23959279,SRX5075176,SMARCA4,349
chr1,23958947,23959186,SRX5075168,SMARCA4,239
chr1,23958976,23959273,SRX5075174,SMARCA4,297
chr1,23959011,23960254,SRX20140895,INTS13,1243
chr1,23959028,23959210,SRX5075169,SMARCA4,182
chr1,23959069,23959240,SRX5075170,SMARCA4,171
chr1,23959348,23960223,SRX20140867,INTS10,875
chr1,23959359,23960195,SRX20140868,INTS10,836
chr1,23959444,23960073,SRX20140881,CPSF3L,629
chr1,23959487,23959825,SRX5075174,SMARCA4,338
chr1,23959501,23959815,SRX5075168,SMARCA4,314
chr1,23959564,23960230,SRX20140897,INTS13,666
chr1,23959608,23960231,SRX20140869,INTS10,623
chr1,23959775,23960139,SRX20140896,INTS13,364
chr1,23959788,23960106,SRX20140879,CPSF3L,318
chr1,23960099,23960268,SRX5075170,SMARCA4,169
chr1,23979788,23980644,SRX20140895,INTS13,856
chr1,23979794,23980538,SRX20140867,INTS10,744
chr1,23979823,23980535,SRX20140881,CPSF3L,712
chr1,23979898,23980527,SRX20140896,INTS13,629
chr1,23979986,23980734,SRX20140868,INTS10,748
chr1,23979987,23980424,SRX20140869,INTS10,437
chr1,23979997,23980410,SRX20140879,CPSF3L,413
chr1,23980005,23980478,SRX20140897,INTS13,473
chr1,23980009,23980349,SRX20140894,INTS13,340
chr1,23980047,23980301,SRX20140880,CPSF3L,254
chr1,23980290,23980660,SRX5075174,SMARCA4,370
chr1,23980301,23980696,SRX5075168,SMARCA4,395
chr1,23980372,23980621,SRX5716463,SMARCA4,249
chr1,23980414,23980615,SRX5054309,FOSL2,201
chr1,23980427,23980706,SRX5716464,SMARCA4,279
chr1,23980428,23980609,SRX5075176,SMARCA4,181
chr1,23984518,23984873,SRX5716469,SMARCA4,355
chr1,23984536,23984949,SRX5716470,SMARCA4,413
chr1,23984579,23984992,SRX5075176,SMARCA4,413
chr1,23984595,23984847,SRX5716468,SMARCA2,252
chr1,23984609,23985006,SRX5075169,SMARCA4,397
chr1,23984613,23984963,SRX5075175,SMARCA4,350
chr1,23984614,23984831,SRX5054309,FOSL2,217
chr1,23984626,23984885,SRX5020211,SMARCA2,259
chr1,23984644,23984872,SRX5075170,SMARCA4,228
chr1,23984669,23984992,SRX5054308,FOSL2,323
chr1,23984671,23984869,SRX5075181,SMARCA2,198
chr1,23997814,23997997,SRX5075176,SMARCA4,183
chr1,24003366,24003729,SRX5075169,SMARCA4,363
chr1,24003388,24003774,SRX5716470,SMARCA4,386
chr1,24003432,24003763,SRX5075175,SMARCA4,331
chr1,24003440,24003765,SRX5716469,SMARCA4,325
chr1,24003443,24003743,SRX5075170,SMARCA4,300
chr1,24003501,24003764,SRX5075176,SMARCA4,263
chr1,24008603,24008921,SRX5716470,SMARCA4,318
chr1,24008605,24008861,SRX5020211,SMARCA2,256
chr1,24008618,24008924,SRX5075170,SMARCA4,306
chr1,24008637,24008883,SRX5075175,SMARCA4,246
chr1,24008641,24008920,SRX5075169,SMARCA4,279
chr1,24008642,24008945,SRX5075176,SMARCA4,303
chr1,24008665,24008940,SRX5716467,SMARCA2,275
chr1,24008667,24008944,SRX5716468,SMARCA2,277
chr1,24009421,24009724,SRX5716469,SMARCA4,303
chr1,24009421,24009774,SRX5075174,SMARCA4,353
chr1,24009428,24009811,SRX5075176,SMARCA4,383
chr1,24009433,24009765,SRX5075169,SMARCA4,332
chr1,24009439,24009759,SRX5075175,SMARCA4,320
chr1,24009450,24009767,SRX5075170,SMARCA4,317
chr1,24009452,24009782,SRX5054309,FOSL2,330
chr1,24009470,24009779,SRX5075168,SMARCA4,309
chr1,24009473,24009752,SRX5054308,FOSL2,279
chr1,24009492,24009741,SRX5716470,SMARCA4,249
chr1,24009548,24009762,SRX5054307,FOSL2,214
chr1,24015827,24016207,SRX5075176,SMARCA4,380
chr1,24015850,24016167,SRX5075170,SMARCA4,317
chr1,24015852,24016084,SRX5716470,SMARCA4,232
chr1,24015860,24016133,SRX5716467,SMARCA2,273
chr1,24015863,24016089,SRX5075175,SMARCA4,226
chr1,24015883,24016104,SRX5716468,SMARCA2,221
chr1,24015910,24016172,SRX5716469,SMARCA4,262
chr1,24015933,24016119,SRX5075169,SMARCA4,186
chr1,24018620,24019279,SRX5716470,SMARCA4,659
chr1,24018659,24019222,SRX5075176,SMARCA4,563
chr1,24018662,24019107,SRX20140867,INTS10,445
chr1,24018675,24019214,SRX5075169,SMARCA4,539
chr1,24018698,24019202,SRX5716469,SMARCA4,504
chr1,24018718,24019231,SRX5075174,SMARCA4,513
chr1,24018719,24019240,SRX5716463,SMARCA4,521
chr1,24018723,24019210,SRX5075175,SMARCA4,487
chr1,24018730,24019260,SRX5075168,SMARCA4,530
chr1,24018735,24019213,SRX5075170,SMARCA4,478
chr1,24018738,24019013,SRX20140897,INTS13,275
chr1,24018741,24019112,SRX5716464,SMARCA4,371
chr1,24018748,24019179,SRX5716468,SMARCA2,431
chr1,24018769,24019157,SRX5020211,SMARCA2,388
chr1,24018769,24019171,SRX5020214,SMARCA2,402
chr1,24018776,24019150,SRX5075181,SMARCA2,374
chr1,24018812,24019169,SRX5716467,SMARCA2,357
chr1,24018813,24019119,SRX5054308,FOSL2,306
chr1,24018933,24019183,SRX5054309,FOSL2,250
chr1,24022697,24022953,SRX5075169,SMARCA4,256
chr1,24022723,24022915,SRX5054309,FOSL2,192
chr1,24028021,24028384,SRX16500061,CTCF,363
chr1,24028057,24028442,SRX16500060,CTCF,385
chr1,24028098,24028349,SRX5075176,SMARCA4,251
chr1,24028113,24028370,SRX5075170,SMARCA4,257
chr1,24028132,24028317,SRX5075169,SMARCA4,185
chr1,24028172,24028477,SRX16500059,CTCF,305
chr1,24046251,24046687,SRX5716470,SMARCA4,436
chr1,24046257,24046702,SRX5075176,SMARCA4,445
chr1,24046260,24046663,SRX5075175,SMARCA4,403
chr1,24046265,24046510,SRX5716467,SMARCA2,245
chr1,24046297,24046690,SRX5075174,SMARCA4,393
chr1,24046306,24046636,SRX5716469,SMARCA4,330
chr1,24046307,24046679,SRX5075169,SMARCA4,372
chr1,24046310,24046699,SRX5075168,SMARCA4,389
chr1,24046327,24046710,SRX5075170,SMARCA4,383
chr1,24046379,24046596,SRX5054308,FOSL2,217
chr1,24046383,24046630,SRX5054309,FOSL2,247
chr1,24070711,24071280,SRX16500060,CTCF,569
chr1,24070714,24071289,SRX16500059,CTCF,575
chr1,24070759,24071311,SRX16500061,CTCF,552
chr1,24070814,24071281,SRX16500062,CTCF,467
chr1,24070872,24071163,SRX5075168,SMARCA4,291
chr1,24070888,24071179,SRX5075174,SMARCA4,291
chr1,24070921,24071155,SRX5075175,SMARCA4,234
chr1,24070945,24071226,SRX4174629,CTCF,281
chr1,24070948,24071149,SRX5075170,SMARCA4,201
chr1,24108879,24109148,SRX5075175,SMARCA4,269
chr1,24108919,24109116,SRX5054309,FOSL2,197
chr1,24108974,24109235,SRX5075169,SMARCA4,261
chr1,24112677,24112887,SRX4174629,CTCF,210
chr1,24117858,24118044,SRX5075169,SMARCA4,186
chr1,24150336,24150908,SRX16500060,CTCF,572
chr1,24150346,24150905,SRX16500061,CTCF,559
chr1,24150355,24150905,SRX16500062,CTCF,550
chr1,24150423,24150983,SRX16500059,CTCF,560
chr1,24150426,24150855,SRX4174629,CTCF,429
chr1,24150431,24150786,SRX5075176,SMARCA4,355
chr1,24150498,24150847,SRX5075170,SMARCA4,349
chr1,24150521,24150775,SRX5075168,SMARCA4,254
chr1,24150543,24150769,SRX5075174,SMARCA4,226
chr1,24150858,24151124,SRX20140869,INTS10,266
chr1,24187320,24187489,SRX5075170,SMARCA4,169
chr1,24199226,24199672,SRX4174629,CTCF,446
chr1,24199232,24199699,SRX16500059,CTCF,467
chr1,24199260,24199700,SRX16500060,CTCF,440
chr1,24199265,24199654,SRX16500062,CTCF,389
chr1,24199276,24199675,SRX16500061,CTCF,399
chr1,24201813,24202249,SRX16500061,CTCF,436
chr1,24201827,24202258,SRX16500060,CTCF,431
chr1,24201831,24202284,SRX16500059,CTCF,453
chr1,24201854,24202224,SRX16500062,CTCF,370
chr1,24201952,24202242,SRX5075170,SMARCA4,290
chr1,24201968,24202280,SRX5075176,SMARCA4,312
chr1,24201982,24202223,SRX5075175,SMARCA4,241
chr1,24201984,24202219,SRX5075169,SMARCA4,235
chr1,24234138,24234523,SRX5075176,SMARCA4,385
chr1,24234247,24234449,SRX5075169,SMARCA4,202
chr1,24234277,24234460,SRX5054309,FOSL2,183
chr1,24236696,24236973,SRX5075176,SMARCA4,277
chr1,24266456,24266650,SRX5054309,FOSL2,194
chr1,24266458,24266676,SRX5075169,SMARCA4,218
chr1,24283918,24284145,SRX5054308,FOSL2,227
chr1,24289951,24290224,SRX5075169,SMARCA4,273
chr1,24289986,24290212,SRX5075176,SMARCA4,226
chr1,24290010,24290232,SRX5075170,SMARCA4,222
chr1,24290019,24290249,SRX5716470,SMARCA4,230
chr1,24294360,24294695,SRX5054309,FOSL2,335
chr1,24294371,24294711,SRX5075176,SMARCA4,340
chr1,24294400,24295142,SRX5075170,SMARCA4,742
chr1,24294406,24294717,SRX5075169,SMARCA4,311
chr1,24294415,24294669,SRX5075175,SMARCA4,254
chr1,24294416,24294651,SRX5054308,FOSL2,235
chr1,24294434,24294767,SRX5716469,SMARCA4,333
chr1,24294857,24295225,SRX5716470,SMARCA4,368
chr1,24301836,24302014,SRX5075170,SMARCA4,178
chr1,24308424,24308665,SRX5075170,SMARCA4,241
chr1,24308428,24308673,SRX5075169,SMARCA4,245
chr1,24308444,24308641,SRX5054308,FOSL2,197
chr1,24308456,24308662,SRX5075175,SMARCA4,206
chr1,24308474,24308657,SRX5054309,FOSL2,183
chr1,24308526,24308701,SRX5075176,SMARCA4,175
chr1,24308728,24309016,SRX16500061,CTCF,288
chr1,24318034,24318552,SRX5075170,SMARCA4,518
chr1,24318110,24318420,SRX5716467,SMARCA2,310
chr1,24318155,24318530,SRX5075176,SMARCA4,375
chr1,24318209,24318478,SRX5075169,SMARCA4,269
chr1,24318235,24318485,SRX5716470,SMARCA4,250
chr1,24318256,24318472,SRX5716469,SMARCA4,216
chr1,24318322,24318599,SRX5075175,SMARCA4,277
chr1,24322296,24322686,SRX5075176,SMARCA4,390
chr1,24322340,24322626,SRX5075169,SMARCA4,286
chr1,24322350,24322653,SRX5075174,SMARCA4,303
chr1,24322365,24322584,SRX5075181,SMARCA2,219
chr1,24322379,24322600,SRX5075168,SMARCA4,221
chr1,24330181,24330398,SRX5716469,SMARCA4,217
chr1,24330212,24330583,SRX5075176,SMARCA4,371
chr1,24330241,24330551,SRX5075170,SMARCA4,310
chr1,24330246,24330433,SRX5075175,SMARCA4,187
chr1,24330249,24330468,SRX5716470,SMARCA4,219
chr1,24330315,24330531,SRX5075169,SMARCA4,216
chr1,24344826,24345274,SRX20140895,INTS13,448
chr1,24362951,24363407,SRX5075176,SMARCA4,456
chr1,24362973,24363347,SRX5075175,SMARCA4,374
chr1,24362986,24363372,SRX5075169,SMARCA4,386
chr1,24362987,24363501,SRX5075170,SMARCA4,514
chr1,24363001,24363352,SRX5716469,SMARCA4,351
chr1,24363015,24363334,SRX5054309,FOSL2,319
chr1,24363026,24363341,SRX5054308,FOSL2,315
chr1,24363030,24363346,SRX5716468,SMARCA2,316
chr1,24363037,24363300,SRX5716467,SMARCA2,263
chr1,24363048,24363323,SRX5716470,SMARCA4,275
chr1,24363147,24363347,SRX5020211,SMARCA2,200
chr1,24365139,24365540,SRX5075169,SMARCA4,401
chr1,24365273,24365540,SRX5054309,FOSL2,267
chr1,24365297,24365484,SRX5075175,SMARCA4,187
chr1,24375182,24375396,SRX5716469,SMARCA4,214
chr1,24375186,24375494,SRX5075169,SMARCA4,308
chr1,24375199,24375512,SRX5075175,SMARCA4,313
chr1,24375284,24375535,SRX5075176,SMARCA4,251
chr1,24375305,24375517,SRX5716470,SMARCA4,212
chr1,24390084,24390377,SRX16500060,CTCF,293
chr1,24390093,24390363,SRX16500062,CTCF,270
chr1,24390099,24390379,SRX16500059,CTCF,280
chr1,24390131,24390405,SRX16500061,CTCF,274
chr1,24391223,24391668,SRX16500060,CTCF,445
chr1,24391261,24391638,SRX16500062,CTCF,377
chr1,24391275,24391662,SRX16500061,CTCF,387
chr1,24391279,24391698,SRX16500059,CTCF,419
chr1,24391294,24391623,SRX4174629,CTCF,329
chr1,24391301,24391586,SRX5075168,SMARCA4,285
chr1,24391317,24391568,SRX5075170,SMARCA4,251
chr1,24391335,24391548,SRX5075174,SMARCA4,213
chr1,24391341,24391519,SRX5075176,SMARCA4,178
chr1,24391360,24391565,SRX5075169,SMARCA4,205
chr1,24392285,24392698,SRX16500059,CTCF,413
chr1,24392313,24392648,SRX16500062,CTCF,335
chr1,24392322,24392530,SRX5075174,SMARCA4,208
chr1,24392329,24392701,SRX16500060,CTCF,372
chr1,24392341,24392660,SRX16500061,CTCF,319
chr1,24392391,24392570,SRX5075168,SMARCA4,179
chr1,24394038,24394277,SRX5075169,SMARCA4,239
chr1,24394082,24394270,SRX5054308,FOSL2,188
chr1,24415230,24416008,SRX16500059,CTCF,778
chr1,24415294,24415928,SRX16500060,CTCF,634
chr1,24415307,24415788,SRX16500061,CTCF,481
chr1,24415362,24415835,SRX16500062,CTCF,473
chr1,24415443,24415866,SRX4174629,CTCF,423
chr1,24415472,24415775,SRX5075174,SMARCA4,303
chr1,24415542,24415907,SRX5075168,SMARCA4,365
chr1,24415596,24415774,SRX5075170,SMARCA4,178
chr1,24416978,24417303,SRX5075169,SMARCA4,325
chr1,24417012,24417278,SRX5075175,SMARCA4,266
chr1,24443319,24443679,SRX5075176,SMARCA4,360
chr1,24443335,24443710,SRX5716470,SMARCA4,375
chr1,24443381,24443586,SRX5075174,SMARCA4,205
chr1,24443407,24443602,SRX5075170,SMARCA4,195
chr1,24443416,24443672,SRX5075169,SMARCA4,256
chr1,24462190,24462412,SRX5054309,FOSL2,222
chr1,24464244,24464722,SRX5075170,SMARCA4,478
chr1,24464316,24464633,SRX5075176,SMARCA4,317
chr1,24464336,24464651,SRX5075175,SMARCA4,315
chr1,24464340,24464548,SRX5054309,FOSL2,208
chr1,24464393,24464711,SRX5075169,SMARCA4,318
chr1,24502658,24503046,SRX5075169,SMARCA4,388
chr1,24502671,24503007,SRX5075175,SMARCA4,336
chr1,24502697,24503066,SRX5075176,SMARCA4,369
chr1,24502720,24502996,SRX5075174,SMARCA4,276
chr1,24502739,24502951,SRX5716469,SMARCA4,212
chr1,24502745,24502967,SRX5075168,SMARCA4,222
chr1,24502756,24503110,SRX5075170,SMARCA4,354
chr1,24527176,24527502,SRX16500062,CTCF,326
chr1,24527182,24527594,SRX16500060,CTCF,412
chr1,24527184,24527567,SRX16500061,CTCF,383
chr1,24527216,24527563,SRX16500059,CTCF,347
chr1,24541019,24541339,SRX5054309,FOSL2,320
chr1,24541029,24541360,SRX5075175,SMARCA4,331
chr1,24541040,24541271,SRX5075170,SMARCA4,231
chr1,24541041,24541308,SRX5054308,FOSL2,267
chr1,24541057,24541273,SRX5075176,SMARCA4,216
chr1,24541062,24541306,SRX5075174,SMARCA4,244
chr1,24541064,24541339,SRX5075169,SMARCA4,275
chr1,24541943,24542403,SRX16500060,CTCF,460
chr1,24541947,24542417,SRX16500059,CTCF,470
chr1,24541972,24542382,SRX16500062,CTCF,410
chr1,24541975,24542388,SRX16500061,CTCF,413
chr1,24552021,24552359,SRX20140895,INTS13,338
chr1,24552274,24552568,SRX5075168,SMARCA4,294
chr1,24552282,24552584,SRX5075174,SMARCA4,302
chr1,24552294,24552603,SRX5716463,SMARCA4,309
chr1,24559042,24559385,SRX5075176,SMARCA4,343
chr1,24559054,24559367,SRX5075169,SMARCA4,313
chr1,24559060,24559313,SRX5716470,SMARCA4,253
chr1,24559108,24559370,SRX5075170,SMARCA4,262
chr1,24559147,24559377,SRX5075175,SMARCA4,230
chr1,24566338,24566604,SRX5054309,FOSL2,266
chr1,24566382,24566551,SRX5075170,SMARCA4,169
chr1,24587100,24587602,SRX16500060,CTCF,502
chr1,24587176,24587677,SRX16500061,CTCF,501
chr1,24587177,24587631,SRX16500059,CTCF,454
chr1,24587181,24587685,SRX16500062,CTCF,504
chr1,24593512,24593848,SRX16500061,CTCF,336
chr1,24593539,24593782,SRX16500059,CTCF,243
chr1,24599800,24599855,SRX1424893,POU3F2,55
chr1,24599801,24599856,SRX1424892,POU3F2,55
chr1,24599803,24599857,SRX1424891,POU3F2,54
chr1,24599807,24599855,SRX1424894,POU3F2,48
chr1,24635202,24635738,SRX16500059,CTCF,536
chr1,24635212,24635513,SRX5075176,SMARCA4,301
chr1,24635223,24635580,SRX16500062,CTCF,357
chr1,24635252,24635691,SRX16500060,CTCF,439
chr1,24635259,24635493,SRX5075174,SMARCA4,234
chr1,24635268,24635790,SRX16500061,CTCF,522
chr1,24635278,24635490,SRX5075168,SMARCA4,212
chr1,24635283,24635500,SRX5075170,SMARCA4,217
chr1,24642297,24643098,SRX20140869,INTS10,801
chr1,24642456,24643631,SRX20140895,INTS13,1175
chr1,24642468,24643369,SRX20140897,INTS13,901
chr1,24642473,24643039,SRX20140881,CPSF3L,566
chr1,24642504,24642765,SRX5075175,SMARCA4,261
chr1,24642510,24642922,SRX5075169,SMARCA4,412
chr1,24642510,24643074,SRX20140868,INTS10,564
chr1,24642539,24643055,SRX5075170,SMARCA4,516
chr1,24642548,24643020,SRX5075176,SMARCA4,472
chr1,24642592,24642811,SRX5716469,SMARCA4,219
chr1,24642606,24643106,SRX20140896,INTS13,500
chr1,24642609,24643021,SRX20140879,CPSF3L,412
chr1,24642618,24643427,SRX20140867,INTS10,809
chr1,24642667,24643375,SRX5075168,SMARCA4,708
chr1,24642698,24642938,SRX20140880,CPSF3L,240
chr1,24642817,24643261,SRX5716451,SOX2,444
chr1,24642827,24643189,SRX5054308,FOSL2,362
chr1,24642836,24643235,SRX5054309,FOSL2,399
chr1,24642836,24643247,SRX5054307,FOSL2,411
chr1,24642868,24643098,SRX5716469,SMARCA4,230
chr1,24642908,24643211,SRX5716454,SOX3,303
chr1,24642909,24643450,SRX5716463,SMARCA4,541
chr1,24642918,24643424,SRX5075174,SMARCA4,506
chr1,24643003,24643272,SRX5716464,SMARCA4,269
chr1,24672629,24672900,SRX5075170,SMARCA4,271
chr1,24672817,24673033,SRX5075169,SMARCA4,216
chr1,24683585,24684064,SRX5075176,SMARCA4,479
chr1,24683594,24684071,SRX5075175,SMARCA4,477
chr1,24683605,24684015,SRX5075168,SMARCA4,410
chr1,24683613,24684020,SRX5075174,SMARCA4,407
chr1,24683624,24683999,SRX5716459,Epitope tags,375
chr1,24683627,24684071,SRX5075169,SMARCA4,444
chr1,24683650,24684072,SRX5054309,FOSL2,422
chr1,24683657,24684070,SRX5075170,SMARCA4,413
chr1,24683665,24684089,SRX5716470,SMARCA4,424
chr1,24683687,24684072,SRX5716469,SMARCA4,385
chr1,24683713,24684039,SRX5716467,SMARCA2,326
chr1,24683734,24684048,SRX5054308,FOSL2,314
chr1,24683788,24684027,SRX5020214,SMARCA2,239
chr1,24688441,24689018,SRX16500059,CTCF,577
chr1,24688461,24688968,SRX16500060,CTCF,507
chr1,24688476,24688962,SRX16500062,CTCF,486
chr1,24688501,24688936,SRX16500061,CTCF,435
chr1,24688615,24688881,SRX5075174,SMARCA4,266
chr1,24688628,24688888,SRX4174629,CTCF,260
chr1,24688637,24688969,SRX5075168,SMARCA4,332
chr1,24688646,24688885,SRX5075170,SMARCA4,239
chr1,24688649,24688894,SRX5716463,SMARCA4,245
chr1,24688711,24688984,SRX5075175,SMARCA4,273
chr1,24688719,24688928,SRX5075176,SMARCA4,209
chr1,24699037,24699287,SRX5075176,SMARCA4,250
chr1,24699054,24699242,SRX5075170,SMARCA4,188
chr1,24702495,24702815,SRX5075169,SMARCA4,320
chr1,24702517,24702820,SRX5716467,SMARCA2,303
chr1,24702520,24702824,SRX5075170,SMARCA4,304
chr1,24702541,24702812,SRX5716470,SMARCA4,271
chr1,24702547,24702913,SRX5075175,SMARCA4,366
chr1,24702572,24702878,SRX5075176,SMARCA4,306
chr1,24702577,24702846,SRX5716469,SMARCA4,269
chr1,24704795,24705015,SRX5075174,SMARCA4,220
chr1,24705161,24705611,SRX5075168,SMARCA4,450
chr1,24705325,24705594,SRX5075174,SMARCA4,269
chr1,24705370,24705915,SRX5075176,SMARCA4,545
chr1,24705407,24705857,SRX5716469,SMARCA4,450
chr1,24705415,24705886,SRX5075170,SMARCA4,471
chr1,24705420,24705860,SRX5075169,SMARCA4,440
chr1,24705460,24705769,SRX5716470,SMARCA4,309
chr1,24705536,24705751,SRX5716467,SMARCA2,215
chr1,24713268,24713496,SRX5054309,FOSL2,228
chr1,24720152,24720354,SRX5075176,SMARCA4,202
chr1,24720201,24720379,SRX5075170,SMARCA4,178
chr1,24724781,24725131,SRX5075174,SMARCA4,350
chr1,24724786,24725087,SRX5716469,SMARCA4,301
chr1,24724786,24725214,SRX5075175,SMARCA4,428
chr1,24724798,24725072,SRX5020214,SMARCA2,274
chr1,24724808,24725184,SRX5075169,SMARCA4,376
chr1,24724811,24725135,SRX5716470,SMARCA4,324
chr1,24724857,24725142,SRX5075176,SMARCA4,285
chr1,24724860,24725120,SRX5716467,SMARCA2,260
chr1,24724872,24725152,SRX5075170,SMARCA4,280
chr1,24724887,24725098,SRX5716468,SMARCA2,211
chr1,24724948,24725220,SRX20140869,INTS10,272
chr1,24724992,24725733,SRX5075168,SMARCA4,741
chr1,24725216,24725748,SRX5075174,SMARCA4,532
chr1,24725359,24725685,SRX20140895,INTS13,326
chr1,24725384,24725712,SRX20140868,INTS10,328
chr1,24725425,24725701,SRX20140894,INTS13,276
chr1,24725448,24725656,SRX5075176,SMARCA4,208
chr1,24727539,24727881,SRX5075169,SMARCA4,342
chr1,24727576,24727820,SRX5075176,SMARCA4,244
chr1,24727587,24727799,SRX5075170,SMARCA4,212
chr1,24727594,24727805,SRX5716470,SMARCA4,211
chr1,24727597,24727829,SRX5075175,SMARCA4,232
chr1,24727660,24727868,SRX5020211,SMARCA2,208
chr1,24735685,24736276,SRX5716469,SMARCA4,591
chr1,24735779,24736304,SRX5075175,SMARCA4,525
chr1,24735801,24736322,SRX5075176,SMARCA4,521
chr1,24735819,24736286,SRX5075170,SMARCA4,467
chr1,24735837,24736403,SRX5716468,SMARCA2,566
chr1,24735856,24736216,SRX5716470,SMARCA4,360
chr1,24735859,24736278,SRX5075169,SMARCA4,419
chr1,24735874,24736258,SRX5716467,SMARCA2,384
chr1,24743764,24744081,SRX5075170,SMARCA4,317
chr1,24743780,24744070,SRX5075176,SMARCA4,290
chr1,24744803,24745420,SRX5075176,SMARCA4,617
chr1,24744841,24745394,SRX5075175,SMARCA4,553
chr1,24744844,24745425,SRX5075174,SMARCA4,581
chr1,24744846,24745294,SRX5716470,SMARCA4,448
chr1,24744846,24745381,SRX5716469,SMARCA4,535
chr1,24744877,24745506,SRX5075168,SMARCA4,629
chr1,24744895,24745430,SRX5075170,SMARCA4,535
chr1,24744927,24745365,SRX5075169,SMARCA4,438
chr1,24745003,24745359,SRX5716464,SMARCA4,356
chr1,24745014,24745429,SRX5054308,FOSL2,415
chr1,24745025,24745867,SRX20140895,INTS13,842
chr1,24745056,24745421,SRX5716463,SMARCA4,365
chr1,24745106,24745386,SRX5054307,FOSL2,280
chr1,24745145,24745431,SRX5716451,SOX2,286
chr1,24745166,24745659,SRX20140867,INTS10,493
chr1,24745168,24745662,SRX20140896,INTS13,494
chr1,24745239,24745642,SRX20140897,INTS13,403
chr1,24745274,24745790,SRX20140868,INTS10,516
chr1,24745281,24745657,SRX20140879,CPSF3L,376
chr1,24745283,24745718,SRX20140881,CPSF3L,435
chr1,24754242,24754495,SRX5075169,SMARCA4,253
chr1,24754298,24754501,SRX5075170,SMARCA4,203
chr1,24765449,24765729,SRX5075176,SMARCA4,280
chr1,24765495,24765675,SRX5054308,FOSL2,180
chr1,24765544,24765734,SRX5054309,FOSL2,190
chr1,24770164,24770617,SRX5075175,SMARCA4,453
chr1,24770179,24770619,SRX5075169,SMARCA4,440
chr1,24770201,24770569,SRX5075176,SMARCA4,368
chr1,24770202,24770567,SRX5075170,SMARCA4,365
chr1,24770211,24770517,SRX5020214,SMARCA2,306
chr1,24770237,24770499,SRX5054309,FOSL2,262
chr1,24770262,24770636,SRX5054308,FOSL2,374
chr1,24770264,24770529,SRX5020211,SMARCA2,265
chr1,24770304,24770612,SRX5716467,SMARCA2,308
chr1,24770340,24770609,SRX5716470,SMARCA4,269
chr1,24793473,24793685,SRX5075175,SMARCA4,212
chr1,24793815,24794032,SRX5054309,FOSL2,217
chr1,24793855,24794137,SRX5716469,SMARCA4,282
chr1,24793871,24794040,SRX5075170,SMARCA4,169
chr1,24793875,24794086,SRX5075169,SMARCA4,211
chr1,24805666,24805841,SRX5075176,SMARCA4,175
chr1,24827835,24828022,SRX5075176,SMARCA4,187
chr1,24828697,24828951,SRX5054308,FOSL2,254
chr1,24830646,24831108,SRX16500059,CTCF,462
chr1,24830673,24831076,SRX16500062,CTCF,403
chr1,24830673,24831123,SRX16500060,CTCF,450
chr1,24830674,24831107,SRX16500061,CTCF,433
chr1,24830734,24830962,SRX5075174,SMARCA4,228
chr1,24830773,24831017,SRX5075168,SMARCA4,244
chr1,24831193,24831418,SRX4174629,CTCF,225
chr1,24835001,24835288,SRX16500062,CTCF,287
chr1,24835014,24835334,SRX16500060,CTCF,320
chr1,24835023,24835261,SRX16500061,CTCF,238
chr1,24835027,24835332,SRX16500059,CTCF,305
chr1,24847785,24848429,SRX16500060,CTCF,644
chr1,24847839,24848361,SRX16500059,CTCF,522
chr1,24847843,24848351,SRX16500062,CTCF,508
chr1,24847851,24848394,SRX16500061,CTCF,543
chr1,24847940,24848411,SRX5075176,SMARCA4,471
chr1,24847941,24848338,SRX5075170,SMARCA4,397
chr1,24847948,24848292,SRX4174629,CTCF,344
chr1,24847948,24848297,SRX5075174,SMARCA4,349
chr1,24847958,24848231,SRX5075168,SMARCA4,273
chr1,24848023,24848337,SRX5075169,SMARCA4,314
chr1,24848046,24848379,SRX5716469,SMARCA4,333
chr1,24848047,24848349,SRX5716470,SMARCA4,302
chr1,24848085,24848377,SRX5075175,SMARCA4,292
chr1,24850411,24850673,SRX5075174,SMARCA4,262
chr1,24850433,24850717,SRX5075168,SMARCA4,284
chr1,24878857,24879088,SRX5054309,FOSL2,231
chr1,24898029,24898493,SRX16500062,CTCF,464
chr1,24898031,24898506,SRX16500061,CTCF,475
chr1,24898053,24898512,SRX16500059,CTCF,459
chr1,24898064,24898532,SRX16500060,CTCF,468
chr1,24898115,24898342,SRX5075168,SMARCA4,227
chr1,24909480,24909792,SRX16500060,CTCF,312
chr1,24914580,24914760,SRX5075169,SMARCA4,180
chr1,24932080,24932638,SRX16500060,CTCF,558
chr1,24932092,24932650,SRX16500059,CTCF,558
chr1,24932109,24932633,SRX16500061,CTCF,524
chr1,24932196,24932639,SRX16500062,CTCF,443
chr1,24932283,24932577,SRX5075168,SMARCA4,294
chr1,24932296,24932575,SRX5075169,SMARCA4,279
chr1,24932313,24932564,SRX5075174,SMARCA4,251
chr1,24932332,24932547,SRX5075170,SMARCA4,215
chr1,24932355,24932585,SRX5716470,SMARCA4,230
chr1,24932359,24932572,SRX5716464,SMARCA4,213
chr1,24932384,24932571,SRX5075175,SMARCA4,187
chr1,24949303,24949556,SRX5054309,FOSL2,253
chr1,24949371,24949551,SRX5075169,SMARCA4,180
chr1,24962261,24962508,SRX16500059,CTCF,247
chr1,25022799,25023345,SRX5075176,SMARCA4,546
chr1,25022809,25023296,SRX5075169,SMARCA4,487
chr1,25022810,25023258,SRX5716467,SMARCA2,448
chr1,25022839,25023254,SRX5020211,SMARCA2,415
chr1,25022843,25023237,SRX5716469,SMARCA4,394
chr1,25022844,25023282,SRX5075174,SMARCA4,438
chr1,25022853,25023330,SRX5075168,SMARCA4,477
chr1,25022863,25023198,SRX5054309,FOSL2,335
chr1,25022865,25023249,SRX5054308,FOSL2,384
chr1,25022874,25023334,SRX5075170,SMARCA4,460
chr1,25022876,25023150,SRX5716468,SMARCA2,274
chr1,25022879,25023243,SRX5075175,SMARCA4,364
chr1,25022882,25023141,SRX5020214,SMARCA2,259
chr1,25022898,25023224,SRX5716470,SMARCA4,326
chr1,25022913,25023129,SRX5075181,SMARCA2,216
chr1,25022917,25023176,SRX5054307,FOSL2,259
chr1,25022960,25023216,SRX5716459,Epitope tags,256
chr1,25037123,25037603,SRX16500061,CTCF,480
chr1,25037150,25037755,SRX16500060,CTCF,605
chr1,25037168,25037653,SRX16500059,CTCF,485
chr1,25037172,25037642,SRX16500062,CTCF,470
chr1,25091159,25091380,SRX5054308,FOSL2,221
chr1,25101331,25101857,SRX16500060,CTCF,526
chr1,25101366,25101865,SRX16500059,CTCF,499
chr1,25101388,25101864,SRX16500062,CTCF,476
chr1,25101400,25101844,SRX16500061,CTCF,444
chr1,25101435,25101705,SRX5716463,SMARCA4,270
chr1,25101445,25101734,SRX5075168,SMARCA4,289
chr1,25101450,25101748,SRX5075176,SMARCA4,298
chr1,25101456,25101777,SRX5075174,SMARCA4,321
chr1,25101459,25101742,SRX5075170,SMARCA4,283
chr1,25101461,25101685,SRX5075175,SMARCA4,224
chr1,25101464,25101755,SRX4174629,CTCF,291
chr1,25101520,25101700,SRX5075169,SMARCA4,180
chr1,25137496,25137706,SRX5075176,SMARCA4,210
chr1,25137507,25137769,SRX5075170,SMARCA4,262
chr1,25137582,25137821,SRX5716470,SMARCA4,239
chr1,25162020,25162307,SRX5075170,SMARCA4,287
chr1,25162054,25162311,SRX5075176,SMARCA4,257
chr1,25182625,25182940,SRX5054309,FOSL2,315
chr1,25182642,25182856,SRX5716469,SMARCA4,214
chr1,25182659,25182929,SRX5054308,FOSL2,270
chr1,25182687,25182917,SRX5075175,SMARCA4,230
chr1,25182692,25182875,SRX5075169,SMARCA4,183
chr1,25204766,25205334,SRX16500060,CTCF,568
chr1,25204801,25205301,SRX16500062,CTCF,500
chr1,25204802,25205261,SRX16500059,CTCF,459
chr1,25204812,25205356,SRX16500061,CTCF,544
chr1,25204849,25205120,SRX5075174,SMARCA4,271
chr1,25204888,25205145,SRX5075176,SMARCA4,257
chr1,25204934,25205198,SRX5075168,SMARCA4,264
chr1,25204941,25205110,SRX5075170,SMARCA4,169
chr1,25232235,25233031,SRX20140869,INTS10,796
chr1,25232344,25233032,SRX20140895,INTS13,688
chr1,25232433,25232693,SRX5075168,SMARCA4,260
chr1,25232454,25232812,SRX5075170,SMARCA4,358
chr1,25232579,25232821,SRX5075176,SMARCA4,242
chr1,25232623,25232824,SRX5075175,SMARCA4,201
chr1,25232655,25232866,SRX5716470,SMARCA4,211
chr1,25232690,25233076,SRX20140897,INTS13,386
chr1,25232979,25233337,SRX5075169,SMARCA4,358
chr1,25233080,25233385,SRX5075176,SMARCA4,305
chr1,25233124,25233464,SRX5075174,SMARCA4,340
chr1,25233151,25233426,SRX5075168,SMARCA4,275
chr1,25233205,25233406,SRX5075170,SMARCA4,201
chr1,25239624,25240282,SRX5075176,SMARCA4,658
chr1,25239627,25240315,SRX5075170,SMARCA4,688
chr1,25239647,25240341,SRX5075174,SMARCA4,694
chr1,25239648,25240015,SRX5716470,SMARCA4,367
chr1,25239658,25240338,SRX5075168,SMARCA4,680
chr1,25239665,25240033,SRX5075175,SMARCA4,368
chr1,25239677,25239889,SRX5716469,SMARCA4,212
chr1,25239720,25240301,SRX20140895,INTS13,581
chr1,25239722,25239984,SRX5716467,SMARCA2,262
chr1,25239780,25240254,SRX16500060,CTCF,474
chr1,25239781,25240323,SRX16500059,CTCF,542
chr1,25239829,25240243,SRX16500062,CTCF,414
chr1,25239888,25240120,SRX5075169,SMARCA4,232
chr1,25239890,25240259,SRX16500061,CTCF,369
chr1,25239903,25240119,SRX4174629,CTCF,216
chr1,25239918,25240141,SRX5716463,SMARCA4,223
chr1,25247011,25247923,SRX20140895,INTS13,912
chr1,25247037,25247640,SRX20140897,INTS13,603
chr1,25247084,25247641,SRX20140879,CPSF3L,557
chr1,25247146,25247692,SRX20140868,INTS10,546
chr1,25247148,25247524,SRX20140880,CPSF3L,376
chr1,25247158,25247650,SRX20140881,CPSF3L,492
chr1,25247176,25247627,SRX20140867,INTS10,451
chr1,25247176,25247645,SRX20140894,INTS13,469
chr1,25247223,25247571,SRX20140869,INTS10,348
chr1,25247231,25247879,SRX20140896,INTS13,648
chr1,25247250,25247525,SRX20140882,CPSF3L,275
chr1,25247276,25247445,SRX5075170,SMARCA4,169
chr1,25247464,25248069,SRX5075174,SMARCA4,605
chr1,25247498,25248099,SRX16500060,CTCF,601
chr1,25247531,25247960,SRX5075170,SMARCA4,429
chr1,25247533,25247835,SRX5716463,SMARCA4,302
chr1,25247536,25247762,SRX5054308,FOSL2,226
chr1,25247558,25248021,SRX16500062,CTCF,463
chr1,25247564,25247822,SRX5075168,SMARCA4,258
chr1,25247564,25248034,SRX5075176,SMARCA4,470
chr1,25247575,25247838,SRX16500061,CTCF,263
chr1,25247596,25248142,SRX16500059,CTCF,546
chr1,25247642,25248055,SRX5716470,SMARCA4,413
chr1,25247877,25248073,SRX5075169,SMARCA4,196
chr1,25247936,25248170,SRX16500061,CTCF,234
chr1,25259836,25260187,SRX5075176,SMARCA4,351
chr1,25259863,25260174,SRX5075170,SMARCA4,311
chr1,25259916,25260103,SRX5075175,SMARCA4,187
chr1,25259918,25260129,SRX5716470,SMARCA4,211
chr1,25259949,25260168,SRX5075169,SMARCA4,219
chr1,25266683,25266974,SRX5075174,SMARCA4,291
chr1,25266898,25267125,SRX5075170,SMARCA4,227
chr1,25266974,25267182,SRX5075169,SMARCA4,208
chr1,25267626,25267889,SRX20140895,INTS13,263
chr1,25267692,25268085,SRX5075170,SMARCA4,393
chr1,25267707,25268061,SRX5075168,SMARCA4,354
chr1,25267720,25267906,SRX5075169,SMARCA4,186
chr1,25267754,25268093,SRX5075174,SMARCA4,339
chr1,25290029,25290453,SRX16500059,CTCF,424
chr1,25290034,25290444,SRX16500060,CTCF,410
chr1,25290044,25290298,SRX4174629,CTCF,254
chr1,25290069,25290398,SRX16500061,CTCF,329
chr1,25290116,25290446,SRX16500062,CTCF,330
chr1,25320271,25320671,SRX5075170,SMARCA4,400
chr1,25320272,25320644,SRX5075169,SMARCA4,372
chr1,25320274,25320596,SRX5716469,SMARCA4,322
chr1,25320304,25320576,SRX5054308,FOSL2,272
chr1,25320314,25320617,SRX5075175,SMARCA4,303
chr1,25320318,25320610,SRX5054309,FOSL2,292
chr1,25320327,25320688,SRX5075176,SMARCA4,361
chr1,25320364,25320598,SRX5020214,SMARCA2,234
chr1,25320367,25320593,SRX5716470,SMARCA4,226
chr1,25320368,25320593,SRX5716467,SMARCA2,225
chr1,25330020,25330350,SRX5075170,SMARCA4,330
chr1,25330032,25330320,SRX5075176,SMARCA4,288
chr1,25330044,25330263,SRX5075169,SMARCA4,219
chr1,25338100,25338873,SRX20140895,INTS13,773
chr1,25338126,25338594,SRX5075174,SMARCA4,468
chr1,25338168,25338585,SRX5075170,SMARCA4,417
chr1,25338189,25338422,SRX5075176,SMARCA4,233
chr1,25338265,25338500,SRX20140867,INTS10,235
chr1,25338295,25338519,SRX5075168,SMARCA4,224
chr1,25338368,25338777,SRX20140881,CPSF3L,409
chr1,25343855,25344268,SRX5075169,SMARCA4,413
chr1,25343865,25344221,SRX5054308,FOSL2,356
chr1,25343872,25344271,SRX5075175,SMARCA4,399
chr1,25343904,25344164,SRX5054309,FOSL2,260
chr1,25343932,25344164,SRX5075176,SMARCA4,232
chr1,25343961,25344178,SRX5716470,SMARCA4,217
chr1,25361167,25361408,SRX5054309,FOSL2,241
chr1,25371709,25372185,SRX5075176,SMARCA4,476
chr1,25371764,25372153,SRX5075170,SMARCA4,389
chr1,25371776,25372184,SRX5075169,SMARCA4,408
chr1,25371792,25372121,SRX5716470,SMARCA4,329
chr1,25371815,25372131,SRX5716469,SMARCA4,316
chr1,25371829,25372151,SRX5716468,SMARCA2,322
chr1,25371849,25372156,SRX5054309,FOSL2,307
chr1,25371852,25372190,SRX5075175,SMARCA4,338
chr1,25371876,25372194,SRX5054308,FOSL2,318
chr1,25371914,25372177,SRX5716467,SMARCA2,263
chr1,25371969,25372169,SRX5020211,SMARCA2,200
chr1,25402895,25403420,SRX16500059,CTCF,525
chr1,25402929,25403361,SRX16500060,CTCF,432
chr1,25402967,25403346,SRX4174629,CTCF,379
chr1,25402986,25403365,SRX16500061,CTCF,379
chr1,25403008,25403374,SRX16500062,CTCF,366
chr1,25429884,25430220,SRX5075175,SMARCA4,336
chr1,25429925,25430582,SRX20140895,INTS13,657
chr1,25429939,25430398,SRX5075168,SMARCA4,459
chr1,25429951,25430215,SRX5716470,SMARCA4,264
chr1,25429983,25430473,SRX20140868,INTS10,490
chr1,25429989,25430374,SRX5075174,SMARCA4,385
chr1,25429991,25430215,SRX5075169,SMARCA4,224
chr1,25429998,25430350,SRX5075170,SMARCA4,352
chr1,25430018,25430390,SRX5075176,SMARCA4,372
chr1,25430809,25430999,SRX5716451,SOX2,190
chr1,25430878,25431051,SRX5075174,SMARCA4,173
chr1,25430895,25431245,SRX20140895,INTS13,350
chr1,25442179,25442530,SRX5054309,FOSL2,351
chr1,25442209,25442556,SRX5075169,SMARCA4,347
chr1,25442216,25442428,SRX5075176,SMARCA4,212
chr1,25442239,25442522,SRX5716469,SMARCA4,283
chr1,25442240,25442590,SRX5075175,SMARCA4,350
chr1,25442241,25442524,SRX5054308,FOSL2,283
chr1,25442277,25442535,SRX5716470,SMARCA4,258
chr1,25442280,25442505,SRX5075174,SMARCA4,225
chr1,25442292,25442492,SRX5020211,SMARCA2,200
chr1,25487588,25487909,SRX16500062,CTCF,321
chr1,25487592,25487960,SRX16500060,CTCF,368
chr1,25487596,25487863,SRX16500059,CTCF,267
chr1,25487610,25487922,SRX16500061,CTCF,312
chr1,25503016,25503204,SRX5075170,SMARCA4,188
chr1,25503860,25504182,SRX16500060,CTCF,322
chr1,25503880,25504123,SRX16500059,CTCF,243
chr1,25503884,25504118,SRX16500061,CTCF,234
chr1,25519728,25519908,SRX5054308,FOSL2,180
chr1,25520372,25520876,SRX16500060,CTCF,504
chr1,25520379,25520893,SRX16500059,CTCF,514
chr1,25520421,25520846,SRX16500061,CTCF,425
chr1,25520424,25520846,SRX16500062,CTCF,422
chr1,25522384,25522654,SRX5075168,SMARCA4,270
chr1,25522428,25522626,SRX5075174,SMARCA4,198
chr1,25543387,25543850,SRX5716464,SMARCA4,463
chr1,25543415,25543871,SRX5075168,SMARCA4,456
chr1,25543424,25543907,SRX5075174,SMARCA4,483
chr1,25543435,25543769,SRX5075176,SMARCA4,334
chr1,25543440,25543673,SRX5716463,SMARCA4,233
chr1,25543457,25543832,SRX5075170,SMARCA4,375
chr1,25543461,25543953,SRX20140895,INTS13,492
chr1,25543477,25543945,SRX5075169,SMARCA4,468
chr1,25543532,25543808,SRX5075175,SMARCA4,276
chr1,25543587,25543870,SRX5716469,SMARCA4,283
chr1,25549617,25549797,SRX5075169,SMARCA4,180
chr1,25550737,25550942,SRX5075169,SMARCA4,205
chr1,25550779,25551014,SRX5716470,SMARCA4,235
chr1,25566759,25567353,SRX20140895,INTS13,594
chr1,25566879,25567335,SRX5075174,SMARCA4,456
chr1,25566930,25567208,SRX20140897,INTS13,278
chr1,25566960,25567348,SRX20140868,INTS10,388
chr1,25566971,25567288,SRX20140867,INTS10,317
chr1,25567014,25567243,SRX5075168,SMARCA4,229
chr1,25567119,25567361,SRX5075176,SMARCA4,242
chr1,25567128,25567362,SRX5075170,SMARCA4,234
chr1,25567152,25567357,SRX5075169,SMARCA4,205
chr1,25568914,25569204,SRX5075176,SMARCA4,290
chr1,25568931,25569199,SRX5075170,SMARCA4,268
chr1,25568939,25569250,SRX5054308,FOSL2,311
chr1,25568950,25569227,SRX5054309,FOSL2,277
chr1,25568967,25569199,SRX5716469,SMARCA4,232
chr1,25568970,25569267,SRX5075175,SMARCA4,297
chr1,25568981,25569227,SRX5075169,SMARCA4,246
chr1,25572722,25573200,SRX16500060,CTCF,478
chr1,25572737,25573281,SRX16500062,CTCF,544
chr1,25572739,25573286,SRX16500059,CTCF,547
chr1,25572781,25573281,SRX16500061,CTCF,500
chr1,25608539,25608974,SRX16500059,CTCF,435
chr1,25608550,25608968,SRX16500060,CTCF,418
chr1,25608556,25608961,SRX16500062,CTCF,405
chr1,25608576,25608971,SRX20140895,INTS13,395
chr1,25608576,25609003,SRX16500061,CTCF,427
chr1,25608618,25608910,SRX5075168,SMARCA4,292
chr1,25608631,25608923,SRX5075174,SMARCA4,292
chr1,25608709,25608944,SRX4174629,CTCF,235
chr1,25616152,25616332,SRX5075169,SMARCA4,180
chr1,25616180,25616505,SRX20140895,INTS13,325
chr1,25616260,25616623,SRX5075174,SMARCA4,363
chr1,25616375,25616670,SRX5075168,SMARCA4,295
chr1,25616430,25616653,SRX5075170,SMARCA4,223
chr1,25618983,25619508,SRX16500062,CTCF,525
chr1,25618995,25619459,SRX16500059,CTCF,464
chr1,25619001,25619559,SRX16500060,CTCF,558
chr1,25619019,25619472,SRX16500061,CTCF,453
chr1,25619091,25619531,SRX4174629,CTCF,440
chr1,25619109,25619360,SRX5075168,SMARCA4,251
chr1,25619129,25619365,SRX5075174,SMARCA4,236
chr1,25642832,25643048,SRX5054309,FOSL2,216
chr1,25642855,25643082,SRX5054308,FOSL2,227
chr1,25648704,25649012,SRX5075174,SMARCA4,308
chr1,25648743,25649020,SRX5075168,SMARCA4,277
chr1,25664264,25664565,SRX5075181,SMARCA2,301
chr1,25664268,25664565,SRX5716469,SMARCA4,297
chr1,25664272,25664523,SRX5075175,SMARCA4,251
chr1,25664274,25664652,SRX5020211,SMARCA2,378
chr1,25664278,25664747,SRX5054308,FOSL2,469
chr1,25664281,25664588,SRX5716467,SMARCA2,307
chr1,25664290,25664552,SRX5716468,SMARCA2,262
chr1,25664312,25664732,SRX5075170,SMARCA4,420
chr1,25664314,25664600,SRX5716470,SMARCA4,286
chr1,25664315,25664543,SRX5075169,SMARCA4,228
chr1,25664359,25664795,SRX5075176,SMARCA4,436
chr1,25667928,25668206,SRX20140869,INTS10,278
chr1,25667981,25668242,SRX20140881,CPSF3L,261
chr1,25688478,25688653,SRX5075176,SMARCA4,175
chr1,25692544,25692967,SRX16500061,CTCF,423
chr1,25692584,25692932,SRX16500059,CTCF,348
chr1,25692614,25692965,SRX16500060,CTCF,351
chr1,25692630,25692924,SRX16500062,CTCF,294
chr1,25692665,25692838,SRX5075174,SMARCA4,173
chr1,25694204,25694678,SRX5075170,SMARCA4,474
chr1,25694301,25694601,SRX5075176,SMARCA4,300
chr1,25694334,25694623,SRX5716470,SMARCA4,289
chr1,25694351,25694643,SRX5716467,SMARCA2,292
chr1,25694352,25694573,SRX5075175,SMARCA4,221
chr1,25694955,25695266,SRX20140869,INTS10,311
chr1,25695036,25695373,SRX5075176,SMARCA4,337
chr1,25695057,25695272,SRX5716467,SMARCA2,215
chr1,25695058,25695352,SRX5054309,FOSL2,294
chr1,25695072,25695349,SRX5716469,SMARCA4,277
chr1,25695073,25695372,SRX5716470,SMARCA4,299
chr1,25695101,25695357,SRX5075169,SMARCA4,256
chr1,25695104,25695347,SRX5075175,SMARCA4,243
chr1,25695111,25695349,SRX5075170,SMARCA4,238
chr1,25695118,25695344,SRX5716468,SMARCA2,226
chr1,25695137,25695326,SRX5054308,FOSL2,189
chr1,25695916,25696168,SRX5075170,SMARCA4,252
chr1,25695917,25696197,SRX5075176,SMARCA4,280
chr1,25695918,25696232,SRX5054308,FOSL2,314
chr1,25695942,25696221,SRX5075169,SMARCA4,279
chr1,25695955,25696200,SRX5054309,FOSL2,245
chr1,25695991,25696282,SRX5075168,SMARCA4,291
chr1,25696019,25696202,SRX5075174,SMARCA4,183
chr1,25699856,25700188,SRX5075174,SMARCA4,332
chr1,25699886,25700111,SRX5075168,SMARCA4,225
chr1,25707615,25707937,SRX5075176,SMARCA4,322
chr1,25707648,25708065,SRX5075170,SMARCA4,417
chr1,25718755,25718983,SRX5020211,SMARCA2,228
chr1,25718792,25719049,SRX5075176,SMARCA4,257
chr1,25718798,25719009,SRX5716470,SMARCA4,211
chr1,25718799,25719011,SRX5054308,FOSL2,212
chr1,25718808,25718992,SRX5075170,SMARCA4,184
chr1,25720717,25720929,SRX5054308,FOSL2,212
chr1,25720731,25720984,SRX5054309,FOSL2,253
chr1,25727700,25727869,SRX5075170,SMARCA4,169
chr1,25730178,25730440,SRX5075176,SMARCA4,262
chr1,25743541,25743796,SRX5075176,SMARCA4,255
chr1,25748921,25749090,SRX5075170,SMARCA4,169
chr1,25752487,25752747,SRX5075168,SMARCA4,260
chr1,25752561,25752805,SRX5075174,SMARCA4,244
chr1,25770910,25771091,SRX5075174,SMARCA4,181
chr1,25770954,25771256,SRX20140868,INTS10,302
chr1,25770997,25771458,SRX20140895,INTS13,461
chr1,25771852,25772031,SRX5075168,SMARCA4,179
chr1,25771869,25772071,SRX5075174,SMARCA4,202
chr1,25784793,25785070,SRX20140867,INTS10,277
chr1,25786894,25787215,SRX5054309,FOSL2,321
chr1,25786929,25787140,SRX5075170,SMARCA4,211
chr1,25786935,25787143,SRX5075176,SMARCA4,208
chr1,25786940,25787222,SRX5054308,FOSL2,282
chr1,25787506,25787757,SRX5075175,SMARCA4,251
chr1,25787541,25787753,SRX5075169,SMARCA4,212
chr1,25787558,25787770,SRX5075170,SMARCA4,212
chr1,25787603,25787803,SRX5054309,FOSL2,200
chr1,25791331,25791632,SRX20140867,INTS10,301
chr1,25796764,25797222,SRX16500059,CTCF,458
chr1,25796786,25797192,SRX16500061,CTCF,406
chr1,25796809,25797214,SRX16500060,CTCF,405
chr1,25796812,25797284,SRX16500062,CTCF,472
chr1,25796817,25797105,SRX4174629,CTCF,288
chr1,25796854,25797128,SRX5075168,SMARCA4,274
chr1,25796863,25797127,SRX5075174,SMARCA4,264
chr1,25796914,25797169,SRX5075170,SMARCA4,255
chr1,25796939,25797134,SRX5075169,SMARCA4,195
chr1,25799790,25800129,SRX20140895,INTS13,339
chr1,25799923,25800101,SRX5075176,SMARCA4,178
chr1,25799931,25800125,SRX5075168,SMARCA4,194
chr1,25806406,25806720,SRX5075176,SMARCA4,314
chr1,25806462,25806742,SRX5075169,SMARCA4,280
chr1,25806464,25806695,SRX5075175,SMARCA4,231
chr1,25810738,25811271,SRX16500059,CTCF,533
chr1,25810746,25811304,SRX16500061,CTCF,558
chr1,25810762,25811227,SRX16500062,CTCF,465
chr1,25810762,25811249,SRX16500060,CTCF,487
chr1,25810852,25811237,SRX4174629,CTCF,385
chr1,25810857,25811129,SRX5075168,SMARCA4,272
chr1,25810936,25811109,SRX5075174,SMARCA4,173
chr1,25819176,25819356,SRX5075169,SMARCA4,180
chr1,25819660,25819952,SRX5075176,SMARCA4,292
chr1,25819679,25820128,SRX5075168,SMARCA4,449
chr1,25819697,25819921,SRX5716470,SMARCA4,224
chr1,25819704,25819912,SRX5075174,SMARCA4,208
chr1,25819723,25819915,SRX5075170,SMARCA4,192
chr1,25819733,25820272,SRX20140895,INTS13,539
chr1,25819876,25820161,SRX20140879,CPSF3L,285
chr1,25820092,25820422,SRX20140868,INTS10,330
chr1,25820510,25820766,SRX5075174,SMARCA4,256
chr1,25837322,25837572,SRX16500061,CTCF,250
chr1,25837345,25837566,SRX16500060,CTCF,221
chr1,25859124,25859736,SRX20140895,INTS13,612
chr1,25859157,25859591,SRX20140868,INTS10,434
chr1,25859200,25859726,SRX5075174,SMARCA4,526
chr1,25859208,25859615,SRX20140879,CPSF3L,407
chr1,25859245,25859693,SRX5716463,SMARCA4,448
chr1,25859245,25859762,SRX5075168,SMARCA4,517
chr1,25859249,25859870,SRX5075169,SMARCA4,621
chr1,25859268,25859798,SRX5716470,SMARCA4,530
chr1,25859270,25859920,SRX5075170,SMARCA4,650
chr1,25859278,25859567,SRX20140867,INTS10,289
chr1,25859298,25859858,SRX5075176,SMARCA4,560
chr1,25859303,25859670,SRX5716464,SMARCA4,367
chr1,25859327,25859655,SRX5075175,SMARCA4,328
chr1,25859488,25859914,SRX5716469,SMARCA4,426
chr1,25859496,25859715,SRX5716467,SMARCA2,219
chr1,25859553,25859801,SRX5020211,SMARCA2,248
chr1,25875311,25876051,SRX20140895,INTS13,740
chr1,25875385,25875787,SRX5716470,SMARCA4,402
chr1,25875428,25875916,SRX20140868,INTS10,488
chr1,25875474,25875906,SRX5075175,SMARCA4,432
chr1,25875513,25875844,SRX5075174,SMARCA4,331
chr1,25875552,25875933,SRX5075170,SMARCA4,381
chr1,25875570,25875905,SRX5075169,SMARCA4,335
chr1,25875575,25875864,SRX5075176,SMARCA4,289
chr1,25875623,25875855,SRX20140867,INTS10,232
chr1,25875719,25875922,SRX5075168,SMARCA4,203
chr1,25892292,25892881,SRX5075169,SMARCA4,589
chr1,25892337,25892860,SRX5716470,SMARCA4,523
chr1,25892338,25892743,SRX5716467,SMARCA2,405
chr1,25892358,25892680,SRX5716460,Epitope tags,322
chr1,25892402,25892758,SRX5716468,SMARCA2,356
chr1,25892402,25892832,SRX5020211,SMARCA2,430
chr1,25892406,25892671,SRX5020214,SMARCA2,265
chr1,25892406,25892878,SRX5075170,SMARCA4,472
chr1,25892409,25892862,SRX5716469,SMARCA4,453
chr1,25892417,25892886,SRX5075176,SMARCA4,469
chr1,25892425,25892855,SRX5075175,SMARCA4,430
chr1,25892427,25892779,SRX5054309,FOSL2,352
chr1,25892427,25892809,SRX5075168,SMARCA4,382
chr1,25892467,25892890,SRX5716459,Epitope tags,423
chr1,25892476,25892757,SRX5054308,FOSL2,281
chr1,25892480,25892738,SRX5075181,SMARCA2,258
chr1,25892559,25892763,SRX5075174,SMARCA4,204
chr1,25895259,25895786,SRX16500062,CTCF,527
chr1,25895301,25895864,SRX16500061,CTCF,563
chr1,25895313,25895909,SRX16500059,CTCF,596
chr1,25895318,25895823,SRX16500060,CTCF,505
chr1,25895348,25895858,SRX4174629,CTCF,510
chr1,25895369,25895749,SRX5716463,SMARCA4,380
chr1,25895371,25895739,SRX5075168,SMARCA4,368
chr1,25895386,25895798,SRX5075174,SMARCA4,412
chr1,25895450,25895665,SRX5716464,SMARCA4,215
chr1,25895452,25895713,SRX5716470,SMARCA4,261
chr1,25895453,25895748,SRX5075170,SMARCA4,295
chr1,25895470,25895713,SRX5075176,SMARCA4,243
chr1,25895476,25895714,SRX5075169,SMARCA4,238
chr1,25895484,25895671,SRX5075175,SMARCA4,187
chr1,25905022,25905250,SRX5075176,SMARCA4,228
chr1,25905052,25905250,SRX5075169,SMARCA4,198
chr1,25905112,25905617,SRX5075174,SMARCA4,505
chr1,25905304,25905505,SRX5075176,SMARCA4,201
chr1,25905306,25905736,SRX5075168,SMARCA4,430
chr1,25905336,25905547,SRX5716470,SMARCA4,211
chr1,25905551,25906542,SRX20140868,INTS10,991
chr1,25905558,25906751,SRX20140895,INTS13,1193
chr1,25905576,25906582,SRX20140879,CPSF3L,1006
chr1,25905789,25906063,SRX16500062,CTCF,274
chr1,25906041,25906583,SRX20140867,INTS10,542
chr1,25906088,25906561,SRX20140881,CPSF3L,473
chr1,25906193,25906700,SRX20140896,INTS13,507
chr1,25906200,25906719,SRX20140897,INTS13,519
chr1,25906263,25906582,SRX5075168,SMARCA4,319
chr1,25906297,25906603,SRX5716454,SOX3,306
chr1,25906319,25906634,SRX20140894,INTS13,315
chr1,25906436,25906615,SRX5054307,FOSL2,179
chr1,25912115,25912324,SRX5054308,FOSL2,209
chr1,25912124,25912539,SRX5075169,SMARCA4,415
chr1,25912138,25912416,SRX5054309,FOSL2,278
chr1,25912150,25912387,SRX5020214,SMARCA2,237
chr1,25912157,25912454,SRX5075170,SMARCA4,297
chr1,25912166,25912437,SRX5075176,SMARCA4,271
chr1,25912181,25912540,SRX5075175,SMARCA4,359
chr1,25912203,25912418,SRX5716467,SMARCA2,215
chr1,25921943,25922265,SRX5075174,SMARCA4,322
chr1,25922435,25922893,SRX20140895,INTS13,458
chr1,25927277,25928087,SRX5075168,SMARCA4,810
chr1,25927292,25927974,SRX5075174,SMARCA4,682
chr1,25937004,25937255,SRX5075170,SMARCA4,251
chr1,25937020,25937282,SRX5075176,SMARCA4,262
chr1,25945769,25946129,SRX5075174,SMARCA4,360
chr1,25945830,25946148,SRX5075168,SMARCA4,318
chr1,25952783,25953449,SRX5075170,SMARCA4,666
chr1,25952798,25953477,SRX5075176,SMARCA4,679
chr1,25952846,25953306,SRX5716467,SMARCA2,460
chr1,25952900,25953197,SRX5716468,SMARCA2,297
chr1,25952999,25953257,SRX5075169,SMARCA4,258
chr1,25953036,25953281,SRX5075175,SMARCA4,245
chr1,25959734,25960015,SRX5075176,SMARCA4,281
chr1,25993658,25993888,SRX20140867,INTS10,230
chr1,25997937,25998531,SRX20140881,CPSF3L,594
chr1,25997950,25998630,SRX20140895,INTS13,680
chr1,25997982,25998528,SRX20140897,INTS13,546
chr1,25998017,25998567,SRX16500061,CTCF,550
chr1,25998028,25998576,SRX20140879,CPSF3L,548
chr1,25998046,25998517,SRX5075168,SMARCA4,471
chr1,25998048,25998526,SRX4174629,CTCF,478
chr1,25998052,25998591,SRX20140869,INTS10,539
chr1,25998060,25998588,SRX16500060,CTCF,528
chr1,25998068,25998551,SRX16500059,CTCF,483
chr1,25998072,25998619,SRX20140868,INTS10,547
chr1,25998078,25998291,SRX5054309,FOSL2,213
chr1,25998082,25998538,SRX5075174,SMARCA4,456
chr1,25998088,25998501,SRX5075176,SMARCA4,413
chr1,25998091,25998550,SRX16500062,CTCF,459
chr1,25998126,25998490,SRX5716463,SMARCA4,364
chr1,25998150,25998416,SRX5054307,FOSL2,266
chr1,25998158,25998364,SRX5716454,SOX3,206
chr1,25998213,25998476,SRX20140867,INTS10,263
chr1,25998226,25998490,SRX5075175,SMARCA4,264
chr1,25998237,25998487,SRX5075169,SMARCA4,250
chr1,25998300,25998505,SRX5075170,SMARCA4,205
chr1,26005421,26005758,SRX5075176,SMARCA4,337
chr1,26005481,26005757,SRX5716468,SMARCA2,276
chr1,26005482,26005722,SRX5716470,SMARCA4,240
chr1,26005516,26005766,SRX5075170,SMARCA4,250
chr1,26009925,26010552,SRX16500061,CTCF,627
chr1,26009974,26010524,SRX16500060,CTCF,550
chr1,26010094,26010547,SRX16500059,CTCF,453
chr1,26010158,26010471,SRX16500062,CTCF,313
chr1,26016462,26016802,SRX5075174,SMARCA4,340
chr1,26016583,26016837,SRX5075168,SMARCA4,254
chr1,26021607,26021885,SRX5075174,SMARCA4,278
chr1,26021620,26021861,SRX5075168,SMARCA4,241
chr1,26029965,26030200,SRX16500059,CTCF,235
chr1,26035116,26036031,SRX20140895,INTS13,915
chr1,26035213,26035665,SRX5075168,SMARCA4,452
chr1,26035225,26035457,SRX5716463,SMARCA4,232
chr1,26035230,26035627,SRX5075174,SMARCA4,397
chr1,26035262,26035441,SRX5075176,SMARCA4,179
chr1,26035271,26035485,SRX5075170,SMARCA4,214
chr1,26035348,26035528,SRX5075169,SMARCA4,180
chr1,26035422,26035756,SRX20140897,INTS13,334
chr1,26035535,26035753,SRX20140867,INTS10,218
chr1,26035702,26036432,SRX16500060,CTCF,730
chr1,26035726,26036369,SRX16500059,CTCF,643
chr1,26035782,26036375,SRX16500062,CTCF,593
chr1,26035853,26036354,SRX16500061,CTCF,501
chr1,26035929,26036352,SRX4174629,CTCF,423
chr1,26035959,26036328,SRX5075174,SMARCA4,369
chr1,26035990,26036330,SRX5075168,SMARCA4,340
chr1,26035999,26036316,SRX5075169,SMARCA4,317
chr1,26036002,26036284,SRX5075175,SMARCA4,282
chr1,26036005,26036303,SRX5075170,SMARCA4,298
chr1,26036014,26036329,SRX5716463,SMARCA4,315
chr1,26036023,26036280,SRX5716469,SMARCA4,257
chr1,26036031,26036291,SRX5716470,SMARCA4,260
chr1,26036042,26036267,SRX5075176,SMARCA4,225
chr1,26087769,26087817,SRX1424893,POU3F2,48
chr1,26087770,26087813,SRX1424892,POU3F2,43
chr1,26087770,26087815,SRX1424891,POU3F2,45
chr1,26087771,26087813,SRX1424894,POU3F2,42
chr1,26104849,26105324,SRX4174629,CTCF,475
chr1,26104872,26105385,SRX16500062,CTCF,513
chr1,26104878,26105366,SRX16500060,CTCF,488
chr1,26104887,26105413,SRX16500061,CTCF,526
chr1,26104905,26105403,SRX16500059,CTCF,498
chr1,26104944,26105303,SRX5075168,SMARCA4,359
chr1,26104961,26105212,SRX5716463,SMARCA4,251
chr1,26105018,26105330,SRX5075174,SMARCA4,312
chr1,26105023,26105291,SRX5075176,SMARCA4,268
chr1,26105029,26105281,SRX5075170,SMARCA4,252
chr1,26110755,26111866,SRX20140868,INTS10,1111
chr1,26110784,26112166,SRX20140895,INTS13,1382
chr1,26110788,26110967,SRX5075170,SMARCA4,179
chr1,26110816,26111254,SRX5075168,SMARCA4,438
chr1,26110820,26111032,SRX5716469,SMARCA4,212
chr1,26110830,26111043,SRX5716470,SMARCA4,213
chr1,26111544,26111958,SRX5075174,SMARCA4,414
chr1,26111574,26111910,SRX5075168,SMARCA4,336
chr1,26111586,26111857,SRX5075170,SMARCA4,271
chr1,26111602,26112092,SRX5075176,SMARCA4,490
chr1,26111630,26111931,SRX5075175,SMARCA4,301
chr1,26111645,26112002,SRX20140867,INTS10,357
chr1,26111745,26112127,SRX20140897,INTS13,382
chr1,26111853,26112100,SRX20140894,INTS13,247
chr1,26145014,26145507,SRX16500061,CTCF,493
chr1,26145016,26145502,SRX16500059,CTCF,486
chr1,26145026,26145511,SRX16500060,CTCF,485
chr1,26145091,26145376,SRX5075170,SMARCA4,285
chr1,26145103,26145496,SRX16500062,CTCF,393
chr1,26145104,26145430,SRX4174629,CTCF,326
chr1,26145105,26145413,SRX5075168,SMARCA4,308
chr1,26145107,26145443,SRX5075174,SMARCA4,336
chr1,26154887,26155086,SRX5075174,SMARCA4,199
chr1,26161545,26161957,SRX20140868,INTS10,412
chr1,26161547,26162013,SRX20140895,INTS13,466
chr1,26164166,26164584,SRX16500062,CTCF,418
chr1,26164186,26164630,SRX16500059,CTCF,444
chr1,26164206,26164598,SRX16500060,CTCF,392
chr1,26164210,26164546,SRX16500061,CTCF,336
chr1,26164222,26164493,SRX5075174,SMARCA4,271
chr1,26164227,26164420,SRX5075176,SMARCA4,193
chr1,26164242,26164485,SRX5075175,SMARCA4,243
chr1,26164266,26164565,SRX5075168,SMARCA4,299
chr1,26164277,26164457,SRX5075169,SMARCA4,180
chr1,26164285,26164523,SRX5075170,SMARCA4,238
chr1,26164365,26164745,SRX20140895,INTS13,380
chr1,26168750,26169189,SRX20140867,INTS10,439
chr1,26168846,26169268,SRX5075168,SMARCA4,422
chr1,26168858,26169256,SRX5075174,SMARCA4,398
chr1,26168898,26169147,SRX5716451,SOX2,249
chr1,26168914,26169161,SRX5716464,SMARCA4,247
chr1,26168938,26169270,SRX5716463,SMARCA4,332
chr1,26168959,26169219,SRX20140879,CPSF3L,260
chr1,26169538,26170081,SRX16500060,CTCF,543
chr1,26169546,26170079,SRX16500059,CTCF,533
chr1,26169551,26170020,SRX16500061,CTCF,469
chr1,26169590,26170020,SRX16500062,CTCF,430
chr1,26169620,26169820,SRX5075175,SMARCA4,200
chr1,26169620,26170117,SRX5716470,SMARCA4,497
chr1,26169623,26170070,SRX5075174,SMARCA4,447
chr1,26169630,26170011,SRX5075169,SMARCA4,381
chr1,26169639,26169946,SRX4174629,CTCF,307
chr1,26169655,26170049,SRX5075168,SMARCA4,394
chr1,26169677,26170034,SRX5075176,SMARCA4,357
chr1,26169701,26170212,SRX5075170,SMARCA4,511
chr1,26169709,26169909,SRX5054309,FOSL2,200
chr1,26169716,26170163,SRX5716469,SMARCA4,447
chr1,26169716,26170222,SRX20140895,INTS13,506
chr1,26169721,26170203,SRX20140868,INTS10,482
chr1,26169881,26170220,SRX5075175,SMARCA4,339
chr1,26190385,26190673,SRX16500061,CTCF,288
chr1,26190436,26190646,SRX16500062,CTCF,210
chr1,26190445,26190782,SRX16500060,CTCF,337
chr1,26190477,26190732,SRX16500059,CTCF,255
chr1,26233655,26234563,SRX16500059,CTCF,908
chr1,26233699,26234496,SRX16500062,CTCF,797
chr1,26233705,26234583,SRX16500060,CTCF,878
chr1,26233730,26234208,SRX16500061,CTCF,478
chr1,26233755,26234155,SRX5075174,SMARCA4,400
chr1,26233784,26234127,SRX4174629,CTCF,343
chr1,26233800,26234524,SRX20140895,INTS13,724
chr1,26233801,26234205,SRX5075168,SMARCA4,404
chr1,26233835,26234035,SRX5075170,SMARCA4,200
chr1,26233896,26234212,SRX5716463,SMARCA4,316
chr1,26233972,26234203,SRX5716454,SOX3,231
chr1,26233982,26234238,SRX5054307,FOSL2,256
chr1,26234257,26234656,SRX5075168,SMARCA4,399
chr1,26234295,26234653,SRX5075174,SMARCA4,358
chr1,26234312,26234655,SRX16500061,CTCF,343
chr1,26239947,26240305,SRX5075168,SMARCA4,358
chr1,26240041,26240345,SRX5075174,SMARCA4,304
chr1,26240091,26240346,SRX5716463,SMARCA4,255
chr1,26240137,26240317,SRX5075169,SMARCA4,180
chr1,26266078,26266119,SRX1424894,POU3F2,41
chr1,26275499,26276230,SRX16500061,CTCF,731
chr1,26275523,26276134,SRX16500062,CTCF,611
chr1,26275529,26276187,SRX16500059,CTCF,658
chr1,26275533,26276167,SRX16500060,CTCF,634
chr1,26275565,26275865,SRX4174629,CTCF,300
chr1,26275590,26275865,SRX5075168,SMARCA4,275
chr1,26275602,26275928,SRX5075174,SMARCA4,326
chr1,26275644,26275965,SRX20140895,INTS13,321
chr1,26275678,26275923,SRX5075176,SMARCA4,245
chr1,26276160,26276518,SRX5075176,SMARCA4,358
chr1,26276216,26276503,SRX5075175,SMARCA4,287
chr1,26276221,26276535,SRX5075170,SMARCA4,314
chr1,26276242,26276503,SRX5054309,FOSL2,261
chr1,26276249,26276603,SRX5075169,SMARCA4,354
chr1,26276338,26276540,SRX5054308,FOSL2,202
chr1,26279789,26280190,SRX5075174,SMARCA4,401
chr1,26279795,26280304,SRX20140895,INTS13,509
chr1,26279829,26280189,SRX20140879,CPSF3L,360
chr1,26279839,26280179,SRX5075168,SMARCA4,340
chr1,26279911,26280225,SRX20140868,INTS10,314
chr1,26279968,26280182,SRX20140867,INTS10,214
chr1,26284998,26285477,SRX16500062,CTCF,479
chr1,26285010,26285493,SRX16500061,CTCF,483
chr1,26285025,26285481,SRX16500060,CTCF,456
chr1,26285046,26285489,SRX16500059,CTCF,443
chr1,26285905,26286184,SRX16500060,CTCF,279
chr1,26306377,26306861,SRX20140895,INTS13,484
chr1,26306433,26306608,SRX5075176,SMARCA4,175
chr1,26306434,26306933,SRX5075168,SMARCA4,499
chr1,26306501,26306705,SRX5716463,SMARCA4,204
chr1,26306512,26306881,SRX5075174,SMARCA4,369
chr1,26321452,26321969,SRX16500059,CTCF,517
chr1,26321481,26321975,SRX16500062,CTCF,494
chr1,26321487,26321969,SRX16500060,CTCF,482
chr1,26321503,26321819,SRX5075176,SMARCA4,316
chr1,26321521,26321976,SRX16500061,CTCF,455
chr1,26321525,26321841,SRX5075174,SMARCA4,316
chr1,26321526,26321896,SRX4174629,CTCF,370
chr1,26321541,26321777,SRX5075169,SMARCA4,236
chr1,26321541,26321786,SRX5716464,SMARCA4,245
chr1,26321542,26321963,SRX5075168,SMARCA4,421
chr1,26321545,26321789,SRX5716463,SMARCA4,244
chr1,26321573,26321817,SRX5075170,SMARCA4,244
chr1,26321615,26321817,SRX5075175,SMARCA4,202
chr1,26331651,26331906,SRX5075175,SMARCA4,255
chr1,26331731,26331931,SRX5075170,SMARCA4,200
chr1,26331740,26331920,SRX5054308,FOSL2,180
chr1,26331748,26332021,SRX5054309,FOSL2,273
chr1,26336372,26336591,SRX5075174,SMARCA4,219
chr1,26350659,26351216,SRX5075174,SMARCA4,557
chr1,26350720,26351170,SRX5075168,SMARCA4,450
chr1,26350722,26351140,SRX20140881,CPSF3L,418
chr1,26350781,26351163,SRX20140867,INTS10,382
chr1,26350787,26351109,SRX20140879,CPSF3L,322
chr1,26350825,26351069,SRX5075169,SMARCA4,244
chr1,26350835,26351061,SRX5716463,SMARCA4,226
chr1,26350840,26351097,SRX20140897,INTS13,257
chr1,26350872,26351111,SRX20140861,SOX2,239
chr1,26351579,26352114,SRX5075174,SMARCA4,535
chr1,26351694,26351986,SRX5716463,SMARCA4,292
chr1,26351708,26352121,SRX5075168,SMARCA4,413
chr1,26351808,26352013,SRX5716464,SMARCA4,205
chr1,26351830,26352059,SRX5716454,SOX3,229
chr1,26363759,26364236,SRX16500059,CTCF,477
chr1,26363792,26364171,SRX16500061,CTCF,379
chr1,26363803,26364256,SRX16500062,CTCF,453
chr1,26363809,26364107,SRX5075175,SMARCA4,298
chr1,26363809,26364188,SRX16500060,CTCF,379
chr1,26363819,26364141,SRX5075174,SMARCA4,322
chr1,26363824,26364123,SRX5716470,SMARCA4,299
chr1,26363829,26364109,SRX5716463,SMARCA4,280
chr1,26363843,26364095,SRX5075170,SMARCA4,252
chr1,26363856,26364123,SRX5075176,SMARCA4,267
chr1,26363857,26364062,SRX5716464,SMARCA4,205
chr1,26363857,26364125,SRX5075168,SMARCA4,268
chr1,26363867,26364116,SRX5075169,SMARCA4,249
chr1,26363887,26364130,SRX4174629,CTCF,243
chr1,26377941,26378489,SRX5716469,SMARCA4,548
chr1,26377947,26378384,SRX5716470,SMARCA4,437
chr1,26377951,26378472,SRX5075170,SMARCA4,521
chr1,26377956,26378450,SRX5075169,SMARCA4,494
chr1,26377960,26378440,SRX5054309,FOSL2,480
chr1,26377961,26378484,SRX5075176,SMARCA4,523
chr1,26377962,26378376,SRX5716468,SMARCA2,414
chr1,26377965,26378386,SRX5716467,SMARCA2,421
chr1,26377972,26378346,SRX5020211,SMARCA2,374
chr1,26377974,26378406,SRX5075175,SMARCA4,432
chr1,26377975,26378359,SRX5020214,SMARCA2,384
chr1,26377985,26378414,SRX5054308,FOSL2,429
chr1,26378005,26378316,SRX5716459,Epitope tags,311
chr1,26378017,26378258,SRX5075182,SMARCA2,241
chr1,26378017,26378296,SRX5075181,SMARCA2,279
chr1,26391420,26391838,SRX16500060,CTCF,418
chr1,26391472,26391828,SRX16500061,CTCF,356
chr1,26391481,26391855,SRX16500059,CTCF,374
chr1,26391482,26391807,SRX16500062,CTCF,325
chr1,26396251,26396501,SRX16500059,CTCF,250
chr1,26396274,26396602,SRX16500061,CTCF,328
chr1,26396312,26396581,SRX16500060,CTCF,269
chr1,26396326,26396552,SRX16500062,CTCF,226
chr1,26403713,26404061,SRX5075168,SMARCA4,348
chr1,26403779,26404110,SRX5075174,SMARCA4,331
chr1,26403789,26404040,SRX5716463,SMARCA4,251
chr1,26408538,26408926,SRX5716470,SMARCA4,388
chr1,26408557,26408937,SRX5075170,SMARCA4,380
chr1,26408558,26408930,SRX5716469,SMARCA4,372
chr1,26408567,26408940,SRX5075169,SMARCA4,373
chr1,26408568,26408911,SRX5075175,SMARCA4,343
chr1,26408569,26408917,SRX5075176,SMARCA4,348
chr1,26408583,26408899,SRX5716468,SMARCA2,316
chr1,26408583,26408906,SRX5075174,SMARCA4,323
chr1,26408584,26408872,SRX5075168,SMARCA4,288
chr1,26408598,26408798,SRX5054308,FOSL2,200
chr1,26408615,26408894,SRX5075181,SMARCA2,279
chr1,26408616,26408899,SRX5716467,SMARCA2,283
chr1,26408617,26408812,SRX5075182,SMARCA2,195
chr1,26408628,26408836,SRX5054309,FOSL2,208
chr1,26408669,26408878,SRX5020214,SMARCA2,209
chr1,26409306,26409703,SRX5075168,SMARCA4,397
chr1,26409376,26409639,SRX5075174,SMARCA4,263
chr1,26409510,26409860,SRX20140895,INTS13,350
chr1,26416960,26417359,SRX4174629,CTCF,399
chr1,26416961,26417409,SRX16500062,CTCF,448
chr1,26416962,26417499,SRX16500059,CTCF,537
chr1,26416969,26417417,SRX16500060,CTCF,448
chr1,26417022,26417422,SRX16500061,CTCF,400
chr1,26417069,26417337,SRX5075168,SMARCA4,268
chr1,26417069,26417405,SRX5075174,SMARCA4,336
chr1,26418838,26419284,SRX5075174,SMARCA4,446
chr1,26418878,26419400,SRX5075168,SMARCA4,522
chr1,26418976,26419237,SRX20140881,CPSF3L,261
chr1,26431838,26432460,SRX20140895,INTS13,622
chr1,26431877,26432441,SRX5075176,SMARCA4,564
chr1,26431888,26432473,SRX20140868,INTS10,585
chr1,26431889,26432169,SRX5075169,SMARCA4,280
chr1,26431899,26432379,SRX20140897,INTS13,480
chr1,26431933,26432563,SRX5075168,SMARCA4,630
chr1,26431936,26432171,SRX5716470,SMARCA4,235
chr1,26431943,26432154,SRX5075175,SMARCA4,211
chr1,26431964,26432517,SRX5075174,SMARCA4,553
chr1,26431966,26432306,SRX20140894,INTS13,340
chr1,26431974,26432327,SRX20140896,INTS13,353
chr1,26431991,26432303,SRX20140881,CPSF3L,312
chr1,26431995,26432412,SRX5075170,SMARCA4,417
chr1,26432076,26432356,SRX5716464,SMARCA4,280
chr1,26432089,26432331,SRX20140879,CPSF3L,242
chr1,26432117,26432353,SRX5054307,FOSL2,236
chr1,26432134,26432490,SRX20140867,INTS10,356
chr1,26432141,26432539,SRX5716463,SMARCA4,398
chr1,26432182,26432362,SRX5054308,FOSL2,180
chr1,26432334,26432596,SRX5716469,SMARCA4,262
chr1,26434277,26434486,SRX5075170,SMARCA4,209
chr1,26470251,26470754,SRX16500060,CTCF,503
chr1,26470262,26470765,SRX16500061,CTCF,503
chr1,26470264,26470661,SRX16500062,CTCF,397
chr1,26470265,26470711,SRX16500059,CTCF,446
chr1,26471908,26472194,SRX5716470,SMARCA4,286
chr1,26471978,26472283,SRX5075168,SMARCA4,305
chr1,26471990,26472250,SRX5075174,SMARCA4,260
chr1,26471997,26472207,SRX5075175,SMARCA4,210
chr1,26472028,26472253,SRX5075170,SMARCA4,225
chr1,26472108,26473270,SRX20140895,INTS13,1162
chr1,26472199,26473046,SRX20140897,INTS13,847
chr1,26472452,26473022,SRX20140868,INTS10,570
chr1,26472480,26473071,SRX20140867,INTS10,591
chr1,26472562,26472876,SRX20140896,INTS13,314
chr1,26472591,26472987,SRX20140869,INTS10,396
chr1,26472619,26472947,SRX20140881,CPSF3L,328
chr1,26472635,26472949,SRX20140879,CPSF3L,314
chr1,26472780,26473109,SRX5716470,SMARCA4,329
chr1,26472825,26473353,SRX5075174,SMARCA4,528
chr1,26472849,26473101,SRX5716464,SMARCA4,252
chr1,26472854,26473367,SRX5075176,SMARCA4,513
chr1,26472882,26473343,SRX5075170,SMARCA4,461
chr1,26472940,26473331,SRX5075168,SMARCA4,391
chr1,26473003,26473261,SRX5716463,SMARCA4,258
chr1,26482968,26483186,SRX5054309,FOSL2,218
chr1,26500064,26500748,SRX16500060,CTCF,684
chr1,26500088,26500770,SRX16500059,CTCF,682
chr1,26500100,26500632,SRX16500062,CTCF,532
chr1,26500117,26500676,SRX16500061,CTCF,559
chr1,26500120,26500568,SRX5075176,SMARCA4,448
chr1,26500121,26500376,SRX5716464,SMARCA4,255
chr1,26500130,26500554,SRX5075168,SMARCA4,424
chr1,26500144,26500510,SRX5075174,SMARCA4,366
chr1,26500150,26500528,SRX5716463,SMARCA4,378
chr1,26500157,26500546,SRX5075170,SMARCA4,389
chr1,26500208,26500556,SRX5716470,SMARCA4,348
chr1,26500209,26500520,SRX5075175,SMARCA4,311
chr1,26500238,26500532,SRX5075169,SMARCA4,294
chr1,26500241,26500549,SRX4174629,CTCF,308
chr1,26500283,26501287,SRX20140895,INTS13,1004
chr1,26500441,26501236,SRX20140897,INTS13,795
chr1,26500486,26501094,SRX20140869,INTS10,608
chr1,26500827,26501171,SRX5075169,SMARCA4,344
chr1,26500931,26501237,SRX5075174,SMARCA4,306
chr1,26500948,26501299,SRX5075175,SMARCA4,351
chr1,26500948,26501320,SRX5075170,SMARCA4,372
chr1,26500998,26501226,SRX5075176,SMARCA4,228
chr1,26500998,26501278,SRX20140868,INTS10,280
chr1,26501038,26501258,SRX5716469,SMARCA4,220
chr1,26501042,26501275,SRX5075168,SMARCA4,233
chr1,26529344,26530070,SRX20140895,INTS13,726
chr1,26529443,26529960,SRX5075174,SMARCA4,517
chr1,26529460,26530051,SRX5075168,SMARCA4,591
chr1,26529483,26529919,SRX5716463,SMARCA4,436
chr1,26529505,26530018,SRX5075169,SMARCA4,513
chr1,26529566,26529947,SRX5075170,SMARCA4,381
chr1,26529621,26529930,SRX20140867,INTS10,309
chr1,26529744,26529966,SRX5075176,SMARCA4,222
chr1,26529817,26530029,SRX5716469,SMARCA4,212
chr1,26529851,26530092,SRX5075175,SMARCA4,241
chr1,26531149,26531394,SRX5075170,SMARCA4,245
chr1,26531160,26531392,SRX5054309,FOSL2,232
chr1,26531166,26531385,SRX5075176,SMARCA4,219
chr1,26531189,26531425,SRX5716470,SMARCA4,236
chr1,26531215,26531457,SRX5075175,SMARCA4,242
chr1,26531247,26531427,SRX5075169,SMARCA4,180
chr1,26538732,26539025,SRX16500060,CTCF,293
chr1,26538735,26539015,SRX16500059,CTCF,280
chr1,26541810,26542118,SRX5075168,SMARCA4,308
chr1,26541840,26542084,SRX16500060,CTCF,244
chr1,26541871,26542172,SRX5075174,SMARCA4,301
chr1,26541905,26542137,SRX16500062,CTCF,232
chr1,26541915,26542252,SRX16500061,CTCF,337
chr1,26555543,26555910,SRX5075168,SMARCA4,367
chr1,26555631,26556051,SRX5075174,SMARCA4,420
chr1,26555689,26555927,SRX5075170,SMARCA4,238
chr1,26574794,26574963,SRX5075170,SMARCA4,169
chr1,26597515,26597971,SRX16500060,CTCF,456
chr1,26597544,26598037,SRX16500059,CTCF,493
chr1,26597564,26598033,SRX16500062,CTCF,469
chr1,26597579,26597977,SRX16500061,CTCF,398
chr1,26597693,26597886,SRX5075168,SMARCA4,193
chr1,26602329,26602799,SRX16500061,CTCF,470
chr1,26602339,26602816,SRX16500060,CTCF,477
chr1,26602347,26602774,SRX16500062,CTCF,427
chr1,26602350,26602814,SRX16500059,CTCF,464
chr1,26602440,26602637,SRX5075168,SMARCA4,197
chr1,26602453,26602693,SRX5075174,SMARCA4,240
chr1,26602464,26602696,SRX5075176,SMARCA4,232
chr1,26602469,26602678,SRX5075170,SMARCA4,209
chr1,26602510,26602714,SRX5716463,SMARCA4,204
chr1,26602519,26602721,SRX5075169,SMARCA4,202
chr1,26620094,26620903,SRX5075170,SMARCA4,809
chr1,26620161,26620621,SRX5075176,SMARCA4,460
chr1,26620172,26620671,SRX16500062,CTCF,499
chr1,26620177,26620514,SRX5716463,SMARCA4,337
chr1,26620189,26621240,SRX20140869,INTS10,1051
chr1,26620212,26620450,SRX4174629,CTCF,238
chr1,26620213,26620689,SRX16500059,CTCF,476
chr1,26620213,26621578,SRX20140895,INTS13,1365
chr1,26620215,26620601,SRX5075168,SMARCA4,386
chr1,26620215,26620691,SRX5716469,SMARCA4,476
chr1,26620219,26620764,SRX5716470,SMARCA4,545
chr1,26620222,26620631,SRX16500060,CTCF,409
chr1,26620229,26620655,SRX16500061,CTCF,426
chr1,26620230,26620624,SRX5075169,SMARCA4,394
chr1,26620231,26620829,SRX5075174,SMARCA4,598
chr1,26620267,26620565,SRX5075175,SMARCA4,298
chr1,26620292,26621350,SRX20140867,INTS10,1058
chr1,26620293,26620555,SRX5716464,SMARCA4,262
chr1,26620335,26621441,SRX20140868,INTS10,1106
chr1,26620351,26621229,SRX20140879,CPSF3L,878
chr1,26620385,26620584,SRX5054307,FOSL2,199
chr1,26620409,26620895,SRX20140894,INTS13,486
chr1,26620492,26621477,SRX20140881,CPSF3L,985
chr1,26620664,26621472,SRX20140897,INTS13,808
chr1,26668117,26668368,SRX5075169,SMARCA4,251
chr1,26668136,26668469,SRX5075175,SMARCA4,333
chr1,26668171,26668436,SRX5716470,SMARCA4,265
chr1,26668237,26668449,SRX5054309,FOSL2,212
chr1,26677438,26677880,SRX16500061,CTCF,442
chr1,26677484,26677858,SRX16500059,CTCF,374
chr1,26677496,26677731,SRX4174629,CTCF,235
chr1,26677518,26677901,SRX16500062,CTCF,383
chr1,26677539,26677852,SRX16500060,CTCF,313
chr1,26692149,26692536,SRX5075170,SMARCA4,387
chr1,26692179,26692522,SRX5075176,SMARCA4,343
chr1,26692222,26692474,SRX5075174,SMARCA4,252
chr1,26692323,26692517,SRX5075175,SMARCA4,194
chr1,26693001,26693328,SRX20140895,INTS13,327
chr1,26693012,26693261,SRX5075170,SMARCA4,249
chr1,26693115,26693368,SRX5075168,SMARCA4,253
chr1,26693146,26693389,SRX5716470,SMARCA4,243
chr1,26695445,26695931,SRX20140895,INTS13,486
chr1,26695464,26695913,SRX20140868,INTS10,449
chr1,26695481,26695701,SRX5075175,SMARCA4,220
chr1,26695503,26695861,SRX20140881,CPSF3L,358
chr1,26695512,26695690,SRX5075176,SMARCA4,178
chr1,26695523,26695745,SRX5075174,SMARCA4,222
chr1,26695533,26695737,SRX5075168,SMARCA4,204
chr1,26695539,26695888,SRX20140867,INTS10,349
chr1,26698208,26698466,SRX5054308,FOSL2,258
chr1,26698290,26698465,SRX5075176,SMARCA4,175
chr1,26698322,26698507,SRX5075168,SMARCA4,185
chr1,26705688,26706129,SRX5075169,SMARCA4,441
chr1,26705691,26705943,SRX5716469,SMARCA4,252
chr1,26705705,26706121,SRX5075175,SMARCA4,416
chr1,26705732,26705936,SRX5054308,FOSL2,204
chr1,26705766,26706153,SRX5075176,SMARCA4,387
chr1,26705806,26706077,SRX5716470,SMARCA4,271
chr1,26705809,26706180,SRX5075170,SMARCA4,371
chr1,26705840,26706083,SRX5054309,FOSL2,243
chr1,26723233,26723708,SRX20140895,INTS13,475
chr1,26723249,26723758,SRX5075174,SMARCA4,509
chr1,26723263,26723790,SRX5075168,SMARCA4,527
chr1,26723316,26724099,SRX5075176,SMARCA4,783
chr1,26723375,26723624,SRX20140897,INTS13,249
chr1,26723457,26724071,SRX5075169,SMARCA4,614
chr1,26723551,26724107,SRX5075170,SMARCA4,556
chr1,26723556,26724074,SRX5716467,SMARCA2,518
chr1,26723667,26724056,SRX5716470,SMARCA4,389
chr1,26723669,26724028,SRX5054309,FOSL2,359
chr1,26723703,26723973,SRX5716468,SMARCA2,270
chr1,26723716,26724066,SRX5075175,SMARCA4,350
chr1,26723729,26724066,SRX5716469,SMARCA4,337
chr1,26723734,26723988,SRX5054308,FOSL2,254
chr1,26744066,26744466,SRX5075174,SMARCA4,400
chr1,26744107,26744410,SRX5075170,SMARCA4,303
chr1,26744107,26744420,SRX5075176,SMARCA4,313
chr1,26744122,26744427,SRX5075169,SMARCA4,305
chr1,26744123,26744541,SRX5075168,SMARCA4,418
chr1,26744178,26744421,SRX5075175,SMARCA4,243
chr1,26771563,26771947,SRX5716469,SMARCA4,384
chr1,26771592,26772012,SRX5716467,SMARCA2,420
chr1,26771607,26772054,SRX5075175,SMARCA4,447
chr1,26771620,26772139,SRX5075169,SMARCA4,519
chr1,26771682,26772050,SRX5716470,SMARCA4,368
chr1,26771684,26771948,SRX5075174,SMARCA4,264
chr1,26771695,26772096,SRX5054308,FOSL2,401
chr1,26771709,26772099,SRX5054309,FOSL2,390
chr1,26771726,26771937,SRX5020211,SMARCA2,211
chr1,26771748,26772183,SRX5075170,SMARCA4,435
chr1,26771757,26772146,SRX5075176,SMARCA4,389
chr1,26772811,26773097,SRX5054309,FOSL2,286
chr1,26784060,26784282,SRX5075168,SMARCA4,222
chr1,26787690,26788383,SRX20140895,INTS13,693
chr1,26787764,26788134,SRX5075168,SMARCA4,370
chr1,26788064,26788334,SRX5075170,SMARCA4,270
chr1,26788124,26788297,SRX5075174,SMARCA4,173
chr1,26789062,26789534,SRX16500062,CTCF,472
chr1,26789066,26789600,SRX16500059,CTCF,534
chr1,26789089,26789545,SRX16500061,CTCF,456
chr1,26789122,26789487,SRX4174629,CTCF,365
chr1,26789124,26789593,SRX16500060,CTCF,469
chr1,26789144,26789425,SRX5075175,SMARCA4,281
chr1,26789186,26789479,SRX5075168,SMARCA4,293
chr1,26789205,26789425,SRX5075176,SMARCA4,220
chr1,26789224,26789434,SRX5075174,SMARCA4,210
chr1,26789233,26789420,SRX5075170,SMARCA4,187
chr1,26799532,26799707,SRX5075176,SMARCA4,175
chr1,26799567,26799769,SRX5075170,SMARCA4,202
chr1,26799787,26800160,SRX5075176,SMARCA4,373
chr1,26799828,26800166,SRX5716469,SMARCA4,338
chr1,26799846,26800335,SRX5075170,SMARCA4,489
chr1,26799885,26800160,SRX5075175,SMARCA4,275
chr1,26799888,26800209,SRX5054309,FOSL2,321
chr1,26799927,26800159,SRX5075169,SMARCA4,232
chr1,26799942,26800155,SRX5054308,FOSL2,213
chr1,26800497,26800677,SRX5075169,SMARCA4,180
chr1,26800536,26800790,SRX5054308,FOSL2,254
chr1,26800571,26800767,SRX5054309,FOSL2,196
chr1,26809957,26810500,SRX16500059,CTCF,543
chr1,26809960,26810409,SRX16500060,CTCF,449
chr1,26810005,26810463,SRX16500062,CTCF,458
chr1,26810011,26810469,SRX16500061,CTCF,458
chr1,26810097,26810397,SRX5075168,SMARCA4,300
chr1,26810101,26810364,SRX5075174,SMARCA4,263
chr1,26810164,26810340,SRX5075176,SMARCA4,176
chr1,26826275,26826753,SRX20140895,INTS13,478
chr1,26826294,26826622,SRX16500062,CTCF,328
chr1,26826330,26826704,SRX5075168,SMARCA4,374
chr1,26826341,26826674,SRX16500060,CTCF,333
chr1,26826341,26826691,SRX20140868,INTS10,350
chr1,26826355,26826628,SRX16500061,CTCF,273
chr1,26826358,26826707,SRX5075176,SMARCA4,349
chr1,26826361,26826676,SRX5716463,SMARCA4,315
chr1,26826377,26826686,SRX16500059,CTCF,309
chr1,26826379,26826734,SRX5075169,SMARCA4,355
chr1,26826388,26826767,SRX5075174,SMARCA4,379
chr1,26826398,26826640,SRX5716470,SMARCA4,242
chr1,26826407,26826666,SRX5075170,SMARCA4,259
chr1,26826407,26826694,SRX5716469,SMARCA4,287
chr1,26826431,26826740,SRX5075175,SMARCA4,309
chr1,26826532,26826746,SRX20140867,INTS10,214
chr1,26852941,26853474,SRX16500059,CTCF,533
chr1,26852943,26853443,SRX16500060,CTCF,500
chr1,26852943,26853487,SRX16500061,CTCF,544
chr1,26853006,26853435,SRX16500062,CTCF,429
chr1,26853104,26853328,SRX4174629,CTCF,224
chr1,26853161,26853404,SRX5075174,SMARCA4,243
chr1,26853163,26853376,SRX5075176,SMARCA4,213
chr1,26853204,26853407,SRX5075168,SMARCA4,203
chr1,26864781,26865223,SRX20140881,CPSF3L,442
chr1,26864852,26865571,SRX20140895,INTS13,719
chr1,26864873,26865186,SRX20140879,CPSF3L,313
chr1,26864884,26865435,SRX20140867,INTS10,551
chr1,26864960,26865474,SRX20140868,INTS10,514
chr1,26865022,26865541,SRX5075168,SMARCA4,519
chr1,26865041,26865553,SRX5075174,SMARCA4,512
chr1,26865073,26865493,SRX5054307,FOSL2,420
chr1,26865085,26865338,SRX5716463,SMARCA4,253
chr1,26865091,26865534,SRX5075176,SMARCA4,443
chr1,26865114,26865563,SRX5075170,SMARCA4,449
chr1,26865127,26865585,SRX5054308,FOSL2,458
chr1,26865157,26865460,SRX5716469,SMARCA4,303
chr1,26865175,26865625,SRX5075169,SMARCA4,450
chr1,26865180,26865615,SRX5075175,SMARCA4,435
chr1,26865266,26865594,SRX5054309,FOSL2,328
chr1,26877873,26878414,SRX16500059,CTCF,541
chr1,26877905,26878413,SRX16500060,CTCF,508
chr1,26877917,26878367,SRX16500062,CTCF,450
chr1,26877923,26878390,SRX16500061,CTCF,467
chr1,26878019,26878247,SRX5075174,SMARCA4,228
chr1,26878039,26878226,SRX5075175,SMARCA4,187
chr1,26878043,26878227,SRX5075170,SMARCA4,184
chr1,26878056,26878267,SRX5075168,SMARCA4,211
chr1,26887046,26887464,SRX16500062,CTCF,418
chr1,26887104,26887462,SRX16500059,CTCF,358
chr1,26887167,26887440,SRX16500060,CTCF,273
chr1,26887181,26887449,SRX16500061,CTCF,268
chr1,26889912,26890515,SRX20140895,INTS13,603
chr1,26890048,26890314,SRX20140869,INTS10,266
chr1,26890072,26890344,SRX5075169,SMARCA4,272
chr1,26890082,26890545,SRX5075168,SMARCA4,463
chr1,26890151,26890436,SRX5075170,SMARCA4,285
chr1,26890158,26890564,SRX5075174,SMARCA4,406
chr1,26890172,26890436,SRX5075176,SMARCA4,264
chr1,26900022,26900667,SRX20140897,INTS13,645
chr1,26900114,26900709,SRX20140895,INTS13,595
chr1,26900120,26900532,SRX20140896,INTS13,412
chr1,26900120,26900651,SRX20140869,INTS10,531
chr1,26900134,26900683,SRX20140868,INTS10,549
chr1,26900160,26900624,SRX20140881,CPSF3L,464
chr1,26900192,26900624,SRX20140867,INTS10,432
chr1,26900206,26900637,SRX20140894,INTS13,431
chr1,26900229,26900658,SRX5716464,SMARCA4,429
chr1,26900259,26900723,SRX20140879,CPSF3L,464
chr1,26900271,26900709,SRX5075174,SMARCA4,438
chr1,26900357,26900718,SRX5075168,SMARCA4,361
chr1,26900380,26900719,SRX5075169,SMARCA4,339
chr1,26900409,26900716,SRX5075170,SMARCA4,307
chr1,26900477,26900819,SRX5075176,SMARCA4,342
chr1,26900508,26900744,SRX5716470,SMARCA4,236
chr1,26900509,26900746,SRX5716469,SMARCA4,237
chr1,26900514,26900735,SRX5075175,SMARCA4,221
chr1,26921297,26921824,SRX5075174,SMARCA4,527
chr1,26921331,26921694,SRX5075176,SMARCA4,363
chr1,26921383,26921592,SRX5075170,SMARCA4,209
chr1,26921388,26921894,SRX5075168,SMARCA4,506
chr1,26921468,26921733,SRX5716463,SMARCA4,265
chr1,26921517,26921749,SRX5054307,FOSL2,232
chr1,26921605,26922137,SRX20140895,INTS13,532
chr1,26921686,26922018,SRX20140897,INTS13,332
chr1,26921718,26922019,SRX20140867,INTS10,301
chr1,26921731,26921974,SRX5075169,SMARCA4,243
chr1,26921734,26921953,SRX5716470,SMARCA4,219
chr1,26921766,26922054,SRX20140881,CPSF3L,288
chr1,26921809,26922075,SRX20140869,INTS10,266
chr1,26961828,26962136,SRX5054308,FOSL2,308
chr1,26961834,26962183,SRX5075170,SMARCA4,349
chr1,26961839,26962155,SRX5054309,FOSL2,316
chr1,26961855,26962120,SRX5075175,SMARCA4,265
chr1,26961856,26962106,SRX5075169,SMARCA4,250
chr1,26961877,26962139,SRX5075176,SMARCA4,262
chr1,26961922,26962135,SRX5716470,SMARCA4,213
chr1,26966888,26967259,SRX16500061,CTCF,371
chr1,26966917,26967250,SRX16500062,CTCF,333
chr1,26966920,26967290,SRX16500059,CTCF,370
chr1,26966971,26967297,SRX16500060,CTCF,326
chr1,26966993,26967174,SRX5075168,SMARCA4,181
chr1,26972340,26972641,SRX5075176,SMARCA4,301
chr1,26972346,26972816,SRX5075169,SMARCA4,470
chr1,26972411,26972646,SRX5075170,SMARCA4,235
chr1,26972426,26972646,SRX5716470,SMARCA4,220
chr1,26993505,26993860,SRX20140896,INTS13,355
chr1,26993559,26993970,SRX20140897,INTS13,411
chr1,26993617,26993908,SRX20140879,CPSF3L,291
chr1,26993623,26994241,SRX20140895,INTS13,618
chr1,26993628,26994084,SRX20140867,INTS10,456
chr1,26993669,26994000,SRX20140881,CPSF3L,331
chr1,26993745,26994100,SRX20140868,INTS10,355
chr1,26997517,26998034,SRX16500060,CTCF,517
chr1,26997524,26998073,SRX16500059,CTCF,549
chr1,26997532,26997982,SRX16500062,CTCF,450
chr1,26997581,26998103,SRX16500061,CTCF,522
chr1,26997720,26997949,SRX5075176,SMARCA4,229
chr1,26997741,26997961,SRX5075168,SMARCA4,220
chr1,26997759,26997969,SRX4174629,CTCF,210
chr1,26997772,26998012,SRX5075174,SMARCA4,240
chr1,26999412,26999837,SRX5075169,SMARCA4,425
chr1,26999422,26999749,SRX5716467,SMARCA2,327
chr1,26999424,26999801,SRX5075175,SMARCA4,377
chr1,26999437,26999785,SRX5716470,SMARCA4,348
chr1,26999446,26999772,SRX5716468,SMARCA2,326
chr1,26999462,26999781,SRX5716469,SMARCA4,319
chr1,26999463,26999817,SRX5020214,SMARCA2,354
chr1,26999469,26999757,SRX5075170,SMARCA4,288
chr1,26999469,26999784,SRX5054308,FOSL2,315
chr1,26999474,26999788,SRX5054309,FOSL2,314
chr1,26999510,26999809,SRX5075176,SMARCA4,299
chr1,26999516,26999742,SRX5075174,SMARCA4,226
chr1,26999517,26999745,SRX5075168,SMARCA4,228
chr1,27001642,27002158,SRX5075174,SMARCA4,516
chr1,27001708,27002039,SRX20140867,INTS10,331
chr1,27001750,27001970,SRX5075168,SMARCA4,220
chr1,27010975,27011366,SRX5075174,SMARCA4,391
chr1,27010989,27011264,SRX5020211,SMARCA2,275
chr1,27010995,27011384,SRX5075168,SMARCA4,389
chr1,27011008,27011326,SRX5075175,SMARCA4,318
chr1,27011014,27011358,SRX5054309,FOSL2,344
chr1,27011015,27011331,SRX5075169,SMARCA4,316
chr1,27011029,27011339,SRX5075170,SMARCA4,310
chr1,27011032,27011244,SRX5716469,SMARCA4,212
chr1,27011042,27011317,SRX5054308,FOSL2,275
chr1,27011046,27011267,SRX5054307,FOSL2,221
chr1,27011077,27011353,SRX5075176,SMARCA4,276
chr1,27011081,27011335,SRX5020214,SMARCA2,254
chr1,27012440,27013105,SRX20140881,CPSF3L,665
chr1,27012455,27013028,SRX20140896,INTS13,573
chr1,27012501,27013037,SRX20140879,CPSF3L,536
chr1,27012547,27013016,SRX20140867,INTS10,469
chr1,27012633,27013085,SRX20140897,INTS13,452
chr1,27012663,27013446,SRX20140895,INTS13,783
chr1,27012730,27013035,SRX20140869,INTS10,305
chr1,27012766,27013286,SRX5075168,SMARCA4,520
chr1,27012803,27013257,SRX5075174,SMARCA4,454
chr1,27012813,27013139,SRX5054309,FOSL2,326
chr1,27012830,27013151,SRX5054308,FOSL2,321
chr1,27012839,27013147,SRX5054307,FOSL2,308
chr1,27012841,27013163,SRX5075170,SMARCA4,322
chr1,27012844,27013197,SRX5075176,SMARCA4,353
chr1,27012861,27013166,SRX5716451,SOX2,305
chr1,27012863,27013101,SRX5075169,SMARCA4,238
chr1,27012882,27013139,SRX5716454,SOX3,257
chr1,27012898,27013174,SRX5716469,SMARCA4,276
chr1,27012924,27013196,SRX5716464,SMARCA4,272
chr1,27027098,27027276,SRX5075176,SMARCA4,178
chr1,27027766,27028214,SRX5075170,SMARCA4,448
chr1,27027961,27028234,SRX5075175,SMARCA4,273
chr1,27028070,27028293,SRX5075176,SMARCA4,223
chr1,27042797,27042984,SRX5075168,SMARCA4,187
chr1,27044471,27044947,SRX16500060,CTCF,476
chr1,27044479,27044953,SRX16500059,CTCF,474
chr1,27044503,27044908,SRX16500062,CTCF,405
chr1,27044505,27044911,SRX16500061,CTCF,406
chr1,27044547,27044986,SRX4174629,CTCF,439
chr1,27044631,27044808,SRX5075176,SMARCA4,177
chr1,27044664,27044874,SRX5075168,SMARCA4,210
chr1,27045678,27046173,SRX4174629,CTCF,495
chr1,27045809,27046295,SRX16500061,CTCF,486
chr1,27045842,27046288,SRX16500059,CTCF,446
chr1,27045881,27046302,SRX16500060,CTCF,421
chr1,27045903,27046289,SRX16500062,CTCF,386
chr1,27045940,27046223,SRX5075176,SMARCA4,283
chr1,27045956,27046265,SRX20140895,INTS13,309
chr1,27045981,27046233,SRX5075168,SMARCA4,252
chr1,27045983,27046220,SRX5075170,SMARCA4,237
chr1,27045992,27046218,SRX5075174,SMARCA4,226
chr1,27046064,27046258,SRX5075169,SMARCA4,194
chr1,27049114,27049428,SRX5716467,SMARCA2,314
chr1,27049165,27049391,SRX5716470,SMARCA4,226
chr1,27049176,27049485,SRX5075181,SMARCA2,309
chr1,27049203,27049427,SRX5020211,SMARCA2,224
chr1,27049208,27049411,SRX5075170,SMARCA4,203
chr1,27049217,27049429,SRX5716469,SMARCA4,212
chr1,27070998,27071388,SRX5075174,SMARCA4,390
chr1,27071069,27071479,SRX5075168,SMARCA4,410
chr1,27071118,27071357,SRX5716463,SMARCA4,239
chr1,27071163,27071443,SRX5716464,SMARCA4,280
chr1,27097303,27097824,SRX16500060,CTCF,521
chr1,27097310,27097828,SRX16500061,CTCF,518
chr1,27097318,27097709,SRX4174629,CTCF,391
chr1,27097330,27097843,SRX16500059,CTCF,513
chr1,27097352,27097795,SRX16500062,CTCF,443
chr1,27097393,27097682,SRX5075169,SMARCA4,289
chr1,27097406,27097728,SRX5075170,SMARCA4,322
chr1,27097437,27097679,SRX5075176,SMARCA4,242
chr1,27097441,27097710,SRX5075168,SMARCA4,269
chr1,27097470,27097675,SRX5075174,SMARCA4,205
chr1,27099266,27099520,SRX5075176,SMARCA4,254
chr1,27099350,27099741,SRX5075174,SMARCA4,391
chr1,27099425,27099643,SRX5716469,SMARCA4,218
chr1,27099441,27099696,SRX5716470,SMARCA4,255
chr1,27099518,27099725,SRX5075169,SMARCA4,207
chr1,27099535,27099903,SRX5075175,SMARCA4,368
chr1,27099539,27099807,SRX5075168,SMARCA4,268
chr1,27099585,27099781,SRX5075176,SMARCA4,196
chr1,27099594,27099828,SRX5075170,SMARCA4,234
chr1,27102616,27103095,SRX16500061,CTCF,479
chr1,27102645,27103123,SRX16500059,CTCF,478
chr1,27102657,27103125,SRX16500062,CTCF,468
chr1,27102659,27103121,SRX16500060,CTCF,462
chr1,27102726,27103079,SRX4174629,CTCF,353
chr1,27102800,27102995,SRX5075174,SMARCA4,195
chr1,27111860,27112547,SRX5075176,SMARCA4,687
chr1,27111915,27112517,SRX5075175,SMARCA4,602
chr1,27111919,27112587,SRX5075169,SMARCA4,668
chr1,27111924,27112553,SRX5075170,SMARCA4,629
chr1,27111957,27112535,SRX5054309,FOSL2,578
chr1,27111976,27112529,SRX5054308,FOSL2,553
chr1,27112025,27112500,SRX5716469,SMARCA4,475
chr1,27112062,27112558,SRX5716470,SMARCA4,496
chr1,27112120,27112471,SRX5020211,SMARCA2,351
chr1,27112139,27112463,SRX5716467,SMARCA2,324
chr1,27112224,27112416,SRX5075168,SMARCA4,192
chr1,27112271,27112465,SRX5075174,SMARCA4,194
chr1,27118993,27119316,SRX5716467,SMARCA2,323
chr1,27119016,27119312,SRX5716470,SMARCA4,296
chr1,27119020,27119248,SRX5075176,SMARCA4,228
chr1,27119106,27119300,SRX5075181,SMARCA2,194
chr1,27119111,27119315,SRX5716463,SMARCA4,204
chr1,27122664,27122952,SRX5075168,SMARCA4,288
chr1,27122684,27122911,SRX5075175,SMARCA4,227
chr1,27122685,27122961,SRX5075174,SMARCA4,276
chr1,27122690,27122957,SRX5054308,FOSL2,267
chr1,27122692,27122944,SRX5054309,FOSL2,252
chr1,27122707,27122945,SRX5075170,SMARCA4,238
chr1,27122719,27122947,SRX5054307,FOSL2,228
chr1,27122733,27122955,SRX5075169,SMARCA4,222
chr1,27136032,27136257,SRX16500062,CTCF,225
chr1,27145888,27146247,SRX5716470,SMARCA4,359
chr1,27145917,27146288,SRX5075170,SMARCA4,371
chr1,27145919,27146282,SRX5075176,SMARCA4,363
chr1,27145928,27146213,SRX5054308,FOSL2,285
chr1,27145929,27146276,SRX5075169,SMARCA4,347
chr1,27145933,27146313,SRX5075175,SMARCA4,380
chr1,27145943,27146253,SRX5054309,FOSL2,310
chr1,27154735,27155408,SRX20140895,INTS13,673
chr1,27154747,27155381,SRX20140881,CPSF3L,634
chr1,27154781,27155339,SRX20140894,INTS13,558
chr1,27154804,27155343,SRX20140879,CPSF3L,539
chr1,27154824,27155407,SRX20140869,INTS10,583
chr1,27154834,27155348,SRX20140867,INTS10,514
chr1,27154845,27155353,SRX20140897,INTS13,508
chr1,27154847,27155369,SRX20140896,INTS13,522
chr1,27154871,27155267,SRX20140880,CPSF3L,396
chr1,27154877,27155329,SRX5716464,SMARCA4,452
chr1,27154886,27155363,SRX5716470,SMARCA4,477
chr1,27154893,27155365,SRX20140868,INTS10,472
chr1,27154894,27155409,SRX5075168,SMARCA4,515
chr1,27154901,27155314,SRX20140882,CPSF3L,413
chr1,27154922,27155344,SRX5075175,SMARCA4,422
chr1,27154939,27155255,SRX20140870,INTS10,316
chr1,27154941,27155408,SRX16500060,CTCF,467
chr1,27154956,27155408,SRX5075174,SMARCA4,452
chr1,27154959,27155432,SRX5075170,SMARCA4,473
chr1,27154976,27155488,SRX5075176,SMARCA4,512
chr1,27154995,27155474,SRX16500059,CTCF,479
chr1,27154998,27155380,SRX5716463,SMARCA4,382
chr1,27155008,27155198,SRX5716451,SOX2,190
chr1,27155028,27155428,SRX16500062,CTCF,400
chr1,27155039,27155545,SRX16500061,CTCF,506
chr1,27155043,27155491,SRX5075169,SMARCA4,448
chr1,27155135,27155545,SRX5716469,SMARCA4,410
chr1,27155150,27155361,SRX4174629,CTCF,211
chr1,27155150,27155422,SRX5054309,FOSL2,272
chr1,27155242,27155516,SRX5054308,FOSL2,274
chr1,27197826,27198388,SRX16500059,CTCF,562
chr1,27197838,27198421,SRX16500060,CTCF,583
chr1,27197862,27198391,SRX16500061,CTCF,529
chr1,27197917,27198392,SRX16500062,CTCF,475
chr1,27197967,27198207,SRX5075168,SMARCA4,240
chr1,27198016,27198249,SRX5075174,SMARCA4,233
chr1,27198023,27198233,SRX5075176,SMARCA4,210
chr1,27198029,27198270,SRX5075170,SMARCA4,241
chr1,27198040,27198268,SRX5075175,SMARCA4,228
chr1,27198056,27198240,SRX5075169,SMARCA4,184
chr1,27234239,27234706,SRX5075174,SMARCA4,467
chr1,27234242,27234697,SRX5075168,SMARCA4,455
chr1,27234272,27234591,SRX5075170,SMARCA4,319
chr1,27234468,27234766,SRX20140895,INTS13,298
chr1,27234472,27234775,SRX5075176,SMARCA4,303
chr1,27234671,27234974,SRX5716470,SMARCA4,303
chr1,27284542,27285080,SRX16500060,CTCF,538
chr1,27284600,27285161,SRX16500059,CTCF,561
chr1,27284604,27285080,SRX16500061,CTCF,476
chr1,27284614,27285129,SRX16500062,CTCF,515
chr1,27284676,27284949,SRX5075168,SMARCA4,273
chr1,27284681,27284931,SRX5075174,SMARCA4,250
chr1,27284683,27284917,SRX5716469,SMARCA4,234
chr1,27284687,27284907,SRX5716470,SMARCA4,220
chr1,27284697,27285038,SRX4174629,CTCF,341
chr1,27284698,27284903,SRX5716464,SMARCA4,205
chr1,27284713,27284888,SRX5075176,SMARCA4,175
chr1,27284726,27284918,SRX5075170,SMARCA4,192
chr1,27296749,27297007,SRX4174629,CTCF,258
chr1,27296818,27297127,SRX16500059,CTCF,309
chr1,27296821,27297081,SRX16500061,CTCF,260
chr1,27296829,27297088,SRX16500060,CTCF,259
chr1,27299357,27299762,SRX5075170,SMARCA4,405
chr1,27299368,27299753,SRX5075168,SMARCA4,385
chr1,27299372,27299752,SRX5716463,SMARCA4,380
chr1,27299386,27299822,SRX5716470,SMARCA4,436
chr1,27299397,27299718,SRX5075175,SMARCA4,321
chr1,27299409,27299758,SRX5075169,SMARCA4,349
chr1,27299411,27299791,SRX5716469,SMARCA4,380
chr1,27299413,27299802,SRX5075174,SMARCA4,389
chr1,27299418,27299748,SRX5716467,SMARCA2,330
chr1,27299427,27299735,SRX5075176,SMARCA4,308
chr1,27299443,27299691,SRX5716464,SMARCA4,248
chr1,27299449,27299649,SRX5054308,FOSL2,200
chr1,27299476,27299686,SRX5054309,FOSL2,210
chr1,27299507,27299740,SRX5716468,SMARCA2,233
chr1,27300430,27301084,SRX5075176,SMARCA4,654
chr1,27300458,27301094,SRX5075169,SMARCA4,636
chr1,27300601,27301083,SRX5716469,SMARCA4,482
chr1,27300602,27301118,SRX5075170,SMARCA4,516
chr1,27300647,27300856,SRX5054309,FOSL2,209
chr1,27300656,27300982,SRX5716470,SMARCA4,326
chr1,27300668,27301114,SRX5075175,SMARCA4,446
chr1,27300691,27301214,SRX16500061,CTCF,523
chr1,27300732,27301015,SRX5020214,SMARCA2,283
chr1,27300737,27301201,SRX16500059,CTCF,464
chr1,27300753,27301196,SRX16500062,CTCF,443
chr1,27300753,27301227,SRX16500060,CTCF,474
chr1,27300838,27301063,SRX5075168,SMARCA4,225
chr1,27300843,27301175,SRX4174629,CTCF,332
chr1,27300876,27301123,SRX5075174,SMARCA4,247
chr1,27318627,27318916,SRX5075170,SMARCA4,289
chr1,27318665,27318895,SRX5075176,SMARCA4,230
chr1,27321817,27322523,SRX20140895,INTS13,706
chr1,27321828,27322409,SRX20140868,INTS10,581
chr1,27321851,27322355,SRX5075168,SMARCA4,504
chr1,27321909,27322170,SRX20140881,CPSF3L,261
chr1,27321909,27322462,SRX16500059,CTCF,553
chr1,27321910,27322428,SRX5075174,SMARCA4,518
chr1,27321914,27322253,SRX20140879,CPSF3L,339
chr1,27321925,27322342,SRX5716470,SMARCA4,417
chr1,27321959,27322465,SRX16500060,CTCF,506
chr1,27321962,27322417,SRX5075176,SMARCA4,455
chr1,27321968,27322346,SRX5075170,SMARCA4,378
chr1,27321986,27322373,SRX16500062,CTCF,387
chr1,27321987,27322456,SRX20140897,INTS13,469
chr1,27322027,27322387,SRX20140867,INTS10,360
chr1,27322040,27322440,SRX20140869,INTS10,400
chr1,27322087,27322348,SRX5075169,SMARCA4,261
chr1,27322156,27322422,SRX16500061,CTCF,266
chr1,27332698,27333223,SRX16500059,CTCF,525
chr1,27332727,27333159,SRX16500061,CTCF,432
chr1,27332745,27333168,SRX16500062,CTCF,423
chr1,27332760,27333280,SRX16500060,CTCF,520
chr1,27332820,27333135,SRX4174629,CTCF,315
chr1,27332885,27333115,SRX5075168,SMARCA4,230
chr1,27341865,27342159,SRX5075169,SMARCA4,294
chr1,27341884,27342155,SRX5075176,SMARCA4,271
chr1,27341889,27342196,SRX5075170,SMARCA4,307
chr1,27341899,27342090,SRX5054308,FOSL2,191
chr1,27341969,27342188,SRX5054309,FOSL2,219
chr1,27349695,27350042,SRX20140881,CPSF3L,347
chr1,27349891,27350199,SRX5075174,SMARCA4,308
chr1,27357365,27357934,SRX16500061,CTCF,569
chr1,27357415,27357908,SRX16500062,CTCF,493
chr1,27357415,27357934,SRX16500059,CTCF,519
chr1,27357418,27357972,SRX16500060,CTCF,554
chr1,27357515,27357860,SRX5075168,SMARCA4,345
chr1,27357525,27357878,SRX5075174,SMARCA4,353
chr1,27357545,27357844,SRX5716464,SMARCA4,299
chr1,27357547,27357864,SRX4174629,CTCF,317
chr1,27357554,27357820,SRX5075176,SMARCA4,266
chr1,27357562,27357797,SRX5075175,SMARCA4,235
chr1,27357571,27357814,SRX5075170,SMARCA4,243
chr1,27357611,27357791,SRX5075169,SMARCA4,180
chr1,27357635,27357874,SRX5716463,SMARCA4,239
chr1,27365355,27365846,SRX5075168,SMARCA4,491
chr1,27365381,27365787,SRX5075170,SMARCA4,406
chr1,27365402,27365825,SRX5075174,SMARCA4,423
chr1,27365415,27365795,SRX5075176,SMARCA4,380
chr1,27365505,27365788,SRX5716463,SMARCA4,283
chr1,27365535,27365727,SRX5054307,FOSL2,192
chr1,27366123,27366807,SRX20140895,INTS13,684
chr1,27366156,27366482,SRX20140868,INTS10,326
chr1,27366263,27366477,SRX20140867,INTS10,214
chr1,27366303,27366760,SRX5075169,SMARCA4,457
chr1,27366354,27366809,SRX5075175,SMARCA4,455
chr1,27366544,27366748,SRX5075170,SMARCA4,204
chr1,27366547,27366854,SRX5716470,SMARCA4,307
chr1,27366684,27366930,SRX5716469,SMARCA4,246
chr1,27366931,27367251,SRX5075176,SMARCA4,320
chr1,27368929,27369148,SRX16500061,CTCF,219
chr1,27381020,27381429,SRX5075176,SMARCA4,409
chr1,27381152,27381426,SRX5075170,SMARCA4,274
chr1,27381167,27381435,SRX5716469,SMARCA4,268
chr1,27388288,27388811,SRX16500061,CTCF,523
chr1,27388331,27388841,SRX16500060,CTCF,510
chr1,27388357,27388786,SRX16500062,CTCF,429
chr1,27388372,27388809,SRX16500059,CTCF,437
chr1,27392315,27392810,SRX5075170,SMARCA4,495
chr1,27392324,27392843,SRX5075176,SMARCA4,519
chr1,27392324,27392869,SRX5075174,SMARCA4,545
chr1,27392326,27392645,SRX5716451,SOX2,319
chr1,27392337,27392827,SRX5075168,SMARCA4,490
chr1,27392339,27392923,SRX5075169,SMARCA4,584
chr1,27392363,27392836,SRX5716463,SMARCA4,473
chr1,27392397,27392836,SRX20140895,INTS13,439
chr1,27392410,27392773,SRX5054307,FOSL2,363
chr1,27392420,27392828,SRX5716469,SMARCA4,408
chr1,27392427,27392821,SRX5054308,FOSL2,394
chr1,27392438,27392849,SRX5716470,SMARCA4,411
chr1,27392439,27392858,SRX5054309,FOSL2,419
chr1,27392603,27392862,SRX5075175,SMARCA4,259
chr1,27392634,27392855,SRX20140867,INTS10,221
chr1,27395291,27395780,SRX16500060,CTCF,489
chr1,27395292,27395820,SRX16500061,CTCF,528
chr1,27395293,27395756,SRX16500062,CTCF,463
chr1,27395297,27395773,SRX16500059,CTCF,476
chr1,27395400,27395686,SRX5075168,SMARCA4,286
chr1,27395421,27395610,SRX5075170,SMARCA4,189
chr1,27395429,27395676,SRX5075174,SMARCA4,247
chr1,27395446,27395755,SRX4174629,CTCF,309
chr1,27395471,27395682,SRX5075176,SMARCA4,211
chr1,27405834,27406223,SRX16500059,CTCF,389
chr1,27405846,27406211,SRX16500060,CTCF,365
chr1,27405871,27406157,SRX16500061,CTCF,286
chr1,27405875,27406214,SRX16500062,CTCF,339
chr1,27416536,27416901,SRX16500062,CTCF,365
chr1,27416539,27416782,SRX16500061,CTCF,243
chr1,27416635,27416935,SRX16500059,CTCF,300
chr1,27416645,27416866,SRX16500060,CTCF,221
chr1,27417780,27417978,SRX5075176,SMARCA4,198
chr1,27418266,27418813,SRX5075169,SMARCA4,547
chr1,27418299,27418805,SRX5075176,SMARCA4,506
chr1,27418327,27418768,SRX5075170,SMARCA4,441
chr1,27418343,27418724,SRX5054308,FOSL2,381
chr1,27418351,27418668,SRX5054309,FOSL2,317
chr1,27418370,27418773,SRX5075175,SMARCA4,403
chr1,27418383,27418793,SRX5716469,SMARCA4,410
chr1,27418391,27418741,SRX5716470,SMARCA4,350
chr1,27418408,27418667,SRX5716467,SMARCA2,259
chr1,27418456,27418712,SRX5075174,SMARCA4,256
chr1,27428526,27428929,SRX5075174,SMARCA4,403
chr1,27428534,27428816,SRX20140881,CPSF3L,282
chr1,27428544,27428951,SRX5075168,SMARCA4,407
chr1,27428604,27428865,SRX20140867,INTS10,261
chr1,27428732,27428966,SRX5716463,SMARCA4,234
chr1,27448072,27448367,SRX20140868,INTS10,295
chr1,27463976,27464268,SRX5075175,SMARCA4,292
chr1,27489754,27490359,SRX20140895,INTS13,605
chr1,27489948,27490264,SRX5075168,SMARCA4,316
chr1,27490126,27490331,SRX5054308,FOSL2,205
chr1,27490152,27490346,SRX5054307,FOSL2,194
chr1,27490153,27490788,SRX5054309,FOSL2,635
chr1,27490352,27490750,SRX5075176,SMARCA4,398
chr1,27490387,27490777,SRX5075174,SMARCA4,390
chr1,27490426,27490770,SRX5054308,FOSL2,344
chr1,27490441,27490781,SRX5075170,SMARCA4,340
chr1,27490516,27490777,SRX5075168,SMARCA4,261
chr1,27490534,27490713,SRX5054307,FOSL2,179
chr1,27496736,27497137,SRX5075176,SMARCA4,401
chr1,27496797,27497257,SRX5075168,SMARCA4,460
chr1,27496808,27497196,SRX5075174,SMARCA4,388
chr1,27496813,27497155,SRX5075170,SMARCA4,342
chr1,27496815,27497204,SRX5716470,SMARCA4,389
chr1,27496828,27497064,SRX5020211,SMARCA2,236
chr1,27496829,27497061,SRX5075169,SMARCA4,232
chr1,27496830,27497161,SRX16500060,CTCF,331
chr1,27496839,27497186,SRX16500059,CTCF,347
chr1,27496842,27497193,SRX5716464,SMARCA4,351
chr1,27496851,27497163,SRX16500061,CTCF,312
chr1,27496866,27497152,SRX16500062,CTCF,286
chr1,27496868,27497080,SRX5716469,SMARCA4,212
chr1,27504320,27504944,SRX5716470,SMARCA4,624
chr1,27504324,27505036,SRX5075170,SMARCA4,712
chr1,27504325,27504721,SRX5075176,SMARCA4,396
chr1,27504329,27504600,SRX5716468,SMARCA2,271
chr1,27504341,27504936,SRX5075174,SMARCA4,595
chr1,27504376,27504756,SRX5075175,SMARCA4,380
chr1,27504409,27504659,SRX5716469,SMARCA4,250
chr1,27504418,27504924,SRX5075169,SMARCA4,506
chr1,27504440,27504924,SRX20140895,INTS13,484
chr1,27504524,27504783,SRX5716467,SMARCA2,259
chr1,27504550,27504828,SRX20140868,INTS10,278
chr1,27504568,27504782,SRX20140867,INTS10,214
chr1,27504581,27504942,SRX20140881,CPSF3L,361
chr1,27504652,27504901,SRX5075168,SMARCA4,249
chr1,27504821,27505023,SRX5075176,SMARCA4,202
chr1,27519208,27519548,SRX5075168,SMARCA4,340
chr1,27519291,27519590,SRX5075174,SMARCA4,299
chr1,27520752,27520985,SRX5075176,SMARCA4,233
chr1,27523010,27523391,SRX16500060,CTCF,381
chr1,27523128,27523441,SRX16500059,CTCF,313
chr1,27523202,27523412,SRX16500062,CTCF,210
chr1,27527161,27527372,SRX5716468,SMARCA2,211
chr1,27527170,27527363,SRX5075170,SMARCA4,193
chr1,27528015,27528284,SRX5075174,SMARCA4,269
chr1,27529179,27529359,SRX5075170,SMARCA4,180
chr1,27536711,27537128,SRX5075174,SMARCA4,417
chr1,27536790,27537210,SRX5075176,SMARCA4,420
chr1,27536800,27537070,SRX5075168,SMARCA4,270
chr1,27536877,27537112,SRX5075175,SMARCA4,235
chr1,27536882,27537218,SRX5075170,SMARCA4,336
chr1,27536900,27537145,SRX5716470,SMARCA4,245
chr1,27536901,27537117,SRX5075169,SMARCA4,216
chr1,27538827,27539093,SRX5054309,FOSL2,266
chr1,27538830,27539062,SRX5075176,SMARCA4,232
chr1,27538833,27539068,SRX5075169,SMARCA4,235
chr1,27538833,27539103,SRX5075170,SMARCA4,270
chr1,27538850,27539099,SRX5054308,FOSL2,249
chr1,27542833,27543175,SRX20140895,INTS13,342
chr1,27556626,27557207,SRX16500061,CTCF,581
chr1,27556636,27557233,SRX16500060,CTCF,597
chr1,27556661,27557233,SRX16500059,CTCF,572
chr1,27556679,27557225,SRX16500062,CTCF,546
chr1,27556682,27556985,SRX4174629,CTCF,303
chr1,27557316,27557588,SRX5075170,SMARCA4,272
chr1,27557396,27557569,SRX5075174,SMARCA4,173
chr1,27561534,27561709,SRX5075176,SMARCA4,175
chr1,27564027,27564251,SRX5054309,FOSL2,224
chr1,27567041,27567412,SRX5716464,SMARCA4,371
chr1,27567056,27567470,SRX20140895,INTS13,414
chr1,27567128,27567470,SRX20140879,CPSF3L,342
chr1,27567138,27567508,SRX5075168,SMARCA4,370
chr1,27567159,27567518,SRX5075174,SMARCA4,359
chr1,27567167,27567487,SRX20140881,CPSF3L,320
chr1,27567243,27567470,SRX20140867,INTS10,227
chr1,27568406,27568976,SRX16500060,CTCF,570
chr1,27568485,27568971,SRX16500059,CTCF,486
chr1,27568513,27568947,SRX16500061,CTCF,434
chr1,27568518,27568787,SRX5075174,SMARCA4,269
chr1,27568521,27568955,SRX16500062,CTCF,434
chr1,27568618,27568812,SRX5075168,SMARCA4,194
chr1,27575261,27575654,SRX16500059,CTCF,393
chr1,27575298,27575621,SRX16500060,CTCF,323
chr1,27575353,27575594,SRX16500062,CTCF,241
chr1,27575355,27575669,SRX16500061,CTCF,314
chr1,27575359,27575845,SRX5075170,SMARCA4,486
chr1,27575369,27575754,SRX5716469,SMARCA4,385
chr1,27575379,27575828,SRX5075169,SMARCA4,449
chr1,27575397,27575815,SRX5075176,SMARCA4,418
chr1,27575408,27575793,SRX5075175,SMARCA4,385
chr1,27575482,27575675,SRX5054309,FOSL2,193
chr1,27575489,27575748,SRX5075174,SMARCA4,259
chr1,27575493,27575770,SRX5054308,FOSL2,277
chr1,27575632,27575862,SRX5716470,SMARCA4,230
chr1,27575808,27576080,SRX20140895,INTS13,272
chr1,27589901,27590128,SRX5075170,SMARCA4,227
chr1,27590032,27590294,SRX5075176,SMARCA4,262
chr1,27593069,27593464,SRX5075174,SMARCA4,395
chr1,27593177,27593415,SRX5075168,SMARCA4,238
chr1,27599152,27599520,SRX5075170,SMARCA4,368
chr1,27599160,27599541,SRX5075169,SMARCA4,381
chr1,27599189,27599509,SRX5075176,SMARCA4,320
chr1,27599191,27599500,SRX5054308,FOSL2,309
chr1,27599193,27599513,SRX5054309,FOSL2,320
chr1,27599218,27599499,SRX5075175,SMARCA4,281
chr1,27604062,27604367,SRX5075174,SMARCA4,305
chr1,27604092,27604347,SRX5075168,SMARCA4,255
chr1,27606304,27606755,SRX16500060,CTCF,451
chr1,27606313,27606688,SRX4174629,CTCF,375
chr1,27606317,27606749,SRX16500061,CTCF,432
chr1,27606319,27606774,SRX16500059,CTCF,455
chr1,27606353,27606732,SRX16500062,CTCF,379
chr1,27606417,27606624,SRX5075170,SMARCA4,207
chr1,27607232,27607680,SRX20140895,INTS13,448
chr1,27607262,27607586,SRX20140881,CPSF3L,324
chr1,27607290,27607685,SRX20140868,INTS10,395
chr1,27607317,27607668,SRX20140879,CPSF3L,351
chr1,27607331,27607580,SRX5075168,SMARCA4,249
chr1,27607362,27607618,SRX5075174,SMARCA4,256
chr1,27607369,27607597,SRX5716464,SMARCA4,228
chr1,27607374,27607598,SRX5075170,SMARCA4,224
chr1,27607383,27607605,SRX5075176,SMARCA4,222
chr1,27607384,27607664,SRX20140867,INTS10,280
chr1,27608536,27608857,SRX16500059,CTCF,321
chr1,27608564,27608849,SRX16500062,CTCF,285
chr1,27608566,27608843,SRX16500060,CTCF,277
chr1,27608603,27608875,SRX16500061,CTCF,272
chr1,27624871,27625050,SRX5075168,SMARCA4,179
chr1,27624885,27625135,SRX5075174,SMARCA4,250
chr1,27634106,27634516,SRX5075176,SMARCA4,410
chr1,27634148,27634392,SRX5075174,SMARCA4,244
chr1,27634149,27634349,SRX5075169,SMARCA4,200
chr1,27634152,27634371,SRX5075175,SMARCA4,219
chr1,27643840,27644282,SRX16500059,CTCF,442
chr1,27643847,27644257,SRX16500060,CTCF,410
chr1,27643868,27644258,SRX16500061,CTCF,390
chr1,27643902,27644352,SRX16500062,CTCF,450
chr1,27643984,27644182,SRX5075174,SMARCA4,198
chr1,27650889,27651191,SRX5075174,SMARCA4,302
chr1,27656133,27656390,SRX5075176,SMARCA4,257
chr1,27656140,27656427,SRX5075170,SMARCA4,287
chr1,27659908,27660164,SRX20140895,INTS13,256
chr1,27663056,27663601,SRX16500060,CTCF,545
chr1,27663074,27663471,SRX5075168,SMARCA4,397
chr1,27663074,27663601,SRX16500059,CTCF,527
chr1,27663109,27663607,SRX16500062,CTCF,498
chr1,27663112,27663600,SRX16500061,CTCF,488
chr1,27663115,27663528,SRX4174629,CTCF,413
chr1,27663125,27663474,SRX5075176,SMARCA4,349
chr1,27663129,27663472,SRX5075174,SMARCA4,343
chr1,27663145,27663414,SRX5075170,SMARCA4,269
chr1,27663160,27663398,SRX5716469,SMARCA4,238
chr1,27663164,27663469,SRX5075169,SMARCA4,305
chr1,27663173,27663434,SRX5075175,SMARCA4,261
chr1,27663208,27663413,SRX5716464,SMARCA4,205
chr1,27669064,27669550,SRX16500060,CTCF,486
chr1,27669090,27669557,SRX16500061,CTCF,467
chr1,27669092,27669561,SRX16500062,CTCF,469
chr1,27669181,27669629,SRX16500059,CTCF,448
chr1,27669224,27669416,SRX5075174,SMARCA4,192
chr1,27672099,27672534,SRX5075170,SMARCA4,435
chr1,27672110,27672589,SRX5075176,SMARCA4,479
chr1,27672115,27672626,SRX5075174,SMARCA4,511
chr1,27672122,27672588,SRX5075168,SMARCA4,466
chr1,27672145,27672590,SRX5716469,SMARCA4,445
chr1,27672152,27672586,SRX5716470,SMARCA4,434
chr1,27672161,27672501,SRX5716463,SMARCA4,340
chr1,27672168,27672578,SRX20140895,INTS13,410
chr1,27672188,27672565,SRX5075169,SMARCA4,377
chr1,27672217,27672530,SRX5075175,SMARCA4,313
chr1,27672218,27672593,SRX5716451,SOX2,375
chr1,27672240,27672465,SRX5716468,SMARCA2,225
chr1,27672253,27672573,SRX5020211,SMARCA2,320
chr1,27672272,27672511,SRX20140867,INTS10,239
chr1,27672272,27672580,SRX16500061,CTCF,308
chr1,27672272,27672592,SRX20140869,INTS10,320
chr1,27672322,27672567,SRX5075181,SMARCA2,245
chr1,27672335,27672589,SRX16500060,CTCF,254
chr1,27672730,27673062,SRX5054309,FOSL2,332
chr1,27672807,27672992,SRX5075170,SMARCA4,185
chr1,27672853,27673069,SRX5054308,FOSL2,216
chr1,27689487,27689980,SRX5075170,SMARCA4,493
chr1,27689489,27690046,SRX5075169,SMARCA4,557
chr1,27689522,27690023,SRX5716469,SMARCA4,501
chr1,27689558,27690003,SRX5716470,SMARCA4,445
chr1,27689588,27690009,SRX5075175,SMARCA4,421
chr1,27689618,27690001,SRX5020211,SMARCA2,383
chr1,27689692,27689979,SRX5716468,SMARCA2,287
chr1,27689732,27689992,SRX5716467,SMARCA2,260
chr1,27689749,27690009,SRX5054308,FOSL2,260
chr1,27689754,27690049,SRX5075176,SMARCA4,295
chr1,27725360,27725666,SRX20140868,INTS10,306
chr1,27725395,27725697,SRX5716470,SMARCA4,302
chr1,27725396,27726150,SRX5075168,SMARCA4,754
chr1,27725402,27725819,SRX5075170,SMARCA4,417
chr1,27725406,27725624,SRX5075175,SMARCA4,218
chr1,27725421,27725997,SRX16500060,CTCF,576
chr1,27725422,27725895,SRX20140897,INTS13,473
chr1,27725423,27726467,SRX20140895,INTS13,1044
chr1,27725427,27725687,SRX5716467,SMARCA2,260
chr1,27725448,27725780,SRX5075176,SMARCA4,332
chr1,27725455,27725794,SRX5716469,SMARCA4,339
chr1,27725472,27725869,SRX5716463,SMARCA4,397
chr1,27725480,27725971,SRX5075174,SMARCA4,491
chr1,27725490,27725793,SRX5075169,SMARCA4,303
chr1,27725496,27725697,SRX5020211,SMARCA2,201
chr1,27725518,27725748,SRX20140867,INTS10,230
chr1,27725524,27725897,SRX5716454,SOX3,373
chr1,27725539,27725857,SRX5716464,SMARCA4,318
chr1,27725550,27725879,SRX5716451,SOX2,329
chr1,27725554,27725912,SRX16500062,CTCF,358
chr1,27725569,27726221,SRX16500059,CTCF,652
chr1,27725669,27725709,SRX1424894,POU3F2,40
chr1,27725765,27725997,SRX5054307,FOSL2,232
chr1,27725896,27726167,SRX20140896,INTS13,271
chr1,27725925,27726223,SRX20140867,INTS10,298
chr1,27725983,27726260,SRX20140868,INTS10,277
chr1,27725994,27726174,SRX5075169,SMARCA4,180
chr1,27726339,27726630,SRX5075174,SMARCA4,291
chr1,27757989,27758191,SRX5054309,FOSL2,202
chr1,27772149,27772428,SRX5075169,SMARCA4,279
chr1,27772569,27773123,SRX5716469,SMARCA4,554
chr1,27772598,27772987,SRX5075175,SMARCA4,389
chr1,27772618,27773326,SRX5075170,SMARCA4,708
chr1,27772647,27773073,SRX5075169,SMARCA4,426
chr1,27772693,27773066,SRX5716470,SMARCA4,373
chr1,27772711,27773351,SRX5075176,SMARCA4,640
chr1,27772722,27773317,SRX5075168,SMARCA4,595
chr1,27772755,27773125,SRX5054308,FOSL2,370
chr1,27772758,27773383,SRX5075174,SMARCA4,625
chr1,27772774,27773105,SRX5716451,SOX2,331
chr1,27772775,27773187,SRX5054309,FOSL2,412
chr1,27772883,27773349,SRX5716464,SMARCA4,466
chr1,27772910,27773125,SRX5716454,SOX3,215
chr1,27772970,27773221,SRX5716463,SMARCA4,251
chr1,27773015,27773471,SRX20140895,INTS13,456
chr1,27773125,27773492,SRX20140867,INTS10,367
chr1,27773196,27773469,SRX20140881,CPSF3L,273
chr1,27773321,27773501,SRX5075169,SMARCA4,180
chr1,27817314,27817514,SRX5075169,SMARCA4,200
chr1,27830516,27831206,SRX20140895,INTS13,690
chr1,27830531,27830975,SRX5075168,SMARCA4,444
chr1,27830534,27830862,SRX5075176,SMARCA4,328
chr1,27830539,27830904,SRX5716464,SMARCA4,365
chr1,27830540,27831029,SRX5075170,SMARCA4,489
chr1,27830543,27830839,SRX5716470,SMARCA4,296
chr1,27830546,27830979,SRX5075174,SMARCA4,433
chr1,27830560,27831126,SRX20140869,INTS10,566
chr1,27830561,27830808,SRX5075169,SMARCA4,247
chr1,27830568,27831063,SRX20140868,INTS10,495
chr1,27830570,27830919,SRX5716463,SMARCA4,349
chr1,27830581,27830857,SRX5716468,SMARCA2,276
chr1,27830616,27831116,SRX20140897,INTS13,500
chr1,27830619,27831087,SRX20140879,CPSF3L,468
chr1,27830652,27831182,SRX20140867,INTS10,530
chr1,27830701,27831111,SRX20140881,CPSF3L,410
chr1,27830717,27831074,SRX20140896,INTS13,357
chr1,27830752,27831007,SRX20140894,INTS13,255
chr1,27832753,27833046,SRX5054309,FOSL2,293
chr1,27832769,27833019,SRX5054308,FOSL2,250
chr1,27857972,27858440,SRX16500060,CTCF,468
chr1,27857972,27858451,SRX16500059,CTCF,479
chr1,27857996,27858420,SRX16500062,CTCF,424
chr1,27858003,27858453,SRX16500061,CTCF,450
chr1,27858089,27858357,SRX5075170,SMARCA4,268
chr1,27858139,27858326,SRX5075168,SMARCA4,187
chr1,27858139,27858387,SRX5075176,SMARCA4,248
chr1,27858163,27858382,SRX4174629,CTCF,219
chr1,27863116,27863567,SRX5075176,SMARCA4,451
chr1,27863183,27863521,SRX5075170,SMARCA4,338
chr1,27863228,27863508,SRX5075169,SMARCA4,280
chr1,27863241,27863465,SRX5075175,SMARCA4,224
chr1,27863243,27863511,SRX5716470,SMARCA4,268
chr1,27872262,27872661,SRX5075174,SMARCA4,399
chr1,27872288,27872747,SRX5075168,SMARCA4,459
chr1,27872464,27872679,SRX5075170,SMARCA4,215
chr1,27872535,27872834,SRX20140895,INTS13,299
chr1,27875211,27875547,SRX5075176,SMARCA4,336
chr1,27875212,27875560,SRX5075169,SMARCA4,348
chr1,27875223,27875562,SRX5075170,SMARCA4,339
chr1,27875234,27875566,SRX5716469,SMARCA4,332
chr1,27875245,27875536,SRX5716467,SMARCA2,291
chr1,27875246,27875478,SRX5054308,FOSL2,232
chr1,27875251,27875607,SRX5716470,SMARCA4,356
chr1,27875255,27875577,SRX5075175,SMARCA4,322
chr1,27894553,27894755,SRX5075168,SMARCA4,202
chr1,27894653,27894837,SRX5075174,SMARCA4,184
chr1,27914282,27914933,SRX20140895,INTS13,651
chr1,27914289,27914713,SRX5075168,SMARCA4,424
chr1,27914299,27914743,SRX20140881,CPSF3L,444
chr1,27914305,27914817,SRX20140867,INTS10,512
chr1,27914316,27914732,SRX20140879,CPSF3L,416
chr1,27914326,27914640,SRX5075169,SMARCA4,314
chr1,27914334,27914953,SRX20140868,INTS10,619
chr1,27914341,27914702,SRX5716470,SMARCA4,361
chr1,27914343,27914847,SRX5075174,SMARCA4,504
chr1,27914392,27914773,SRX5075176,SMARCA4,381
chr1,27914393,27914746,SRX5075170,SMARCA4,353
chr1,27914425,27914800,SRX20140897,INTS13,375
chr1,27914500,27914780,SRX20140896,INTS13,280
chr1,27914556,27914936,SRX5716451,SOX2,380
chr1,27914658,27914862,SRX5716463,SMARCA4,204
chr1,27914671,27914905,SRX5716454,SOX3,234
chr1,27940317,27940614,SRX16500061,CTCF,297
chr1,27940356,27940653,SRX16500060,CTCF,297
chr1,27940372,27940649,SRX16500059,CTCF,277
chr1,27940389,27940632,SRX16500062,CTCF,243
chr1,27947581,27947816,SRX16500059,CTCF,235
chr1,27959867,27960111,SRX5075170,SMARCA4,244
chr1,27959891,27960070,SRX5075168,SMARCA4,179
chr1,27959894,27960244,SRX20140881,CPSF3L,350
chr1,27959957,27960137,SRX5075169,SMARCA4,180
chr1,27959971,27960428,SRX16500059,CTCF,457
chr1,27960044,27960335,SRX16500062,CTCF,291
chr1,27960059,27960363,SRX16500061,CTCF,304
chr1,27960107,27960442,SRX16500060,CTCF,335
chr1,27970463,27970769,SRX5054309,FOSL2,306
chr1,27970488,27970701,SRX5075170,SMARCA4,213
chr1,27970489,27970734,SRX5054308,FOSL2,245
chr1,27970497,27970731,SRX5075175,SMARCA4,234
chr1,27970506,27970747,SRX5075169,SMARCA4,241
chr1,27971677,27971930,SRX5716470,SMARCA4,253
chr1,27971752,27971960,SRX5075176,SMARCA4,208
chr1,27971770,27971963,SRX5075170,SMARCA4,193
chr1,27971800,27972003,SRX5075175,SMARCA4,203
chr1,27979598,27980121,SRX16500059,CTCF,523
chr1,27979607,27980023,SRX16500061,CTCF,416
chr1,27979629,27979914,SRX16500062,CTCF,285
chr1,27979653,27979917,SRX5075170,SMARCA4,264
chr1,27979664,27980028,SRX16500060,CTCF,364
chr1,27979685,27979916,SRX5075176,SMARCA4,231
chr1,27981193,27981508,SRX5075176,SMARCA4,315
chr1,27981209,27981440,SRX5075170,SMARCA4,231
chr1,28021181,28021421,SRX5075168,SMARCA4,240
chr1,28021202,28021397,SRX5075169,SMARCA4,195
chr1,28021204,28021400,SRX5075176,SMARCA4,196
chr1,28021223,28021403,SRX5054308,FOSL2,180
chr1,28021231,28021413,SRX5075170,SMARCA4,182
chr1,28021234,28021438,SRX5054309,FOSL2,204
chr1,28064055,28064516,SRX5075170,SMARCA4,461
chr1,28064134,28064465,SRX5075176,SMARCA4,331
chr1,28064137,28064458,SRX5054308,FOSL2,321
chr1,28064145,28064441,SRX5054309,FOSL2,296
chr1,28064156,28064403,SRX5075169,SMARCA4,247
chr1,28064196,28064375,SRX5054307,FOSL2,179
chr1,28064207,28064489,SRX5075175,SMARCA4,282
chr1,28064219,28064443,SRX5716469,SMARCA4,224
chr1,28066030,28066232,SRX5075169,SMARCA4,202
chr1,28079288,28079457,SRX5075170,SMARCA4,169
chr1,28088381,28088729,SRX20140895,INTS13,348
chr1,28088393,28088986,SRX5716470,SMARCA4,593
chr1,28088448,28088971,SRX5075174,SMARCA4,523
chr1,28088453,28088943,SRX5075176,SMARCA4,490
chr1,28088458,28088960,SRX5075168,SMARCA4,502
chr1,28088466,28088662,SRX5716451,SOX2,196
chr1,28088500,28089001,SRX5075170,SMARCA4,501
chr1,28088567,28088832,SRX5716464,SMARCA4,265
chr1,28088575,28088834,SRX5716463,SMARCA4,259
chr1,28088604,28088784,SRX5054308,FOSL2,180
chr1,28091046,28091662,SRX16500060,CTCF,616
chr1,28091091,28091584,SRX16500061,CTCF,493
chr1,28091131,28091630,SRX16500059,CTCF,499
chr1,28091187,28091588,SRX16500062,CTCF,401
chr1,28122237,28122516,SRX5075174,SMARCA4,279
chr1,28122315,28122528,SRX5716463,SMARCA4,213
chr1,28153244,28153458,SRX5075169,SMARCA4,214
chr1,28153269,28153451,SRX5075176,SMARCA4,182
chr1,28153275,28153444,SRX5075170,SMARCA4,169
chr1,28153290,28153477,SRX5075175,SMARCA4,187
chr1,28163777,28164047,SRX5075176,SMARCA4,270
chr1,28163842,28164053,SRX5075170,SMARCA4,211
chr1,28208824,28209231,SRX16500061,CTCF,407
chr1,28208848,28209258,SRX16500059,CTCF,410
chr1,28208849,28209237,SRX16500060,CTCF,388
chr1,28208875,28209242,SRX16500062,CTCF,367
chr1,28208943,28209123,SRX5075168,SMARCA4,180
chr1,28208949,28209200,SRX4174629,CTCF,251
chr1,28208973,28209142,SRX5075170,SMARCA4,169
chr1,28232747,28233293,SRX20140895,INTS13,546
chr1,28232760,28233254,SRX20140897,INTS13,494
chr1,28232822,28233254,SRX20140896,INTS13,432
chr1,28232844,28233265,SRX5075174,SMARCA4,421
chr1,28232847,28233145,SRX20140894,INTS13,298
chr1,28232855,28233105,SRX20140867,INTS10,250
chr1,28235801,28236088,SRX5075170,SMARCA4,287
chr1,28235865,28236280,SRX5075168,SMARCA4,415
chr1,28235899,28236154,SRX5054307,FOSL2,255
chr1,28235910,28236196,SRX20140868,INTS10,286
chr1,28235955,28236338,SRX5075174,SMARCA4,383
chr1,28236019,28236334,SRX5075176,SMARCA4,315
chr1,28236072,28236340,SRX20140867,INTS10,268
chr1,28247146,28247570,SRX5075170,SMARCA4,424
chr1,28247162,28247616,SRX5075176,SMARCA4,454
chr1,28247163,28247534,SRX5075174,SMARCA4,371
chr1,28247184,28247515,SRX5075168,SMARCA4,331
chr1,28247193,28247460,SRX5054307,FOSL2,267
chr1,28248350,28249012,SRX16500059,CTCF,662
chr1,28248357,28248995,SRX16500060,CTCF,638
chr1,28248386,28249012,SRX16500061,CTCF,626
chr1,28248412,28248775,SRX4174629,CTCF,363
chr1,28248427,28248905,SRX16500062,CTCF,478
chr1,28248515,28248798,SRX5075168,SMARCA4,283
chr1,28248527,28248817,SRX5075176,SMARCA4,290
chr1,28248542,28248814,SRX5075170,SMARCA4,272
chr1,28248547,28248790,SRX5075174,SMARCA4,243
chr1,28248613,28248816,SRX5075169,SMARCA4,203
chr1,28248620,28248853,SRX5075175,SMARCA4,233
chr1,28249009,28249284,SRX5054309,FOSL2,275
chr1,28249051,28249268,SRX5075168,SMARCA4,217
chr1,28249100,28249317,SRX5075174,SMARCA4,217
chr1,28259129,28259590,SRX5075174,SMARCA4,461
chr1,28259136,28259509,SRX5075170,SMARCA4,373
chr1,28259165,28259559,SRX5075168,SMARCA4,394
chr1,28259202,28259533,SRX5075176,SMARCA4,331
chr1,28259217,28259421,SRX5716463,SMARCA4,204
chr1,28259231,28259483,SRX5054307,FOSL2,252
chr1,28259279,28259554,SRX5716464,SMARCA4,275
chr1,28259282,28259519,SRX5716451,SOX2,237
chr1,28259284,28260065,SRX20140895,INTS13,781
chr1,28259300,28259911,SRX20140868,INTS10,611
chr1,28259308,28259513,SRX5716454,SOX3,205
chr1,28259338,28259667,SRX20140881,CPSF3L,329
chr1,28259340,28259772,SRX20140867,INTS10,432
chr1,28259369,28259895,SRX20140879,CPSF3L,526
chr1,28259386,28259849,SRX20140897,INTS13,463
chr1,28259447,28259653,SRX5075175,SMARCA4,206
chr1,28259503,28259789,SRX20140880,CPSF3L,286
chr1,28259521,28259899,SRX20140894,INTS13,378
chr1,28260193,28260479,SRX5075174,SMARCA4,286
chr1,28260216,28260453,SRX5075168,SMARCA4,237
chr1,28260283,28260533,SRX5075170,SMARCA4,250
chr1,28260359,28260629,SRX5075169,SMARCA4,270
chr1,28296741,28296958,SRX5716467,SMARCA2,217
chr1,28296744,28297010,SRX5716470,SMARCA4,266
chr1,28296815,28297118,SRX5075176,SMARCA4,303
chr1,28296824,28297119,SRX20140895,INTS13,295
chr1,28296884,28297111,SRX5075170,SMARCA4,227
chr1,28296892,28297142,SRX20140897,INTS13,250
chr1,28301930,28302141,SRX5716470,SMARCA4,211
chr1,28307624,28307669,SRX1424894,POU3F2,45
chr1,28307627,28307667,SRX1424892,POU3F2,40
chr1,28328551,28329242,SRX20140869,INTS10,691
chr1,28328666,28329361,SRX20140895,INTS13,695
chr1,28328690,28329177,SRX20140867,INTS10,487
chr1,28328716,28329117,SRX20140897,INTS13,401
chr1,28328737,28329133,SRX20140868,INTS10,396
chr1,28328744,28329203,SRX5075174,SMARCA4,459
chr1,28328756,28329202,SRX5075170,SMARCA4,446
chr1,28328767,28329212,SRX5075168,SMARCA4,445
chr1,28328784,28329116,SRX5716463,SMARCA4,332
chr1,28328812,28329167,SRX5716464,SMARCA4,355
chr1,28328834,28329113,SRX20140879,CPSF3L,279
chr1,28328847,28329137,SRX5075169,SMARCA4,290
chr1,28328850,28329186,SRX5075176,SMARCA4,336
chr1,28328865,28329259,SRX20140881,CPSF3L,394
chr1,28328924,28329148,SRX5716470,SMARCA4,224
chr1,28328972,28329265,SRX20140894,INTS13,293
chr1,28329350,28329622,SRX5716470,SMARCA4,272
chr1,28346206,28346524,SRX5075169,SMARCA4,318
chr1,28346226,28346523,SRX5054309,FOSL2,297
chr1,28346244,28346500,SRX5054308,FOSL2,256
chr1,28346246,28346543,SRX5075170,SMARCA4,297
chr1,28346252,28346535,SRX5075176,SMARCA4,283
chr1,28346307,28346487,SRX5075168,SMARCA4,180
chr1,28359578,28360116,SRX16500059,CTCF,538
chr1,28359588,28360097,SRX16500062,CTCF,509
chr1,28359594,28360117,SRX16500060,CTCF,523
chr1,28359641,28360119,SRX16500061,CTCF,478
chr1,28359699,28359986,SRX5075174,SMARCA4,287
chr1,28359722,28359973,SRX5075168,SMARCA4,251
chr1,28359737,28360064,SRX4174629,CTCF,327
chr1,28359747,28359987,SRX5075170,SMARCA4,240
chr1,28359821,28360001,SRX5075169,SMARCA4,180
chr1,28369381,28369984,SRX5075168,SMARCA4,603
chr1,28369437,28370225,SRX5075174,SMARCA4,788
chr1,28369466,28370331,SRX20140895,INTS13,865
chr1,28369471,28370134,SRX20140868,INTS10,663
chr1,28369472,28369722,SRX5075170,SMARCA4,250
chr1,28369508,28370123,SRX20140867,INTS10,615
chr1,28369513,28369778,SRX5075176,SMARCA4,265
chr1,28369529,28370058,SRX20140897,INTS13,529
chr1,28369544,28369944,SRX20140879,CPSF3L,400
chr1,28369574,28369818,SRX5075169,SMARCA4,244
chr1,28369602,28369904,SRX20140894,INTS13,302
chr1,28369606,28370128,SRX20140869,INTS10,522
chr1,28369691,28369994,SRX20140881,CPSF3L,303
chr1,28369947,28370240,SRX5075176,SMARCA4,293
chr1,28370092,28370432,SRX5075170,SMARCA4,340
chr1,28392000,28392307,SRX5716470,SMARCA4,307
chr1,28392032,28392327,SRX5075169,SMARCA4,295
chr1,28392046,28392258,SRX5716469,SMARCA4,212
chr1,28392082,28392364,SRX5075170,SMARCA4,282
chr1,28392093,28392374,SRX5075175,SMARCA4,281
chr1,28392100,28392302,SRX5075176,SMARCA4,202
chr1,28392129,28392336,SRX5054309,FOSL2,207
chr1,28399707,28400077,SRX5075168,SMARCA4,370
chr1,28399718,28400049,SRX5716463,SMARCA4,331
chr1,28399754,28400117,SRX5075174,SMARCA4,363
chr1,28409081,28409472,SRX5075174,SMARCA4,391
chr1,28409107,28409476,SRX5075168,SMARCA4,369
chr1,28409129,28409457,SRX5716463,SMARCA4,328
chr1,28409140,28409416,SRX5716464,SMARCA4,276
chr1,28409499,28410079,SRX16500060,CTCF,580
chr1,28409660,28410113,SRX16500059,CTCF,453
chr1,28409737,28410101,SRX16500062,CTCF,364
chr1,28409773,28409992,SRX5075168,SMARCA4,219
chr1,28409786,28410045,SRX5075170,SMARCA4,259
chr1,28409806,28410244,SRX16500061,CTCF,438
chr1,28417446,28417698,SRX5716469,SMARCA4,252
chr1,28417454,28417629,SRX5075176,SMARCA4,175
chr1,28431494,28431699,SRX5075169,SMARCA4,205
chr1,28437369,28437662,SRX5075175,SMARCA4,293
chr1,28437370,28437697,SRX5054309,FOSL2,327
chr1,28437382,28437667,SRX5075169,SMARCA4,285
chr1,28437419,28437616,SRX5075170,SMARCA4,197
chr1,28437423,28437621,SRX5054308,FOSL2,198
chr1,28437815,28438337,SRX5716469,SMARCA4,522
chr1,28437849,28438330,SRX5075170,SMARCA4,481
chr1,28437855,28438330,SRX5075168,SMARCA4,475
chr1,28437859,28438321,SRX5075176,SMARCA4,462
chr1,28437863,28438302,SRX5075169,SMARCA4,439
chr1,28437866,28438353,SRX5075174,SMARCA4,487
chr1,28437882,28438346,SRX5075175,SMARCA4,464
chr1,28437890,28438161,SRX5716467,SMARCA2,271
chr1,28437905,28438124,SRX5054309,FOSL2,219
chr1,28437929,28438341,SRX5716470,SMARCA4,412
chr1,28437937,28438117,SRX5054308,FOSL2,180
chr1,28437937,28438136,SRX5054307,FOSL2,199
chr1,28437955,28438286,SRX5716463,SMARCA4,331
chr1,28438026,28438253,SRX5716464,SMARCA4,227
chr1,28447798,28448002,SRX5075176,SMARCA4,204
chr1,28450002,28450354,SRX5075176,SMARCA4,352
chr1,28450030,28450325,SRX5716470,SMARCA4,295
chr1,28450035,28450345,SRX5075170,SMARCA4,310
chr1,28450050,28450244,SRX5054308,FOSL2,194
chr1,28450069,28450351,SRX5075169,SMARCA4,282
chr1,28450071,28450322,SRX5075175,SMARCA4,251
chr1,28456003,28456347,SRX5075176,SMARCA4,344
chr1,28456059,28456367,SRX5075175,SMARCA4,308
chr1,28456066,28456344,SRX5054309,FOSL2,278
chr1,28456072,28456358,SRX5075170,SMARCA4,286
chr1,28456095,28456299,SRX5054308,FOSL2,204
chr1,28456097,28456300,SRX5075169,SMARCA4,203
chr1,28456131,28456357,SRX5716469,SMARCA4,226
chr1,28505623,28506034,SRX5716463,SMARCA4,411
chr1,28505638,28505890,SRX5716470,SMARCA4,252
chr1,28505663,28506183,SRX5075168,SMARCA4,520
chr1,28505665,28506066,SRX5075174,SMARCA4,401
chr1,28505681,28506499,SRX20140895,INTS13,818
chr1,28505689,28506042,SRX5075176,SMARCA4,353
chr1,28505693,28506027,SRX5075170,SMARCA4,334
chr1,28505742,28506309,SRX20140897,INTS13,567
chr1,28505846,28506377,SRX20140879,CPSF3L,531
chr1,28505860,28506316,SRX20140869,INTS10,456
chr1,28505865,28506335,SRX20140894,INTS13,470
chr1,28505865,28506378,SRX20140868,INTS10,513
chr1,28505867,28506357,SRX20140867,INTS10,490
chr1,28505877,28506689,SRX20140881,CPSF3L,812
chr1,28505887,28506231,SRX20140896,INTS13,344
chr1,28505913,28506278,SRX20140880,CPSF3L,365
chr1,28517891,28518458,SRX16500060,CTCF,567
chr1,28517899,28518430,SRX16500062,CTCF,531
chr1,28517900,28518429,SRX16500059,CTCF,529
chr1,28517912,28518467,SRX16500061,CTCF,555
chr1,28517966,28518719,SRX5075174,SMARCA4,753
chr1,28517984,28518456,SRX5075168,SMARCA4,472
chr1,28517994,28518247,SRX4174629,CTCF,253
chr1,28518018,28518609,SRX5075170,SMARCA4,591
chr1,28518030,28518598,SRX5075176,SMARCA4,568
chr1,28518052,28518402,SRX5075169,SMARCA4,350
chr1,28518055,28518791,SRX20140895,INTS13,736
chr1,28518122,28518377,SRX20140897,INTS13,255
chr1,28518138,28518711,SRX20140868,INTS10,573
chr1,28518148,28518586,SRX20140867,INTS10,438
chr1,28540789,28541010,SRX16500060,CTCF,221
chr1,28552638,28553089,SRX5716470,SMARCA4,451
chr1,28552703,28553359,SRX20140895,INTS13,656
chr1,28552706,28553019,SRX5716463,SMARCA4,313
chr1,28552714,28553185,SRX5075174,SMARCA4,471
chr1,28552715,28553251,SRX5075168,SMARCA4,536
chr1,28552738,28553266,SRX5075176,SMARCA4,528
chr1,28552785,28553178,SRX5075170,SMARCA4,393
chr1,28552792,28553098,SRX5716464,SMARCA4,306
chr1,28552792,28553113,SRX20140869,INTS10,321
chr1,28552818,28553236,SRX20140867,INTS10,418
chr1,28552835,28553237,SRX5075175,SMARCA4,402
chr1,28552844,28553099,SRX5075169,SMARCA4,255
chr1,28552869,28553324,SRX20140879,CPSF3L,455
chr1,28552871,28553287,SRX20140868,INTS10,416
chr1,28553439,28553665,SRX5075175,SMARCA4,226
chr1,28553527,28553719,SRX5075176,SMARCA4,192
chr1,28581249,28581487,SRX16500061,CTCF,238
chr1,28581264,28581554,SRX16500059,CTCF,290
chr1,28581409,28582294,SRX20140895,INTS13,885
chr1,28581526,28582112,SRX20140897,INTS13,586
chr1,28581541,28582206,SRX20140868,INTS10,665
chr1,28581544,28582207,SRX20140867,INTS10,663
chr1,28581544,28582265,SRX20140881,CPSF3L,721
chr1,28581546,28581986,SRX20140894,INTS13,440
chr1,28581550,28582183,SRX20140869,INTS10,633
chr1,28581568,28582082,SRX20140896,INTS13,514
chr1,28581580,28582181,SRX20140879,CPSF3L,601
chr1,28581585,28581968,SRX20140882,CPSF3L,383
chr1,28581632,28582239,SRX5075174,SMARCA4,607
chr1,28581650,28581996,SRX20140880,CPSF3L,346
chr1,28581696,28581879,SRX5075169,SMARCA4,183
chr1,28581725,28581946,SRX16500060,CTCF,221
chr1,28581735,28582179,SRX5716463,SMARCA4,444
chr1,28581749,28582157,SRX5075170,SMARCA4,408
chr1,28581751,28582252,SRX5075168,SMARCA4,501
chr1,28581949,28582433,SRX5075176,SMARCA4,484
chr1,28582080,28582320,SRX5075169,SMARCA4,240
chr1,28590219,28590582,SRX5075176,SMARCA4,363
chr1,28590299,28590550,SRX5075170,SMARCA4,251
chr1,28592351,28592790,SRX20140895,INTS13,439
chr1,28594715,28594906,SRX5075170,SMARCA4,191
chr1,28601615,28602071,SRX5075176,SMARCA4,456
chr1,28601646,28602053,SRX5716469,SMARCA4,407
chr1,28601652,28601980,SRX5054308,FOSL2,328
chr1,28601655,28602059,SRX5075175,SMARCA4,404
chr1,28601660,28601989,SRX5054309,FOSL2,329
chr1,28601674,28602071,SRX5075170,SMARCA4,397
chr1,28601676,28602062,SRX5716470,SMARCA4,386
chr1,28601688,28602041,SRX5716467,SMARCA2,353
chr1,28601690,28602081,SRX5075169,SMARCA4,391
chr1,28601770,28601999,SRX5075182,SMARCA2,229
chr1,28602807,28603269,SRX16500060,CTCF,462
chr1,28602818,28603356,SRX16500061,CTCF,538
chr1,28602827,28603283,SRX16500059,CTCF,456
chr1,28602849,28603310,SRX16500062,CTCF,461
chr1,28602851,28603101,SRX5075170,SMARCA4,250
chr1,28602862,28603138,SRX5075168,SMARCA4,276
chr1,28602876,28603102,SRX5075176,SMARCA4,226
chr1,28602879,28603130,SRX5075174,SMARCA4,251
chr1,28602933,28603176,SRX4174629,CTCF,243
chr1,28642732,28643331,SRX20140869,INTS10,599
chr1,28642754,28643253,SRX20140881,CPSF3L,499
chr1,28642764,28643410,SRX20140895,INTS13,646
chr1,28642787,28643225,SRX20140879,CPSF3L,438
chr1,28642789,28643396,SRX20140897,INTS13,607
chr1,28642806,28643291,SRX20140868,INTS10,485
chr1,28642822,28643136,SRX20140882,CPSF3L,314
chr1,28642850,28643345,SRX20140867,INTS10,495
chr1,28642859,28643404,SRX5075176,SMARCA4,545
chr1,28642860,28643101,SRX20140880,CPSF3L,241
chr1,28642880,28643283,SRX20140896,INTS13,403
chr1,28642903,28643166,SRX20140894,INTS13,263
chr1,28642922,28643421,SRX5075174,SMARCA4,499
chr1,28642976,28643333,SRX5075169,SMARCA4,357
chr1,28642978,28643360,SRX5716470,SMARCA4,382
chr1,28642982,28643362,SRX5075170,SMARCA4,380
chr1,28642982,28643412,SRX16500060,CTCF,430
chr1,28642999,28643361,SRX5716463,SMARCA4,362
chr1,28643010,28643426,SRX16500061,CTCF,416
chr1,28643011,28643344,SRX16500059,CTCF,333
chr1,28643011,28643380,SRX5075168,SMARCA4,369
chr1,28643029,28643398,SRX16500062,CTCF,369
chr1,28643051,28643309,SRX5075175,SMARCA4,258
chr1,28648042,28648489,SRX5075174,SMARCA4,447
chr1,28648124,28648327,SRX5075168,SMARCA4,203
chr1,28648164,28649096,SRX5075170,SMARCA4,932
chr1,28648335,28649531,SRX20140895,INTS13,1196
chr1,28648338,28649265,SRX20140868,INTS10,927
chr1,28648352,28649360,SRX20140867,INTS10,1008
chr1,28648373,28649365,SRX20140881,CPSF3L,992
chr1,28648374,28649341,SRX20140897,INTS13,967
chr1,28648374,28649556,SRX20140869,INTS10,1182
chr1,28648382,28649260,SRX20140894,INTS13,878
chr1,28648393,28648638,SRX5716451,SOX2,245
chr1,28648400,28649408,SRX20140879,CPSF3L,1008
chr1,28648407,28649345,SRX20140896,INTS13,938
chr1,28648442,28649246,SRX20140880,CPSF3L,804
chr1,28648465,28648831,SRX20140870,INTS10,366
chr1,28648468,28649105,SRX5075176,SMARCA4,637
chr1,28648475,28649183,SRX20140882,CPSF3L,708
chr1,28648477,28649100,SRX20140860,SOX2,623
chr1,28648490,28648938,SRX20140861,SOX2,448
chr1,28648504,28649241,SRX5075168,SMARCA4,737
chr1,28648520,28649033,SRX5716469,SMARCA4,513
chr1,28648583,28649150,SRX5075169,SMARCA4,567
chr1,28648593,28649133,SRX5075175,SMARCA4,540
chr1,28648597,28649188,SRX5075174,SMARCA4,591
chr1,28648729,28648996,SRX5716451,SOX2,267
chr1,28648794,28649052,SRX5020211,SMARCA2,258
chr1,28648817,28649033,SRX5020214,SMARCA2,216
chr1,28649085,28649489,SRX16500062,CTCF,404
chr1,28649187,28649502,SRX16500061,CTCF,315
chr1,28668394,28668712,SRX20140869,INTS10,318
chr1,28668419,28668731,SRX20140895,INTS13,312
chr1,28668452,28668830,SRX5075170,SMARCA4,378
chr1,28668473,28668819,SRX5075176,SMARCA4,346
chr1,28668493,28668814,SRX5075168,SMARCA4,321
chr1,28668532,28668849,SRX5075174,SMARCA4,317
chr1,28669098,28669519,SRX20140895,INTS13,421
chr1,28669111,28669290,SRX5075176,SMARCA4,179
chr1,28718976,28719156,SRX5075169,SMARCA4,180
chr1,28721961,28722219,SRX5054309,FOSL2,258
chr1,28721991,28722182,SRX5075169,SMARCA4,191
chr1,28722001,28722206,SRX5054308,FOSL2,205
chr1,28722004,28722231,SRX5075175,SMARCA4,227
chr1,28722036,28722227,SRX5075176,SMARCA4,191
chr1,28736202,28736948,SRX5075176,SMARCA4,746
chr1,28736317,28736957,SRX5075174,SMARCA4,640
chr1,28736364,28736942,SRX5075175,SMARCA4,578
chr1,28736392,28736886,SRX5075169,SMARCA4,494
chr1,28736394,28737028,SRX16500060,CTCF,634
chr1,28736402,28736972,SRX5075170,SMARCA4,570
chr1,28736404,28736981,SRX16500061,CTCF,577
chr1,28736416,28736981,SRX5075168,SMARCA4,565
chr1,28736429,28737003,SRX16500059,CTCF,574
chr1,28736439,28737494,SRX20140895,INTS13,1055
chr1,28736448,28737155,SRX20140869,INTS10,707
chr1,28736467,28737439,SRX20140868,INTS10,972
chr1,28736492,28737044,SRX20140879,CPSF3L,552
chr1,28736526,28736970,SRX16500062,CTCF,444
chr1,28736554,28736909,SRX5716463,SMARCA4,355
chr1,28736650,28737271,SRX20140867,INTS10,621
chr1,28736666,28736876,SRX4174629,CTCF,210
chr1,28736672,28736984,SRX5716464,SMARCA4,312
chr1,28736721,28736930,SRX5054308,FOSL2,209
chr1,28736725,28737155,SRX20140897,INTS13,430
chr1,28736775,28737161,SRX20140896,INTS13,386
chr1,28736862,28737140,SRX20140881,CPSF3L,278
chr1,28751369,28751708,SRX5054308,FOSL2,339
chr1,28751391,28751691,SRX5054309,FOSL2,300
chr1,28751460,28751664,SRX5075175,SMARCA4,204
chr1,28751465,28751646,SRX5075170,SMARCA4,181
chr1,28751480,28751676,SRX5075169,SMARCA4,196
chr1,28768199,28768498,SRX5075170,SMARCA4,299
chr1,28768230,28768488,SRX5075176,SMARCA4,258
chr1,28768236,28768463,SRX5020211,SMARCA2,227
chr1,28768271,28768460,SRX5075169,SMARCA4,189
chr1,28785001,28785537,SRX16500061,CTCF,536
chr1,28785017,28785588,SRX16500060,CTCF,571
chr1,28785032,28785589,SRX16500059,CTCF,557
chr1,28785045,28785506,SRX16500062,CTCF,461
chr1,28785093,28785493,SRX5075174,SMARCA4,400
chr1,28785106,28785451,SRX5075168,SMARCA4,345
chr1,28785114,28785426,SRX5075170,SMARCA4,312
chr1,28785154,28785449,SRX5075176,SMARCA4,295
chr1,28785175,28785428,SRX5716463,SMARCA4,253
chr1,28785194,28785485,SRX4174629,CTCF,291
chr1,28785199,28785449,SRX5075169,SMARCA4,250
chr1,28785224,28785429,SRX5716464,SMARCA4,205
chr1,28785247,28785489,SRX5075175,SMARCA4,242
chr1,28804106,28804474,SRX5075168,SMARCA4,368
chr1,28804207,28804435,SRX5716463,SMARCA4,228
chr1,28804209,28804485,SRX5075174,SMARCA4,276
chr1,28826098,28826267,SRX5075170,SMARCA4,169
chr1,28826100,28826334,SRX5716470,SMARCA4,234
chr1,28826140,28826320,SRX5054308,FOSL2,180
chr1,28826148,28826355,SRX5054309,FOSL2,207
chr1,28860427,28860610,SRX5054309,FOSL2,183
chr1,28860689,28860992,SRX20140868,INTS10,303
chr1,28860724,28861063,SRX20140867,INTS10,339
chr1,28860847,28861027,SRX5075170,SMARCA4,180
chr1,28860848,28861079,SRX5075174,SMARCA4,231
chr1,28860855,28861107,SRX5075168,SMARCA4,252
chr1,28877068,28877497,SRX4174629,CTCF,429
chr1,28877128,28877587,SRX16500059,CTCF,459
chr1,28877133,28877584,SRX16500060,CTCF,451
chr1,28877137,28877568,SRX16500062,CTCF,431
chr1,28877155,28877564,SRX16500061,CTCF,409
chr1,28877209,28877472,SRX5075176,SMARCA4,263
chr1,28877238,28877492,SRX5075170,SMARCA4,254
chr1,28877239,28877454,SRX5075174,SMARCA4,215
chr1,28877244,28877553,SRX5075168,SMARCA4,309
chr1,28882013,28882450,SRX16500061,CTCF,437
chr1,28882013,28882525,SRX16500059,CTCF,512
chr1,28882044,28882425,SRX16500062,CTCF,381
chr1,28882052,28882498,SRX16500060,CTCF,446
chr1,28882062,28882489,SRX4174629,CTCF,427
chr1,28882133,28882424,SRX5075174,SMARCA4,291
chr1,28882140,28882433,SRX5075176,SMARCA4,293
chr1,28882161,28882398,SRX5075175,SMARCA4,237
chr1,28882186,28882383,SRX5075168,SMARCA4,197
chr1,28884953,28885275,SRX5075169,SMARCA4,322
chr1,28884969,28885272,SRX5716469,SMARCA4,303
chr1,28884992,28885239,SRX5075175,SMARCA4,247
chr1,28884992,28885258,SRX5054309,FOSL2,266
chr1,28885012,28885260,SRX5075170,SMARCA4,248
chr1,28886785,28887130,SRX20140895,INTS13,345
chr1,28893606,28893994,SRX16500060,CTCF,388
chr1,28893671,28893880,SRX5075176,SMARCA4,209
chr1,28893714,28893932,SRX5054309,FOSL2,218
chr1,28893757,28893996,SRX5075170,SMARCA4,239
chr1,28893768,28894098,SRX16500061,CTCF,330
chr1,28914127,28915158,SRX20140895,INTS13,1031
chr1,28914172,28914550,SRX5075174,SMARCA4,378
chr1,28914188,28914637,SRX5075168,SMARCA4,449
chr1,28914231,28914742,SRX5075176,SMARCA4,511
chr1,28914257,28914501,SRX20140897,INTS13,244
chr1,28914261,28914524,SRX5716463,SMARCA4,263
chr1,28914265,28914583,SRX5716464,SMARCA4,318
chr1,28914268,28914636,SRX5075175,SMARCA4,368
chr1,28914352,28914562,SRX5716451,SOX2,210
chr1,28914354,28915202,SRX20140868,INTS10,848
chr1,28914376,28914882,SRX20140879,CPSF3L,506
chr1,28914384,28914966,SRX20140867,INTS10,582
chr1,28914396,28914737,SRX20140881,CPSF3L,341
chr1,28914404,28914887,SRX5075170,SMARCA4,483
chr1,28914482,28914802,SRX5075169,SMARCA4,320
chr1,28914520,28914830,SRX5716470,SMARCA4,310
chr1,28914625,28914877,SRX5075174,SMARCA4,252
chr1,28914699,28914968,SRX5075168,SMARCA4,269
chr1,28914853,28915040,SRX5075175,SMARCA4,187
chr1,28927492,28927921,SRX5716470,SMARCA4,429
chr1,28927608,28928096,SRX5075170,SMARCA4,488
chr1,28927636,28928066,SRX5075176,SMARCA4,430
chr1,28927755,28928056,SRX5075175,SMARCA4,301
chr1,28927819,28928038,SRX5075169,SMARCA4,219
chr1,28954269,28954542,SRX5075170,SMARCA4,273
chr1,28954331,28954511,SRX5075169,SMARCA4,180
chr1,28956021,28956227,SRX5075175,SMARCA4,206
chr1,28956040,28956220,SRX5075169,SMARCA4,180
chr1,28956103,28956526,SRX5075176,SMARCA4,423
chr1,28956118,28956505,SRX5075170,SMARCA4,387
chr1,28956179,28956452,SRX5716469,SMARCA4,273
chr1,28972236,28972743,SRX5075169,SMARCA4,507
chr1,28972285,28972751,SRX5054308,FOSL2,466
chr1,28972291,28972745,SRX5075176,SMARCA4,454
chr1,28972307,28972797,SRX5054309,FOSL2,490
chr1,28972320,28972842,SRX5075175,SMARCA4,522
chr1,28972321,28972806,SRX5075170,SMARCA4,485
chr1,28972381,28972686,SRX5716469,SMARCA4,305
chr1,28972408,28972675,SRX5020211,SMARCA2,267
chr1,28983597,28983955,SRX5075168,SMARCA4,358
chr1,28983678,28983999,SRX20140867,INTS10,321
chr1,28983725,28983977,SRX5075174,SMARCA4,252
chr1,28983844,28984013,SRX5075170,SMARCA4,169
chr1,28983965,28984140,SRX5075176,SMARCA4,175
chr1,29033786,29034254,SRX16500060,CTCF,468
chr1,29033799,29034209,SRX16500062,CTCF,410
chr1,29033805,29034271,SRX16500059,CTCF,466
chr1,29033823,29034279,SRX16500061,CTCF,456
chr1,29033886,29034160,SRX5075174,SMARCA4,274
chr1,29033927,29034114,SRX5075169,SMARCA4,187
chr1,29042339,29042514,SRX5075176,SMARCA4,175
chr1,29043585,29043882,SRX5075174,SMARCA4,297
chr1,29043666,29043872,SRX5075168,SMARCA4,206
chr1,29055168,29055513,SRX5075170,SMARCA4,345
chr1,29055208,29055479,SRX5054309,FOSL2,271
chr1,29055219,29055531,SRX5075176,SMARCA4,312
chr1,29055226,29055460,SRX5716470,SMARCA4,234
chr1,29055228,29055494,SRX5020211,SMARCA2,266
chr1,29055234,29055515,SRX5075169,SMARCA4,281
chr1,29055242,29055495,SRX5716469,SMARCA4,253
chr1,29055249,29055525,SRX5054308,FOSL2,276
chr1,29055260,29055496,SRX5075175,SMARCA4,236
chr1,29096627,29096832,SRX5075176,SMARCA4,205
chr1,29121151,29121614,SRX16500059,CTCF,463
chr1,29121181,29121596,SRX16500060,CTCF,415
chr1,29121192,29121588,SRX16500061,CTCF,396
chr1,29121202,29121624,SRX16500062,CTCF,422
chr1,29121214,29121486,SRX4174629,CTCF,272
chr1,29122588,29122839,SRX5054309,FOSL2,251
chr1,29122597,29122779,SRX5054308,FOSL2,182
chr1,29124420,29124918,SRX5716470,SMARCA4,498
chr1,29124421,29125052,SRX20140895,INTS13,631
chr1,29124429,29125050,SRX5075168,SMARCA4,621
chr1,29124438,29124830,SRX16500060,CTCF,392
chr1,29124451,29125044,SRX5075170,SMARCA4,593
chr1,29124458,29124752,SRX16500062,CTCF,294
chr1,29124471,29124991,SRX5075176,SMARCA4,520
chr1,29124474,29124826,SRX16500061,CTCF,352
chr1,29124480,29124908,SRX5716467,SMARCA2,428
chr1,29124489,29124935,SRX5716469,SMARCA4,446
chr1,29124498,29124757,SRX16500059,CTCF,259
chr1,29124504,29124966,SRX5075175,SMARCA4,462
chr1,29124508,29124903,SRX5716468,SMARCA2,395
chr1,29124523,29125047,SRX5075174,SMARCA4,524
chr1,29124538,29124923,SRX5075169,SMARCA4,385
chr1,29124596,29124850,SRX5075182,SMARCA2,254
chr1,29124653,29124880,SRX5020211,SMARCA2,227
chr1,29124664,29124847,SRX5054309,FOSL2,183
chr1,29135804,29136090,SRX5075170,SMARCA4,286
chr1,29135869,29136130,SRX5716467,SMARCA2,261
chr1,29135870,29136133,SRX5075169,SMARCA4,263
chr1,29135872,29136173,SRX5716470,SMARCA4,301
chr1,29135880,29136113,SRX5075176,SMARCA4,233
chr1,29146975,29147434,SRX5075176,SMARCA4,459
chr1,29146978,29147375,SRX5716469,SMARCA4,397
chr1,29146995,29147403,SRX5075169,SMARCA4,408
chr1,29147001,29147438,SRX5075170,SMARCA4,437
chr1,29147014,29147353,SRX5075175,SMARCA4,339
chr1,29147021,29147359,SRX5716467,SMARCA2,338
chr1,29147022,29147343,SRX5716470,SMARCA4,321
chr1,29147031,29147332,SRX5054309,FOSL2,301
chr1,29147042,29147309,SRX5054308,FOSL2,267
chr1,29156394,29156808,SRX5716470,SMARCA4,414
chr1,29156404,29156787,SRX5075170,SMARCA4,383
chr1,29156410,29156844,SRX5075176,SMARCA4,434
chr1,29156412,29156788,SRX5716469,SMARCA4,376
chr1,29156420,29156778,SRX5716467,SMARCA2,358
chr1,29156422,29156815,SRX5075169,SMARCA4,393
chr1,29156423,29156756,SRX5075175,SMARCA4,333
chr1,29156428,29156829,SRX5716468,SMARCA2,401
chr1,29156440,29156740,SRX5020211,SMARCA2,300
chr1,29156471,29156733,SRX5075181,SMARCA2,262
chr1,29156494,29156729,SRX5075168,SMARCA4,235
chr1,29156498,29157071,SRX5075174,SMARCA4,573
chr1,29156921,29157114,SRX5075168,SMARCA4,193
chr1,29164287,29165067,SRX5075174,SMARCA4,780
chr1,29164450,29164968,SRX5075168,SMARCA4,518
chr1,29164577,29164927,SRX5716463,SMARCA4,350
chr1,29164602,29164899,SRX5716451,SOX2,297
chr1,29164644,29164850,SRX5716454,SOX3,206
chr1,29171108,29171368,SRX5075175,SMARCA4,260
chr1,29171161,29171420,SRX5075176,SMARCA4,259
chr1,29171217,29171440,SRX5075170,SMARCA4,223
chr1,29176765,29176959,SRX5054308,FOSL2,194
chr1,29181235,29182162,SRX20140895,INTS13,927
chr1,29181302,29181974,SRX20140897,INTS13,672
chr1,29181312,29181729,SRX20140896,INTS13,417
chr1,29181328,29182028,SRX20140868,INTS10,700
chr1,29181331,29182127,SRX20140867,INTS10,796
chr1,29181344,29181999,SRX20140881,CPSF3L,655
chr1,29181428,29182040,SRX20140869,INTS10,612
chr1,29181431,29181884,SRX20140879,CPSF3L,453
chr1,29181545,29181878,SRX20140870,INTS10,333
chr1,29181693,29182247,SRX16500061,CTCF,554
chr1,29181790,29182259,SRX16500059,CTCF,469
chr1,29181794,29182248,SRX16500060,CTCF,454
chr1,29181840,29182330,SRX5075170,SMARCA4,490
chr1,29181845,29182333,SRX5075174,SMARCA4,488
chr1,29181849,29182217,SRX16500062,CTCF,368
chr1,29181855,29182305,SRX5075176,SMARCA4,450
chr1,29181857,29182293,SRX5075168,SMARCA4,436
chr1,29181914,29182186,SRX5716469,SMARCA4,272
chr1,29181916,29182151,SRX5054309,FOSL2,235
chr1,29181942,29182278,SRX5716470,SMARCA4,336
chr1,29181963,29182171,SRX5020214,SMARCA2,208
chr1,29181969,29182252,SRX5716463,SMARCA4,283
chr1,29181972,29182205,SRX5075169,SMARCA4,233
chr1,29181975,29182216,SRX5716464,SMARCA4,241
chr1,29181981,29182274,SRX5075175,SMARCA4,293
chr1,29196909,29197202,SRX5075175,SMARCA4,293
chr1,29196941,29197244,SRX5075169,SMARCA4,303
chr1,29196944,29197167,SRX5054308,FOSL2,223
chr1,29196945,29197220,SRX5054309,FOSL2,275
chr1,29196958,29197193,SRX5716469,SMARCA4,235
chr1,29197006,29197175,SRX5075170,SMARCA4,169
chr1,29197588,29197829,SRX16500060,CTCF,241
chr1,29202716,29203187,SRX5075176,SMARCA4,471
chr1,29202736,29203160,SRX5075170,SMARCA4,424
chr1,29202741,29203164,SRX5075175,SMARCA4,423
chr1,29202743,29203206,SRX5075174,SMARCA4,463
chr1,29202748,29203194,SRX5075168,SMARCA4,446
chr1,29202773,29203137,SRX5716470,SMARCA4,364
chr1,29202779,29203143,SRX5075169,SMARCA4,364
chr1,29202793,29203154,SRX5054309,FOSL2,361
chr1,29202795,29203142,SRX5716469,SMARCA4,347
chr1,29202799,29203271,SRX16500062,CTCF,472
chr1,29202800,29203062,SRX5716467,SMARCA2,262
chr1,29202809,29203086,SRX5020211,SMARCA2,277
chr1,29202809,29203148,SRX5054308,FOSL2,339
chr1,29202811,29203282,SRX16500060,CTCF,471
chr1,29202812,29203148,SRX5716463,SMARCA4,336
chr1,29202826,29203079,SRX5716468,SMARCA2,253
chr1,29202826,29203296,SRX16500059,CTCF,470
chr1,29202830,29203351,SRX16500061,CTCF,521
chr1,29202833,29203121,SRX5054307,FOSL2,288
chr1,29202841,29203108,SRX5716460,Epitope tags,267
chr1,29202855,29203227,SRX4174629,CTCF,372
chr1,29202881,29203105,SRX5716464,SMARCA4,224
chr1,29230590,29230903,SRX20140881,CPSF3L,313
chr1,29230628,29231236,SRX5075170,SMARCA4,608
chr1,29230659,29231302,SRX20140895,INTS13,643
chr1,29230672,29231159,SRX5075175,SMARCA4,487
chr1,29230694,29231223,SRX5075174,SMARCA4,529
chr1,29230715,29231162,SRX20140868,INTS10,447
chr1,29230723,29231159,SRX5716463,SMARCA4,436
chr1,29230729,29231236,SRX5075169,SMARCA4,507
chr1,29230736,29231097,SRX20140867,INTS10,361
chr1,29230742,29231213,SRX5075168,SMARCA4,471
chr1,29230743,29231093,SRX20140879,CPSF3L,350
chr1,29230752,29231169,SRX20140897,INTS13,417
chr1,29230767,29231247,SRX5716469,SMARCA4,480
chr1,29230769,29231195,SRX5075176,SMARCA4,426
chr1,29230805,29231153,SRX5716464,SMARCA4,348
chr1,29230808,29231132,SRX20140869,INTS10,324
chr1,29230868,29231180,SRX5716470,SMARCA4,312
chr1,29230896,29231122,SRX5054309,FOSL2,226
chr1,29236148,29236582,SRX16500061,CTCF,434
chr1,29236172,29236631,SRX16500060,CTCF,459
chr1,29236196,29236646,SRX16500059,CTCF,450
chr1,29236204,29236590,SRX16500062,CTCF,386
chr1,29236233,29236657,SRX5075168,SMARCA4,424
chr1,29236259,29236684,SRX5075174,SMARCA4,425
chr1,29236304,29236703,SRX5716470,SMARCA4,399
chr1,29236310,29236680,SRX5075175,SMARCA4,370
chr1,29236314,29236675,SRX5075176,SMARCA4,361
chr1,29236320,29236662,SRX5075169,SMARCA4,342
chr1,29236335,29236717,SRX5075170,SMARCA4,382
chr1,29236389,29236677,SRX5716469,SMARCA4,288
chr1,29243806,29244159,SRX5054309,FOSL2,353
chr1,29243872,29244118,SRX5075169,SMARCA4,246
chr1,29243888,29244094,SRX5075175,SMARCA4,206
chr1,29243944,29244124,SRX5054308,FOSL2,180
chr1,29243958,29244127,SRX5075170,SMARCA4,169
chr1,29245841,29246064,SRX16500060,CTCF,223
chr1,29245861,29246099,SRX16500059,CTCF,238
chr1,29245862,29246080,SRX4174629,CTCF,218
chr1,29245865,29246102,SRX16500061,CTCF,237
chr1,29249115,29249646,SRX5075168,SMARCA4,531
chr1,29249123,29249535,SRX5075174,SMARCA4,412
chr1,29249178,29249561,SRX5075176,SMARCA4,383
chr1,29249194,29249499,SRX5075170,SMARCA4,305
chr1,29249218,29249503,SRX5075169,SMARCA4,285
chr1,29249219,29249500,SRX5716470,SMARCA4,281
chr1,29249233,29249458,SRX5054309,FOSL2,225
chr1,29249241,29249483,SRX5716464,SMARCA4,242
chr1,29249249,29249528,SRX5075175,SMARCA4,279
chr1,29249266,29249549,SRX5716463,SMARCA4,283
chr1,29249382,29249605,SRX5020214,SMARCA2,223
chr1,29259878,29260162,SRX5075174,SMARCA4,284
chr1,29259900,29260114,SRX5075170,SMARCA4,214
chr1,29259925,29260143,SRX5075168,SMARCA4,218
chr1,29264975,29265290,SRX5054309,FOSL2,315
chr1,29265041,29265270,SRX5054308,FOSL2,229
chr1,29265053,29265233,SRX5075169,SMARCA4,180
chr1,29271686,29271989,SRX5075174,SMARCA4,303
chr1,29271701,29271994,SRX5075169,SMARCA4,293
chr1,29271705,29272043,SRX5075175,SMARCA4,338
chr1,29271710,29272017,SRX5716469,SMARCA4,307
chr1,29271720,29272038,SRX5075168,SMARCA4,318
chr1,29271723,29272062,SRX5716470,SMARCA4,339
chr1,29271725,29272004,SRX5716463,SMARCA4,279
chr1,29271734,29272049,SRX5075176,SMARCA4,315
chr1,29271742,29272044,SRX5075170,SMARCA4,302
chr1,29271773,29272043,SRX5716467,SMARCA2,270
chr1,29332177,29332556,SRX16500061,CTCF,379
chr1,29332202,29332552,SRX16500062,CTCF,350
chr1,29332221,29332568,SRX16500059,CTCF,347
chr1,29332263,29332580,SRX16500060,CTCF,317
chr1,29340962,29341226,SRX16500062,CTCF,264
chr1,29340978,29341234,SRX16500060,CTCF,256
chr1,29340979,29341287,SRX16500059,CTCF,308
chr1,29341004,29341268,SRX16500061,CTCF,264
chr1,29379431,29379904,SRX16500059,CTCF,473
chr1,29379454,29379896,SRX16500060,CTCF,442
chr1,29379456,29379860,SRX16500061,CTCF,404
chr1,29379471,29379867,SRX16500062,CTCF,396
chr1,29383849,29384335,SRX5075170,SMARCA4,486
chr1,29383989,29384305,SRX5075175,SMARCA4,316
chr1,29384062,29384370,SRX5075176,SMARCA4,308
chr1,29384117,29384300,SRX5054309,FOSL2,183
chr1,29396739,29397000,SRX16500060,CTCF,261
chr1,29417177,29417455,SRX5075170,SMARCA4,278
chr1,29417267,29417442,SRX5075176,SMARCA4,175
chr1,29453414,29453768,SRX16500062,CTCF,354
chr1,29453419,29453861,SRX16500061,CTCF,442
chr1,29453427,29453806,SRX16500059,CTCF,379
chr1,29453484,29453793,SRX16500060,CTCF,309
chr1,29453583,29453798,SRX5075168,SMARCA4,215
chr1,29501549,29502003,SRX5075174,SMARCA4,454
chr1,29501552,29502019,SRX5075168,SMARCA4,467
chr1,29501564,29501875,SRX20140895,INTS13,311
chr1,29501576,29501952,SRX5716463,SMARCA4,376
chr1,29501586,29501894,SRX5716451,SOX2,308
chr1,29513296,29513615,SRX16500060,CTCF,319
chr1,29513353,29513584,SRX16500062,CTCF,231
chr1,29513360,29513573,SRX5075168,SMARCA4,213
chr1,29569998,29570556,SRX5075176,SMARCA4,558
chr1,29570000,29570427,SRX5075169,SMARCA4,427
chr1,29570031,29570522,SRX5075170,SMARCA4,491
chr1,29570045,29570380,SRX5075175,SMARCA4,335
chr1,29570051,29570380,SRX5716469,SMARCA4,329
chr1,29570051,29570388,SRX5054309,FOSL2,337
chr1,29570062,29570444,SRX5054308,FOSL2,382
chr1,29575834,29576237,SRX5075170,SMARCA4,403
chr1,29575949,29576175,SRX5075176,SMARCA4,226
chr1,29575979,29576189,SRX5054309,FOSL2,210
chr1,29576015,29576226,SRX5716470,SMARCA4,211
chr1,29633127,29633301,SRX5075170,SMARCA4,174
chr1,29633128,29633304,SRX5075176,SMARCA4,176
chr1,29633737,29634089,SRX5075170,SMARCA4,352
chr1,29640105,29640332,SRX5075176,SMARCA4,227
chr1,29640128,29640308,SRX5075169,SMARCA4,180
chr1,29656375,29656868,SRX16500060,CTCF,493
chr1,29656453,29656884,SRX16500062,CTCF,431
chr1,29656467,29656850,SRX16500059,CTCF,383
chr1,29656506,29656816,SRX16500061,CTCF,310
chr1,29675418,29675919,SRX20140867,INTS10,501
chr1,29675563,29675830,SRX5075170,SMARCA4,267
chr1,29675621,29675909,SRX5075168,SMARCA4,288
chr1,29688373,29688854,SRX5075175,SMARCA4,481
chr1,29688397,29688950,SRX5075170,SMARCA4,553
chr1,29688435,29688941,SRX5075174,SMARCA4,506
chr1,29688457,29688826,SRX5075176,SMARCA4,369
chr1,29688460,29688806,SRX5054308,FOSL2,346
chr1,29688480,29688996,SRX5075168,SMARCA4,516
chr1,29688487,29688826,SRX5054309,FOSL2,339
chr1,29688510,29688842,SRX5075169,SMARCA4,332
chr1,29697966,29698354,SRX16500060,CTCF,388
chr1,29697980,29698373,SRX16500062,CTCF,393
chr1,29697984,29698396,SRX16500059,CTCF,412
chr1,29697992,29698375,SRX16500061,CTCF,383
chr1,29703458,29703936,SRX16500060,CTCF,478
chr1,29703466,29703930,SRX16500062,CTCF,464
chr1,29703498,29704034,SRX16500061,CTCF,536
chr1,29703532,29703968,SRX16500059,CTCF,436
chr1,29703578,29703775,SRX5075168,SMARCA4,197
chr1,29706968,29707216,SRX16500059,CTCF,248
chr1,29707014,29707305,SRX16500060,CTCF,291
chr1,29707044,29707301,SRX16500062,CTCF,257
chr1,29708914,29710097,SRX5075176,SMARCA4,1183
chr1,29708929,29709296,SRX5075169,SMARCA4,367
chr1,29708971,29709284,SRX5716467,SMARCA2,313
chr1,29708974,29709448,SRX5075170,SMARCA4,474
chr1,29708993,29709239,SRX5075175,SMARCA4,246
chr1,29709119,29709341,SRX5054309,FOSL2,222
chr1,29709265,29709873,SRX5716470,SMARCA4,608
chr1,29709367,29709959,SRX5075169,SMARCA4,592
chr1,29709458,29709897,SRX5054308,FOSL2,439
chr1,29709471,29709874,SRX5075175,SMARCA4,403
chr1,29709499,29709936,SRX5716469,SMARCA4,437
chr1,29709520,29709958,SRX5075170,SMARCA4,438
chr1,29709611,29709920,SRX5716467,SMARCA2,309
chr1,29709624,29709945,SRX5054309,FOSL2,321
chr1,29712013,29712313,SRX5075168,SMARCA4,300
chr1,29712025,29712258,SRX5075174,SMARCA4,233
chr1,29713889,29714110,SRX16500060,CTCF,221
chr1,29792947,29793398,SRX16500060,CTCF,451
chr1,29792949,29793480,SRX16500059,CTCF,531
chr1,29792953,29793423,SRX16500062,CTCF,470
chr1,29792958,29793415,SRX16500061,CTCF,457
chr1,29792978,29793300,SRX4174629,CTCF,322
chr1,29793061,29793305,SRX5075174,SMARCA4,244
chr1,29793078,29793338,SRX5075170,SMARCA4,260
chr1,29793106,29793329,SRX5075168,SMARCA4,223
chr1,29793163,29793371,SRX5075176,SMARCA4,208
chr1,29849045,29849440,SRX16500059,CTCF,395
chr1,29849055,29849410,SRX16500061,CTCF,355
chr1,29849101,29849393,SRX16500060,CTCF,292
chr1,29849188,29849453,SRX16500062,CTCF,265
chr1,29960918,29961263,SRX5075174,SMARCA4,345
chr1,29960932,29961276,SRX5075168,SMARCA4,344
chr1,29973476,29973718,SRX5075168,SMARCA4,242
chr1,29974216,29974826,SRX5075174,SMARCA4,610
chr1,29974221,29974784,SRX5716451,SOX2,563
chr1,29974229,29974801,SRX5075168,SMARCA4,572
chr1,29974238,29974615,SRX5075169,SMARCA4,377
chr1,29974269,29974723,SRX5054309,FOSL2,454
chr1,29974274,29974721,SRX5075175,SMARCA4,447
chr1,29974284,29974639,SRX5075170,SMARCA4,355
chr1,29974302,29974579,SRX5054308,FOSL2,277
chr1,29974333,29974593,SRX5075176,SMARCA4,260
chr1,29974359,29974649,SRX5054307,FOSL2,290
chr1,29974388,29974607,SRX5716463,SMARCA4,219
chr1,29975180,29975413,SRX5075170,SMARCA4,233
chr1,30058950,30059237,SRX5075174,SMARCA4,287
chr1,30058965,30059378,SRX5075169,SMARCA4,413
chr1,30058966,30059317,SRX5075170,SMARCA4,351
chr1,30058987,30059324,SRX5075176,SMARCA4,337
chr1,30058987,30059342,SRX5054309,FOSL2,355
chr1,30058996,30059298,SRX5075175,SMARCA4,302
chr1,30059005,30059336,SRX5054308,FOSL2,331
chr1,30059014,30059300,SRX5716469,SMARCA4,286
chr1,30059034,30059213,SRX5075168,SMARCA4,179
chr1,30083812,30084411,SRX5075170,SMARCA4,599
chr1,30083813,30084398,SRX5075175,SMARCA4,585
chr1,30083818,30084382,SRX5075176,SMARCA4,564
chr1,30083842,30084328,SRX5716470,SMARCA4,486
chr1,30083872,30084279,SRX5054309,FOSL2,407
chr1,30083903,30084390,SRX5075169,SMARCA4,487
chr1,30083909,30084263,SRX5716469,SMARCA4,354
chr1,30083910,30084321,SRX5716467,SMARCA2,411
chr1,30083934,30084247,SRX5054308,FOSL2,313
chr1,30083939,30084215,SRX5716468,SMARCA2,276
chr1,30083990,30084271,SRX5020214,SMARCA2,281
chr1,30083997,30084220,SRX5020211,SMARCA2,223
chr1,30084008,30084219,SRX5075181,SMARCA2,211
chr1,30085852,30086414,SRX16500060,CTCF,562
chr1,30085889,30086360,SRX16500062,CTCF,471
chr1,30085914,30086404,SRX16500059,CTCF,490
chr1,30085945,30086371,SRX16500061,CTCF,426
chr1,30085957,30086218,SRX5075174,SMARCA4,261
chr1,30085967,30086177,SRX4174629,CTCF,210
chr1,30085974,30086185,SRX5716470,SMARCA4,211
chr1,30086025,30086194,SRX5075170,SMARCA4,169
chr1,30086042,30086221,SRX5075168,SMARCA4,179
chr1,30106051,30106493,SRX16500059,CTCF,442
chr1,30106071,30106502,SRX16500060,CTCF,431
chr1,30106118,30106474,SRX16500062,CTCF,356
chr1,30106154,30106474,SRX16500061,CTCF,320
chr1,30111402,30111858,SRX16500060,CTCF,456
chr1,30111436,30111770,SRX4174629,CTCF,334
chr1,30111460,30111902,SRX16500059,CTCF,442
chr1,30111465,30111819,SRX16500061,CTCF,354
chr1,30111481,30111822,SRX16500062,CTCF,341
chr1,30232314,30232648,SRX16500061,CTCF,334
chr1,30232318,30232654,SRX16500060,CTCF,336
chr1,30232348,30232722,SRX16500059,CTCF,374
chr1,30232390,30232643,SRX16500062,CTCF,253
chr1,30353627,30353942,SRX16500059,CTCF,315
chr1,30353629,30353984,SRX16500060,CTCF,355
chr1,30353686,30353979,SRX16500061,CTCF,293
chr1,30353697,30354114,SRX16500062,CTCF,417
chr1,30380028,30380864,SRX16500060,CTCF,836
chr1,30380155,30380838,SRX16500059,CTCF,683
chr1,30380269,30380793,SRX16500061,CTCF,524
chr1,30380373,30380872,SRX16500062,CTCF,499
chr1,30380389,30380818,SRX4174629,CTCF,429
chr1,30380390,30380668,SRX5716470,SMARCA4,278
chr1,30380404,30380684,SRX5075175,SMARCA4,280
chr1,30380442,30380721,SRX5075174,SMARCA4,279
chr1,30380443,30380676,SRX5075176,SMARCA4,233
chr1,30380452,30380707,SRX5075170,SMARCA4,255
chr1,30380471,30380675,SRX5716463,SMARCA4,204
chr1,30380478,30380695,SRX5075168,SMARCA4,217
chr1,30629926,30630101,SRX5075170,SMARCA4,175
chr1,30666761,30667188,SRX5075174,SMARCA4,427
chr1,30666786,30667210,SRX5075168,SMARCA4,424
chr1,30685115,30685456,SRX16500060,CTCF,341
chr1,30685124,30685359,SRX16500059,CTCF,235
chr1,30708040,30708531,SRX16500060,CTCF,491
chr1,30708048,30708567,SRX16500059,CTCF,519
chr1,30708051,30708514,SRX16500062,CTCF,463
chr1,30708074,30708446,SRX4174629,CTCF,372
chr1,30708078,30708500,SRX16500061,CTCF,422
chr1,30708176,30708370,SRX5075168,SMARCA4,194
chr1,30708203,30708387,SRX5075170,SMARCA4,184
chr1,30708264,30708439,SRX5075176,SMARCA4,175
chr1,30718025,30718913,SRX5075174,SMARCA4,888
chr1,30718035,30718513,SRX5716463,SMARCA4,478
chr1,30718082,30718700,SRX5054307,FOSL2,618
chr1,30718096,30718993,SRX5075168,SMARCA4,897
chr1,30718126,30718692,SRX5716464,SMARCA4,566
chr1,30718139,30718915,SRX5075170,SMARCA4,776
chr1,30718170,30718412,SRX5075176,SMARCA4,242
chr1,30718222,30718412,SRX5716451,SOX2,190
chr1,30718368,30718773,SRX5054308,FOSL2,405
chr1,30718370,30718803,SRX5054309,FOSL2,433
chr1,30718539,30718956,SRX5075176,SMARCA4,417
chr1,30718695,30719040,SRX5075169,SMARCA4,345
chr1,30718750,30719201,SRX20140881,CPSF3L,451
chr1,30718761,30719039,SRX20140897,INTS13,278
chr1,30718788,30719259,SRX20140895,INTS13,471
chr1,30718849,30719104,SRX20140867,INTS10,255
chr1,30718887,30719229,SRX20140869,INTS10,342
chr1,30718995,30719480,SRX5716469,SMARCA4,485
chr1,30719127,30719634,SRX16500060,CTCF,507
chr1,30719130,30719609,SRX16500062,CTCF,479
chr1,30719145,30719476,SRX5075169,SMARCA4,331
chr1,30719146,30719623,SRX16500061,CTCF,477
chr1,30719153,30719612,SRX16500059,CTCF,459
chr1,30719155,30719546,SRX5716470,SMARCA4,391
chr1,30719185,30719575,SRX5075175,SMARCA4,390
chr1,30719193,30719529,SRX5075176,SMARCA4,336
chr1,30719194,30719588,SRX4174629,CTCF,394
chr1,30719231,30719532,SRX5075170,SMARCA4,301
chr1,30719266,30719521,SRX5075174,SMARCA4,255
chr1,30727853,30728116,SRX5054309,FOSL2,263
chr1,30727856,30728102,SRX5054308,FOSL2,246
chr1,30727864,30728066,SRX5075175,SMARCA4,202
chr1,30727921,30728097,SRX5075170,SMARCA4,176
chr1,30756623,30756940,SRX5054309,FOSL2,317
chr1,30756672,30756898,SRX5054308,FOSL2,226
chr1,30756693,30756913,SRX5075169,SMARCA4,220
chr1,30763672,30763859,SRX5075175,SMARCA4,187
chr1,30779515,30780007,SRX16500060,CTCF,492
chr1,30779551,30779969,SRX16500062,CTCF,418
chr1,30779565,30780012,SRX16500059,CTCF,447
chr1,30779574,30780008,SRX16500061,CTCF,434
chr1,30779598,30779873,SRX5075168,SMARCA4,275
chr1,30779646,30779844,SRX5075174,SMARCA4,198
chr1,30782360,30783146,SRX16500059,CTCF,786
chr1,30782369,30782679,SRX4174629,CTCF,310
chr1,30782372,30782711,SRX16500060,CTCF,339
chr1,30782395,30782746,SRX16500061,CTCF,351
chr1,30782421,30782766,SRX16500062,CTCF,345
chr1,30782436,30782635,SRX5075174,SMARCA4,199
chr1,30782842,30783208,SRX16500060,CTCF,366
chr1,30782875,30783156,SRX16500061,CTCF,281
chr1,30782944,30783165,SRX16500062,CTCF,221
chr1,30786469,30786982,SRX5075174,SMARCA4,513
chr1,30786610,30787022,SRX5075168,SMARCA4,412
chr1,30801647,30802127,SRX16500061,CTCF,480
chr1,30801653,30802138,SRX16500059,CTCF,485
chr1,30801667,30802167,SRX16500060,CTCF,500
chr1,30801669,30802144,SRX16500062,CTCF,475
chr1,30801749,30802081,SRX5075168,SMARCA4,332
chr1,30801782,30802218,SRX4174629,CTCF,436
chr1,30801786,30802090,SRX5075174,SMARCA4,304
chr1,30801823,30802029,SRX5075170,SMARCA4,206
chr1,30801831,30802063,SRX5075169,SMARCA4,232
chr1,30807442,30807748,SRX5075176,SMARCA4,306
chr1,30807478,30807806,SRX5716468,SMARCA2,328
chr1,30807480,30807774,SRX5075169,SMARCA4,294
chr1,30807485,30807768,SRX5075175,SMARCA4,283
chr1,30807495,30807740,SRX5716469,SMARCA4,245
chr1,30807497,30807810,SRX5075170,SMARCA4,313
chr1,30809524,30810035,SRX5075176,SMARCA4,511
chr1,30809528,30809946,SRX5075169,SMARCA4,418
chr1,30809530,30809978,SRX5075170,SMARCA4,448
chr1,30809565,30809935,SRX5075174,SMARCA4,370
chr1,30809566,30809942,SRX5075175,SMARCA4,376
chr1,30809569,30809901,SRX5054308,FOSL2,332
chr1,30809570,30809910,SRX5716467,SMARCA2,340
chr1,30809590,30809947,SRX5054309,FOSL2,357
chr1,30809604,30809801,SRX5075168,SMARCA4,197
chr1,30809632,30809892,SRX5716469,SMARCA4,260
chr1,30809663,30809881,SRX5716470,SMARCA4,218
chr1,30816136,30816628,SRX5075168,SMARCA4,492
chr1,30816164,30816715,SRX5075174,SMARCA4,551
chr1,30816228,30816487,SRX5716464,SMARCA4,259
chr1,30816240,30816516,SRX20140895,INTS13,276
chr1,30816249,30816558,SRX5716463,SMARCA4,309
chr1,30816269,30816460,SRX5075170,SMARCA4,191
chr1,30816271,30816482,SRX5716468,SMARCA2,211
chr1,30816301,30816551,SRX5075176,SMARCA4,250
chr1,30816338,30816539,SRX5075175,SMARCA4,201
chr1,30816607,30816790,SRX5075170,SMARCA4,183
chr1,30816616,30816830,SRX5075175,SMARCA4,214
chr1,30816665,30816871,SRX5075169,SMARCA4,206
chr1,30816665,30816872,SRX5054309,FOSL2,207
chr1,30823867,30824530,SRX5075170,SMARCA4,663
chr1,30823895,30824468,SRX5716469,SMARCA4,573
chr1,30823897,30824387,SRX5716470,SMARCA4,490
chr1,30823907,30824452,SRX5075175,SMARCA4,545
chr1,30823907,30824512,SRX5075176,SMARCA4,605
chr1,30823918,30824538,SRX5075169,SMARCA4,620
chr1,30823921,30824385,SRX5716467,SMARCA2,464
chr1,30823921,30824419,SRX5716459,Epitope tags,498
chr1,30823940,30824370,SRX5054308,FOSL2,430
chr1,30823957,30824355,SRX5716468,SMARCA2,398
chr1,30823958,30824441,SRX5716460,Epitope tags,483
chr1,30823973,30824396,SRX5020214,SMARCA2,423
chr1,30823985,30824352,SRX5020211,SMARCA2,367
chr1,30823989,30824382,SRX5054309,FOSL2,393
chr1,30824000,30824723,SRX5075174,SMARCA4,723
chr1,30824001,30824180,SRX5075168,SMARCA4,179
chr1,30824003,30824382,SRX5075181,SMARCA2,379
chr1,30824018,30824292,SRX5075182,SMARCA2,274
chr1,30824061,30824259,SRX5054307,FOSL2,198
chr1,30824077,30824452,SRX20140867,INTS10,375
chr1,30824329,30824671,SRX5075168,SMARCA4,342
chr1,30824481,30824686,SRX5716464,SMARCA4,205
chr1,30840789,30841165,SRX5075168,SMARCA4,376
chr1,30840840,30841256,SRX5075174,SMARCA4,416
chr1,30840909,30841189,SRX20140868,INTS10,280
chr1,30840917,30841121,SRX5716463,SMARCA4,204
chr1,30842594,30842980,SRX5075170,SMARCA4,386
chr1,30842595,30842991,SRX5075176,SMARCA4,396
chr1,30842638,30842868,SRX5075175,SMARCA4,230
chr1,30842663,30842951,SRX5716470,SMARCA4,288
chr1,30842682,30842952,SRX5054309,FOSL2,270
chr1,30842718,30842930,SRX5716469,SMARCA4,212
chr1,30842768,30842973,SRX5075169,SMARCA4,205
chr1,30845943,30846239,SRX16500060,CTCF,296
chr1,30847388,30847848,SRX5075174,SMARCA4,460
chr1,30847448,30847884,SRX5075168,SMARCA4,436
chr1,30847589,30847836,SRX5716454,SOX3,247
chr1,30847596,30847890,SRX20140895,INTS13,294
chr1,30847639,30847869,SRX5716463,SMARCA4,230
chr1,30847658,30847875,SRX5716451,SOX2,217
chr1,30854082,30854552,SRX20140895,INTS13,470
chr1,30896181,30896415,SRX5075170,SMARCA4,234
chr1,30911289,30911768,SRX16500061,CTCF,479
chr1,30911305,30911828,SRX16500059,CTCF,523
chr1,30911321,30911773,SRX4174629,CTCF,452
chr1,30911321,30911820,SRX16500060,CTCF,499
chr1,30911350,30911821,SRX16500062,CTCF,471
chr1,30911386,30911581,SRX5075176,SMARCA4,195
chr1,30911398,30911603,SRX5075168,SMARCA4,205
chr1,30919068,30919391,SRX5075170,SMARCA4,323
chr1,30919075,30919273,SRX5054309,FOSL2,198
chr1,30919407,30919771,SRX5075176,SMARCA4,364
chr1,30919457,30919725,SRX5075170,SMARCA4,268
chr1,30919499,30919699,SRX5075175,SMARCA4,200
chr1,30919513,30919712,SRX5075169,SMARCA4,199
chr1,30920832,30921160,SRX5075176,SMARCA4,328
chr1,30929293,30929810,SRX16500062,CTCF,517
chr1,30929317,30929837,SRX16500059,CTCF,520
chr1,30929332,30929861,SRX16500061,CTCF,529
chr1,30929343,30929885,SRX16500060,CTCF,542
chr1,30929416,30929700,SRX5075174,SMARCA4,284
chr1,30955699,30955982,SRX5054309,FOSL2,283
chr1,30966684,30967148,SRX5075169,SMARCA4,464
chr1,30966696,30967109,SRX5075170,SMARCA4,413
chr1,30966705,30967119,SRX5716469,SMARCA4,414
chr1,30966707,30967024,SRX5716470,SMARCA4,317
chr1,30966725,30967071,SRX5054309,FOSL2,346
chr1,30966741,30967088,SRX5075176,SMARCA4,347
chr1,30966754,30967027,SRX5716467,SMARCA2,273
chr1,30966755,30967039,SRX5054308,FOSL2,284
chr1,30966770,30967118,SRX5075175,SMARCA4,348
chr1,30966773,30967002,SRX5020211,SMARCA2,229
chr1,30977093,30977273,SRX5054308,FOSL2,180
chr1,30977109,30977312,SRX5075175,SMARCA4,203
chr1,30977116,30977321,SRX5075169,SMARCA4,205
chr1,31007407,31008062,SRX5054309,FOSL2,655
chr1,31007468,31007656,SRX5075170,SMARCA4,188
chr1,31007469,31007778,SRX5075169,SMARCA4,309
chr1,31007477,31007710,SRX5020211,SMARCA2,233
chr1,31007489,31007709,SRX5716470,SMARCA4,220
chr1,31007492,31007732,SRX5075175,SMARCA4,240
chr1,31007526,31007920,SRX5075176,SMARCA4,394
chr1,31065162,31065916,SRX20140869,INTS10,754
chr1,31065175,31066130,SRX20140895,INTS13,955
chr1,31065304,31065959,SRX20140867,INTS10,655
chr1,31065326,31066123,SRX20140868,INTS10,797
chr1,31065335,31065899,SRX20140897,INTS13,564
chr1,31065420,31065789,SRX20140881,CPSF3L,369
chr1,31065480,31065757,SRX20140879,CPSF3L,277
chr1,31065486,31065927,SRX20140896,INTS13,441
chr1,31065605,31066075,SRX5716470,SMARCA4,470
chr1,31065640,31066133,SRX5075168,SMARCA4,493
chr1,31065660,31066115,SRX5075174,SMARCA4,455
chr1,31065696,31066087,SRX5075170,SMARCA4,391
chr1,31065697,31066065,SRX5075176,SMARCA4,368
chr1,31065744,31065956,SRX5716469,SMARCA4,212
chr1,31065773,31066060,SRX5716464,SMARCA4,287
chr1,31065774,31066020,SRX5075169,SMARCA4,246
chr1,31065804,31066029,SRX5716463,SMARCA4,225
chr1,31095525,31095973,SRX5075170,SMARCA4,448
chr1,31095567,31095920,SRX5054308,FOSL2,353
chr1,31095576,31095959,SRX5075169,SMARCA4,383
chr1,31095594,31095999,SRX5075176,SMARCA4,405
chr1,31095597,31095951,SRX5054309,FOSL2,354
chr1,31095607,31095977,SRX5075175,SMARCA4,370
chr1,31095619,31095982,SRX5716469,SMARCA4,363
chr1,31095623,31095921,SRX5716470,SMARCA4,298
chr1,31095656,31095914,SRX5716467,SMARCA2,258
chr1,31101031,31101354,SRX5716470,SMARCA4,323
chr1,31101063,31101367,SRX5075169,SMARCA4,304
chr1,31101093,31101284,SRX5054309,FOSL2,191
chr1,31101099,31101334,SRX5075176,SMARCA4,235
chr1,31101101,31101424,SRX5075170,SMARCA4,323
chr1,31102457,31102747,SRX5075170,SMARCA4,290
chr1,31102459,31102700,SRX5075176,SMARCA4,241
chr1,31111317,31111709,SRX5075174,SMARCA4,392
chr1,31111353,31111694,SRX5716463,SMARCA4,341
chr1,31111367,31111757,SRX5075168,SMARCA4,390
chr1,31111413,31111643,SRX5716451,SOX2,230
chr1,31122248,31122417,SRX5075170,SMARCA4,169
chr1,31122737,31123163,SRX5075168,SMARCA4,426
chr1,31122763,31123210,SRX5075174,SMARCA4,447
chr1,31127304,31127576,SRX5075169,SMARCA4,272
chr1,31127380,31127553,SRX5075170,SMARCA4,173
chr1,31127393,31127582,SRX5054309,FOSL2,189
chr1,31127405,31127641,SRX5075176,SMARCA4,236
chr1,31154480,31154902,SRX20140869,INTS10,422
chr1,31154627,31155085,SRX5075174,SMARCA4,458
chr1,31154630,31155130,SRX20140895,INTS13,500
chr1,31154680,31155035,SRX5075168,SMARCA4,355
chr1,31154707,31154925,SRX5075175,SMARCA4,218
chr1,31154707,31154954,SRX20140867,INTS10,247
chr1,31154708,31154910,SRX5075176,SMARCA4,202
chr1,31154740,31154992,SRX5075170,SMARCA4,252
chr1,31155218,31155650,SRX20140895,INTS13,432
chr1,31155312,31155569,SRX16500060,CTCF,257
chr1,31155312,31155625,SRX20140868,INTS10,313
chr1,31155314,31155595,SRX16500061,CTCF,281
chr1,31155333,31155673,SRX5075174,SMARCA4,340
chr1,31155358,31155729,SRX5075169,SMARCA4,371
chr1,31155377,31155692,SRX5075175,SMARCA4,315
chr1,31155490,31155692,SRX5075170,SMARCA4,202
chr1,31155505,31155683,SRX5075176,SMARCA4,178
chr1,31162462,31163042,SRX16500061,CTCF,580
chr1,31162521,31163048,SRX16500060,CTCF,527
chr1,31162526,31163015,SRX16500062,CTCF,489
chr1,31162573,31163065,SRX16500059,CTCF,492
chr1,31162631,31162858,SRX5716468,SMARCA2,227
chr1,31162642,31162961,SRX5716470,SMARCA4,319
chr1,31162648,31163023,SRX5075168,SMARCA4,375
chr1,31162656,31163021,SRX5075170,SMARCA4,365
chr1,31162674,31163035,SRX5075174,SMARCA4,361
chr1,31162675,31162920,SRX5716463,SMARCA4,245
chr1,31162683,31162990,SRX5075176,SMARCA4,307
chr1,31162687,31162991,SRX5075169,SMARCA4,304
chr1,31162696,31162940,SRX5075175,SMARCA4,244
chr1,31162782,31163111,SRX4174629,CTCF,329
chr1,31162784,31162996,SRX5716469,SMARCA4,212
chr1,31170625,31171305,SRX5075176,SMARCA4,680
chr1,31170707,31171155,SRX5075175,SMARCA4,448
chr1,31170753,31171204,SRX5075170,SMARCA4,451
chr1,31170772,31171092,SRX5716470,SMARCA4,320
chr1,31170772,31171208,SRX5075169,SMARCA4,436
chr1,31170775,31171037,SRX5716467,SMARCA2,262
chr1,31170775,31171212,SRX5716469,SMARCA4,437
chr1,31170825,31171069,SRX5054309,FOSL2,244
chr1,31170830,31171097,SRX5716468,SMARCA2,267
chr1,31170831,31171127,SRX5054308,FOSL2,296
chr1,31181507,31181765,SRX16500061,CTCF,258
chr1,31182265,31182688,SRX5716469,SMARCA4,423
chr1,31182307,31182709,SRX5075176,SMARCA4,402
chr1,31182309,31182674,SRX5716470,SMARCA4,365
chr1,31182323,31182684,SRX5075175,SMARCA4,361
chr1,31182332,31182700,SRX5075169,SMARCA4,368
chr1,31182335,31182726,SRX5075170,SMARCA4,391
chr1,31182361,31182683,SRX5054308,FOSL2,322
chr1,31182384,31182652,SRX5054309,FOSL2,268
chr1,31182386,31182597,SRX5075181,SMARCA2,211
chr1,31182467,31182675,SRX5020211,SMARCA2,208
chr1,31183893,31184368,SRX16500062,CTCF,475
chr1,31183906,31184405,SRX16500059,CTCF,499
chr1,31183911,31184320,SRX16500061,CTCF,409
chr1,31183915,31184401,SRX16500060,CTCF,486
chr1,31184051,31184377,SRX4174629,CTCF,326
chr1,31185712,31185947,SRX16500059,CTCF,235
chr1,31185726,31185986,SRX16500062,CTCF,260
chr1,31198748,31198935,SRX5075174,SMARCA4,187
chr1,31214800,31215092,SRX16500059,CTCF,292
chr1,31214935,31215211,SRX5075174,SMARCA4,276
chr1,31216101,31216454,SRX5075176,SMARCA4,353
chr1,31216137,31216373,SRX5075170,SMARCA4,236
chr1,31227876,31228283,SRX5075168,SMARCA4,407
chr1,31227892,31228188,SRX5716463,SMARCA4,296
chr1,31227910,31228260,SRX5075174,SMARCA4,350
chr1,31227936,31228175,SRX5716464,SMARCA4,239
chr1,31239214,31240136,SRX20140895,INTS13,922
chr1,31239259,31239555,SRX20140868,INTS10,296
chr1,31239588,31239996,SRX20140867,INTS10,408
chr1,31239611,31240149,SRX20140868,INTS10,538
chr1,31239715,31240095,SRX5075168,SMARCA4,380
chr1,31239772,31239952,SRX5075169,SMARCA4,180
chr1,31239796,31240062,SRX5075174,SMARCA4,266
chr1,31243895,31244260,SRX5075170,SMARCA4,365
chr1,31243958,31244158,SRX5075175,SMARCA4,200
chr1,31243962,31244147,SRX5075169,SMARCA4,185
chr1,31243991,31244209,SRX5054308,FOSL2,218
chr1,31244074,31244361,SRX5075176,SMARCA4,287
chr1,31296482,31296761,SRX5075175,SMARCA4,279
chr1,31296495,31297300,SRX20140895,INTS13,805
chr1,31296500,31296811,SRX5075169,SMARCA4,311
chr1,31296503,31297113,SRX5075174,SMARCA4,610
chr1,31296514,31296902,SRX5075170,SMARCA4,388
chr1,31296520,31297179,SRX5075168,SMARCA4,659
chr1,31296531,31297218,SRX20140897,INTS13,687
chr1,31296541,31296901,SRX20140868,INTS10,360
chr1,31296543,31296800,SRX5716470,SMARCA4,257
chr1,31296543,31296865,SRX20140869,INTS10,322
chr1,31296552,31296886,SRX20140867,INTS10,334
chr1,31296561,31296898,SRX20140879,CPSF3L,337
chr1,31296581,31297069,SRX5075176,SMARCA4,488
chr1,31296610,31296865,SRX5716463,SMARCA4,255
chr1,31296663,31296958,SRX5716464,SMARCA4,295
chr1,31296775,31296992,SRX5054307,FOSL2,217
chr1,31296808,31297263,SRX20140881,CPSF3L,455
chr1,31306231,31306626,SRX5075169,SMARCA4,395
chr1,31306244,31306556,SRX5075176,SMARCA4,312
chr1,31306276,31306547,SRX5054308,FOSL2,271
chr1,31306278,31306603,SRX5075170,SMARCA4,325
chr1,31306293,31306666,SRX5075175,SMARCA4,373
chr1,31306295,31306606,SRX5716469,SMARCA4,311
chr1,31306301,31306627,SRX5054309,FOSL2,326
chr1,31334977,31335414,SRX16500059,CTCF,437
chr1,31334990,31335401,SRX16500060,CTCF,411
chr1,31335021,31335462,SRX16500061,CTCF,441
chr1,31335028,31335238,SRX4174629,CTCF,210
chr1,31335100,31335412,SRX16500062,CTCF,312
chr1,31335103,31335299,SRX5075175,SMARCA4,196
chr1,31335124,31335293,SRX5075170,SMARCA4,169
chr1,31335124,31335299,SRX5075176,SMARCA4,175
chr1,31364589,31365004,SRX5716463,SMARCA4,415
chr1,31373191,31373376,SRX5075169,SMARCA4,185
chr1,31373533,31373879,SRX20140895,INTS13,346
chr1,31373569,31374056,SRX5075174,SMARCA4,487
chr1,31373570,31374006,SRX5075168,SMARCA4,436
chr1,31373591,31373814,SRX20140867,INTS10,223
chr1,31373632,31373819,SRX5075175,SMARCA4,187
chr1,31376665,31377183,SRX5075170,SMARCA4,518
chr1,31376669,31377188,SRX5075176,SMARCA4,519
chr1,31376705,31377122,SRX5075175,SMARCA4,417
chr1,31376721,31377117,SRX5054308,FOSL2,396
chr1,31376732,31377078,SRX5716470,SMARCA4,346
chr1,31376738,31377171,SRX5075169,SMARCA4,433
chr1,31376755,31377124,SRX5075174,SMARCA4,369
chr1,31376763,31377125,SRX5054309,FOSL2,362
chr1,31376767,31377011,SRX5716467,SMARCA2,244
chr1,31376772,31376983,SRX5716468,SMARCA2,211
chr1,31376774,31377080,SRX5716469,SMARCA4,306
chr1,31376783,31377089,SRX5075168,SMARCA4,306
chr1,31394504,31395121,SRX16500061,CTCF,617
chr1,31394515,31395101,SRX16500059,CTCF,586
chr1,31394539,31395081,SRX16500060,CTCF,542
chr1,31394593,31395015,SRX5075168,SMARCA4,422
chr1,31394594,31395026,SRX16500062,CTCF,432
chr1,31394596,31394991,SRX4174629,CTCF,395
chr1,31394611,31394987,SRX5075174,SMARCA4,376
chr1,31394642,31394968,SRX5075169,SMARCA4,326
chr1,31394687,31395038,SRX5075176,SMARCA4,351
chr1,31394698,31395066,SRX5075175,SMARCA4,368
chr1,31394725,31395012,SRX5075170,SMARCA4,287
chr1,31394745,31395173,SRX5716470,SMARCA4,428
chr1,31394764,31394988,SRX5716464,SMARCA4,224
chr1,31397048,31397277,SRX5054309,FOSL2,229
chr1,31413232,31414387,SRX20140895,INTS13,1155
chr1,31413280,31413680,SRX5075175,SMARCA4,400
chr1,31413459,31413639,SRX5075169,SMARCA4,180
chr1,31413900,31414144,SRX20140897,INTS13,244
chr1,31414061,31414428,SRX5075174,SMARCA4,367
chr1,31414241,31414656,SRX5075168,SMARCA4,415
chr1,31421428,31421759,SRX16500062,CTCF,331
chr1,31421492,31421740,SRX16500059,CTCF,248
chr1,31422506,31423040,SRX5075176,SMARCA4,534
chr1,31422625,31422898,SRX5054308,FOSL2,273
chr1,31422635,31422986,SRX5075170,SMARCA4,351
chr1,31422651,31422985,SRX5716469,SMARCA4,334
chr1,31422673,31422948,SRX5075175,SMARCA4,275
chr1,31422678,31423171,SRX16500059,CTCF,493
chr1,31422689,31423207,SRX16500060,CTCF,518
chr1,31422697,31422996,SRX5075169,SMARCA4,299
chr1,31422701,31423178,SRX16500061,CTCF,477
chr1,31422715,31423041,SRX4174629,CTCF,326
chr1,31422725,31422996,SRX5716463,SMARCA4,271
chr1,31422729,31422998,SRX5075174,SMARCA4,269
chr1,31422732,31423131,SRX16500062,CTCF,399
chr1,31422737,31423052,SRX5075168,SMARCA4,315
chr1,31422764,31423036,SRX5716470,SMARCA4,272
chr1,31431787,31432017,SRX16500061,CTCF,230
chr1,31431807,31432020,SRX16500062,CTCF,213
chr1,31431972,31432054,SRX1424893,POU3F2,82
chr1,31460168,31460693,SRX5075170,SMARCA4,525
chr1,31466906,31467853,SRX5075170,SMARCA4,947
chr1,31466966,31467750,SRX5075169,SMARCA4,784
chr1,31467164,31467645,SRX5716470,SMARCA4,481
chr1,31467169,31467840,SRX5075176,SMARCA4,671
chr1,31467188,31467648,SRX5075175,SMARCA4,460
chr1,31467279,31467669,SRX5054308,FOSL2,390
chr1,31467282,31467655,SRX5716467,SMARCA2,373
chr1,31467292,31467641,SRX5716469,SMARCA4,349
chr1,31467303,31467592,SRX5020211,SMARCA2,289
chr1,31467316,31467707,SRX5054309,FOSL2,391
chr1,31467348,31467696,SRX5716468,SMARCA2,348
chr1,31483141,31483880,SRX5075170,SMARCA4,739
chr1,31483158,31483826,SRX5716470,SMARCA4,668
chr1,31483180,31483969,SRX5075176,SMARCA4,789
chr1,31483193,31483810,SRX5075169,SMARCA4,617
chr1,31483242,31483734,SRX5716467,SMARCA2,492
chr1,31483298,31483873,SRX5075175,SMARCA4,575
chr1,31483303,31483717,SRX5020214,SMARCA2,414
chr1,31483310,31483762,SRX5716468,SMARCA2,452
chr1,31483320,31483769,SRX5716469,SMARCA4,449
chr1,31483336,31483702,SRX5020211,SMARCA2,366
chr1,31483360,31483776,SRX5054308,FOSL2,416
chr1,31483372,31483733,SRX5054309,FOSL2,361
chr1,31483400,31483617,SRX5075181,SMARCA2,217
chr1,31483413,31483777,SRX5075174,SMARCA4,364
chr1,31483423,31483659,SRX5075182,SMARCA2,236
chr1,31497554,31497964,SRX5054308,FOSL2,410
chr1,31497591,31497980,SRX5075176,SMARCA4,389
chr1,31497599,31497860,SRX5716467,SMARCA2,261
chr1,31497600,31498006,SRX5075175,SMARCA4,406
chr1,31497601,31497947,SRX5054309,FOSL2,346
chr1,31497612,31498029,SRX5075169,SMARCA4,417
chr1,31497618,31497966,SRX5075170,SMARCA4,348
chr1,31497621,31498004,SRX5020211,SMARCA2,383
chr1,31497654,31498031,SRX5716469,SMARCA4,377
chr1,31497658,31497981,SRX5020214,SMARCA2,323
chr1,31497672,31497990,SRX5075181,SMARCA2,318
chr1,31497710,31497927,SRX5716468,SMARCA2,217
chr1,31497762,31497948,SRX5075182,SMARCA2,186
chr1,31530274,31530576,SRX5075170,SMARCA4,302
chr1,31530316,31530607,SRX5075175,SMARCA4,291
chr1,31530342,31530607,SRX5716467,SMARCA2,265
chr1,31530367,31530618,SRX5075176,SMARCA4,251
chr1,31530369,31530583,SRX5716470,SMARCA4,214
chr1,31530389,31530604,SRX5075169,SMARCA4,215
chr1,31531079,31531402,SRX5075175,SMARCA4,323
chr1,31531094,31531502,SRX5075176,SMARCA4,408
chr1,31531095,31531400,SRX5054309,FOSL2,305
chr1,31531115,31531496,SRX5075170,SMARCA4,381
chr1,31531135,31531496,SRX5075169,SMARCA4,361
chr1,31531144,31531493,SRX5716469,SMARCA4,349
chr1,31532279,31532497,SRX5716470,SMARCA4,218
chr1,31532318,31532573,SRX5075176,SMARCA4,255
chr1,31548753,31549319,SRX16500059,CTCF,566
chr1,31548757,31549309,SRX16500060,CTCF,552
chr1,31548762,31549289,SRX16500062,CTCF,527
chr1,31548783,31549324,SRX16500061,CTCF,541
chr1,31548850,31549186,SRX5075168,SMARCA4,336
chr1,31548850,31549231,SRX5075174,SMARCA4,381
chr1,31548885,31549313,SRX4174629,CTCF,428
chr1,31548886,31549334,SRX5075170,SMARCA4,448
chr1,31548896,31549235,SRX5075176,SMARCA4,339
chr1,31548952,31549359,SRX5075169,SMARCA4,407
chr1,31549005,31549238,SRX5716469,SMARCA4,233
chr1,31563921,31564509,SRX16500059,CTCF,588
chr1,31563995,31564463,SRX16500061,CTCF,468
chr1,31563995,31564564,SRX16500060,CTCF,569
chr1,31564034,31564487,SRX16500062,CTCF,453
chr1,31564093,31564400,SRX5075168,SMARCA4,307
chr1,31564111,31564424,SRX5075174,SMARCA4,313
chr1,31564122,31564432,SRX5075176,SMARCA4,310
chr1,31564135,31564380,SRX5075169,SMARCA4,245
chr1,31564136,31564451,SRX4174629,CTCF,315
chr1,31564146,31564480,SRX5075170,SMARCA4,334
chr1,31564167,31564376,SRX5716463,SMARCA4,209
chr1,31573842,31574199,SRX5054309,FOSL2,357
chr1,31573866,31574216,SRX5075176,SMARCA4,350
chr1,31573870,31574266,SRX5075175,SMARCA4,396
chr1,31573879,31574202,SRX5054308,FOSL2,323
chr1,31573884,31574268,SRX5075169,SMARCA4,384
chr1,31573888,31574182,SRX5716470,SMARCA4,294
chr1,31573895,31574272,SRX5075170,SMARCA4,377
chr1,31573902,31574193,SRX5716469,SMARCA4,291
chr1,31587733,31588159,SRX16500060,CTCF,426
chr1,31587738,31588128,SRX16500059,CTCF,390
chr1,31587771,31588117,SRX16500062,CTCF,346
chr1,31587783,31588176,SRX16500061,CTCF,393
chr1,31591761,31591948,SRX5075175,SMARCA4,187
chr1,31593966,31594369,SRX16500061,CTCF,403
chr1,31593968,31594364,SRX16500060,CTCF,396
chr1,31593989,31594417,SRX16500059,CTCF,428
chr1,31594032,31594369,SRX16500062,CTCF,337
chr1,31605850,31606068,SRX5075169,SMARCA4,218
chr1,31618002,31618297,SRX20140895,INTS13,295
chr1,31618026,31618684,SRX16500060,CTCF,658
chr1,31618034,31618635,SRX16500061,CTCF,601
chr1,31618061,31618636,SRX16500059,CTCF,575
chr1,31618063,31618477,SRX5075168,SMARCA4,414
chr1,31618074,31618544,SRX16500062,CTCF,470
chr1,31618077,31618455,SRX5075170,SMARCA4,378
chr1,31618090,31618455,SRX5075174,SMARCA4,365
chr1,31618135,31618412,SRX5075176,SMARCA4,277
chr1,31618138,31618363,SRX5075175,SMARCA4,225
chr1,31618142,31618354,SRX5716463,SMARCA4,212
chr1,31618151,31618426,SRX5075169,SMARCA4,275
chr1,31618222,31618491,SRX4174629,CTCF,269
chr1,31618239,31618459,SRX5716470,SMARCA4,220
chr1,31625678,31625994,SRX5075170,SMARCA4,316
chr1,31625694,31625911,SRX5054309,FOSL2,217
chr1,31625753,31625928,SRX5075176,SMARCA4,175
chr1,31633171,31633476,SRX16500062,CTCF,305
chr1,31644439,31644819,SRX20140895,INTS13,380
chr1,31644477,31644895,SRX20140869,INTS10,418
chr1,31644492,31644689,SRX5075175,SMARCA4,197
chr1,31644507,31644828,SRX20140868,INTS10,321
chr1,31644977,31645378,SRX20140895,INTS13,401
chr1,31645023,31645515,SRX5075174,SMARCA4,492
chr1,31645066,31645455,SRX5075168,SMARCA4,389
chr1,31645088,31645310,SRX5075176,SMARCA4,222
chr1,31645142,31645530,SRX5075170,SMARCA4,388
chr1,31645190,31645403,SRX5075175,SMARCA4,213
chr1,31645206,31645467,SRX5716470,SMARCA4,261
chr1,31658713,31659130,SRX5075170,SMARCA4,417
chr1,31658744,31659112,SRX5075169,SMARCA4,368
chr1,31658771,31659121,SRX5075176,SMARCA4,350
chr1,31658792,31659109,SRX5075175,SMARCA4,317
chr1,31658793,31659112,SRX5054308,FOSL2,319
chr1,31658799,31659091,SRX5054309,FOSL2,292
chr1,31658857,31659073,SRX5716469,SMARCA4,216
chr1,31663747,31664188,SRX16500061,CTCF,441
chr1,31663758,31664186,SRX16500059,CTCF,428
chr1,31663760,31664194,SRX16500062,CTCF,434
chr1,31663786,31664186,SRX16500060,CTCF,400
chr1,31663830,31664157,SRX4174629,CTCF,327
chr1,31663866,31664142,SRX5075174,SMARCA4,276
chr1,31663896,31664135,SRX5075168,SMARCA4,239
chr1,31669971,31670157,SRX5075170,SMARCA4,186
chr1,31669977,31670157,SRX5075169,SMARCA4,180
chr1,31669992,31670323,SRX5075176,SMARCA4,331
chr1,31684018,31684307,SRX16500061,CTCF,289
chr1,31684035,31684327,SRX16500060,CTCF,292
chr1,31684047,31684350,SRX16500059,CTCF,303
chr1,31689823,31690207,SRX5075175,SMARCA4,384
chr1,31689873,31690142,SRX5054308,FOSL2,269
chr1,31689885,31690180,SRX5054309,FOSL2,295
chr1,31689900,31690188,SRX5075169,SMARCA4,288
chr1,31689904,31690112,SRX5075170,SMARCA4,208
chr1,31689914,31690173,SRX5075176,SMARCA4,259
chr1,31694553,31694820,SRX5075176,SMARCA4,267
chr1,31694591,31694854,SRX5075170,SMARCA4,263
chr1,31700988,31701471,SRX5075176,SMARCA4,483
chr1,31701007,31701395,SRX5054309,FOSL2,388
chr1,31701009,31701488,SRX5075169,SMARCA4,479
chr1,31701019,31701396,SRX5054308,FOSL2,377
chr1,31701021,31701529,SRX5716470,SMARCA4,508
chr1,31701032,31701492,SRX5075170,SMARCA4,460
chr1,31701034,31701519,SRX5075175,SMARCA4,485
chr1,31701051,31701452,SRX5716469,SMARCA4,401
chr1,31701065,31701276,SRX5020214,SMARCA2,211
chr1,31701066,31701361,SRX5716468,SMARCA2,295
chr1,31701090,31701284,SRX5075181,SMARCA2,194
chr1,31701093,31701407,SRX5716467,SMARCA2,314
chr1,31701102,31701334,SRX5075174,SMARCA4,232
chr1,31701116,31701404,SRX5020211,SMARCA2,288
chr1,31701130,31701326,SRX5075168,SMARCA4,196
chr1,31701158,31701343,SRX5054307,FOSL2,185
chr1,31705258,31705463,SRX5054308,FOSL2,205
chr1,31712633,31713050,SRX5075169,SMARCA4,417
chr1,31712695,31712919,SRX5716468,SMARCA2,224
chr1,31712719,31713028,SRX5716470,SMARCA4,309
chr1,31712734,31712992,SRX5075176,SMARCA4,258
chr1,31712743,31713060,SRX5054309,FOSL2,317
chr1,31712747,31713009,SRX5716469,SMARCA4,262
chr1,31712749,31713072,SRX5075175,SMARCA4,323
chr1,31712764,31713022,SRX5716467,SMARCA2,258
chr1,31712792,31713075,SRX5054308,FOSL2,283
chr1,31712793,31713050,SRX5020211,SMARCA2,257
chr1,31712803,31713018,SRX5075170,SMARCA4,215
chr1,31714443,31714676,SRX16500062,CTCF,233
chr1,31714489,31714831,SRX5075175,SMARCA4,342
chr1,31714563,31714839,SRX5075169,SMARCA4,276
chr1,31714582,31714951,SRX5075176,SMARCA4,369
chr1,31714621,31714902,SRX5054309,FOSL2,281
chr1,31715515,31716060,SRX16500059,CTCF,545
chr1,31715524,31716061,SRX16500061,CTCF,537
chr1,31715571,31716109,SRX16500060,CTCF,538
chr1,31715645,31716144,SRX16500062,CTCF,499
chr1,31723814,31724041,SRX5075174,SMARCA4,227
chr1,31723832,31724129,SRX5075170,SMARCA4,297
chr1,31723856,31724118,SRX5075176,SMARCA4,262
chr1,31723857,31724109,SRX5075169,SMARCA4,252
chr1,31723877,31724102,SRX5075168,SMARCA4,225
chr1,31723902,31724126,SRX5075175,SMARCA4,224
chr1,31723902,31724186,SRX5716464,SMARCA4,284
chr1,31723907,31724118,SRX5716470,SMARCA4,211
chr1,31745617,31746047,SRX16500060,CTCF,430
chr1,31745626,31745945,SRX16500062,CTCF,319
chr1,31745643,31746061,SRX16500059,CTCF,418
chr1,31745722,31745953,SRX5075170,SMARCA4,231
chr1,31745741,31746021,SRX16500061,CTCF,280
chr1,31750903,31751086,SRX5054309,FOSL2,183
chr1,31760613,31761213,SRX20140895,INTS13,600
chr1,31760831,31761268,SRX5075168,SMARCA4,437
chr1,31760859,31761245,SRX5075176,SMARCA4,386
chr1,31760864,31761191,SRX5075170,SMARCA4,327
chr1,31760865,31761211,SRX5075169,SMARCA4,346
chr1,31760872,31761222,SRX5054308,FOSL2,350
chr1,31760874,31761106,SRX5716470,SMARCA4,232
chr1,31760875,31761189,SRX5075175,SMARCA4,314
chr1,31760909,31761207,SRX5054309,FOSL2,298
chr1,31760925,31761137,SRX5716469,SMARCA4,212
chr1,31760964,31761187,SRX5054307,FOSL2,223
chr1,31760970,31761265,SRX5075174,SMARCA4,295
chr1,31761008,31761202,SRX5716451,SOX2,194
chr1,31762594,31763017,SRX16500060,CTCF,423
chr1,31762636,31763036,SRX16500059,CTCF,400
chr1,31762636,31763066,SRX16500061,CTCF,430
chr1,31762651,31762996,SRX16500062,CTCF,345
chr1,31762698,31762965,SRX5075170,SMARCA4,267
chr1,31762715,31762963,SRX5075175,SMARCA4,248
chr1,31762732,31762991,SRX5075174,SMARCA4,259
chr1,31762746,31762928,SRX5075168,SMARCA4,182
chr1,31762769,31762972,SRX5075169,SMARCA4,203
chr1,31762781,31762956,SRX5075176,SMARCA4,175
chr1,31771941,31772222,SRX5075168,SMARCA4,281
chr1,31771992,31772266,SRX5075174,SMARCA4,274
chr1,31788317,31788905,SRX20140895,INTS13,588
chr1,31788350,31788890,SRX5075168,SMARCA4,540
chr1,31788391,31788841,SRX5075174,SMARCA4,450
chr1,31788444,31788904,SRX20140868,INTS10,460
chr1,31788526,31788749,SRX5716454,SOX3,223
chr1,31788933,31789554,SRX5075176,SMARCA4,621
chr1,31789011,31789554,SRX5716469,SMARCA4,543
chr1,31789060,31789678,SRX16500062,CTCF,618
chr1,31789062,31789628,SRX4174629,CTCF,566
chr1,31789111,31789401,SRX5716470,SMARCA4,290
chr1,31789117,31789663,SRX16500060,CTCF,546
chr1,31789120,31789530,SRX5075170,SMARCA4,410
chr1,31789132,31789664,SRX16500059,CTCF,532
chr1,31789155,31789630,SRX16500061,CTCF,475
chr1,31789176,31789475,SRX5075175,SMARCA4,299
chr1,31789225,31789486,SRX5075174,SMARCA4,261
chr1,31789250,31789516,SRX5075168,SMARCA4,266
chr1,31789277,31789493,SRX5075169,SMARCA4,216
chr1,31798501,31799065,SRX5075170,SMARCA4,564
chr1,31798605,31799103,SRX5075175,SMARCA4,498
chr1,31798619,31799069,SRX5075176,SMARCA4,450
chr1,31798642,31799085,SRX5075169,SMARCA4,443
chr1,31798690,31799033,SRX5054309,FOSL2,343
chr1,31798695,31798910,SRX5716467,SMARCA2,215
chr1,31798721,31798981,SRX5716469,SMARCA4,260
chr1,31798742,31799137,SRX5075168,SMARCA4,395
chr1,31798755,31798997,SRX5054308,FOSL2,242
chr1,31798767,31798998,SRX5075182,SMARCA2,231
chr1,31798779,31799004,SRX5075174,SMARCA4,225
chr1,31811646,31811977,SRX5075174,SMARCA4,331
chr1,31811674,31811899,SRX5075168,SMARCA4,225
chr1,31815792,31816236,SRX20140895,INTS13,444
chr1,31815906,31816421,SRX16500059,CTCF,515
chr1,31815940,31816217,SRX5075168,SMARCA4,277
chr1,31815960,31816412,SRX16500060,CTCF,452
chr1,31815962,31816321,SRX16500062,CTCF,359
chr1,31815972,31816397,SRX16500061,CTCF,425
chr1,31855490,31855876,SRX5075170,SMARCA4,386
chr1,31855504,31855837,SRX5075176,SMARCA4,333
chr1,31855514,31855848,SRX5054309,FOSL2,334
chr1,31855524,31855865,SRX5075175,SMARCA4,341
chr1,31855527,31855923,SRX5716470,SMARCA4,396
chr1,31855528,31855824,SRX5075169,SMARCA4,296
chr1,31855531,31855830,SRX5075168,SMARCA4,299
chr1,31855558,31855826,SRX5716469,SMARCA4,268
chr1,31855571,31855819,SRX5075174,SMARCA4,248
chr1,31855573,31855803,SRX5054308,FOSL2,230
chr1,31872885,31873177,SRX5075174,SMARCA4,292
chr1,31872938,31873130,SRX5075168,SMARCA4,192
chr1,31908361,31908611,SRX5075170,SMARCA4,250
chr1,31908366,31908638,SRX5075176,SMARCA4,272
chr1,31931658,31931937,SRX5075175,SMARCA4,279
chr1,31931663,31931983,SRX5075170,SMARCA4,320
chr1,31931699,31932034,SRX5075174,SMARCA4,335
chr1,31931702,31932001,SRX5054308,FOSL2,299
chr1,31931710,31931988,SRX5075169,SMARCA4,278
chr1,31931718,31931964,SRX5054309,FOSL2,246
chr1,31931721,31931949,SRX5075168,SMARCA4,228
chr1,31931740,31932006,SRX5075176,SMARCA4,266
chr1,31934754,31934987,SRX5054308,FOSL2,233
chr1,31934763,31934999,SRX5054309,FOSL2,236
chr1,31937852,31938767,SRX20140895,INTS13,915
chr1,31938230,31938707,SRX20140867,INTS10,477
chr1,31938231,31938529,SRX16500061,CTCF,298
chr1,31938232,31938574,SRX16500060,CTCF,342
chr1,31938235,31938611,SRX16500059,CTCF,376
chr1,31938258,31938512,SRX16500062,CTCF,254
chr1,31938268,31938706,SRX5075174,SMARCA4,438
chr1,31938307,31938667,SRX5075168,SMARCA4,360
chr1,31938320,31938715,SRX5075170,SMARCA4,395
chr1,31938322,31938683,SRX5716464,SMARCA4,361
chr1,31938370,31938740,SRX20140868,INTS10,370
chr1,31938373,31938659,SRX5075176,SMARCA4,286
chr1,31938374,31938593,SRX5075169,SMARCA4,219
chr1,31938379,31938610,SRX5054307,FOSL2,231
chr1,31939825,31940093,SRX5054309,FOSL2,268
chr1,31939826,31940101,SRX5054308,FOSL2,275
chr1,31939856,31940085,SRX5075176,SMARCA4,229
chr1,31939880,31940061,SRX5075170,SMARCA4,181
chr1,31944281,31944829,SRX5075174,SMARCA4,548
chr1,31944336,31944707,SRX5075170,SMARCA4,371
chr1,31944350,31944729,SRX5075175,SMARCA4,379
chr1,31944369,31944809,SRX5075176,SMARCA4,440
chr1,31944381,31944803,SRX5075168,SMARCA4,422
chr1,31944415,31944752,SRX5716470,SMARCA4,337
chr1,31944446,31944810,SRX20140895,INTS13,364
chr1,31944463,31944837,SRX20140868,INTS10,374
chr1,31944476,31944708,SRX20140867,INTS10,232
chr1,31944696,31945011,SRX5716469,SMARCA4,315
chr1,31944819,31945078,SRX5075170,SMARCA4,259
chr1,31954650,31954946,SRX5075176,SMARCA4,296
chr1,31954691,31954927,SRX5075170,SMARCA4,236
chr1,31954725,31954920,SRX5075169,SMARCA4,195
chr1,31955929,31956515,SRX5075175,SMARCA4,586
chr1,31955956,31956329,SRX5054308,FOSL2,373
chr1,31955961,31956322,SRX5054309,FOSL2,361
chr1,31955967,31956485,SRX5716469,SMARCA4,518
chr1,31955974,31956284,SRX5716468,SMARCA2,310
chr1,31955974,31956466,SRX5075176,SMARCA4,492
chr1,31955975,31956374,SRX5075169,SMARCA4,399
chr1,31955985,31956511,SRX5075170,SMARCA4,526
chr1,31955992,31956267,SRX5075174,SMARCA4,275
chr1,31956032,31956329,SRX5075168,SMARCA4,297
chr1,31956035,31956351,SRX5716467,SMARCA2,316
chr1,31956043,31956334,SRX5075182,SMARCA2,291
chr1,31956051,31956290,SRX5020211,SMARCA2,239
chr1,31956051,31956362,SRX5716470,SMARCA4,311
chr1,31956057,31956318,SRX5020214,SMARCA2,261
chr1,31964063,31964501,SRX16500062,CTCF,438
chr1,31964071,31964502,SRX16500059,CTCF,431
chr1,31964074,31964553,SRX4174629,CTCF,479
chr1,31964083,31964571,SRX16500060,CTCF,488
chr1,31964090,31964551,SRX16500061,CTCF,461
chr1,31964129,31964431,SRX5075176,SMARCA4,302
chr1,31964140,31964463,SRX5075174,SMARCA4,323
chr1,31964159,31964488,SRX5075170,SMARCA4,329
chr1,31964171,31964464,SRX5075168,SMARCA4,293
chr1,31977755,31978153,SRX16500060,CTCF,398
chr1,31978800,31979103,SRX5054309,FOSL2,303
chr1,31978822,31979064,SRX5054308,FOSL2,242
chr1,31978845,31979085,SRX5075169,SMARCA4,240
chr1,31987135,31987511,SRX5075170,SMARCA4,376
chr1,31987138,31987531,SRX5075169,SMARCA4,393
chr1,31987146,31987526,SRX5075176,SMARCA4,380
chr1,31987147,31987416,SRX5716470,SMARCA4,269
chr1,31987149,31987429,SRX5716469,SMARCA4,280
chr1,31987149,31987573,SRX5075175,SMARCA4,424
chr1,31991292,31991479,SRX5075176,SMARCA4,187
chr1,32002372,32002631,SRX5075170,SMARCA4,259
chr1,32003519,32004020,SRX16500062,CTCF,501
chr1,32003521,32004045,SRX16500059,CTCF,524
chr1,32003565,32003844,SRX5075168,SMARCA4,279
chr1,32003575,32003944,SRX16500061,CTCF,369
chr1,32003578,32003961,SRX16500060,CTCF,383
chr1,32003624,32003910,SRX5716464,SMARCA4,286
chr1,32013291,32013904,SRX5075174,SMARCA4,613
chr1,32013303,32013990,SRX5075170,SMARCA4,687
chr1,32013317,32013856,SRX5075168,SMARCA4,539
chr1,32013318,32014307,SRX20140895,INTS13,989
chr1,32013349,32013874,SRX5716464,SMARCA4,525
chr1,32013352,32013573,SRX5716469,SMARCA4,221
chr1,32013353,32013822,SRX5716463,SMARCA4,469
chr1,32013353,32014006,SRX5075176,SMARCA4,653
chr1,32013354,32013681,SRX5716470,SMARCA4,327
chr1,32013460,32014071,SRX20140897,INTS13,611
chr1,32013481,32013845,SRX5716454,SOX3,364
chr1,32013493,32013790,SRX5716451,SOX2,297
chr1,32013495,32013751,SRX5054307,FOSL2,256
chr1,32032050,32032338,SRX5075175,SMARCA4,288
chr1,32055473,32055832,SRX5075174,SMARCA4,359
chr1,32055477,32055763,SRX5075168,SMARCA4,286
chr1,32062366,32062895,SRX5075170,SMARCA4,529
chr1,32062369,32062971,SRX5075169,SMARCA4,602
chr1,32062389,32062892,SRX5075174,SMARCA4,503
chr1,32062390,32062854,SRX5075176,SMARCA4,464
chr1,32062410,32062893,SRX5716470,SMARCA4,483
chr1,32062430,32062838,SRX5075168,SMARCA4,408
chr1,32062437,32062659,SRX5716463,SMARCA4,222
chr1,32062439,32062863,SRX5075175,SMARCA4,424
chr1,32062466,32062838,SRX5716467,SMARCA2,372
chr1,32062475,32062730,SRX5716464,SMARCA4,255
chr1,32062492,32062690,SRX5054309,FOSL2,198
chr1,32062495,32063013,SRX5716469,SMARCA4,518
chr1,32062551,32062756,SRX5075181,SMARCA2,205
chr1,32063328,32063887,SRX16500059,CTCF,559
chr1,32063371,32063870,SRX16500060,CTCF,499
chr1,32063380,32063711,SRX5075168,SMARCA4,331
chr1,32063386,32063733,SRX5075176,SMARCA4,347
chr1,32063409,32063850,SRX16500061,CTCF,441
chr1,32063415,32063678,SRX5075174,SMARCA4,263
chr1,32063416,32063790,SRX16500062,CTCF,374
chr1,32063441,32063663,SRX5075169,SMARCA4,222
chr1,32063453,32063656,SRX5075170,SMARCA4,203
chr1,32071814,32072013,SRX5075175,SMARCA4,199
chr1,32071838,32072079,SRX5075169,SMARCA4,241
chr1,32072548,32072954,SRX5075176,SMARCA4,406
chr1,32072584,32073110,SRX5075170,SMARCA4,526
chr1,32072585,32073134,SRX5075168,SMARCA4,549
chr1,32072603,32073281,SRX20140895,INTS13,678
chr1,32072657,32072934,SRX5075174,SMARCA4,277
chr1,32072669,32072900,SRX5716463,SMARCA4,231
chr1,32072675,32073210,SRX20140868,INTS10,535
chr1,32072741,32073167,SRX20140869,INTS10,426
chr1,32072764,32073123,SRX20140867,INTS10,359
chr1,32072788,32073144,SRX20140897,INTS13,356
chr1,32072862,32073192,SRX20140879,CPSF3L,330
chr1,32072960,32073174,SRX5716469,SMARCA4,214
chr1,32072989,32073629,SRX5075174,SMARCA4,640
chr1,32073134,32073596,SRX16500059,CTCF,462
chr1,32073140,32073588,SRX16500060,CTCF,448
chr1,32073191,32073604,SRX5075168,SMARCA4,413
chr1,32073199,32073551,SRX16500062,CTCF,352
chr1,32073253,32073515,SRX4174629,CTCF,262
chr1,32073257,32073591,SRX16500061,CTCF,334
chr1,32073300,32073480,SRX5075170,SMARCA4,180
chr1,32073314,32073543,SRX5716464,SMARCA4,229
chr1,32073347,32073552,SRX5716454,SOX3,205
chr1,32073351,32073566,SRX5716463,SMARCA4,215
chr1,32101170,32101533,SRX5054309,FOSL2,363
chr1,32101182,32101488,SRX5054308,FOSL2,306
chr1,32101187,32101520,SRX5075175,SMARCA4,333
chr1,32101215,32101567,SRX5075169,SMARCA4,352
chr1,32101223,32101443,SRX5020214,SMARCA2,220
chr1,32101227,32101472,SRX5020211,SMARCA2,245
chr1,32107774,32108179,SRX20140895,INTS13,405
chr1,32107819,32108067,SRX5075174,SMARCA4,248
chr1,32107909,32108081,SRX5075170,SMARCA4,172
chr1,32107991,32108321,SRX20140897,INTS13,330
chr1,32109199,32109691,SRX16500062,CTCF,492
chr1,32109237,32109739,SRX16500061,CTCF,502
chr1,32109268,32109799,SRX16500059,CTCF,531
chr1,32109316,32109809,SRX16500060,CTCF,493
chr1,32133385,32133625,SRX5020211,SMARCA2,240
chr1,32133426,32133746,SRX5075170,SMARCA4,320
chr1,32133460,32133731,SRX5716470,SMARCA4,271
chr1,32133464,32133767,SRX5716469,SMARCA4,303
chr1,32133486,32133789,SRX5075176,SMARCA4,303
chr1,32133491,32133787,SRX5075169,SMARCA4,296
chr1,32133505,32133754,SRX5075175,SMARCA4,249
chr1,32133525,32133724,SRX5054308,FOSL2,199
chr1,32133551,32133769,SRX5716467,SMARCA2,218
chr1,32133583,32133790,SRX5054309,FOSL2,207
chr1,32138941,32139297,SRX5054308,FOSL2,356
chr1,32138958,32139223,SRX5075169,SMARCA4,265
chr1,32139000,32139323,SRX5054309,FOSL2,323
chr1,32142621,32143035,SRX5075176,SMARCA4,414
chr1,32142634,32143109,SRX5075174,SMARCA4,475
chr1,32142648,32142976,SRX5716470,SMARCA4,328
chr1,32142672,32143061,SRX5075170,SMARCA4,389
chr1,32142697,32143022,SRX5075169,SMARCA4,325
chr1,32142704,32143096,SRX5075168,SMARCA4,392
chr1,32142706,32142998,SRX5020211,SMARCA2,292
chr1,32142720,32142956,SRX5716467,SMARCA2,236
chr1,32142721,32143042,SRX5716464,SMARCA4,321
chr1,32142744,32142977,SRX5716468,SMARCA2,233
chr1,32142772,32143049,SRX5075175,SMARCA4,277
chr1,32151183,32151850,SRX5716469,SMARCA4,667
chr1,32151212,32151838,SRX5075170,SMARCA4,626
chr1,32151277,32151700,SRX5075175,SMARCA4,423
chr1,32151287,32151708,SRX5054309,FOSL2,421
chr1,32151289,32151614,SRX5054308,FOSL2,325
chr1,32151289,32151864,SRX5075176,SMARCA4,575
chr1,32151311,32151776,SRX5075169,SMARCA4,465
chr1,32151386,32151781,SRX5716467,SMARCA2,395
chr1,32151402,32151629,SRX5020214,SMARCA2,227
chr1,32151416,32151806,SRX5716470,SMARCA4,390
chr1,32151485,32151721,SRX5716468,SMARCA2,236
chr1,32179420,32180186,SRX5075168,SMARCA4,766
chr1,32179422,32180226,SRX20140895,INTS13,804
chr1,32179438,32180285,SRX5075174,SMARCA4,847
chr1,32179469,32179713,SRX5716464,SMARCA4,244
chr1,32179490,32180066,SRX20140868,INTS10,576
chr1,32179515,32180184,SRX5075176,SMARCA4,669
chr1,32179533,32180235,SRX5075170,SMARCA4,702
chr1,32179542,32179887,SRX20140897,INTS13,345
chr1,32179544,32180289,SRX5075175,SMARCA4,745
chr1,32179551,32179890,SRX20140879,CPSF3L,339
chr1,32179618,32180321,SRX20140867,INTS10,703
chr1,32179634,32179966,SRX20140869,INTS10,332
chr1,32179731,32180229,SRX5716469,SMARCA4,498
chr1,32179848,32180203,SRX5075169,SMARCA4,355
chr1,32179885,32180212,SRX16500060,CTCF,327
chr1,32179901,32180184,SRX16500059,CTCF,283
chr1,32180030,32180301,SRX20140869,INTS10,271
chr1,32180038,32180327,SRX20140897,INTS13,289
chr1,32200300,32200585,SRX5075170,SMARCA4,285
chr1,32200335,32200822,SRX5075174,SMARCA4,487
chr1,32200358,32200874,SRX5075168,SMARCA4,516
chr1,32200359,32200611,SRX5716463,SMARCA4,252
chr1,32200369,32200678,SRX5716469,SMARCA4,309
chr1,32200616,32200998,SRX20140895,INTS13,382
chr1,32200648,32200838,SRX5075170,SMARCA4,190
chr1,32200855,32201335,SRX5075175,SMARCA4,480
chr1,32201017,32201337,SRX5716470,SMARCA4,320
chr1,32201024,32201366,SRX5075170,SMARCA4,342
chr1,32201050,32201341,SRX5075176,SMARCA4,291
chr1,32201050,32201358,SRX5716469,SMARCA4,308
chr1,32201094,32201356,SRX5716467,SMARCA2,262
chr1,32201132,32201471,SRX5075169,SMARCA4,339
chr1,32205181,32205520,SRX16500059,CTCF,339
chr1,32205245,32205632,SRX16500060,CTCF,387
chr1,32205384,32205874,SRX20140895,INTS13,490
chr1,32205407,32205817,SRX5075174,SMARCA4,410
chr1,32205463,32205785,SRX20140867,INTS10,322
chr1,32205487,32205823,SRX5075168,SMARCA4,336
chr1,32215546,32216024,SRX16500060,CTCF,478
chr1,32215577,32216130,SRX16500059,CTCF,553
chr1,32215638,32216040,SRX16500062,CTCF,402
chr1,32215639,32216073,SRX16500061,CTCF,434
chr1,32215657,32215969,SRX5075168,SMARCA4,312
chr1,32215690,32215974,SRX5075174,SMARCA4,284
chr1,32215734,32215921,SRX5075175,SMARCA4,187
chr1,32215738,32215934,SRX5075170,SMARCA4,196
chr1,32221900,32222586,SRX5075174,SMARCA4,686
chr1,32221901,32222634,SRX5075168,SMARCA4,733
chr1,32221913,32222129,SRX5716469,SMARCA4,216
chr1,32221925,32222563,SRX5075170,SMARCA4,638
chr1,32221942,32222153,SRX5716470,SMARCA4,211
chr1,32222103,32222459,SRX5716463,SMARCA4,356
chr1,32222151,32222517,SRX5716464,SMARCA4,366
chr1,32222267,32222603,SRX5054309,FOSL2,336
chr1,32222302,32222653,SRX20140895,INTS13,351
chr1,32222312,32222551,SRX5075175,SMARCA4,239
chr1,32222337,32222571,SRX5054308,FOSL2,234
chr1,32236152,32236399,SRX5075175,SMARCA4,247
chr1,32241296,32241582,SRX20140895,INTS13,286
chr1,32241357,32241687,SRX5075168,SMARCA4,330
chr1,32241485,32241764,SRX5075169,SMARCA4,279
chr1,32241533,32241830,SRX5075174,SMARCA4,297
chr1,32241611,32241788,SRX5075176,SMARCA4,177
chr1,32248054,32248649,SRX16500062,CTCF,595
chr1,32248070,32248641,SRX16500059,CTCF,571
chr1,32248130,32248670,SRX16500060,CTCF,540
chr1,32248160,32248584,SRX16500061,CTCF,424
chr1,32248213,32248498,SRX5075174,SMARCA4,285
chr1,32248264,32248451,SRX5075168,SMARCA4,187
chr1,32249782,32250293,SRX5075168,SMARCA4,511
chr1,32267273,32267484,SRX5716470,SMARCA4,211
chr1,32267273,32267508,SRX5075175,SMARCA4,235
chr1,32267275,32267498,SRX5075169,SMARCA4,223
chr1,32267331,32267541,SRX5075170,SMARCA4,210
chr1,32282168,32282470,SRX5075176,SMARCA4,302
chr1,32282176,32282593,SRX5075170,SMARCA4,417
chr1,32291691,32292215,SRX5075174,SMARCA4,524
chr1,32291715,32292151,SRX5075168,SMARCA4,436
chr1,32291748,32292298,SRX5075176,SMARCA4,550
chr1,32291754,32292105,SRX5716463,SMARCA4,351
chr1,32291755,32292319,SRX20140868,INTS10,564
chr1,32291796,32292413,SRX5075170,SMARCA4,617
chr1,32291825,32292378,SRX20140895,INTS13,553
chr1,32291838,32292278,SRX5075169,SMARCA4,440
chr1,32291851,32292232,SRX5075175,SMARCA4,381
chr1,32291914,32292129,SRX5716467,SMARCA2,215
chr1,32291975,32292252,SRX5716470,SMARCA4,277
chr1,32291996,32292270,SRX20140869,INTS10,274
chr1,32307435,32307632,SRX5054308,FOSL2,197
chr1,32316486,32316818,SRX16500060,CTCF,332
chr1,32316491,32316874,SRX16500059,CTCF,383
chr1,32316576,32316809,SRX16500062,CTCF,233
chr1,32335094,32335527,SRX16500060,CTCF,433
chr1,32335108,32335462,SRX16500059,CTCF,354
chr1,32335161,32335341,SRX5075169,SMARCA4,180
chr1,32335161,32335507,SRX16500062,CTCF,346
chr1,32335162,32335428,SRX16500061,CTCF,266
chr1,32335195,32335381,SRX5075174,SMARCA4,186
chr1,32335221,32335395,SRX5075170,SMARCA4,174
chr1,32335241,32335475,SRX5075175,SMARCA4,234
chr1,32335782,32336503,SRX20140895,INTS13,721
chr1,32335812,32336474,SRX20140868,INTS10,662
chr1,32335881,32336463,SRX20140897,INTS13,582
chr1,32335889,32336436,SRX20140867,INTS10,547
chr1,32335914,32336388,SRX20140880,CPSF3L,474
chr1,32335920,32336220,SRX20140870,INTS10,300
chr1,32335924,32336314,SRX20140869,INTS10,390
chr1,32335933,32336415,SRX20140881,CPSF3L,482
chr1,32335957,32336414,SRX20140879,CPSF3L,457
chr1,32335987,32336401,SRX20140896,INTS13,414
chr1,32336047,32336437,SRX20140894,INTS13,390
chr1,32336108,32336418,SRX5075168,SMARCA4,310
chr1,32336130,32336377,SRX5075174,SMARCA4,247
chr1,32336189,32336372,SRX5075170,SMARCA4,183
chr1,32338393,32338613,SRX5075168,SMARCA4,220
chr1,32338439,32338620,SRX5075176,SMARCA4,181
chr1,32345498,32345801,SRX5075176,SMARCA4,303
chr1,32345512,32345793,SRX5075170,SMARCA4,281
chr1,32349244,32349435,SRX5075169,SMARCA4,191
chr1,32349251,32349457,SRX5075170,SMARCA4,206
chr1,32351063,32351396,SRX16500062,CTCF,333
chr1,32351063,32351471,SRX16500059,CTCF,408
chr1,32351071,32351459,SRX16500061,CTCF,388
chr1,32351085,32351435,SRX16500060,CTCF,350
chr1,32351120,32351402,SRX4174629,CTCF,282
chr1,32351203,32351408,SRX5716464,SMARCA4,205
chr1,32351269,32351754,SRX5716463,SMARCA4,485
chr1,32351304,32351811,SRX5075174,SMARCA4,507
chr1,32351384,32352054,SRX20140895,INTS13,670
chr1,32351436,32351954,SRX20140868,INTS10,518
chr1,32351473,32351834,SRX5075168,SMARCA4,361
chr1,32351473,32351931,SRX20140897,INTS13,458
chr1,32351486,32351887,SRX20140867,INTS10,401
chr1,32351496,32351796,SRX5075170,SMARCA4,300
chr1,32351510,32351771,SRX5716464,SMARCA4,261
chr1,32351530,32351829,SRX5075175,SMARCA4,299
chr1,32351563,32351813,SRX5075176,SMARCA4,250
chr1,32351572,32351950,SRX20140879,CPSF3L,378
chr1,32351580,32351832,SRX5075169,SMARCA4,252
chr1,32351644,32351903,SRX5716470,SMARCA4,259
chr1,32379826,32380314,SRX20140867,INTS10,488
chr1,32379903,32380387,SRX20140895,INTS13,484
chr1,32394095,32394438,SRX20140897,INTS13,343
chr1,32394225,32395085,SRX20140867,INTS10,860
chr1,32394229,32395102,SRX5075176,SMARCA4,873
chr1,32394342,32394585,SRX5054309,FOSL2,243
chr1,32394362,32394623,SRX5054308,FOSL2,261
chr1,32394375,32394739,SRX5054307,FOSL2,364
chr1,32394416,32395003,SRX5075174,SMARCA4,587
chr1,32394467,32395058,SRX5075168,SMARCA4,591
chr1,32394474,32395175,SRX20140895,INTS13,701
chr1,32394511,32394942,SRX5075170,SMARCA4,431
chr1,32394511,32394963,SRX5716451,SOX2,452
chr1,32394516,32394984,SRX5716463,SMARCA4,468
chr1,32394525,32394859,SRX5716464,SMARCA4,334
chr1,32394533,32394914,SRX20140869,INTS10,381
chr1,32394560,32394876,SRX20140897,INTS13,316
chr1,32394564,32394948,SRX5716454,SOX3,384
chr1,32394570,32394821,SRX5716469,SMARCA4,251
chr1,32394615,32394951,SRX20140881,CPSF3L,336
chr1,32394626,32395054,SRX5716470,SMARCA4,428
chr1,32394686,32395037,SRX20140879,CPSF3L,351
chr1,32394690,32395114,SRX20140868,INTS10,424
chr1,32394797,32395193,SRX5075169,SMARCA4,396
chr1,32400740,32401285,SRX16500060,CTCF,545
chr1,32400742,32401200,SRX16500062,CTCF,458
chr1,32400746,32401331,SRX16500059,CTCF,585
chr1,32400806,32401240,SRX16500061,CTCF,434
chr1,32400851,32401291,SRX4174629,CTCF,440
chr1,32400885,32401137,SRX5075168,SMARCA4,252
chr1,32400889,32401256,SRX5075170,SMARCA4,367
chr1,32400890,32401260,SRX5075176,SMARCA4,370
chr1,32400893,32401231,SRX5075169,SMARCA4,338
chr1,32400895,32401246,SRX5075174,SMARCA4,351
chr1,32400915,32401119,SRX5716463,SMARCA4,204
chr1,32400941,32401238,SRX5075175,SMARCA4,297
chr1,32401046,32401260,SRX5716470,SMARCA4,214
chr1,32413935,32414354,SRX16500061,CTCF,419
chr1,32413942,32414390,SRX16500059,CTCF,448
chr1,32413954,32414351,SRX16500060,CTCF,397
chr1,32413956,32414335,SRX16500062,CTCF,379
chr1,32413962,32414282,SRX4174629,CTCF,320
chr1,32414016,32414293,SRX5075174,SMARCA4,277
chr1,32447916,32448124,SRX5075170,SMARCA4,208
chr1,32447931,32448232,SRX5716470,SMARCA4,301
chr1,32447960,32448141,SRX5075169,SMARCA4,181
chr1,32447987,32448226,SRX5716469,SMARCA4,239
chr1,32447993,32448253,SRX5075174,SMARCA4,260
chr1,32448011,32448231,SRX5075176,SMARCA4,220
chr1,32448176,32448759,SRX16500060,CTCF,583
chr1,32448186,32448821,SRX16500059,CTCF,635
chr1,32448189,32448747,SRX16500061,CTCF,558
chr1,32448256,32448780,SRX16500062,CTCF,524
chr1,32448336,32448645,SRX5075174,SMARCA4,309
chr1,32448339,32448631,SRX4174629,CTCF,292
chr1,32448374,32448555,SRX5075170,SMARCA4,181
chr1,32448427,32448656,SRX5075168,SMARCA4,229
chr1,32449162,32449505,SRX16500060,CTCF,343
chr1,32449168,32449522,SRX16500062,CTCF,354
chr1,32449193,32449479,SRX16500059,CTCF,286
chr1,32449245,32449512,SRX16500061,CTCF,267
chr1,32464559,32464845,SRX20140868,INTS10,286
chr1,32464577,32465206,SRX20140895,INTS13,629
chr1,32464621,32464920,SRX5075176,SMARCA4,299
chr1,32464634,32465415,SRX5075168,SMARCA4,781
chr1,32464648,32465220,SRX5075174,SMARCA4,572
chr1,32464781,32465078,SRX5054307,FOSL2,297
chr1,32464803,32465091,SRX16500060,CTCF,288
chr1,32464831,32465111,SRX5716463,SMARCA4,280
chr1,32464843,32465077,SRX16500061,CTCF,234
chr1,32464860,32465084,SRX5716454,SOX3,224
chr1,32496183,32496496,SRX5075176,SMARCA4,313
chr1,32496272,32496510,SRX5075170,SMARCA4,238
chr1,32500266,32501040,SRX20140895,INTS13,774
chr1,32500382,32500644,SRX5075170,SMARCA4,262
chr1,32500400,32501003,SRX20140868,INTS10,603
chr1,32500428,32501003,SRX5075169,SMARCA4,575
chr1,32500457,32501009,SRX20140867,INTS10,552
chr1,32500486,32500848,SRX20140897,INTS13,362
chr1,32500554,32500876,SRX5075168,SMARCA4,322
chr1,32500593,32500818,SRX5716469,SMARCA4,225
chr1,32500613,32500991,SRX5075175,SMARCA4,378
chr1,32500626,32501072,SRX5075174,SMARCA4,446
chr1,32500727,32500950,SRX5075170,SMARCA4,223
chr1,32500746,32501092,SRX16500059,CTCF,346
chr1,32520333,32520873,SRX16500060,CTCF,540
chr1,32520334,32520888,SRX16500059,CTCF,554
chr1,32520342,32520810,SRX16500062,CTCF,468
chr1,32520362,32520848,SRX16500061,CTCF,486
chr1,32520426,32520757,SRX5716470,SMARCA4,331
chr1,32520435,32520802,SRX5075169,SMARCA4,367
chr1,32520439,32520741,SRX5716463,SMARCA4,302
chr1,32520450,32520761,SRX5075168,SMARCA4,311
chr1,32520460,32520728,SRX5075170,SMARCA4,268
chr1,32520461,32520755,SRX5075174,SMARCA4,294
chr1,32520462,32520709,SRX5716464,SMARCA4,247
chr1,32520474,32520823,SRX5075176,SMARCA4,349
chr1,32520485,32520700,SRX5075175,SMARCA4,215
chr1,32520514,32520815,SRX5716469,SMARCA4,301
chr1,32539109,32539317,SRX5075169,SMARCA4,208
chr1,32539177,32539364,SRX5075174,SMARCA4,187
chr1,32539177,32539450,SRX5075170,SMARCA4,273
chr1,32539207,32539405,SRX5075168,SMARCA4,198
chr1,32539236,32539638,SRX20140895,INTS13,402
chr1,32539239,32539511,SRX20140868,INTS10,272
chr1,32539375,32539607,SRX20140867,INTS10,232
chr1,32539836,32540145,SRX20140895,INTS13,309
chr1,32539893,32540108,SRX5075169,SMARCA4,215
chr1,32539894,32540117,SRX5075175,SMARCA4,223
chr1,32539930,32540187,SRX5716469,SMARCA4,257
chr1,32539943,32540185,SRX5075168,SMARCA4,242
chr1,32539948,32540157,SRX5075176,SMARCA4,209
chr1,32593050,32593233,SRX5054309,FOSL2,183
chr1,32612245,32612543,SRX5075169,SMARCA4,298
chr1,32636867,32637120,SRX5075168,SMARCA4,253
chr1,32650335,32651304,SRX5075174,SMARCA4,969
chr1,32650338,32651102,SRX5075168,SMARCA4,764
chr1,32650502,32651116,SRX20140869,INTS10,614
chr1,32650526,32651464,SRX20140897,INTS13,938
chr1,32650531,32651617,SRX20140895,INTS13,1086
chr1,32650568,32651691,SRX20140868,INTS10,1123
chr1,32650605,32651333,SRX20140881,CPSF3L,728
chr1,32650627,32650933,SRX20140879,CPSF3L,306
chr1,32650636,32651536,SRX20140867,INTS10,900
chr1,32650680,32651113,SRX20140894,INTS13,433
chr1,32650700,32651096,SRX20140896,INTS13,396
chr1,32650726,32651215,SRX5075176,SMARCA4,489
chr1,32650877,32651187,SRX5075170,SMARCA4,310
chr1,32651011,32651232,SRX5054307,FOSL2,221
chr1,32684212,32684498,SRX5075176,SMARCA4,286
chr1,32684248,32684460,SRX5075170,SMARCA4,212
chr1,32702648,32702968,SRX5075170,SMARCA4,320
chr1,32702660,32702905,SRX5075175,SMARCA4,245
chr1,32702695,32702982,SRX5075176,SMARCA4,287
chr1,32703349,32703908,SRX5075170,SMARCA4,559
chr1,32703354,32703839,SRX5075176,SMARCA4,485
chr1,32703365,32703826,SRX5716467,SMARCA2,461
chr1,32703367,32703968,SRX5075169,SMARCA4,601
chr1,32703373,32703953,SRX5716469,SMARCA4,580
chr1,32703400,32704081,SRX5075175,SMARCA4,681
chr1,32703401,32703868,SRX5716470,SMARCA4,467
chr1,32703411,32703811,SRX5716468,SMARCA2,400
chr1,32703447,32703719,SRX5075181,SMARCA2,272
chr1,32703478,32703770,SRX5054308,FOSL2,292
chr1,32703526,32703774,SRX5054309,FOSL2,248
chr1,32712073,32712578,SRX16500060,CTCF,505
chr1,32712102,32712640,SRX4174629,CTCF,538
chr1,32712104,32712645,SRX16500059,CTCF,541
chr1,32712118,32712631,SRX16500062,CTCF,513
chr1,32712119,32712590,SRX16500061,CTCF,471
chr1,32712183,32712486,SRX5716463,SMARCA4,303
chr1,32712187,32712534,SRX5075168,SMARCA4,347
chr1,32712188,32712484,SRX5716464,SMARCA4,296
chr1,32712203,32712553,SRX5075170,SMARCA4,350
chr1,32712225,32712583,SRX5075174,SMARCA4,358
chr1,32712229,32712476,SRX5075169,SMARCA4,247
chr1,32712230,32712529,SRX5075175,SMARCA4,299
chr1,32712258,32712518,SRX5075176,SMARCA4,260
chr1,32712296,32712513,SRX5716470,SMARCA4,217
chr1,32725083,32725590,SRX5075176,SMARCA4,507
chr1,32725131,32725554,SRX5075170,SMARCA4,423
chr1,32725138,32725531,SRX5075169,SMARCA4,393
chr1,32725211,32725512,SRX5075175,SMARCA4,301
chr1,32725224,32725510,SRX5716467,SMARCA2,286
chr1,32725251,32725519,SRX5716469,SMARCA4,268
chr1,32725257,32725488,SRX5054309,FOSL2,231
chr1,32725276,32725456,SRX5054308,FOSL2,180
chr1,32733915,32734279,SRX5075168,SMARCA4,364
chr1,32734027,32734284,SRX5075174,SMARCA4,257
chr1,32741399,32741664,SRX16500059,CTCF,265
chr1,32741421,32741642,SRX16500060,CTCF,221
chr1,32741454,32741819,SRX5075175,SMARCA4,365
chr1,32741510,32741743,SRX5075168,SMARCA4,233
chr1,32741525,32741729,SRX5716463,SMARCA4,204
chr1,32753607,32754300,SRX20140895,INTS13,693
chr1,32753691,32754129,SRX5075174,SMARCA4,438
chr1,32753696,32753969,SRX5716469,SMARCA4,273
chr1,32753721,32754089,SRX5075170,SMARCA4,368
chr1,32753721,32754149,SRX5075168,SMARCA4,428
chr1,32753725,32754172,SRX5075176,SMARCA4,447
chr1,32753743,32754131,SRX5716463,SMARCA4,388
chr1,32753795,32754143,SRX5075175,SMARCA4,348
chr1,32753798,32754046,SRX5716464,SMARCA4,248
chr1,32753852,32754186,SRX5075169,SMARCA4,334
chr1,32754137,32754390,SRX16500061,CTCF,253
chr1,32754908,32755120,SRX5075174,SMARCA4,212
chr1,32769535,32769806,SRX5075176,SMARCA4,271
chr1,32769562,32769769,SRX5054309,FOSL2,207
chr1,32769565,32769766,SRX5075170,SMARCA4,201
chr1,32769578,32769791,SRX5075169,SMARCA4,213
chr1,32772928,32773411,SRX16500060,CTCF,483
chr1,32772952,32773463,SRX16500059,CTCF,511
chr1,32772979,32773393,SRX4174629,CTCF,414
chr1,32772979,32773436,SRX16500061,CTCF,457
chr1,32772985,32773432,SRX16500062,CTCF,447
chr1,32773030,32773238,SRX5075174,SMARCA4,208
chr1,32773042,32773260,SRX5075168,SMARCA4,218
chr1,32775283,32776049,SRX5075176,SMARCA4,766
chr1,32775288,32776056,SRX5075175,SMARCA4,768
chr1,32775300,32776048,SRX5075169,SMARCA4,748
chr1,32775329,32776041,SRX5075170,SMARCA4,712
chr1,32775773,32776035,SRX5054309,FOSL2,262
chr1,32775831,32776025,SRX5054308,FOSL2,194
chr1,32782138,32782384,SRX5075175,SMARCA4,246
chr1,32782171,32782408,SRX5075176,SMARCA4,237
chr1,32782175,32782461,SRX5075169,SMARCA4,286
chr1,32782250,32782423,SRX5075170,SMARCA4,173
chr1,32786891,32787305,SRX16500059,CTCF,414
chr1,32786893,32787305,SRX16500060,CTCF,412
chr1,32786916,32787287,SRX16500062,CTCF,371
chr1,32786936,32787207,SRX16500061,CTCF,271
chr1,32789299,32789613,SRX5075175,SMARCA4,314
chr1,32789375,32789649,SRX5075169,SMARCA4,274
chr1,32789377,32789662,SRX5054309,FOSL2,285
chr1,32789393,32789652,SRX5054308,FOSL2,259
chr1,32789401,32789579,SRX5075176,SMARCA4,178
chr1,32789419,32789645,SRX5075170,SMARCA4,226
chr1,32795776,32795963,SRX5075175,SMARCA4,187
chr1,32795801,32796065,SRX5054308,FOSL2,264
chr1,32801213,32801411,SRX5054308,FOSL2,198
chr1,32817251,32817491,SRX5716470,SMARCA4,240
chr1,32817267,32817681,SRX5075168,SMARCA4,414
chr1,32817272,32817704,SRX5075170,SMARCA4,432
chr1,32817279,32818468,SRX20140895,INTS13,1189
chr1,32817282,32817777,SRX5075174,SMARCA4,495
chr1,32817293,32817551,SRX5054309,FOSL2,258
chr1,32817298,32817478,SRX5075169,SMARCA4,180
chr1,32817305,32817517,SRX5716469,SMARCA4,212
chr1,32817305,32817609,SRX5075176,SMARCA4,304
chr1,32817310,32817595,SRX5054307,FOSL2,285
chr1,32817325,32817626,SRX5716464,SMARCA4,301
chr1,32817332,32817798,SRX20140897,INTS13,466
chr1,32817366,32817699,SRX5075175,SMARCA4,333
chr1,32817383,32817667,SRX5716463,SMARCA4,284
chr1,32817417,32818344,SRX20140867,INTS10,927
chr1,32817468,32817793,SRX20140896,INTS13,325
chr1,32817513,32818245,SRX20140868,INTS10,732
chr1,32817567,32817866,SRX20140879,CPSF3L,299
chr1,32818082,32818325,SRX5075168,SMARCA4,243
chr1,32818098,32818362,SRX5075170,SMARCA4,264
chr1,32818265,32818454,SRX5075176,SMARCA4,189
chr1,32828353,32828730,SRX16500060,CTCF,377
chr1,32828452,32828675,SRX16500062,CTCF,223
chr1,32828482,32828715,SRX16500061,CTCF,233
chr1,32870481,32870766,SRX5716467,SMARCA2,285
chr1,32870486,32870799,SRX5716470,SMARCA4,313
chr1,32870504,32870807,SRX5075170,SMARCA4,303
chr1,32870507,32870810,SRX5716469,SMARCA4,303
chr1,32870511,32870797,SRX5075169,SMARCA4,286
chr1,32870520,32870798,SRX5075176,SMARCA4,278
chr1,32870530,32870774,SRX5075174,SMARCA4,244
chr1,32870535,32870778,SRX5716468,SMARCA2,243
chr1,32870545,32870811,SRX5075175,SMARCA4,266
chr1,32870547,32870739,SRX5075168,SMARCA4,192
chr1,32872506,32872861,SRX5075176,SMARCA4,355
chr1,32872544,32872822,SRX5020211,SMARCA2,278
chr1,32872574,32872780,SRX5075169,SMARCA4,206
chr1,32872583,32872879,SRX5075170,SMARCA4,296
chr1,32872587,32873054,SRX16500060,CTCF,467
chr1,32872609,32873033,SRX16500062,CTCF,424
chr1,32872611,32873032,SRX16500059,CTCF,421
chr1,32872626,32872922,SRX5075168,SMARCA4,296
chr1,32872643,32873013,SRX16500061,CTCF,370
chr1,32872651,32872953,SRX4174629,CTCF,302
chr1,32872652,32872941,SRX5716463,SMARCA4,289
chr1,32872661,32872957,SRX5075174,SMARCA4,296
chr1,32876631,32877021,SRX16500059,CTCF,390
chr1,32876641,32877016,SRX16500061,CTCF,375
chr1,32876649,32876971,SRX16500062,CTCF,322
chr1,32876698,32877017,SRX16500060,CTCF,319
chr1,32886433,32886885,SRX5716470,SMARCA4,452
chr1,32886454,32886859,SRX5075169,SMARCA4,405
chr1,32886471,32886825,SRX5716469,SMARCA4,354
chr1,32886488,32886857,SRX5075176,SMARCA4,369
chr1,32886498,32886867,SRX5075170,SMARCA4,369
chr1,32886500,32886856,SRX5075175,SMARCA4,356
chr1,32886514,32886834,SRX5716463,SMARCA4,320
chr1,32886529,32886819,SRX5716464,SMARCA4,290
chr1,32886532,32886812,SRX5075174,SMARCA4,280
chr1,32886549,32886810,SRX5075181,SMARCA2,261
chr1,32886565,32886948,SRX16500060,CTCF,383
chr1,32886566,32886885,SRX16500059,CTCF,319
chr1,32886574,32886891,SRX5075168,SMARCA4,317
chr1,32886613,32886904,SRX16500061,CTCF,291
chr1,32886620,32886830,SRX16500062,CTCF,210
chr1,32892758,32893070,SRX4174629,CTCF,312
chr1,32892773,32893460,SRX16500062,CTCF,687
chr1,32892779,32893392,SRX16500059,CTCF,613
chr1,32892791,32893557,SRX16500060,CTCF,766
chr1,32892807,32893529,SRX16500061,CTCF,722
chr1,32892824,32893161,SRX5716463,SMARCA4,337
chr1,32892843,32893206,SRX5075168,SMARCA4,363
chr1,32892885,32893359,SRX5075174,SMARCA4,474
chr1,32892965,32893176,SRX5075176,SMARCA4,211
chr1,32892984,32893273,SRX5075169,SMARCA4,289
chr1,32893050,32893292,SRX5716470,SMARCA4,242
chr1,32893118,32893651,SRX20140895,INTS13,533
chr1,32893146,32893433,SRX4174629,CTCF,287
chr1,32901039,32901449,SRX5075170,SMARCA4,410
chr1,32901204,32901728,SRX5075169,SMARCA4,524
chr1,32918346,32918569,SRX20140867,INTS10,223
chr1,32919675,32920314,SRX5075176,SMARCA4,639
chr1,32919743,32920211,SRX5075170,SMARCA4,468
chr1,32919787,32920151,SRX5075169,SMARCA4,364
chr1,32919841,32920290,SRX5075175,SMARCA4,449
chr1,32919858,32920136,SRX5716470,SMARCA4,278
chr1,32919882,32920091,SRX5054309,FOSL2,209
chr1,32919891,32920109,SRX5716467,SMARCA2,218
chr1,32919904,32920101,SRX5054308,FOSL2,197
chr1,32924711,32924956,SRX16500060,CTCF,245
chr1,32924770,32925078,SRX16500059,CTCF,308
chr1,32924797,32925062,SRX16500062,CTCF,265
chr1,32924900,32925073,SRX5075174,SMARCA4,173
chr1,32933367,32933894,SRX16500061,CTCF,527
chr1,32933384,32933938,SRX16500059,CTCF,554
chr1,32933387,32933977,SRX16500060,CTCF,590
chr1,32933430,32933910,SRX16500062,CTCF,480
chr1,32933477,32933725,SRX5075174,SMARCA4,248
chr1,32933615,32933795,SRX5075169,SMARCA4,180
chr1,32939560,32940008,SRX5075170,SMARCA4,448
chr1,32939600,32939903,SRX5075176,SMARCA4,303
chr1,32939615,32939887,SRX5054309,FOSL2,272
chr1,32939646,32940112,SRX5075169,SMARCA4,466
chr1,32939651,32940042,SRX5075175,SMARCA4,391
chr1,32939672,32939933,SRX5054308,FOSL2,261
chr1,32953449,32953792,SRX5075169,SMARCA4,343
chr1,32953464,32953814,SRX5075176,SMARCA4,350
chr1,32953508,32953764,SRX5075175,SMARCA4,256
chr1,32953510,32953822,SRX5075170,SMARCA4,312
chr1,32964568,32965170,SRX20140895,INTS13,602
chr1,32964575,32965107,SRX20140868,INTS10,532
chr1,32964610,32965034,SRX20140867,INTS10,424
chr1,32964640,32965112,SRX20140879,CPSF3L,472
chr1,32964647,32964992,SRX20140894,INTS13,345
chr1,32964672,32965083,SRX20140897,INTS13,411
chr1,32964675,32964937,SRX20140880,CPSF3L,262
chr1,32964679,32965053,SRX5075169,SMARCA4,374
chr1,32964691,32965184,SRX5075174,SMARCA4,493
chr1,32964733,32965069,SRX20140881,CPSF3L,336
chr1,32964747,32965037,SRX20140896,INTS13,290
chr1,32964782,32965199,SRX5075168,SMARCA4,417
chr1,32964803,32965187,SRX5075170,SMARCA4,384
chr1,32964875,32965130,SRX5075176,SMARCA4,255
chr1,32964928,32965154,SRX5716463,SMARCA4,226
chr1,32972770,32973373,SRX5075174,SMARCA4,603
chr1,32972808,32973313,SRX5075168,SMARCA4,505
chr1,32972852,32973331,SRX5075176,SMARCA4,479
chr1,32972858,32973402,SRX20140895,INTS13,544
chr1,32972888,32973338,SRX5075170,SMARCA4,450
chr1,32972903,32973355,SRX5075169,SMARCA4,452
chr1,32972921,32973199,SRX5716464,SMARCA4,278
chr1,32972959,32973354,SRX5716470,SMARCA4,395
chr1,32972999,32973243,SRX20140897,INTS13,244
chr1,32973030,32973277,SRX5716469,SMARCA4,247
chr1,32973067,32973400,SRX5075175,SMARCA4,333
chr1,32981180,32981390,SRX5054309,FOSL2,210
chr1,32981191,32981440,SRX5075169,SMARCA4,249
chr1,32981201,32981536,SRX5075175,SMARCA4,335
chr1,32981231,32981453,SRX5075170,SMARCA4,222
chr1,32981246,32981465,SRX5075176,SMARCA4,219
chr1,32984412,32984677,SRX5075168,SMARCA4,265
chr1,32984465,32984756,SRX5075174,SMARCA4,291
chr1,32989217,32989899,SRX5075170,SMARCA4,682
chr1,32989241,32989996,SRX5075176,SMARCA4,755
chr1,32989295,32989613,SRX5716470,SMARCA4,318
chr1,32989297,32989637,SRX5075169,SMARCA4,340
chr1,32989312,32989658,SRX5054308,FOSL2,346
chr1,32989322,32989637,SRX5054309,FOSL2,315
chr1,32989330,32989593,SRX5020211,SMARCA2,263
chr1,32989336,32989651,SRX5075175,SMARCA4,315
chr1,32989338,32989665,SRX5716469,SMARCA4,327
chr1,32989407,32989612,SRX5020214,SMARCA2,205
chr1,32989471,32989921,SRX5716467,SMARCA2,450
chr1,32991478,32991658,SRX5054308,FOSL2,180
chr1,32992386,32992776,SRX5075175,SMARCA4,390
chr1,32992407,32992705,SRX5716469,SMARCA4,298
chr1,32992438,32992707,SRX5716468,SMARCA2,269
chr1,32992440,32992772,SRX5075169,SMARCA4,332
chr1,32992460,32992690,SRX5075170,SMARCA4,230
chr1,32992468,32992763,SRX5716470,SMARCA4,295
chr1,32997341,32997804,SRX5054309,FOSL2,463
chr1,32997449,32997629,SRX5054308,FOSL2,180
chr1,32997492,32997763,SRX5075169,SMARCA4,271
chr1,32997664,32997851,SRX5075175,SMARCA4,187
chr1,33007157,33007536,SRX16500059,CTCF,379
chr1,33007186,33007573,SRX16500062,CTCF,387
chr1,33007187,33007546,SRX16500060,CTCF,359
chr1,33007193,33007573,SRX5075176,SMARCA4,380
chr1,33007225,33007609,SRX5075174,SMARCA4,384
chr1,33007245,33007513,SRX16500061,CTCF,268
chr1,33007251,33007595,SRX5075170,SMARCA4,344
chr1,33007258,33007589,SRX5075175,SMARCA4,331
chr1,33007263,33007558,SRX5075168,SMARCA4,295
chr1,33007263,33007593,SRX5054309,FOSL2,330
chr1,33007266,33007542,SRX5075169,SMARCA4,276
chr1,33007297,33007564,SRX5054308,FOSL2,267
chr1,33007366,33007460,SRX1424891,POU3F2,94
chr1,33007374,33007431,SRX1424892,POU3F2,57
chr1,33036528,33036759,SRX5075169,SMARCA4,231
chr1,33036597,33037123,SRX20140895,INTS13,526
chr1,33036884,33037092,SRX5054307,FOSL2,208
chr1,33036947,33037246,SRX5075170,SMARCA4,299
chr1,33036984,33037200,SRX5075174,SMARCA4,216
chr1,33037007,33037186,SRX5075168,SMARCA4,179
chr1,33048103,33048326,SRX5054309,FOSL2,223
chr1,33050244,33050465,SRX5075170,SMARCA4,221
chr1,33050256,33050444,SRX5054308,FOSL2,188
chr1,33055099,33055589,SRX16500059,CTCF,490
chr1,33055101,33055574,SRX16500062,CTCF,473
chr1,33055114,33055616,SRX16500061,CTCF,502
chr1,33055114,33055771,SRX16500060,CTCF,657
chr1,33055141,33055346,SRX5716463,SMARCA4,205
chr1,33055157,33055457,SRX5075168,SMARCA4,300
chr1,33055181,33055386,SRX5716464,SMARCA4,205
chr1,33055189,33055398,SRX5075176,SMARCA4,209
chr1,33055209,33055441,SRX5075174,SMARCA4,232
chr1,33055272,33055492,SRX5716470,SMARCA4,220
chr1,33060492,33061211,SRX5075176,SMARCA4,719
chr1,33060519,33061067,SRX5075169,SMARCA4,548
chr1,33060524,33060992,SRX5716470,SMARCA4,468
chr1,33060524,33061160,SRX5075181,SMARCA2,636
chr1,33060558,33061116,SRX5020211,SMARCA2,558
chr1,33060563,33061067,SRX5716467,SMARCA2,504
chr1,33060567,33061077,SRX5716469,SMARCA4,510
chr1,33060580,33061079,SRX5054309,FOSL2,499
chr1,33060592,33061162,SRX5075170,SMARCA4,570
chr1,33060594,33061128,SRX5054308,FOSL2,534
chr1,33060600,33061078,SRX5075175,SMARCA4,478
chr1,33060686,33060961,SRX5020214,SMARCA2,275
chr1,33072767,33072974,SRX5075175,SMARCA4,207
chr1,33072772,33073042,SRX5075169,SMARCA4,270
chr1,33072776,33072960,SRX5075170,SMARCA4,184
chr1,33072837,33073130,SRX5054308,FOSL2,293
chr1,33072874,33073069,SRX5075176,SMARCA4,195
chr1,33080803,33081275,SRX5075174,SMARCA4,472
chr1,33080812,33081358,SRX5075176,SMARCA4,546
chr1,33080850,33081314,SRX5075170,SMARCA4,464
chr1,33080851,33081060,SRX5075169,SMARCA4,209
chr1,33080862,33081330,SRX5075168,SMARCA4,468
chr1,33080882,33081214,SRX5716463,SMARCA4,332
chr1,33080885,33081419,SRX20140895,INTS13,534
chr1,33080910,33081374,SRX20140897,INTS13,464
chr1,33080914,33081280,SRX5716464,SMARCA4,366
chr1,33080935,33081401,SRX20140879,CPSF3L,466
chr1,33080940,33081206,SRX5075175,SMARCA4,266
chr1,33080977,33081359,SRX20140868,INTS10,382
chr1,33080992,33081404,SRX20140894,INTS13,412
chr1,33080998,33081224,SRX20140867,INTS10,226
chr1,33081038,33081336,SRX20140896,INTS13,298
chr1,33081122,33081360,SRX5075169,SMARCA4,238
chr1,33081123,33081468,SRX20140881,CPSF3L,345
chr1,33086273,33086770,SRX16500060,CTCF,497
chr1,33086297,33086761,SRX16500059,CTCF,464
chr1,33086335,33086776,SRX16500062,CTCF,441
chr1,33086343,33086714,SRX16500061,CTCF,371
chr1,33086347,33086627,SRX4174629,CTCF,280
chr1,33086415,33086594,SRX5075168,SMARCA4,179
chr1,33086420,33086629,SRX5075174,SMARCA4,209
chr1,33088687,33088905,SRX5075170,SMARCA4,218
chr1,33094890,33095468,SRX16500061,CTCF,578
chr1,33094899,33095484,SRX16500062,CTCF,585
chr1,33094910,33095482,SRX16500059,CTCF,572
chr1,33094920,33095475,SRX16500060,CTCF,555
chr1,33095022,33095357,SRX4174629,CTCF,335
chr1,33095049,33095354,SRX5075174,SMARCA4,305
chr1,33095065,33095358,SRX5075168,SMARCA4,293
chr1,33095104,33095349,SRX5716463,SMARCA4,245
chr1,33099062,33099938,SRX5075169,SMARCA4,876
chr1,33099179,33099874,SRX5716469,SMARCA4,695
chr1,33099181,33099875,SRX5716470,SMARCA4,694
chr1,33099196,33099922,SRX5075175,SMARCA4,726
chr1,33099199,33099921,SRX5075176,SMARCA4,722
chr1,33099204,33099924,SRX5075170,SMARCA4,720
chr1,33099214,33099619,SRX5716467,SMARCA2,405
chr1,33099244,33099938,SRX5054309,FOSL2,694
chr1,33099255,33099512,SRX5716468,SMARCA2,257
chr1,33099278,33099541,SRX5020211,SMARCA2,263
chr1,33099315,33099780,SRX5054308,FOSL2,465
chr1,33099377,33099586,SRX5075182,SMARCA2,209
chr1,33126910,33127326,SRX20140869,INTS10,416
chr1,33127039,33127374,SRX20140897,INTS13,335
chr1,33127044,33127544,SRX20140895,INTS13,500
chr1,33127058,33127733,SRX16500060,CTCF,675
chr1,33127087,33127411,SRX20140867,INTS10,324
chr1,33127096,33127354,SRX5075169,SMARCA4,258
chr1,33127098,33127605,SRX20140868,INTS10,507
chr1,33127108,33127623,SRX16500059,CTCF,515
chr1,33127124,33127613,SRX16500061,CTCF,489
chr1,33127128,33127449,SRX5075168,SMARCA4,321
chr1,33127145,33127325,SRX5054308,FOSL2,180
chr1,33127168,33127610,SRX16500062,CTCF,442
chr1,33127173,33127577,SRX4174629,CTCF,404
chr1,33127334,33127551,SRX5075174,SMARCA4,217
chr1,33137697,33138209,SRX16500059,CTCF,512
chr1,33137781,33138246,SRX16500061,CTCF,465
chr1,33137791,33138211,SRX16500062,CTCF,420
chr1,33137809,33138258,SRX16500060,CTCF,449
chr1,33137898,33138112,SRX5075168,SMARCA4,214
chr1,33137933,33138175,SRX5075174,SMARCA4,242
chr1,33137949,33138159,SRX4174629,CTCF,210
chr1,33143092,33143447,SRX5075170,SMARCA4,355
chr1,33147888,33148120,SRX16500060,CTCF,232
chr1,33148012,33148244,SRX16500062,CTCF,232
chr1,33151623,33152031,SRX5075176,SMARCA4,408
chr1,33151660,33152001,SRX5075170,SMARCA4,341
chr1,33151769,33151981,SRX5075168,SMARCA4,212
chr1,33153166,33153346,SRX5075169,SMARCA4,180
chr1,33153172,33153424,SRX5075170,SMARCA4,252
chr1,33153220,33153457,SRX5075168,SMARCA4,237
chr1,33153230,33153414,SRX5075174,SMARCA4,184
chr1,33161249,33161594,SRX20140868,INTS10,345
chr1,33161252,33161689,SRX5075168,SMARCA4,437
chr1,33161266,33161630,SRX20140895,INTS13,364
chr1,33161270,33161612,SRX5075176,SMARCA4,342
chr1,33161322,33161620,SRX5075170,SMARCA4,298
chr1,33161325,33161553,SRX5075175,SMARCA4,228
chr1,33161344,33161596,SRX5716470,SMARCA4,252
chr1,33161348,33161571,SRX5075169,SMARCA4,223
chr1,33161363,33161559,SRX5075174,SMARCA4,196
chr1,33163555,33163995,SRX5075170,SMARCA4,440
chr1,33163595,33163986,SRX5075175,SMARCA4,391
chr1,33163616,33164055,SRX5075169,SMARCA4,439
chr1,33163663,33163983,SRX5716470,SMARCA4,320
chr1,33163678,33164003,SRX5075176,SMARCA4,325
chr1,33163753,33163958,SRX5075174,SMARCA4,205
chr1,33164069,33164350,SRX20140881,CPSF3L,281
chr1,33164147,33164382,SRX20140879,CPSF3L,235
chr1,33169397,33169611,SRX20140867,INTS10,214
chr1,33169421,33169689,SRX5075174,SMARCA4,268
chr1,33169424,33169626,SRX5075168,SMARCA4,202
chr1,33180677,33181104,SRX5075168,SMARCA4,427
chr1,33180731,33181004,SRX5075174,SMARCA4,273
chr1,33180739,33180948,SRX5075170,SMARCA4,209
chr1,33181988,33182345,SRX5075174,SMARCA4,357
chr1,33182017,33182364,SRX5075170,SMARCA4,347
chr1,33182021,33182328,SRX5075168,SMARCA4,307
chr1,33182035,33182369,SRX5075176,SMARCA4,334
chr1,33182045,33182360,SRX20140895,INTS13,315
chr1,33182053,33182366,SRX5716469,SMARCA4,313
chr1,33182058,33182677,SRX5075169,SMARCA4,619
chr1,33182068,33182283,SRX5716464,SMARCA4,215
chr1,33182068,33182360,SRX5075175,SMARCA4,292
chr1,33182124,33182367,SRX5716470,SMARCA4,243
chr1,33182435,33182753,SRX5075176,SMARCA4,318
chr1,33182462,33182723,SRX5075170,SMARCA4,261
chr1,33218625,33218899,SRX16500062,CTCF,274
chr1,33218628,33218851,SRX16500061,CTCF,223
chr1,33218640,33218917,SRX16500059,CTCF,277
chr1,33218656,33218920,SRX16500060,CTCF,264
chr1,33218751,33218968,SRX5075168,SMARCA4,217
chr1,33218773,33219025,SRX4174629,CTCF,252
chr1,33219889,33220178,SRX5075176,SMARCA4,289
chr1,33219919,33220143,SRX5054308,FOSL2,224
chr1,33219922,33220191,SRX5075170,SMARCA4,269
chr1,33219939,33220139,SRX5075169,SMARCA4,200
chr1,33229032,33229391,SRX5075176,SMARCA4,359
chr1,33229034,33229386,SRX5075169,SMARCA4,352
chr1,33229091,33229452,SRX5075170,SMARCA4,361
chr1,33229133,33229344,SRX5020211,SMARCA2,211
chr1,33229136,33229354,SRX5716468,SMARCA2,218
chr1,33229154,33229426,SRX5716470,SMARCA4,272
chr1,33229163,33229395,SRX5075175,SMARCA4,232
chr1,33229189,33229442,SRX5716467,SMARCA2,253
chr1,33229250,33229430,SRX5054308,FOSL2,180
chr1,33234710,33234993,SRX5075170,SMARCA4,283
chr1,33234805,33235016,SRX5075176,SMARCA4,211
chr1,33244066,33244275,SRX5075170,SMARCA4,209
chr1,33255744,33256059,SRX20140895,INTS13,315
chr1,33261302,33261579,SRX5075168,SMARCA4,277
chr1,33261313,33261638,SRX5075174,SMARCA4,325
chr1,33295404,33295879,SRX16500059,CTCF,475
chr1,33295409,33295881,SRX16500062,CTCF,472
chr1,33295411,33295904,SRX16500060,CTCF,493
chr1,33295438,33295892,SRX16500061,CTCF,454
chr1,33295510,33295897,SRX4174629,CTCF,387
chr1,33295554,33295831,SRX5075170,SMARCA4,277
chr1,33295567,33295816,SRX5075174,SMARCA4,249
chr1,33295568,33295786,SRX5075168,SMARCA4,218
chr1,33295576,33295829,SRX5075175,SMARCA4,253
chr1,33295611,33295836,SRX5716470,SMARCA4,225
chr1,33295621,33295804,SRX5075169,SMARCA4,183
chr1,33295623,33295823,SRX5075176,SMARCA4,200
chr1,33298652,33299046,SRX16500059,CTCF,394
chr1,33298658,33299058,SRX16500060,CTCF,400
chr1,33298674,33299048,SRX16500061,CTCF,374
chr1,33298682,33299132,SRX16500062,CTCF,450
chr1,33298716,33298889,SRX5075174,SMARCA4,173
chr1,33300708,33301051,SRX5716470,SMARCA4,343
chr1,33300710,33301049,SRX5075170,SMARCA4,339
chr1,33300730,33300945,SRX5716467,SMARCA2,215
chr1,33300747,33301093,SRX5075176,SMARCA4,346
chr1,33327918,33328136,SRX5054308,FOSL2,218
chr1,33327938,33328264,SRX5075169,SMARCA4,326
chr1,33327991,33328179,SRX5075170,SMARCA4,188
chr1,33336262,33336478,SRX5054309,FOSL2,216
chr1,33336283,33336463,SRX5054308,FOSL2,180
chr1,33342244,33342737,SRX5075174,SMARCA4,493
chr1,33342246,33342753,SRX5075170,SMARCA4,507
chr1,33342248,33342793,SRX5075176,SMARCA4,545
chr1,33342259,33342613,SRX5054308,FOSL2,354
chr1,33342268,33342648,SRX5075175,SMARCA4,380
chr1,33342270,33342564,SRX5054309,FOSL2,294
chr1,33342295,33342697,SRX5075169,SMARCA4,402
chr1,33342305,33342561,SRX5054307,FOSL2,256
chr1,33342311,33342751,SRX5075168,SMARCA4,440
chr1,33342314,33342607,SRX5716469,SMARCA4,293
chr1,33342316,33342634,SRX5716470,SMARCA4,318
chr1,33342338,33342585,SRX5716467,SMARCA2,247
chr1,33342351,33342579,SRX5716468,SMARCA2,228
chr1,33346949,33347233,SRX5054309,FOSL2,284
chr1,33346965,33347183,SRX5075169,SMARCA4,218
chr1,33346970,33347184,SRX5054308,FOSL2,214
chr1,33346978,33347181,SRX5075175,SMARCA4,203
chr1,33347006,33347279,SRX5075176,SMARCA4,273
chr1,33347024,33347197,SRX5075170,SMARCA4,173
chr1,33349311,33349677,SRX20140895,INTS13,366
chr1,33349631,33350346,SRX20140867,INTS10,715
chr1,33349890,33350069,SRX5054307,FOSL2,179
chr1,33349917,33350121,SRX5075176,SMARCA4,204
chr1,33349927,33350143,SRX5075174,SMARCA4,216
chr1,33349937,33350490,SRX20140895,INTS13,553
chr1,33349941,33350204,SRX5075168,SMARCA4,263
chr1,33349952,33350129,SRX5075170,SMARCA4,177
chr1,33349954,33350500,SRX20140868,INTS10,546
chr1,33349990,33350195,SRX5716464,SMARCA4,205
chr1,33350003,33350207,SRX5716463,SMARCA4,204
chr1,33350054,33350337,SRX20140879,CPSF3L,283
chr1,33350079,33350345,SRX20140869,INTS10,266
chr1,33363380,33364160,SRX20140895,INTS13,780
chr1,33363494,33364184,SRX20140868,INTS10,690
chr1,33363651,33364117,SRX20140867,INTS10,466
chr1,33363667,33364041,SRX20140894,INTS13,374
chr1,33363667,33364151,SRX20140879,CPSF3L,484
chr1,33363864,33364291,SRX5075174,SMARCA4,427
chr1,33363906,33364246,SRX5075168,SMARCA4,340
chr1,33363973,33364166,SRX5716451,SOX2,193
chr1,33364040,33364290,SRX5716463,SMARCA4,250
chr1,33364046,33364327,SRX5075176,SMARCA4,281
chr1,33364062,33364450,SRX5716470,SMARCA4,388
chr1,33364110,33364320,SRX5075169,SMARCA4,210
chr1,33364120,33364317,SRX5075170,SMARCA4,197
chr1,33364189,33364419,SRX5716469,SMARCA4,230
chr1,33367650,33368226,SRX16500060,CTCF,576
chr1,33367698,33368209,SRX16500059,CTCF,511
chr1,33367719,33368144,SRX4174629,CTCF,425
chr1,33367727,33368185,SRX16500061,CTCF,458
chr1,33367754,33368169,SRX16500062,CTCF,415
chr1,33367766,33367973,SRX5075170,SMARCA4,207
chr1,33382591,33382764,SRX5075170,SMARCA4,173
chr1,33382723,33382970,SRX5075176,SMARCA4,247
chr1,33382737,33382978,SRX5075169,SMARCA4,241
chr1,33384249,33384652,SRX5075176,SMARCA4,403
chr1,33384426,33384704,SRX5054309,FOSL2,278
chr1,33384427,33384711,SRX5075170,SMARCA4,284
chr1,33384452,33384713,SRX5054308,FOSL2,261
chr1,33384456,33384733,SRX5075175,SMARCA4,277
chr1,33384473,33384700,SRX5075169,SMARCA4,227
chr1,33389358,33389890,SRX5075176,SMARCA4,532
chr1,33389438,33389819,SRX5716470,SMARCA4,381
chr1,33389443,33389866,SRX5716467,SMARCA2,423
chr1,33389445,33389840,SRX5075169,SMARCA4,395
chr1,33389448,33389752,SRX5075181,SMARCA2,304
chr1,33389461,33389790,SRX5075175,SMARCA4,329
chr1,33389464,33389856,SRX5716468,SMARCA2,392
chr1,33389486,33389797,SRX5054309,FOSL2,311
chr1,33389491,33389825,SRX5075170,SMARCA4,334
chr1,33389517,33389810,SRX5716469,SMARCA4,293
chr1,33389541,33389863,SRX5020211,SMARCA2,322
chr1,33389542,33389778,SRX5054308,FOSL2,236
chr1,33393821,33394133,SRX5075174,SMARCA4,312
chr1,33393878,33394057,SRX5075168,SMARCA4,179
chr1,33409885,33410696,SRX5075170,SMARCA4,811
chr1,33409899,33410735,SRX5075176,SMARCA4,836
chr1,33409905,33410801,SRX5075169,SMARCA4,896
chr1,33409916,33410464,SRX5716470,SMARCA4,548
chr1,33409939,33410651,SRX5075175,SMARCA4,712
chr1,33409956,33410296,SRX5020214,SMARCA2,340
chr1,33409960,33410446,SRX5716467,SMARCA2,486
chr1,33409965,33410437,SRX5716469,SMARCA4,472
chr1,33409974,33410387,SRX5020211,SMARCA2,413
chr1,33409994,33410265,SRX5075181,SMARCA2,271
chr1,33410011,33410344,SRX5054308,FOSL2,333
chr1,33410017,33410456,SRX5054309,FOSL2,439
chr1,33410033,33410457,SRX5716468,SMARCA2,424
chr1,33410066,33410270,SRX5075182,SMARCA2,204
chr1,33410098,33410685,SRX5075174,SMARCA4,587
chr1,33410103,33410390,SRX5716463,SMARCA4,287
chr1,33410110,33410670,SRX5075168,SMARCA4,560
chr1,33410110,33410769,SRX20140895,INTS13,659
chr1,33410200,33410778,SRX20140868,INTS10,578
chr1,33410295,33410523,SRX20140867,INTS10,228
chr1,33410301,33410549,SRX5716451,SOX2,248
chr1,33410327,33410617,SRX20140880,CPSF3L,290
chr1,33410345,33410550,SRX5716454,SOX3,205
chr1,33410447,33410664,SRX5716463,SMARCA4,217
chr1,33421167,33421465,SRX5075174,SMARCA4,298
chr1,33424210,33424624,SRX5075168,SMARCA4,414
chr1,33424218,33424574,SRX5075174,SMARCA4,356
chr1,33424263,33424546,SRX5716469,SMARCA4,283
chr1,33424264,33424608,SRX5716463,SMARCA4,344
chr1,33424292,33424481,SRX5075175,SMARCA4,189
chr1,33424292,33424569,SRX5716470,SMARCA4,277
chr1,33424298,33424528,SRX5716464,SMARCA4,230
chr1,33424313,33424607,SRX5716467,SMARCA2,294
chr1,33424323,33424594,SRX5075170,SMARCA4,271
chr1,33424326,33424566,SRX5075176,SMARCA4,240
chr1,33430807,33431389,SRX20140895,INTS13,582
chr1,33430872,33431118,SRX16500059,CTCF,246
chr1,33430886,33431322,SRX5075174,SMARCA4,436
chr1,33430889,33431131,SRX16500060,CTCF,242
chr1,33430897,33431388,SRX5716463,SMARCA4,491
chr1,33430929,33431302,SRX5075168,SMARCA4,373
chr1,33430957,33431322,SRX20140897,INTS13,365
chr1,33433539,33434131,SRX5075176,SMARCA4,592
chr1,33433540,33434098,SRX5075169,SMARCA4,558
chr1,33433559,33434120,SRX5075170,SMARCA4,561
chr1,33433627,33434002,SRX5020214,SMARCA2,375
chr1,33433632,33434090,SRX5075175,SMARCA4,458
chr1,33433634,33434115,SRX5054309,FOSL2,481
chr1,33433647,33434036,SRX5716470,SMARCA4,389
chr1,33433670,33434106,SRX5716467,SMARCA2,436
chr1,33433683,33434134,SRX5054308,FOSL2,451
chr1,33433721,33434084,SRX5716469,SMARCA4,363
chr1,33433739,33434073,SRX5020211,SMARCA2,334
chr1,33433762,33434059,SRX5075182,SMARCA2,297
chr1,33433763,33433999,SRX5075174,SMARCA4,236
chr1,33433815,33434039,SRX5716468,SMARCA2,224
chr1,33433821,33434036,SRX5075168,SMARCA4,215
chr1,33435171,33435427,SRX5075176,SMARCA4,256
chr1,33435190,33435423,SRX5075174,SMARCA4,233
chr1,33435213,33435426,SRX5075168,SMARCA4,213
chr1,33435214,33435443,SRX5054308,FOSL2,229
chr1,33435216,33435400,SRX5054309,FOSL2,184
chr1,33443111,33443336,SRX5054308,FOSL2,225
chr1,33443119,33443338,SRX5075170,SMARCA4,219
chr1,33443122,33443385,SRX5075176,SMARCA4,263
chr1,33443135,33443456,SRX5075175,SMARCA4,321
chr1,33443149,33443375,SRX5054309,FOSL2,226
chr1,33452246,33452683,SRX5075174,SMARCA4,437
chr1,33452406,33452698,SRX5075168,SMARCA4,292
chr1,33455780,33456159,SRX16500061,CTCF,379
chr1,33455789,33456205,SRX16500059,CTCF,416
chr1,33455829,33456173,SRX16500062,CTCF,344
chr1,33455859,33456215,SRX16500060,CTCF,356
chr1,33455861,33456185,SRX4174629,CTCF,324
chr1,33455908,33456114,SRX5075176,SMARCA4,206
chr1,33458525,33458904,SRX5054309,FOSL2,379
chr1,33458529,33458942,SRX5075176,SMARCA4,413
chr1,33458531,33458880,SRX5075169,SMARCA4,349
chr1,33458542,33458847,SRX5020214,SMARCA2,305
chr1,33458555,33458905,SRX5054308,FOSL2,350
chr1,33458561,33458895,SRX5075175,SMARCA4,334
chr1,33458579,33458924,SRX5716469,SMARCA4,345
chr1,33458586,33458930,SRX5075170,SMARCA4,344
chr1,33458593,33458831,SRX5020211,SMARCA2,238
chr1,33458594,33458814,SRX5075168,SMARCA4,220
chr1,33458603,33458912,SRX5716467,SMARCA2,309
chr1,33470398,33470876,SRX16500061,CTCF,478
chr1,33470398,33470900,SRX16500060,CTCF,502
chr1,33470425,33470873,SRX16500059,CTCF,448
chr1,33470446,33470907,SRX16500062,CTCF,461
chr1,33470464,33470744,SRX5075174,SMARCA4,280
chr1,33470488,33470693,SRX5716464,SMARCA4,205
chr1,33470494,33470759,SRX5075176,SMARCA4,265
chr1,33470500,33470871,SRX5075168,SMARCA4,371
chr1,33470503,33470788,SRX5075175,SMARCA4,285
chr1,33470505,33470921,SRX4174629,CTCF,416
chr1,33470526,33470747,SRX5075169,SMARCA4,221
chr1,33470537,33470794,SRX5075170,SMARCA4,257
chr1,33472328,33472638,SRX5716463,SMARCA4,310
chr1,33472330,33472604,SRX5054307,FOSL2,274
chr1,33472366,33472800,SRX5075168,SMARCA4,434
chr1,33472371,33472565,SRX5054308,FOSL2,194
chr1,33472373,33472641,SRX5716451,SOX2,268
chr1,33472414,33472702,SRX5075176,SMARCA4,288
chr1,33472421,33472730,SRX5075174,SMARCA4,309
chr1,33472428,33472688,SRX5716454,SOX3,260
chr1,33472482,33472763,SRX5075170,SMARCA4,281
chr1,33575741,33576047,SRX5075170,SMARCA4,306
chr1,33575850,33576025,SRX5075176,SMARCA4,175
chr1,33612783,33613326,SRX16500061,CTCF,543
chr1,33612840,33613309,SRX16500059,CTCF,469
chr1,33612868,33613364,SRX16500060,CTCF,496
chr1,33612874,33613282,SRX16500062,CTCF,408
chr1,33612888,33613075,SRX5075175,SMARCA4,187
chr1,33612897,33613164,SRX5075168,SMARCA4,267
chr1,33612901,33613246,SRX4174629,CTCF,345
chr1,33612927,33613136,SRX5075174,SMARCA4,209
chr1,33625027,33625312,SRX16500059,CTCF,285
chr1,33632808,33633383,SRX16500061,CTCF,575
chr1,33632869,33633448,SRX16500059,CTCF,579
chr1,33632914,33633387,SRX16500062,CTCF,473
chr1,33632944,33633453,SRX16500060,CTCF,509
chr1,33633009,33633459,SRX4174629,CTCF,450
chr1,33633050,33633268,SRX5716464,SMARCA4,218
chr1,33633052,33633359,SRX5075176,SMARCA4,307
chr1,33633053,33633380,SRX5075174,SMARCA4,327
chr1,33633055,33633350,SRX5075168,SMARCA4,295
chr1,33633077,33633330,SRX5075170,SMARCA4,253
chr1,33633092,33633352,SRX5075169,SMARCA4,260
chr1,33633093,33633344,SRX5075175,SMARCA4,251
chr1,33633101,33633321,SRX5716470,SMARCA4,220
chr1,33634930,33635142,SRX5075174,SMARCA4,212
chr1,33641038,33641519,SRX16500059,CTCF,481
chr1,33641061,33641368,SRX16500061,CTCF,307
chr1,33641076,33641437,SRX16500060,CTCF,361
chr1,33641175,33641386,SRX16500062,CTCF,211
chr1,33654187,33654658,SRX16500060,CTCF,471
chr1,33654222,33654602,SRX16500059,CTCF,380
chr1,33654241,33654626,SRX16500061,CTCF,385
chr1,33654313,33654639,SRX16500062,CTCF,326
chr1,33661822,33662015,SRX5075168,SMARCA4,193
chr1,33661849,33662071,SRX5075174,SMARCA4,222
chr1,33682458,33682708,SRX5054309,FOSL2,250
chr1,33709376,33709780,SRX5075168,SMARCA4,404
chr1,33709457,33709662,SRX5716464,SMARCA4,205
chr1,33709463,33709655,SRX5075174,SMARCA4,192
chr1,33720133,33720343,SRX5075170,SMARCA4,210
chr1,33720199,33720374,SRX5075176,SMARCA4,175
chr1,33735682,33735932,SRX16500059,CTCF,250
chr1,33735694,33735946,SRX16500062,CTCF,252
chr1,33762104,33762466,SRX5075170,SMARCA4,362
chr1,33762105,33762348,SRX5075169,SMARCA4,243
chr1,33762143,33762387,SRX5075176,SMARCA4,244
chr1,33762191,33762467,SRX5075175,SMARCA4,276
chr1,33763483,33763694,SRX5054309,FOSL2,211
chr1,33814242,33814454,SRX5054309,FOSL2,212
chr1,33815073,33815362,SRX5054309,FOSL2,289
chr1,33815105,33815337,SRX5075169,SMARCA4,232
chr1,33877022,33877254,SRX5075170,SMARCA4,232
chr1,33918460,33918764,SRX5075169,SMARCA4,304
chr1,33918470,33918778,SRX5054309,FOSL2,308
chr1,33918511,33918787,SRX5054308,FOSL2,276
chr1,33918586,33918773,SRX5075175,SMARCA4,187
chr1,33943992,33944323,SRX5075175,SMARCA4,331
chr1,33944000,33944342,SRX5075169,SMARCA4,342
chr1,33944001,33944294,SRX5075170,SMARCA4,293
chr1,33944017,33944266,SRX5075176,SMARCA4,249
chr1,33944017,33944371,SRX5054308,FOSL2,354
chr1,33944023,33944418,SRX5716470,SMARCA4,395
chr1,33944024,33944365,SRX5716469,SMARCA4,341
chr1,33944029,33944351,SRX5054309,FOSL2,322
chr1,33985216,33985414,SRX5075170,SMARCA4,198
chr1,33985247,33985454,SRX5075176,SMARCA4,207
chr1,33986518,33986705,SRX5075175,SMARCA4,187
chr1,34009710,34009917,SRX5054309,FOSL2,207
chr1,34013974,34014374,SRX16500059,CTCF,400
chr1,34013985,34014308,SRX16500062,CTCF,323
chr1,34013997,34014371,SRX16500060,CTCF,374
chr1,34014012,34014341,SRX16500061,CTCF,329
chr1,34067032,34067284,SRX5054309,FOSL2,252
chr1,34067039,34067271,SRX5075169,SMARCA4,232
chr1,34113880,34114319,SRX16500059,CTCF,439
chr1,34113898,34114125,SRX4174629,CTCF,227
chr1,34113907,34114200,SRX16500062,CTCF,293
chr1,34113928,34114291,SRX16500060,CTCF,363
chr1,34114038,34114291,SRX16500061,CTCF,253
chr1,34162959,34163535,SRX16500061,CTCF,576
chr1,34162960,34163623,SRX16500060,CTCF,663
chr1,34163001,34163600,SRX16500062,CTCF,599
chr1,34163021,34163634,SRX16500059,CTCF,613
chr1,34163075,34163575,SRX4174629,CTCF,500
chr1,34163100,34163423,SRX5075169,SMARCA4,323
chr1,34163144,34163356,SRX5054309,FOSL2,212
chr1,34163190,34163379,SRX5075170,SMARCA4,189
chr1,34164961,34165169,SRX5075175,SMARCA4,208
chr1,34165032,34165251,SRX5075176,SMARCA4,219
chr1,34165050,34165251,SRX5075168,SMARCA4,201
chr1,34268160,34268797,SRX5054309,FOSL2,637
chr1,34268168,34268761,SRX5075175,SMARCA4,593
chr1,34268247,34268760,SRX5075169,SMARCA4,513
chr1,34268322,34268764,SRX5075170,SMARCA4,442
chr1,34268422,34268722,SRX5075176,SMARCA4,300
chr1,34268522,34268776,SRX5716469,SMARCA4,254
chr1,34292558,34292880,SRX16500059,CTCF,322
chr1,34379030,34379228,SRX5075170,SMARCA4,198
chr1,34379063,34379256,SRX5054309,FOSL2,193
chr1,34379992,34380226,SRX5054308,FOSL2,234
chr1,34380001,34380286,SRX5054309,FOSL2,285
chr1,34380002,34380285,SRX5075169,SMARCA4,283
chr1,34380032,34380213,SRX5075176,SMARCA4,181
chr1,34380033,34380238,SRX5020214,SMARCA2,205
chr1,34380041,34380306,SRX5075175,SMARCA4,265
chr1,34380047,34380243,SRX5075170,SMARCA4,196
chr1,34441590,34441897,SRX20140897,INTS13,307
chr1,34441591,34441903,SRX20140869,INTS10,312
chr1,34441653,34442179,SRX5075170,SMARCA4,526
chr1,34441686,34442126,SRX5075176,SMARCA4,440
chr1,34441719,34441973,SRX5075169,SMARCA4,254
chr1,34441756,34441943,SRX5075175,SMARCA4,187
chr1,34441788,34442085,SRX5054309,FOSL2,297
chr1,34460110,34460647,SRX16500059,CTCF,537
chr1,34460151,34460631,SRX16500062,CTCF,480
chr1,34460153,34460665,SRX16500060,CTCF,512
chr1,34460229,34460446,SRX4174629,CTCF,217
chr1,34460229,34460630,SRX16500061,CTCF,401
chr1,34468825,34469059,SRX5054309,FOSL2,234
chr1,34500470,34500706,SRX5075170,SMARCA4,236
chr1,34500489,34500671,SRX5075168,SMARCA4,182
chr1,34500502,34500711,SRX5075174,SMARCA4,209
chr1,34500510,34500712,SRX5075176,SMARCA4,202
chr1,34520116,34520312,SRX5054309,FOSL2,196
chr1,34529975,34530417,SRX5075176,SMARCA4,442
chr1,34530030,34530391,SRX5075170,SMARCA4,361
chr1,34530059,34530242,SRX5075169,SMARCA4,183
chr1,34530092,34530314,SRX5054309,FOSL2,222
chr1,34547072,34547336,SRX16500059,CTCF,264
chr1,34587859,34588064,SRX5075170,SMARCA4,205
chr1,34587918,34588153,SRX5054309,FOSL2,235
chr1,34597769,34598310,SRX16500059,CTCF,541
chr1,34597805,34598305,SRX16500062,CTCF,500
chr1,34597832,34598293,SRX16500060,CTCF,461
chr1,34597864,34598310,SRX16500061,CTCF,446
chr1,34597921,34598302,SRX4174629,CTCF,381
chr1,34645378,34645671,SRX5075168,SMARCA4,293
chr1,34645417,34645595,SRX5075170,SMARCA4,178
chr1,34645485,34645717,SRX5075174,SMARCA4,232
chr1,34655817,34656260,SRX5075168,SMARCA4,443
chr1,34655871,34656326,SRX5075174,SMARCA4,455
chr1,34655919,34656291,SRX5716464,SMARCA4,372
chr1,34655923,34656198,SRX5716463,SMARCA4,275
chr1,34681318,34681899,SRX16500059,CTCF,581
chr1,34681341,34681993,SRX16500060,CTCF,652
chr1,34681429,34681923,SRX16500061,CTCF,494
chr1,34681431,34681910,SRX16500062,CTCF,479
chr1,34681550,34681752,SRX5075174,SMARCA4,202
chr1,34681567,34681819,SRX4174629,CTCF,252
chr1,34681586,34681789,SRX5075168,SMARCA4,203
chr1,34684298,34684493,SRX5054309,FOSL2,195
chr1,34684340,34684520,SRX5075174,SMARCA4,180
chr1,34697756,34698205,SRX5075174,SMARCA4,449
chr1,34697789,34698193,SRX5075168,SMARCA4,404
chr1,34697796,34698146,SRX5716464,SMARCA4,350
chr1,34697813,34698093,SRX5716463,SMARCA4,280
chr1,34726796,34727280,SRX5075168,SMARCA4,484
chr1,34726882,34727087,SRX5716464,SMARCA4,205
chr1,34726891,34727190,SRX5075174,SMARCA4,299
chr1,34726991,34727227,SRX5716463,SMARCA4,236
chr1,34740540,34740959,SRX20140867,INTS10,419
chr1,34740609,34740923,SRX20140881,CPSF3L,314
chr1,34742602,34743124,SRX16500059,CTCF,522
chr1,34742634,34743067,SRX16500061,CTCF,433
chr1,34742640,34743081,SRX16500060,CTCF,441
chr1,34742650,34743043,SRX16500062,CTCF,393
chr1,34742674,34742915,SRX5075170,SMARCA4,241
chr1,34742689,34742973,SRX5075174,SMARCA4,284
chr1,34742701,34742940,SRX5075169,SMARCA4,239
chr1,34742734,34742980,SRX5075168,SMARCA4,246
chr1,34742773,34742950,SRX5075176,SMARCA4,177
chr1,34742830,34743087,SRX4174629,CTCF,257
chr1,34768954,34769142,SRX5054309,FOSL2,188
chr1,34786423,34786879,SRX16500059,CTCF,456
chr1,34786428,34786880,SRX16500060,CTCF,452
chr1,34786434,34786833,SRX4174629,CTCF,399
chr1,34786448,34786879,SRX16500062,CTCF,431
chr1,34786463,34786841,SRX16500061,CTCF,378
chr1,34786474,34786845,SRX5075174,SMARCA4,371
chr1,34786533,34786864,SRX5075168,SMARCA4,331
chr1,34835536,34835847,SRX5075174,SMARCA4,311
chr1,34835690,34835916,SRX5075168,SMARCA4,226
chr1,34842850,34843221,SRX5075174,SMARCA4,371
chr1,34842927,34843231,SRX5075168,SMARCA4,304
chr1,34844043,34844752,SRX20140895,INTS13,709
chr1,34844173,34844741,SRX5075168,SMARCA4,568
chr1,34844196,34844736,SRX5075174,SMARCA4,540
chr1,34844250,34844523,SRX5716464,SMARCA4,273
chr1,34844269,34844580,SRX20140867,INTS10,311
chr1,34844282,34844558,SRX5716451,SOX2,276
chr1,34844293,34844545,SRX5716463,SMARCA4,252
chr1,34844308,34844572,SRX5716454,SOX3,264
chr1,34852444,34853150,SRX16500059,CTCF,706
chr1,34852480,34853129,SRX16500061,CTCF,649
chr1,34852497,34853155,SRX16500060,CTCF,658
chr1,34852500,34853126,SRX16500062,CTCF,626
chr1,34852589,34853112,SRX4174629,CTCF,523
chr1,34852603,34853019,SRX20140895,INTS13,416
chr1,34852612,34852970,SRX5716463,SMARCA4,358
chr1,34852626,34853003,SRX5075170,SMARCA4,377
chr1,34852626,34853025,SRX5075176,SMARCA4,399
chr1,34852632,34853020,SRX5716464,SMARCA4,388
chr1,34852633,34853017,SRX5075168,SMARCA4,384
chr1,34852633,34853051,SRX5075174,SMARCA4,418
chr1,34852644,34852991,SRX5716470,SMARCA4,347
chr1,34852677,34852966,SRX5075169,SMARCA4,289
chr1,34852688,34852900,SRX5716469,SMARCA4,212
chr1,34852731,34852978,SRX5054309,FOSL2,247
chr1,34852746,34852999,SRX5075175,SMARCA4,253
chr1,34852751,34852931,SRX5054308,FOSL2,180
chr1,34859426,34860073,SRX20140895,INTS13,647
chr1,34859536,34859940,SRX20140879,CPSF3L,404
chr1,34859568,34860073,SRX20140868,INTS10,505
chr1,34859571,34860081,SRX5075168,SMARCA4,510
chr1,34859602,34859954,SRX20140897,INTS13,352
chr1,34859604,34860078,SRX5075174,SMARCA4,474
chr1,34859625,34859903,SRX5075175,SMARCA4,278
chr1,34859626,34860212,SRX16500059,CTCF,586
chr1,34859635,34859945,SRX20140867,INTS10,310
chr1,34859672,34860055,SRX5075170,SMARCA4,383
chr1,34859672,34860197,SRX16500062,CTCF,525
chr1,34859677,34860201,SRX16500060,CTCF,524
chr1,34859709,34860293,SRX16500061,CTCF,584
chr1,34859713,34859966,SRX5075176,SMARCA4,253
chr1,34859728,34859933,SRX5716464,SMARCA4,205
chr1,34860027,34860207,SRX5075169,SMARCA4,180
chr1,34866120,34866774,SRX16500060,CTCF,654
chr1,34866121,34866589,SRX5716470,SMARCA4,468
chr1,34866159,34866523,SRX5716469,SMARCA4,364
chr1,34866171,34866610,SRX20140895,INTS13,439
chr1,34866186,34866770,SRX16500059,CTCF,584
chr1,34866187,34866743,SRX16500061,CTCF,556
chr1,34866282,34866767,SRX16500062,CTCF,485
chr1,34866291,34866562,SRX5075175,SMARCA4,271
chr1,34866304,34866656,SRX5075174,SMARCA4,352
chr1,34866308,34866590,SRX5075169,SMARCA4,282
chr1,34866323,34866616,SRX4174629,CTCF,293
chr1,34866361,34866690,SRX5075170,SMARCA4,329
chr1,34866375,34866648,SRX5075168,SMARCA4,273
chr1,34866395,34866642,SRX5075176,SMARCA4,247
chr1,34924847,34925151,SRX5075174,SMARCA4,304
chr1,34924855,34925200,SRX5075175,SMARCA4,345
chr1,34924867,34925102,SRX5716469,SMARCA4,235
chr1,34924868,34925152,SRX5075169,SMARCA4,284
chr1,34924877,34925202,SRX5716470,SMARCA4,325
chr1,34924883,34925191,SRX5075176,SMARCA4,308
chr1,34924884,34925172,SRX5075170,SMARCA4,288
chr1,34924885,34925152,SRX5075168,SMARCA4,267
chr1,34924885,34925157,SRX5716463,SMARCA4,272
chr1,34924901,34925139,SRX5716464,SMARCA4,238
chr1,34929267,34929670,SRX5075168,SMARCA4,403
chr1,34984682,34985333,SRX5075169,SMARCA4,651
chr1,34984754,34985574,SRX5075176,SMARCA4,820
chr1,34984784,34985547,SRX5075170,SMARCA4,763
chr1,34984939,34985537,SRX5716470,SMARCA4,598
chr1,34984954,34985266,SRX5075168,SMARCA4,312
chr1,34985188,34985517,SRX5075174,SMARCA4,329
chr1,34985227,34985509,SRX5075175,SMARCA4,282
chr1,34985247,34985503,SRX20140895,INTS13,256
chr1,34985383,34985598,SRX5075168,SMARCA4,215
chr1,35031093,35031285,SRX5075170,SMARCA4,192
chr1,35031109,35031296,SRX5075175,SMARCA4,187
chr1,35031171,35031405,SRX5716469,SMARCA4,234
chr1,35031433,35032201,SRX20140895,INTS13,768
chr1,35031473,35031692,SRX5075170,SMARCA4,219
chr1,35031485,35031841,SRX5716470,SMARCA4,356
chr1,35031490,35031977,SRX5075175,SMARCA4,487
chr1,35031504,35031901,SRX5075169,SMARCA4,397
chr1,35031524,35032113,SRX5075174,SMARCA4,589
chr1,35031555,35032083,SRX5075176,SMARCA4,528
chr1,35031560,35032068,SRX20140897,INTS13,508
chr1,35031585,35032044,SRX5716463,SMARCA4,459
chr1,35031619,35032171,SRX5075168,SMARCA4,552
chr1,35031750,35032116,SRX5075170,SMARCA4,366
chr1,35031914,35032118,SRX5054308,FOSL2,204
chr1,35047475,35047805,SRX5075169,SMARCA4,330
chr1,35047500,35047745,SRX5054308,FOSL2,245
chr1,35047504,35047842,SRX5075175,SMARCA4,338
chr1,35047511,35047705,SRX5075176,SMARCA4,194
chr1,35047527,35047768,SRX5054309,FOSL2,241
chr1,35078995,35079597,SRX20140895,INTS13,602
chr1,35079064,35079434,SRX5075175,SMARCA4,370
chr1,35079068,35079642,SRX5075176,SMARCA4,574
chr1,35079072,35079530,SRX5075174,SMARCA4,458
chr1,35079082,35079549,SRX5075170,SMARCA4,467
chr1,35079096,35079729,SRX5075169,SMARCA4,633
chr1,35079101,35079564,SRX5075168,SMARCA4,463
chr1,35079117,35079355,SRX5716469,SMARCA4,238
chr1,35079244,35079575,SRX20140868,INTS10,331
chr1,35079267,35079509,SRX5716464,SMARCA4,242
chr1,35079267,35079551,SRX20140897,INTS13,284
chr1,35112737,35112966,SRX16500061,CTCF,229
chr1,35115501,35115751,SRX5075175,SMARCA4,250
chr1,35115551,35115751,SRX5075169,SMARCA4,200
chr1,35191802,35192284,SRX16500060,CTCF,482
chr1,35191878,35192430,SRX16500059,CTCF,552
chr1,35191946,35192294,SRX16500061,CTCF,348
chr1,35191954,35192163,SRX5075168,SMARCA4,209
chr1,35191958,35192343,SRX16500062,CTCF,385
chr1,35191967,35192233,SRX5075170,SMARCA4,266
chr1,35192013,35192521,SRX20140895,INTS13,508
chr1,35192021,35192274,SRX20140867,INTS10,253
chr1,35192116,35192664,SRX20140868,INTS10,548
chr1,35192206,35192577,SRX20140869,INTS10,371
chr1,35192863,35193257,SRX20140897,INTS13,394
chr1,35192886,35193335,SRX20140868,INTS10,449
chr1,35192939,35193375,SRX20140895,INTS13,436
chr1,35192981,35193204,SRX20140867,INTS10,223
chr1,35192990,35193234,SRX20140879,CPSF3L,244
chr1,35193001,35193325,SRX20140881,CPSF3L,324
chr1,35193082,35193602,SRX5075174,SMARCA4,520
chr1,35193109,35193421,SRX5716451,SOX2,312
chr1,35193110,35193589,SRX5075168,SMARCA4,479
chr1,35193114,35193423,SRX5716454,SOX3,309
chr1,35193131,35193516,SRX5075170,SMARCA4,385
chr1,35193149,35193458,SRX5054307,FOSL2,309
chr1,35193169,35193559,SRX5075176,SMARCA4,390
chr1,35193173,35193366,SRX5054308,FOSL2,193
chr1,35193178,35193516,SRX5716463,SMARCA4,338
chr1,35202009,35202593,SRX16500059,CTCF,584
chr1,35202019,35202568,SRX16500062,CTCF,549
chr1,35202030,35202589,SRX16500061,CTCF,559
chr1,35202035,35202576,SRX16500060,CTCF,541
chr1,35202076,35202491,SRX4174629,CTCF,415
chr1,35202119,35202528,SRX5075174,SMARCA4,409
chr1,35202152,35202486,SRX5075168,SMARCA4,334
chr1,35202164,35202387,SRX5716463,SMARCA4,223
chr1,35202175,35202500,SRX5075176,SMARCA4,325
chr1,35202190,35202462,SRX5075169,SMARCA4,272
chr1,35202193,35202399,SRX5716464,SMARCA4,206
chr1,35202209,35202527,SRX5075170,SMARCA4,318
chr1,35202213,35202491,SRX5075175,SMARCA4,278
chr1,35202261,35202533,SRX5716469,SMARCA4,272
chr1,35202272,35202539,SRX5716470,SMARCA4,267
chr1,35221009,35221322,SRX16500060,CTCF,313
chr1,35221056,35221398,SRX16500059,CTCF,342
chr1,35221060,35221391,SRX16500062,CTCF,331
chr1,35222719,35223097,SRX5075176,SMARCA4,378
chr1,35222730,35223155,SRX5716467,SMARCA2,425
chr1,35222839,35223125,SRX5075170,SMARCA4,286
chr1,35222867,35223047,SRX5075169,SMARCA4,180
chr1,35222867,35223098,SRX5054308,FOSL2,231
chr1,35222875,35223152,SRX5054309,FOSL2,277
chr1,35222905,35223138,SRX5716469,SMARCA4,233
chr1,35264869,35265113,SRX5075174,SMARCA4,244
chr1,35264879,35265161,SRX5075170,SMARCA4,282
chr1,35264954,35265211,SRX5075176,SMARCA4,257
chr1,35264977,35265158,SRX5075168,SMARCA4,181
chr1,35268420,35269162,SRX20140895,INTS13,742
chr1,35268464,35268824,SRX5075168,SMARCA4,360
chr1,35268489,35268758,SRX5075174,SMARCA4,269
chr1,35268490,35268695,SRX5716464,SMARCA4,205
chr1,35268490,35268958,SRX5075176,SMARCA4,468
chr1,35268509,35268782,SRX5075170,SMARCA4,273
chr1,35268519,35269164,SRX20140897,INTS13,645
chr1,35268588,35269082,SRX20140867,INTS10,494
chr1,35268651,35269158,SRX20140868,INTS10,507
chr1,35268656,35268986,SRX20140879,CPSF3L,330
chr1,35268659,35268976,SRX20140881,CPSF3L,317
chr1,35268674,35268972,SRX5075169,SMARCA4,298
chr1,35268704,35269161,SRX20140869,INTS10,457
chr1,35268744,35269068,SRX20140896,INTS13,324
chr1,35268753,35269113,SRX5075175,SMARCA4,360
chr1,35268791,35269147,SRX5716470,SMARCA4,356
chr1,35287915,35288142,SRX5075169,SMARCA4,227
chr1,35287928,35288211,SRX5054309,FOSL2,283
chr1,35287965,35288145,SRX5054308,FOSL2,180
chr1,35288864,35289065,SRX5054309,FOSL2,201
chr1,35288888,35289097,SRX5075169,SMARCA4,209
chr1,35370000,35370589,SRX5075176,SMARCA4,589
chr1,35370232,35370593,SRX5075170,SMARCA4,361
chr1,35370300,35370581,SRX5075175,SMARCA4,281
chr1,35370317,35370529,SRX5716469,SMARCA4,212
chr1,35370332,35370596,SRX5716470,SMARCA4,264
chr1,35448519,35448814,SRX5075176,SMARCA4,295
chr1,35448542,35448791,SRX5075170,SMARCA4,249
chr1,35448560,35448798,SRX5075169,SMARCA4,238
chr1,35448600,35448798,SRX5075175,SMARCA4,198
chr1,35449392,35449584,SRX5075169,SMARCA4,192
chr1,35449395,35449598,SRX5075170,SMARCA4,203
chr1,35449437,35449619,SRX5075176,SMARCA4,182
chr1,35450973,35451501,SRX16500059,CTCF,528
chr1,35451008,35451467,SRX16500062,CTCF,459
chr1,35451025,35451467,SRX16500061,CTCF,442
chr1,35451041,35451496,SRX16500060,CTCF,455
chr1,35451043,35451365,SRX4174629,CTCF,322
chr1,35451102,35451384,SRX5075168,SMARCA4,282
chr1,35451119,35451412,SRX5075174,SMARCA4,293
chr1,35451134,35451328,SRX5075176,SMARCA4,194
chr1,35451140,35451350,SRX5075170,SMARCA4,210
chr1,35451148,35451408,SRX5716463,SMARCA4,260
chr1,35451159,35451398,SRX5716470,SMARCA4,239
chr1,35471218,35471484,SRX5075170,SMARCA4,266
chr1,35476400,35476659,SRX5075176,SMARCA4,259
chr1,35488253,35488639,SRX5075170,SMARCA4,386
chr1,35488333,35488583,SRX5075176,SMARCA4,250
chr1,35505770,35506288,SRX5075170,SMARCA4,518
chr1,35505785,35506288,SRX5075175,SMARCA4,503
chr1,35505812,35506383,SRX5075176,SMARCA4,571
chr1,35505841,35506241,SRX5716469,SMARCA4,400
chr1,35505866,35506149,SRX5054308,FOSL2,283
chr1,35505873,35506251,SRX5075169,SMARCA4,378
chr1,35505887,35506335,SRX5716467,SMARCA2,448
chr1,35505911,35506274,SRX5716470,SMARCA4,363
chr1,35505920,35506250,SRX5054309,FOSL2,330
chr1,35539052,35540173,SRX5075176,SMARCA4,1121
chr1,35539104,35540177,SRX5075170,SMARCA4,1073
chr1,35539205,35539698,SRX5075175,SMARCA4,493
chr1,35539252,35539726,SRX5075169,SMARCA4,474
chr1,35539293,35539903,SRX5716470,SMARCA4,610
chr1,35539316,35539579,SRX20140881,CPSF3L,263
chr1,35539322,35539659,SRX5716469,SMARCA4,337
chr1,35539360,35539619,SRX5716467,SMARCA2,259
chr1,35539373,35539677,SRX5075168,SMARCA4,304
chr1,35539787,35540125,SRX5054309,FOSL2,338
chr1,35539809,35540086,SRX5054308,FOSL2,277
chr1,35539889,35540187,SRX5075169,SMARCA4,298
chr1,35545006,35545330,SRX16500059,CTCF,324
chr1,35545124,35545334,SRX16500062,CTCF,210
chr1,35545134,35545355,SRX16500060,CTCF,221
chr1,35557023,35557304,SRX5075174,SMARCA4,281
chr1,35557092,35557338,SRX5075168,SMARCA4,246
chr1,35557109,35558074,SRX20140895,INTS13,965
chr1,35557130,35557331,SRX5075170,SMARCA4,201
chr1,35557185,35557990,SRX20140868,INTS10,805
chr1,35557265,35558011,SRX20140867,INTS10,746
chr1,35557266,35557759,SRX20140897,INTS13,493
chr1,35557326,35558088,SRX20140879,CPSF3L,762
chr1,35557380,35557880,SRX20140869,INTS10,500
chr1,35557410,35557779,SRX20140894,INTS13,369
chr1,35564549,35565034,SRX16500061,CTCF,485
chr1,35564577,35565013,SRX16500059,CTCF,436
chr1,35564605,35564998,SRX16500060,CTCF,393
chr1,35564620,35564967,SRX5075168,SMARCA4,347
chr1,35564628,35565037,SRX16500062,CTCF,409
chr1,35564650,35564958,SRX5716470,SMARCA4,308
chr1,35564670,35564986,SRX5075174,SMARCA4,316
chr1,35564676,35564961,SRX5075176,SMARCA4,285
chr1,35564686,35564962,SRX5075170,SMARCA4,276
chr1,35564688,35564981,SRX5075175,SMARCA4,293
chr1,35564706,35564976,SRX5075169,SMARCA4,270
chr1,35564716,35564958,SRX5716464,SMARCA4,242
chr1,35564738,35564982,SRX4174629,CTCF,244
chr1,35564762,35564977,SRX5716463,SMARCA4,215
chr1,35568868,35569351,SRX16500059,CTCF,483
chr1,35568890,35569322,SRX16500060,CTCF,432
chr1,35568898,35569306,SRX16500062,CTCF,408
chr1,35568929,35569287,SRX16500061,CTCF,358
chr1,35568964,35569245,SRX4174629,CTCF,281
chr1,35569001,35569211,SRX5075170,SMARCA4,210
chr1,35569037,35569242,SRX5716464,SMARCA4,205
chr1,35573307,35573533,SRX5075169,SMARCA4,226
chr1,35637433,35637639,SRX5075169,SMARCA4,206
chr1,35637449,35637652,SRX5075170,SMARCA4,203
chr1,35637450,35637637,SRX5075175,SMARCA4,187
chr1,35637518,35637693,SRX5075176,SMARCA4,175
chr1,35641295,35641551,SRX20140897,INTS13,256
chr1,35641304,35641847,SRX20140869,INTS10,543
chr1,35641311,35641919,SRX20140895,INTS13,608
chr1,35641394,35641774,SRX20140867,INTS10,380
chr1,35641436,35641818,SRX5075168,SMARCA4,382
chr1,35641443,35641739,SRX20140881,CPSF3L,296
chr1,35641465,35641779,SRX20140868,INTS10,314
chr1,35641491,35641790,SRX5075174,SMARCA4,299
chr1,35661046,35661220,SRX5075170,SMARCA4,174
chr1,35661047,35661242,SRX5075176,SMARCA4,195
chr1,35707706,35708212,SRX5075174,SMARCA4,506
chr1,35707718,35708248,SRX5075168,SMARCA4,530
chr1,35707720,35708394,SRX20140895,INTS13,674
chr1,35707722,35708100,SRX5075176,SMARCA4,378
chr1,35707754,35708011,SRX5075170,SMARCA4,257
chr1,35707757,35708415,SRX20140868,INTS10,658
chr1,35707770,35708102,SRX5075175,SMARCA4,332
chr1,35707807,35708084,SRX20140867,INTS10,277
chr1,35707839,35708208,SRX5075169,SMARCA4,369
chr1,35707899,35708111,SRX5716469,SMARCA4,212
chr1,35708095,35708335,SRX5075170,SMARCA4,240
chr1,35715312,35716069,SRX16500060,CTCF,757
chr1,35715412,35715918,SRX16500061,CTCF,506
chr1,35715425,35715928,SRX16500062,CTCF,503
chr1,35715431,35715927,SRX16500059,CTCF,496
chr1,35715532,35715828,SRX4174629,CTCF,296
chr1,35715545,35715718,SRX5075174,SMARCA4,173
chr1,35715573,35715816,SRX5075168,SMARCA4,243
chr1,35718650,35718929,SRX5075170,SMARCA4,279
chr1,35718709,35718979,SRX5716470,SMARCA4,270
chr1,35718737,35718945,SRX5075169,SMARCA4,208
chr1,35718851,35719070,SRX5075175,SMARCA4,219
chr1,35718876,35719120,SRX5075176,SMARCA4,244
chr1,35725734,35725990,SRX20140895,INTS13,256
chr1,35726737,35727231,SRX4174629,CTCF,494
chr1,35726785,35727335,SRX16500059,CTCF,550
chr1,35726799,35727257,SRX16500062,CTCF,458
chr1,35726806,35727286,SRX16500061,CTCF,480
chr1,35726820,35727313,SRX16500060,CTCF,493
chr1,35726896,35727170,SRX5075176,SMARCA4,274
chr1,35726914,35727083,SRX5075170,SMARCA4,169
chr1,35769164,35770174,SRX20140895,INTS13,1010
chr1,35769175,35769575,SRX5075174,SMARCA4,400
chr1,35769230,35769538,SRX5075169,SMARCA4,308
chr1,35769235,35769557,SRX5075175,SMARCA4,322
chr1,35769253,35769575,SRX5075170,SMARCA4,322
chr1,35769266,35769527,SRX5716470,SMARCA4,261
chr1,35769266,35769645,SRX5075168,SMARCA4,379
chr1,35769269,35770076,SRX20140879,CPSF3L,807
chr1,35769281,35769497,SRX5716464,SMARCA4,216
chr1,35769288,35769598,SRX5075176,SMARCA4,310
chr1,35769333,35770141,SRX20140868,INTS10,808
chr1,35769344,35770150,SRX20140867,INTS10,806
chr1,35769570,35770017,SRX20140894,INTS13,447
chr1,35769574,35770111,SRX20140897,INTS13,537
chr1,35769607,35770115,SRX20140881,CPSF3L,508
chr1,35769649,35770121,SRX20140896,INTS13,472
chr1,35769873,35770318,SRX5075168,SMARCA4,445
chr1,35769945,35770305,SRX5075174,SMARCA4,360
chr1,35769967,35770278,SRX5716463,SMARCA4,311
chr1,35769970,35770238,SRX5054307,FOSL2,268
chr1,35769992,35770222,SRX5075176,SMARCA4,230
chr1,35770060,35770258,SRX5075170,SMARCA4,198
chr1,35770101,35770314,SRX5075169,SMARCA4,213
chr1,35774591,35775065,SRX4174629,CTCF,474
chr1,35774592,35775096,SRX16500060,CTCF,504
chr1,35774604,35775105,SRX16500059,CTCF,501
chr1,35774606,35775056,SRX16500061,CTCF,450
chr1,35774636,35775221,SRX16500062,CTCF,585
chr1,35774643,35774970,SRX5075174,SMARCA4,327
chr1,35774691,35774920,SRX5716464,SMARCA4,229
chr1,35774698,35774968,SRX5716463,SMARCA4,270
chr1,35774701,35775003,SRX5075168,SMARCA4,302
chr1,35774711,35774938,SRX5075170,SMARCA4,227
chr1,35774713,35774917,SRX5075176,SMARCA4,204
chr1,35774726,35775001,SRX5075175,SMARCA4,275
chr1,35774744,35774945,SRX5075169,SMARCA4,201
chr1,35807757,35808220,SRX20140895,INTS13,463
chr1,35807773,35808090,SRX5075174,SMARCA4,317
chr1,35807795,35808122,SRX5075168,SMARCA4,327
chr1,35807835,35808316,SRX5075170,SMARCA4,481
chr1,35807836,35808259,SRX5075169,SMARCA4,423
chr1,35807893,35808277,SRX5075176,SMARCA4,384
chr1,35807948,35808325,SRX5075175,SMARCA4,377
chr1,35810184,35810370,SRX5054308,FOSL2,186
chr1,35851319,35851792,SRX5075175,SMARCA4,473
chr1,35851348,35851893,SRX5075176,SMARCA4,545
chr1,35851398,35851817,SRX5716469,SMARCA4,419
chr1,35851398,35851845,SRX5075170,SMARCA4,447
chr1,35851401,35851912,SRX5716470,SMARCA4,511
chr1,35851419,35851829,SRX5075169,SMARCA4,410
chr1,35851450,35851836,SRX5716467,SMARCA2,386
chr1,35851465,35851830,SRX5020211,SMARCA2,365
chr1,35851469,35851810,SRX5075181,SMARCA2,341
chr1,35851492,35851899,SRX5716468,SMARCA2,407
chr1,35854873,35855112,SRX5075168,SMARCA4,239
chr1,35854894,35855224,SRX5075174,SMARCA4,330
chr1,35877090,35877277,SRX5075176,SMARCA4,187
chr1,35882782,35883327,SRX16500062,CTCF,545
chr1,35882794,35883356,SRX16500060,CTCF,562
chr1,35882802,35883367,SRX16500059,CTCF,565
chr1,35882813,35883358,SRX16500061,CTCF,545
chr1,35882934,35883189,SRX4174629,CTCF,255
chr1,35882964,35883389,SRX5075168,SMARCA4,425
chr1,35882978,35883326,SRX5075174,SMARCA4,348
chr1,35883004,35883316,SRX5075176,SMARCA4,312
chr1,35883011,35883316,SRX5075170,SMARCA4,305
chr1,35883026,35883216,SRX5075175,SMARCA4,190
chr1,35883046,35883374,SRX5716470,SMARCA4,328
chr1,35883128,35883481,SRX20140895,INTS13,353
chr1,35885957,35886389,SRX5075168,SMARCA4,432
chr1,35885958,35886437,SRX5075174,SMARCA4,479
chr1,35886071,35886322,SRX5716451,SOX2,251
chr1,35886071,35886348,SRX5716454,SOX3,277
chr1,35886082,35886318,SRX5716464,SMARCA4,236
chr1,35886103,35886390,SRX5716463,SMARCA4,287
chr1,35930358,35930549,SRX5075169,SMARCA4,191
chr1,35930607,35931487,SRX20140895,INTS13,880
chr1,35930668,35931196,SRX20140867,INTS10,528
chr1,35930780,35931243,SRX20140868,INTS10,463
chr1,35930784,35931066,SRX20140897,INTS13,282
chr1,35930903,35931131,SRX5075170,SMARCA4,228
chr1,35930924,35931163,SRX5075174,SMARCA4,239
chr1,35935480,35935743,SRX5075168,SMARCA4,263
chr1,35935504,35935743,SRX5075174,SMARCA4,239
chr1,35935511,35935795,SRX5716470,SMARCA4,284
chr1,35935523,35935758,SRX5075170,SMARCA4,235
chr1,35935526,35935766,SRX5716467,SMARCA2,240
chr1,35935529,35935747,SRX5075169,SMARCA4,218
chr1,35935531,35935780,SRX5075176,SMARCA4,249
chr1,35935539,35935733,SRX5075175,SMARCA4,194
chr1,35935909,35936380,SRX5075174,SMARCA4,471
chr1,35935913,35936326,SRX5075168,SMARCA4,413
chr1,35935947,35936227,SRX5716463,SMARCA4,280
chr1,35935988,35936221,SRX5075176,SMARCA4,233
chr1,35936075,35936272,SRX5075170,SMARCA4,197
chr1,35936084,35936286,SRX5020211,SMARCA2,202
chr1,36008476,36008987,SRX5075174,SMARCA4,511
chr1,36008510,36008993,SRX5075168,SMARCA4,483
chr1,36008564,36008819,SRX5054308,FOSL2,255
chr1,36008597,36008783,SRX5054307,FOSL2,186
chr1,36008611,36008815,SRX5054309,FOSL2,204
chr1,36008613,36008889,SRX5075169,SMARCA4,276
chr1,36008641,36008810,SRX5075170,SMARCA4,169
chr1,36008705,36008907,SRX5075176,SMARCA4,202
chr1,36083831,36084323,SRX5075174,SMARCA4,492
chr1,36083840,36084264,SRX5075168,SMARCA4,424
chr1,36083855,36084191,SRX20140895,INTS13,336
chr1,36083857,36084411,SRX5075176,SMARCA4,554
chr1,36083868,36084164,SRX5716463,SMARCA4,296
chr1,36083879,36084200,SRX5075170,SMARCA4,321
chr1,36083908,36084234,SRX5716470,SMARCA4,326
chr1,36083909,36084216,SRX5716469,SMARCA4,307
chr1,36083914,36084106,SRX5075169,SMARCA4,192
chr1,36083918,36084105,SRX5075175,SMARCA4,187
chr1,36083947,36084164,SRX5716464,SMARCA4,217
chr1,36084347,36084571,SRX5716470,SMARCA4,224
chr1,36088466,36089050,SRX16500059,CTCF,584
chr1,36088467,36089014,SRX16500062,CTCF,547
chr1,36088516,36088994,SRX16500061,CTCF,478
chr1,36088539,36089049,SRX16500060,CTCF,510
chr1,36088648,36089084,SRX5075168,SMARCA4,436
chr1,36088657,36089023,SRX5075174,SMARCA4,366
chr1,36088666,36089301,SRX20140895,INTS13,635
chr1,36088671,36088948,SRX5075176,SMARCA4,277
chr1,36088688,36089184,SRX20140868,INTS10,496
chr1,36088705,36089029,SRX5075169,SMARCA4,324
chr1,36088744,36088927,SRX5075170,SMARCA4,183
chr1,36088745,36089109,SRX20140879,CPSF3L,364
chr1,36088815,36089203,SRX20140897,INTS13,388
chr1,36088846,36089141,SRX20140867,INTS10,295
chr1,36088858,36089129,SRX20140881,CPSF3L,271
chr1,36089672,36089892,SRX5716470,SMARCA4,220
chr1,36099483,36100099,SRX16500060,CTCF,616
chr1,36099514,36099987,SRX16500062,CTCF,473
chr1,36099533,36100012,SRX16500059,CTCF,479
chr1,36099546,36100053,SRX16500061,CTCF,507
chr1,36099572,36099998,SRX4174629,CTCF,426
chr1,36099672,36099958,SRX5075170,SMARCA4,286
chr1,36099688,36099910,SRX5716470,SMARCA4,222
chr1,36099692,36099871,SRX5075168,SMARCA4,179
chr1,36099715,36099944,SRX5075176,SMARCA4,229
chr1,36099732,36099936,SRX5716463,SMARCA4,204
chr1,36099758,36099946,SRX5075175,SMARCA4,188
chr1,36108995,36109206,SRX5075176,SMARCA4,211
chr1,36109002,36109400,SRX5716470,SMARCA4,398
chr1,36109036,36109246,SRX5020211,SMARCA2,210
chr1,36109073,36109375,SRX5716469,SMARCA4,302
chr1,36109082,36109324,SRX5075170,SMARCA4,242
chr1,36109142,36109350,SRX5054309,FOSL2,208
chr1,36115148,36115509,SRX5075176,SMARCA4,361
chr1,36115212,36115572,SRX5075170,SMARCA4,360
chr1,36115217,36115528,SRX5075169,SMARCA4,311
chr1,36115225,36115449,SRX5716467,SMARCA2,224
chr1,36133567,36133761,SRX5054309,FOSL2,194
chr1,36134629,36135171,SRX16500060,CTCF,542
chr1,36134645,36135114,SRX16500061,CTCF,469
chr1,36134651,36135110,SRX4174629,CTCF,459
chr1,36134664,36135199,SRX16500059,CTCF,535
chr1,36134666,36135167,SRX16500062,CTCF,501
chr1,36134719,36134976,SRX5075168,SMARCA4,257
chr1,36134813,36135066,SRX5075174,SMARCA4,253
chr1,36140731,36140996,SRX5054309,FOSL2,265
chr1,36149149,36149826,SRX20140895,INTS13,677
chr1,36149179,36149463,SRX20140897,INTS13,284
chr1,36149224,36149932,SRX5075174,SMARCA4,708
chr1,36149276,36149923,SRX5075168,SMARCA4,647
chr1,36149309,36149972,SRX16500060,CTCF,663
chr1,36149332,36149851,SRX5716463,SMARCA4,519
chr1,36149377,36149776,SRX5716451,SOX2,399
chr1,36149409,36149698,SRX5716454,SOX3,289
chr1,36149441,36149960,SRX16500059,CTCF,519
chr1,36149449,36149991,SRX16500062,CTCF,542
chr1,36149450,36149799,SRX5716464,SMARCA4,349
chr1,36149490,36149948,SRX16500061,CTCF,458
chr1,36149514,36149929,SRX4174629,CTCF,415
chr1,36149523,36149994,SRX5075176,SMARCA4,471
chr1,36149542,36149872,SRX5054307,FOSL2,330
chr1,36149590,36149997,SRX5075170,SMARCA4,407
chr1,36149617,36149969,SRX5075175,SMARCA4,352
chr1,36149618,36149908,SRX5716467,SMARCA2,290
chr1,36149637,36149944,SRX5716470,SMARCA4,307
chr1,36149645,36150094,SRX5075169,SMARCA4,449
chr1,36149696,36150023,SRX5054308,FOSL2,327
chr1,36149703,36150101,SRX5054309,FOSL2,398
chr1,36149707,36149985,SRX5716469,SMARCA4,278
chr1,36150644,36151082,SRX5075169,SMARCA4,438
chr1,36150727,36151087,SRX5075175,SMARCA4,360
chr1,36150774,36151143,SRX5075170,SMARCA4,369
chr1,36150816,36151121,SRX5075168,SMARCA4,305
chr1,36150843,36151106,SRX5054309,FOSL2,263
chr1,36150857,36151162,SRX5075174,SMARCA4,305
chr1,36150863,36151093,SRX5716470,SMARCA4,230
chr1,36150910,36151118,SRX5075176,SMARCA4,208
chr1,36155162,36156637,SRX20140895,INTS13,1475
chr1,36155592,36156088,SRX5075176,SMARCA4,496
chr1,36155608,36156085,SRX5716469,SMARCA4,477
chr1,36155656,36156071,SRX5075175,SMARCA4,415
chr1,36155673,36155888,SRX5716470,SMARCA4,215
chr1,36155675,36156008,SRX5075168,SMARCA4,333
chr1,36155675,36156065,SRX5054309,FOSL2,390
chr1,36155675,36156091,SRX5054308,FOSL2,416
chr1,36155690,36155957,SRX5075170,SMARCA4,267
chr1,36155699,36156094,SRX20140868,INTS10,395
chr1,36155703,36155903,SRX5075174,SMARCA4,200
chr1,36155706,36155991,SRX5075169,SMARCA4,285
chr1,36155759,36155940,SRX5054307,FOSL2,181
chr1,36155876,36156176,SRX20140867,INTS10,300
chr1,36156752,36157092,SRX20140895,INTS13,340
chr1,36156972,36157229,SRX5075174,SMARCA4,257
chr1,36160866,36161276,SRX5075169,SMARCA4,410
chr1,36160917,36161190,SRX5075170,SMARCA4,273
chr1,36160920,36161139,SRX5075174,SMARCA4,219
chr1,36160931,36161292,SRX5075176,SMARCA4,361
chr1,36160976,36161192,SRX5716470,SMARCA4,216
chr1,36161000,36161380,SRX5075168,SMARCA4,380
chr1,36161180,36161406,SRX16500062,CTCF,226
chr1,36172988,36173267,SRX5075175,SMARCA4,279
chr1,36172988,36173355,SRX5075176,SMARCA4,367
chr1,36173003,36173360,SRX5075170,SMARCA4,357
chr1,36173004,36173307,SRX5075168,SMARCA4,303
chr1,36173009,36173331,SRX5075169,SMARCA4,322
chr1,36173025,36173365,SRX5054308,FOSL2,340
chr1,36173026,36173289,SRX5716469,SMARCA4,263
chr1,36173043,36173284,SRX5054309,FOSL2,241
chr1,36173065,36173347,SRX5075174,SMARCA4,282
chr1,36176320,36176555,SRX16500059,CTCF,235
chr1,36187865,36188442,SRX5075170,SMARCA4,577
chr1,36187941,36188530,SRX16500061,CTCF,589
chr1,36188003,36188629,SRX16500060,CTCF,626
chr1,36188009,36188425,SRX5075174,SMARCA4,416
chr1,36188073,36188422,SRX5075168,SMARCA4,349
chr1,36188082,36188574,SRX16500059,CTCF,492
chr1,36188083,36188423,SRX5716470,SMARCA4,340
chr1,36188090,36188576,SRX16500062,CTCF,486
chr1,36188094,36188426,SRX5075175,SMARCA4,332
chr1,36188123,36188517,SRX5075176,SMARCA4,394
chr1,36188151,36188503,SRX4174629,CTCF,352
chr1,36188169,36188426,SRX5716463,SMARCA4,257
chr1,36188170,36188455,SRX5075169,SMARCA4,285
chr1,36188196,36188449,SRX5716469,SMARCA4,253
chr1,36188290,36188552,SRX5054309,FOSL2,262
chr1,36223577,36224171,SRX5716469,SMARCA4,594
chr1,36223753,36224054,SRX5075169,SMARCA4,301
chr1,36223855,36224337,SRX5075174,SMARCA4,482
chr1,36223872,36224284,SRX5716470,SMARCA4,412
chr1,36223896,36224230,SRX5075170,SMARCA4,334
chr1,36223898,36224434,SRX5075176,SMARCA4,536
chr1,36223928,36224334,SRX5075168,SMARCA4,406
chr1,36223947,36224157,SRX5716463,SMARCA4,210
chr1,36223982,36224182,SRX5075175,SMARCA4,200
chr1,36223999,36224904,SRX20140895,INTS13,905
chr1,36224040,36224674,SRX20140897,INTS13,634
chr1,36224045,36224939,SRX20140869,INTS10,894
chr1,36224051,36224267,SRX5054309,FOSL2,216
chr1,36224108,36224453,SRX20140896,INTS13,345
chr1,36224150,36224372,SRX5716451,SOX2,222
chr1,36224170,36224421,SRX5716454,SOX3,251
chr1,36224174,36224555,SRX20140867,INTS10,381
chr1,36224646,36225213,SRX16500062,CTCF,567
chr1,36224690,36225213,SRX16500059,CTCF,523
chr1,36224697,36225150,SRX16500061,CTCF,453
chr1,36224721,36225116,SRX5075168,SMARCA4,395
chr1,36224734,36225181,SRX16500060,CTCF,447
chr1,36224952,36225132,SRX5075169,SMARCA4,180
chr1,36238428,36238784,SRX5075175,SMARCA4,356
chr1,36238446,36238847,SRX5075170,SMARCA4,401
chr1,36238449,36238792,SRX5075169,SMARCA4,343
chr1,36238449,36238796,SRX5075176,SMARCA4,347
chr1,36238481,36238717,SRX5020211,SMARCA2,236
chr1,36238487,36238729,SRX5716469,SMARCA4,242
chr1,36248295,36248676,SRX5075170,SMARCA4,381
chr1,36248333,36248651,SRX5075175,SMARCA4,318
chr1,36248345,36248583,SRX5716469,SMARCA4,238
chr1,36248348,36248650,SRX5054308,FOSL2,302
chr1,36248357,36248662,SRX5054309,FOSL2,305
chr1,36248358,36248635,SRX5075176,SMARCA4,277
chr1,36248371,36248656,SRX5075169,SMARCA4,285
chr1,36266402,36266753,SRX5075176,SMARCA4,351
chr1,36266441,36266733,SRX5075175,SMARCA4,292
chr1,36266460,36266741,SRX5075169,SMARCA4,281
chr1,36266464,36266679,SRX5716467,SMARCA2,215
chr1,36266475,36266731,SRX5075170,SMARCA4,256
chr1,36266536,36266770,SRX5716470,SMARCA4,234
chr1,36285365,36285957,SRX16500061,CTCF,592
chr1,36285400,36286028,SRX16500060,CTCF,628
chr1,36285416,36285727,SRX4174629,CTCF,311
chr1,36285446,36286003,SRX16500062,CTCF,557
chr1,36285448,36285784,SRX5075174,SMARCA4,336
chr1,36285448,36285802,SRX5075168,SMARCA4,354
chr1,36285477,36286096,SRX16500059,CTCF,619
chr1,36285483,36285767,SRX5075176,SMARCA4,284
chr1,36285486,36285736,SRX5075169,SMARCA4,250
chr1,36285493,36285709,SRX5075170,SMARCA4,216
chr1,36285497,36285702,SRX5716464,SMARCA4,205
chr1,36285525,36285736,SRX5716470,SMARCA4,211
chr1,36285534,36285770,SRX5075175,SMARCA4,236
chr1,36285814,36286024,SRX4174629,CTCF,210
chr1,36299885,36300266,SRX16500062,CTCF,381
chr1,36299895,36300196,SRX5075174,SMARCA4,301
chr1,36299905,36300296,SRX5075170,SMARCA4,391
chr1,36299913,36300269,SRX16500059,CTCF,356
chr1,36299918,36300131,SRX5075168,SMARCA4,213
chr1,36299919,36300147,SRX16500061,CTCF,228
chr1,36299924,36300362,SRX5075176,SMARCA4,438
chr1,36299933,36300286,SRX16500060,CTCF,353
chr1,36299958,36300335,SRX5075169,SMARCA4,377
chr1,36299959,36300265,SRX5716470,SMARCA4,306
chr1,36299977,36300348,SRX5716469,SMARCA4,371
chr1,36299987,36300320,SRX5054309,FOSL2,333
chr1,36300025,36300347,SRX5075175,SMARCA4,322
chr1,36300031,36300327,SRX5054308,FOSL2,296
chr1,36306792,36307286,SRX5075168,SMARCA4,494
chr1,36306821,36307369,SRX20140895,INTS13,548
chr1,36306853,36307219,SRX5075174,SMARCA4,366
chr1,36306864,36307037,SRX5075170,SMARCA4,173
chr1,36306904,36307144,SRX5716463,SMARCA4,240
chr1,36307000,36307184,SRX5075169,SMARCA4,184
chr1,36307003,36307245,SRX20140879,CPSF3L,242
chr1,36307021,36307208,SRX5075176,SMARCA4,187
chr1,36307036,36307241,SRX5716464,SMARCA4,205
chr1,36321161,36321564,SRX5075170,SMARCA4,403
chr1,36321184,36321552,SRX5075169,SMARCA4,368
chr1,36321187,36321518,SRX5716470,SMARCA4,331
chr1,36321197,36321636,SRX5075176,SMARCA4,439
chr1,36321204,36321535,SRX5716469,SMARCA4,331
chr1,36321226,36321469,SRX5716468,SMARCA2,243
chr1,36321226,36321527,SRX5075175,SMARCA4,301
chr1,36321248,36321499,SRX5716467,SMARCA2,251
chr1,36321262,36321529,SRX5020211,SMARCA2,267
chr1,36323463,36323902,SRX5075168,SMARCA4,439
chr1,36342662,36343005,SRX16500061,CTCF,343
chr1,36342679,36343025,SRX16500060,CTCF,346
chr1,36342733,36343034,SRX16500059,CTCF,301
chr1,36342779,36343002,SRX16500062,CTCF,223
chr1,36342867,36343134,SRX5075175,SMARCA4,267
chr1,36342903,36343079,SRX5075170,SMARCA4,176
chr1,36342928,36343153,SRX5075169,SMARCA4,225
chr1,36350905,36351187,SRX5075169,SMARCA4,282
chr1,36350926,36351178,SRX5054309,FOSL2,252
chr1,36350980,36351262,SRX5075175,SMARCA4,282
chr1,36351096,36351389,SRX5075170,SMARCA4,293
chr1,36351140,36351367,SRX5716469,SMARCA4,227
chr1,36351437,36351831,SRX5075169,SMARCA4,394
chr1,36351543,36351982,SRX5075176,SMARCA4,439
chr1,36351556,36351998,SRX5075170,SMARCA4,442
chr1,36351568,36351785,SRX5075175,SMARCA4,217
chr1,36351605,36351900,SRX5075168,SMARCA4,295
chr1,36351624,36352049,SRX20140895,INTS13,425
chr1,36351639,36351969,SRX5075174,SMARCA4,330
chr1,36365371,36365557,SRX5075176,SMARCA4,186
chr1,36365436,36365630,SRX5075170,SMARCA4,194
chr1,36366136,36366413,SRX20140895,INTS13,277
chr1,36368864,36369309,SRX4174629,CTCF,445
chr1,36368910,36369467,SRX16500059,CTCF,557
chr1,36368914,36369461,SRX16500061,CTCF,547
chr1,36368930,36369488,SRX16500060,CTCF,558
chr1,36368935,36369430,SRX16500062,CTCF,495
chr1,36369027,36369247,SRX5075168,SMARCA4,220
chr1,36369055,36369271,SRX5075174,SMARCA4,216
chr1,36373561,36374161,SRX5075168,SMARCA4,600
chr1,36373572,36374248,SRX5075176,SMARCA4,676
chr1,36373616,36374257,SRX5075174,SMARCA4,641
chr1,36373670,36373989,SRX5716467,SMARCA2,319
chr1,36373684,36373990,SRX5716460,Epitope tags,306
chr1,36373752,36374170,SRX5075169,SMARCA4,418
chr1,36373752,36374238,SRX5075175,SMARCA4,486
chr1,36373772,36374219,SRX5075170,SMARCA4,447
chr1,36373780,36374127,SRX5054309,FOSL2,347
chr1,36373784,36374121,SRX5054308,FOSL2,337
chr1,36373794,36374197,SRX5716470,SMARCA4,403
chr1,36373796,36374196,SRX5716469,SMARCA4,400
chr1,36373826,36374079,SRX5716468,SMARCA2,253
chr1,36373833,36374012,SRX5075182,SMARCA2,179
chr1,36373833,36374116,SRX5716464,SMARCA4,283
chr1,36373834,36374037,SRX5054307,FOSL2,203
chr1,36373875,36374075,SRX5020211,SMARCA2,200
chr1,36374637,36374968,SRX5075169,SMARCA4,331
chr1,36374638,36374949,SRX5075175,SMARCA4,311
chr1,36374649,36374905,SRX5075176,SMARCA4,256
chr1,36374654,36374869,SRX5054309,FOSL2,215
chr1,36374678,36374960,SRX5075170,SMARCA4,282
chr1,36385620,36386248,SRX20140895,INTS13,628
chr1,36385678,36385936,SRX20140879,CPSF3L,258
chr1,36385880,36386232,SRX5054307,FOSL2,352
chr1,36385898,36386857,SRX5054308,FOSL2,959
chr1,36386153,36386904,SRX5075170,SMARCA4,751
chr1,36386175,36386857,SRX5054309,FOSL2,682
chr1,36386204,36386849,SRX5716470,SMARCA4,645
chr1,36386208,36386417,SRX5075174,SMARCA4,209
chr1,36386267,36386882,SRX5075176,SMARCA4,615
chr1,36386279,36386922,SRX5075169,SMARCA4,643
chr1,36386321,36386875,SRX20140867,INTS10,554
chr1,36386326,36386742,SRX5075168,SMARCA4,416
chr1,36386330,36386646,SRX20140881,CPSF3L,316
chr1,36386361,36386896,SRX5075175,SMARCA4,535
chr1,36386367,36386891,SRX5716469,SMARCA4,524
chr1,36386396,36387142,SRX20140869,INTS10,746
chr1,36386436,36386744,SRX5716460,Epitope tags,308
chr1,36386443,36386903,SRX20140879,CPSF3L,460
chr1,36386451,36386938,SRX20140895,INTS13,487
chr1,36386503,36386792,SRX5020214,SMARCA2,289
chr1,36386507,36386859,SRX5716467,SMARCA2,352
chr1,36386514,36386799,SRX20140897,INTS13,285
chr1,36386517,36386884,SRX5075174,SMARCA4,367
chr1,36386543,36386748,SRX5054307,FOSL2,205
chr1,36387419,36387860,SRX5075168,SMARCA4,441
chr1,36387421,36387832,SRX5075176,SMARCA4,411
chr1,36387447,36387714,SRX5075175,SMARCA4,267
chr1,36387460,36387757,SRX5716469,SMARCA4,297
chr1,36387472,36387788,SRX5075170,SMARCA4,316
chr1,36387474,36387717,SRX5054309,FOSL2,243
chr1,36387505,36387711,SRX5020214,SMARCA2,206
chr1,36387518,36387796,SRX5075169,SMARCA4,278
chr1,36387533,36387748,SRX5075174,SMARCA4,215
chr1,36397448,36398160,SRX20140895,INTS13,712
chr1,36397621,36398025,SRX20140897,INTS13,404
chr1,36397637,36398057,SRX20140867,INTS10,420
chr1,36397679,36397859,SRX5075169,SMARCA4,180
chr1,36397692,36398123,SRX5075168,SMARCA4,431
chr1,36397713,36397984,SRX20140868,INTS10,271
chr1,36397720,36397992,SRX5075175,SMARCA4,272
chr1,36397759,36398169,SRX5075174,SMARCA4,410
chr1,36397825,36398086,SRX5054309,FOSL2,261
chr1,36397839,36398038,SRX5054307,FOSL2,199
chr1,36397916,36398177,SRX5716451,SOX2,261
chr1,36400955,36401480,SRX5075170,SMARCA4,525
chr1,36400982,36401513,SRX5075176,SMARCA4,531
chr1,36401051,36401458,SRX5075175,SMARCA4,407
chr1,36401056,36401356,SRX5075168,SMARCA4,300
chr1,36401085,36401433,SRX5716470,SMARCA4,348
chr1,36401098,36401447,SRX5075169,SMARCA4,349
chr1,36401099,36401426,SRX5075174,SMARCA4,327
chr1,36401122,36401378,SRX20140895,INTS13,256
chr1,36420710,36421223,SRX16500059,CTCF,513
chr1,36420738,36421222,SRX16500060,CTCF,484
chr1,36420755,36421237,SRX16500061,CTCF,482
chr1,36420764,36421123,SRX5075168,SMARCA4,359
chr1,36420773,36421267,SRX16500062,CTCF,494
chr1,36420777,36421121,SRX4174629,CTCF,344
chr1,36420801,36421085,SRX5716464,SMARCA4,284
chr1,36420807,36421047,SRX5075169,SMARCA4,240
chr1,36420811,36421115,SRX5075174,SMARCA4,304
chr1,36420813,36421097,SRX5075170,SMARCA4,284
chr1,36420820,36421087,SRX5075176,SMARCA4,267
chr1,36420843,36421084,SRX5075175,SMARCA4,241
chr1,36449843,36450154,SRX16500062,CTCF,311
chr1,36449872,36450161,SRX16500061,CTCF,289
chr1,36449900,36450179,SRX16500060,CTCF,279
chr1,36450219,36450894,SRX20140895,INTS13,675
chr1,36450254,36450898,SRX5075176,SMARCA4,644
chr1,36450284,36451023,SRX5716469,SMARCA4,739
chr1,36450293,36450876,SRX20140868,INTS10,583
chr1,36450303,36450774,SRX5075168,SMARCA4,471
chr1,36450335,36450822,SRX5075174,SMARCA4,487
chr1,36450335,36450855,SRX20140897,INTS13,520
chr1,36450339,36450789,SRX5075170,SMARCA4,450
chr1,36450382,36450724,SRX5716463,SMARCA4,342
chr1,36450393,36450810,SRX5075169,SMARCA4,417
chr1,36450403,36450621,SRX5716464,SMARCA4,218
chr1,36450437,36450856,SRX5716470,SMARCA4,419
chr1,36450453,36450632,SRX5054307,FOSL2,179
chr1,36450458,36450817,SRX20140867,INTS10,359
chr1,36450497,36450850,SRX5075175,SMARCA4,353
chr1,36450584,36450837,SRX20140879,CPSF3L,253
chr1,36464052,36464687,SRX20140895,INTS13,635
chr1,36464067,36464562,SRX20140881,CPSF3L,495
chr1,36464097,36464433,SRX20140879,CPSF3L,336
chr1,36464132,36464650,SRX20140868,INTS10,518
chr1,36464133,36464793,SRX20140869,INTS10,660
chr1,36464176,36464733,SRX20140867,INTS10,557
chr1,36464190,36464725,SRX20140897,INTS13,535
chr1,36464211,36464734,SRX5075169,SMARCA4,523
chr1,36464220,36464860,SRX5075174,SMARCA4,640
chr1,36464223,36464640,SRX5716464,SMARCA4,417
chr1,36464233,36464613,SRX5075168,SMARCA4,380
chr1,36464247,36464860,SRX5075170,SMARCA4,613
chr1,36464282,36464799,SRX5075176,SMARCA4,517
chr1,36464322,36464505,SRX5054309,FOSL2,183
chr1,36464345,36464687,SRX5716463,SMARCA4,342
chr1,36464405,36464806,SRX5716469,SMARCA4,401
chr1,36464406,36464823,SRX5075175,SMARCA4,417
chr1,36464468,36464811,SRX5716470,SMARCA4,343
chr1,36516307,36516799,SRX16500061,CTCF,492
chr1,36516320,36516811,SRX16500060,CTCF,491
chr1,36516325,36516829,SRX16500059,CTCF,504
chr1,36516334,36516780,SRX16500062,CTCF,446
chr1,36516421,36516737,SRX5716464,SMARCA4,316
chr1,36516434,36516663,SRX5075174,SMARCA4,229
chr1,36516440,36516627,SRX5075168,SMARCA4,187
chr1,36516458,36516726,SRX4174629,CTCF,268
chr1,36553751,36554235,SRX16500059,CTCF,484
chr1,36553770,36554242,SRX16500060,CTCF,472
chr1,36553793,36554215,SRX16500061,CTCF,422
chr1,36553802,36554066,SRX4174629,CTCF,264
chr1,36553817,36554224,SRX16500062,CTCF,407
chr1,36575942,36576515,SRX16500059,CTCF,573
chr1,36576012,36576445,SRX16500061,CTCF,433
chr1,36576036,36576540,SRX16500060,CTCF,504
chr1,36576036,36576543,SRX16500062,CTCF,507
chr1,36576059,36576455,SRX4174629,CTCF,396
chr1,36576193,36576393,SRX5075174,SMARCA4,200
chr1,36585640,36586002,SRX5075174,SMARCA4,362
chr1,36585652,36585955,SRX5075170,SMARCA4,303
chr1,36585698,36585972,SRX5075168,SMARCA4,274
chr1,36609097,36609696,SRX16500060,CTCF,599
chr1,36609193,36609676,SRX16500059,CTCF,483
chr1,36609240,36609649,SRX16500061,CTCF,409
chr1,36609261,36609623,SRX16500062,CTCF,362
chr1,36609294,36609762,SRX4174629,CTCF,468
chr1,36638392,36638635,SRX5054309,FOSL2,243
chr1,36650348,36650897,SRX16500061,CTCF,549
chr1,36650371,36650878,SRX16500060,CTCF,507
chr1,36650394,36650864,SRX16500059,CTCF,470
chr1,36650459,36650889,SRX16500062,CTCF,430
chr1,36650491,36650715,SRX5075168,SMARCA4,224
chr1,36650582,36650846,SRX20140895,INTS13,264
chr1,36703627,36704114,SRX16500059,CTCF,487
chr1,36703640,36704112,SRX16500061,CTCF,472
chr1,36703654,36704138,SRX16500060,CTCF,484
chr1,36703667,36704078,SRX16500062,CTCF,411
chr1,36703693,36704070,SRX5716463,SMARCA4,377
chr1,36703705,36704068,SRX5075174,SMARCA4,363
chr1,36703720,36704062,SRX5075168,SMARCA4,342
chr1,36703736,36704025,SRX4174629,CTCF,289
chr1,36703751,36704026,SRX5075176,SMARCA4,275
chr1,36703754,36703980,SRX5075169,SMARCA4,226
chr1,36703764,36704003,SRX5075170,SMARCA4,239
chr1,36703768,36704025,SRX20140895,INTS13,257
chr1,36703768,36704058,SRX5716464,SMARCA4,290
chr1,36703789,36704031,SRX5716470,SMARCA4,242
chr1,36814299,36814340,SRX1424893,POU3F2,41
chr1,36814342,36814388,SRX1424894,POU3F2,46
chr1,36864130,36864515,SRX16500060,CTCF,385
chr1,36864223,36864556,SRX16500059,CTCF,333
chr1,36864245,36864527,SRX16500062,CTCF,282
chr1,36864323,36864566,SRX16500061,CTCF,243
chr1,36924280,36924461,SRX5075176,SMARCA4,181
chr1,37020753,37020941,SRX5075168,SMARCA4,188
chr1,37020758,37020931,SRX5075174,SMARCA4,173
chr1,37038258,37038531,SRX4174629,CTCF,273
chr1,37038263,37038565,SRX16500060,CTCF,302
chr1,37038264,37038502,SRX16500062,CTCF,238
chr1,37038308,37038541,SRX16500061,CTCF,233
chr1,37083597,37083932,SRX5075174,SMARCA4,335
chr1,37083743,37084190,SRX5075168,SMARCA4,447
chr1,37085431,37085703,SRX16500060,CTCF,272
chr1,37085454,37085707,SRX16500061,CTCF,253
chr1,37085476,37085689,SRX16500062,CTCF,213
chr1,37096539,37096865,SRX16500060,CTCF,326
chr1,37096604,37096958,SRX16500059,CTCF,354
chr1,37096605,37096817,SRX16500062,CTCF,212
chr1,37096626,37096911,SRX16500061,CTCF,285
chr1,37177235,37177601,SRX16500062,CTCF,366
chr1,37177239,37177749,SRX16500059,CTCF,510
chr1,37177361,37177745,SRX16500060,CTCF,384
chr1,37177370,37177604,SRX16500061,CTCF,234
chr1,37234996,37235322,SRX5075168,SMARCA4,326
chr1,37235001,37235372,SRX5075174,SMARCA4,371
chr1,37235183,37235387,SRX5716463,SMARCA4,204
chr1,37255477,37255703,SRX5075174,SMARCA4,226
chr1,37255511,37255690,SRX5075168,SMARCA4,179
chr1,37323758,37324156,SRX16500059,CTCF,398
chr1,37323760,37324160,SRX16500060,CTCF,400
chr1,37323784,37324129,SRX16500061,CTCF,345
chr1,37323797,37324143,SRX16500062,CTCF,346
chr1,37400531,37400739,SRX5075168,SMARCA4,208
chr1,37434188,37434679,SRX16500062,CTCF,491
chr1,37434210,37434771,SRX16500060,CTCF,561
chr1,37434224,37434742,SRX16500059,CTCF,518
chr1,37434257,37434668,SRX16500061,CTCF,411
chr1,37434263,37434629,SRX4174629,CTCF,366
chr1,37454748,37455257,SRX16500059,CTCF,509
chr1,37454751,37455233,SRX16500060,CTCF,482
chr1,37454775,37455210,SRX16500061,CTCF,435
chr1,37454800,37455226,SRX16500062,CTCF,426
chr1,37454839,37455095,SRX4174629,CTCF,256
chr1,37454967,37455169,SRX5075175,SMARCA4,202
chr1,37471673,37472063,SRX5075175,SMARCA4,390
chr1,37471677,37472103,SRX5075169,SMARCA4,426
chr1,37471698,37471991,SRX5054308,FOSL2,293
chr1,37471698,37472052,SRX5075176,SMARCA4,354
chr1,37471705,37472050,SRX5075170,SMARCA4,345
chr1,37471714,37472084,SRX5054309,FOSL2,370
chr1,37471725,37471953,SRX5716469,SMARCA4,228
chr1,37471736,37471954,SRX5716470,SMARCA4,218
chr1,37471749,37472018,SRX5075168,SMARCA4,269
chr1,37471771,37472043,SRX5075174,SMARCA4,272
chr1,37471784,37471987,SRX5020211,SMARCA2,203
chr1,37474242,37474671,SRX5075174,SMARCA4,429
chr1,37474270,37474692,SRX5075168,SMARCA4,422
chr1,37474282,37474639,SRX5716464,SMARCA4,357
chr1,37474291,37474606,SRX5716463,SMARCA4,315
chr1,37474321,37474942,SRX20140895,INTS13,621
chr1,37474329,37474514,SRX5075176,SMARCA4,185
chr1,37474357,37474636,SRX5075170,SMARCA4,279
chr1,37474364,37474800,SRX20140868,INTS10,436
chr1,37474415,37474749,SRX20140867,INTS10,334
chr1,37474484,37474801,SRX20140879,CPSF3L,317
chr1,37474549,37474794,SRX20140897,INTS13,245
chr1,37476707,37476942,SRX5054309,FOSL2,235
chr1,37476744,37477017,SRX5075176,SMARCA4,273
chr1,37476813,37477012,SRX5075170,SMARCA4,199
chr1,37479718,37479911,SRX5054308,FOSL2,193
chr1,37487289,37487905,SRX16500059,CTCF,616
chr1,37487294,37487885,SRX16500061,CTCF,591
chr1,37487303,37487823,SRX16500060,CTCF,520
chr1,37487348,37487843,SRX16500062,CTCF,495
chr1,37487378,37487705,SRX4174629,CTCF,327
chr1,37487387,37487662,SRX5075168,SMARCA4,275
chr1,37487413,37487620,SRX5075175,SMARCA4,207
chr1,37487433,37487690,SRX5075174,SMARCA4,257
chr1,37487440,37487645,SRX5075169,SMARCA4,205
chr1,37487453,37487634,SRX5075170,SMARCA4,181
chr1,37514361,37515117,SRX20140895,INTS13,756
chr1,37514419,37514909,SRX20140868,INTS10,490
chr1,37514508,37515138,SRX5075170,SMARCA4,630
chr1,37514544,37515128,SRX5075176,SMARCA4,584
chr1,37514546,37515022,SRX16500059,CTCF,476
chr1,37514563,37515091,SRX5075168,SMARCA4,528
chr1,37514582,37515020,SRX16500061,CTCF,438
chr1,37514584,37515145,SRX5075174,SMARCA4,561
chr1,37514596,37514987,SRX16500062,CTCF,391
chr1,37514603,37515015,SRX16500060,CTCF,412
chr1,37514607,37515108,SRX5075169,SMARCA4,501
chr1,37514610,37514857,SRX20140867,INTS10,247
chr1,37514743,37515119,SRX5716469,SMARCA4,376
chr1,37514813,37515028,SRX5075175,SMARCA4,215
chr1,37514877,37515148,SRX5716470,SMARCA4,271
chr1,37534420,37534871,SRX5075169,SMARCA4,451
chr1,37534424,37534832,SRX5075176,SMARCA4,408
chr1,37534439,37534838,SRX5075175,SMARCA4,399
chr1,37534507,37534781,SRX5054308,FOSL2,274
chr1,37534512,37534792,SRX5075170,SMARCA4,280
chr1,37534515,37534726,SRX5716470,SMARCA4,211
chr1,37534520,37534860,SRX5054309,FOSL2,340
chr1,37534552,37534786,SRX5075168,SMARCA4,234
chr1,37553988,37554373,SRX20140869,INTS10,385
chr1,37554117,37554549,SRX20140895,INTS13,432
chr1,37554150,37554505,SRX5075174,SMARCA4,355
chr1,37554209,37554517,SRX5075168,SMARCA4,308
chr1,37554211,37554380,SRX5075170,SMARCA4,169
chr1,37556683,37556982,SRX5075169,SMARCA4,299
chr1,37556710,37557147,SRX5716469,SMARCA4,437
chr1,37556740,37557163,SRX5075174,SMARCA4,423
chr1,37556747,37557136,SRX5075176,SMARCA4,389
chr1,37556749,37557173,SRX5075168,SMARCA4,424
chr1,37556758,37557092,SRX5075170,SMARCA4,334
chr1,37556789,37557043,SRX5716464,SMARCA4,254
chr1,37556828,37557119,SRX20140895,INTS13,291
chr1,37556887,37557130,SRX5716463,SMARCA4,243
chr1,37556922,37557198,SRX5716470,SMARCA4,276
chr1,37561795,37562126,SRX16500062,CTCF,331
chr1,37561798,37562163,SRX16500060,CTCF,365
chr1,37561816,37562170,SRX16500059,CTCF,354
chr1,37561821,37562120,SRX16500061,CTCF,299
chr1,37575117,37575399,SRX5075169,SMARCA4,282
chr1,37575170,37575393,SRX5054309,FOSL2,223
chr1,37576586,37576817,SRX5075175,SMARCA4,231
chr1,37576596,37576870,SRX5054308,FOSL2,274
chr1,37576597,37576862,SRX5075170,SMARCA4,265
chr1,37576614,37576860,SRX5054309,FOSL2,246
chr1,37576626,37576895,SRX5075176,SMARCA4,269
chr1,37576630,37576889,SRX5075169,SMARCA4,259
chr1,37595634,37596154,SRX20140895,INTS13,520
chr1,37595713,37595994,SRX5075175,SMARCA4,281
chr1,37595721,37596030,SRX20140897,INTS13,309
chr1,37595745,37596256,SRX5075174,SMARCA4,511
chr1,37595747,37596261,SRX5075168,SMARCA4,514
chr1,37595764,37596259,SRX5075169,SMARCA4,495
chr1,37595887,37596259,SRX5075176,SMARCA4,372
chr1,37595895,37596276,SRX5075170,SMARCA4,381
chr1,37595924,37596192,SRX5716464,SMARCA4,268
chr1,37595999,37596357,SRX5716469,SMARCA4,358
chr1,37596052,37596278,SRX5075175,SMARCA4,226
chr1,37596056,37596369,SRX5716470,SMARCA4,313
chr1,37596085,37596300,SRX5716467,SMARCA2,215
chr1,37603031,37603517,SRX16500060,CTCF,486
chr1,37603074,37603566,SRX16500059,CTCF,492
chr1,37603082,37603516,SRX16500061,CTCF,434
chr1,37603109,37603549,SRX16500062,CTCF,440
chr1,37603196,37603469,SRX4174629,CTCF,273
chr1,37634692,37635000,SRX20140895,INTS13,308
chr1,37659037,37659078,SRX1424892,POU3F2,41
chr1,37682224,37682863,SRX16500060,CTCF,639
chr1,37682232,37682582,SRX4174629,CTCF,350
chr1,37682291,37682853,SRX16500059,CTCF,562
chr1,37682322,37682825,SRX16500061,CTCF,503
chr1,37682328,37682807,SRX16500062,CTCF,479
chr1,37682396,37682664,SRX5075168,SMARCA4,268
chr1,37682400,37682676,SRX5054309,FOSL2,276
chr1,37682474,37682665,SRX5075174,SMARCA4,191
chr1,37690252,37690562,SRX5075176,SMARCA4,310
chr1,37690340,37690658,SRX20140895,INTS13,318
chr1,37690365,37690534,SRX5075170,SMARCA4,169
chr1,37690424,37690742,SRX5075174,SMARCA4,318
chr1,37690476,37690684,SRX5075168,SMARCA4,208
chr1,37690525,37690718,SRX5054307,FOSL2,193
chr1,37692035,37692713,SRX20140895,INTS13,678
chr1,37692127,37692456,SRX5075168,SMARCA4,329
chr1,37692143,37692640,SRX16500059,CTCF,497
chr1,37692167,37692613,SRX16500060,CTCF,446
chr1,37692168,37692528,SRX5716463,SMARCA4,360
chr1,37692183,37692585,SRX16500062,CTCF,402
chr1,37692192,37692583,SRX16500061,CTCF,391
chr1,37692252,37692462,SRX5054307,FOSL2,210
chr1,37692262,37692515,SRX4174629,CTCF,253
chr1,37692263,37692521,SRX5075174,SMARCA4,258
chr1,37764344,37764664,SRX5716470,SMARCA4,320
chr1,37764345,37764616,SRX5075168,SMARCA4,271
chr1,37764352,37764575,SRX5075169,SMARCA4,223
chr1,37764354,37764583,SRX5075175,SMARCA4,229
chr1,37764366,37764607,SRX5075174,SMARCA4,241
chr1,37764380,37764603,SRX5716464,SMARCA4,223
chr1,37764389,37764648,SRX5075170,SMARCA4,259
chr1,37764404,37764596,SRX5075176,SMARCA4,192
chr1,37793880,37794233,SRX20140895,INTS13,353
chr1,37793894,37794171,SRX5075174,SMARCA4,277
chr1,37793907,37794136,SRX5716470,SMARCA4,229
chr1,37793960,37794164,SRX5075175,SMARCA4,204
chr1,37793973,37794168,SRX5075176,SMARCA4,195
chr1,37795450,37795723,SRX5716470,SMARCA4,273
chr1,37795460,37795702,SRX5075168,SMARCA4,242
chr1,37795462,37795725,SRX5075174,SMARCA4,263
chr1,37795469,37795712,SRX5075170,SMARCA4,243
chr1,37795480,37795707,SRX5075169,SMARCA4,227
chr1,37795482,37795694,SRX5716469,SMARCA4,212
chr1,37795490,37795704,SRX5075176,SMARCA4,214
chr1,37807693,37808747,SRX20140895,INTS13,1054
chr1,37807867,37808404,SRX20140869,INTS10,537
chr1,37808071,37808530,SRX20140868,INTS10,459
chr1,37808109,37808521,SRX20140897,INTS13,412
chr1,37808283,37808494,SRX5716470,SMARCA4,211
chr1,37810981,37811475,SRX16500060,CTCF,494
chr1,37811008,37811468,SRX16500061,CTCF,460
chr1,37811011,37811492,SRX16500059,CTCF,481
chr1,37811037,37811438,SRX16500062,CTCF,401
chr1,37811076,37811502,SRX4174629,CTCF,426
chr1,37811082,37811410,SRX5716470,SMARCA4,328
chr1,37811083,37811405,SRX5075176,SMARCA4,322
chr1,37811090,37811425,SRX5075170,SMARCA4,335
chr1,37811093,37811457,SRX5075168,SMARCA4,364
chr1,37811101,37811432,SRX5075174,SMARCA4,331
chr1,37811113,37811352,SRX5075181,SMARCA2,239
chr1,37811115,37811406,SRX5075169,SMARCA4,291
chr1,37811117,37811389,SRX5075175,SMARCA4,272
chr1,37811121,37811420,SRX5716463,SMARCA4,299
chr1,37811128,37811401,SRX5716464,SMARCA4,273
chr1,37811135,37811410,SRX5716469,SMARCA4,275
chr1,37811182,37811414,SRX5716468,SMARCA2,232
chr1,37811199,37811440,SRX5716467,SMARCA2,241
chr1,37811200,37811424,SRX5020211,SMARCA2,224
chr1,37859235,37859828,SRX5075168,SMARCA4,593
chr1,37859449,37860369,SRX20140895,INTS13,920
chr1,37859476,37860099,SRX20140868,INTS10,623
chr1,37859507,37860031,SRX20140879,CPSF3L,524
chr1,37859720,37859964,SRX20140897,INTS13,244
chr1,37859880,37860603,SRX16500059,CTCF,723
chr1,37859893,37860607,SRX16500062,CTCF,714
chr1,37859919,37860184,SRX20140894,INTS13,265
chr1,37859952,37860540,SRX16500060,CTCF,588
chr1,37859988,37860500,SRX16500061,CTCF,512
chr1,37860074,37860537,SRX4174629,CTCF,463
chr1,37860125,37860375,SRX5716470,SMARCA4,250
chr1,37860137,37860377,SRX5075176,SMARCA4,240
chr1,37860140,37860414,SRX5075174,SMARCA4,274
chr1,37860160,37860353,SRX5075169,SMARCA4,193
chr1,37860160,37860387,SRX5075168,SMARCA4,227
chr1,37860185,37860393,SRX5075170,SMARCA4,208
chr1,37860202,37860409,SRX5075175,SMARCA4,207
chr1,37890335,37890761,SRX16500060,CTCF,426
chr1,37890339,37890797,SRX16500059,CTCF,458
chr1,37890384,37890808,SRX16500062,CTCF,424
chr1,37890400,37890782,SRX16500061,CTCF,382
chr1,37919276,37919601,SRX16500059,CTCF,325
chr1,37919278,37919618,SRX16500061,CTCF,340
chr1,37919379,37919625,SRX16500062,CTCF,246
chr1,37931546,37932058,SRX5075168,SMARCA4,512
chr1,37931548,37932021,SRX20140895,INTS13,473
chr1,37931642,37932030,SRX5075170,SMARCA4,388
chr1,37931654,37932078,SRX5075174,SMARCA4,424
chr1,37931773,37932000,SRX5054307,FOSL2,227
chr1,37931783,37931967,SRX5075176,SMARCA4,184
chr1,37931784,37931992,SRX5716463,SMARCA4,208
chr1,37946886,37947225,SRX20140895,INTS13,339
chr1,37946917,37947313,SRX5075168,SMARCA4,396
chr1,37946939,37947253,SRX5075174,SMARCA4,314
chr1,37946979,37947198,SRX5075170,SMARCA4,219
chr1,37947008,37947239,SRX5716463,SMARCA4,231
chr1,37947012,37947201,SRX5075169,SMARCA4,189
chr1,37958667,37959000,SRX5054308,FOSL2,333
chr1,37958698,37958926,SRX5716469,SMARCA4,228
chr1,37958724,37958946,SRX5075175,SMARCA4,222
chr1,37958729,37959110,SRX5054309,FOSL2,381
chr1,37958811,37959074,SRX5075169,SMARCA4,263
chr1,37974984,37975434,SRX16500060,CTCF,450
chr1,37974988,37975430,SRX16500059,CTCF,442
chr1,37975022,37975335,SRX16500061,CTCF,313
chr1,37975023,37975198,SRX5075176,SMARCA4,175
chr1,37975031,37975388,SRX16500062,CTCF,357
chr1,37975060,37975277,SRX5075174,SMARCA4,217
chr1,37975068,37975262,SRX5075168,SMARCA4,194
chr1,37975102,37975309,SRX5075170,SMARCA4,207
chr1,37989652,37990498,SRX20140895,INTS13,846
chr1,37989826,37990359,SRX20140868,INTS10,533
chr1,37989853,37990328,SRX5075170,SMARCA4,475
chr1,37989867,37990425,SRX5075174,SMARCA4,558
chr1,37989872,37990402,SRX5075169,SMARCA4,530
chr1,37989900,37990276,SRX20140867,INTS10,376
chr1,37989912,37990312,SRX5716463,SMARCA4,400
chr1,37989915,37990480,SRX16500059,CTCF,565
chr1,37989924,37990450,SRX16500060,CTCF,526
chr1,37989929,37990301,SRX20140869,INTS10,372
chr1,37989929,37990438,SRX16500061,CTCF,509
chr1,37989930,37990447,SRX5075168,SMARCA4,517
chr1,37989941,37990205,SRX20140879,CPSF3L,264
chr1,37989947,37990375,SRX5716464,SMARCA4,428
chr1,37989951,37990477,SRX16500062,CTCF,526
chr1,37989963,37990404,SRX5075176,SMARCA4,441
chr1,37989974,37990399,SRX5716470,SMARCA4,425
chr1,37989983,37990390,SRX4174629,CTCF,407
chr1,37990002,37990364,SRX5716469,SMARCA4,362
chr1,37990040,37990252,SRX5716451,SOX2,212
chr1,37990064,37990304,SRX5075175,SMARCA4,240
chr1,37999569,37999804,SRX5075174,SMARCA4,235
chr1,37999640,37999820,SRX5054308,FOSL2,180
chr1,37999789,38000929,SRX5075176,SMARCA4,1140
chr1,37999942,38000301,SRX5075170,SMARCA4,359
chr1,38000359,38000819,SRX5075170,SMARCA4,460
chr1,38000379,38000804,SRX5716469,SMARCA4,425
chr1,38000408,38000822,SRX5075169,SMARCA4,414
chr1,38000408,38000852,SRX5075168,SMARCA4,444
chr1,38000410,38000805,SRX5075174,SMARCA4,395
chr1,38000427,38000777,SRX5075175,SMARCA4,350
chr1,38000429,38000732,SRX5716470,SMARCA4,303
chr1,38000465,38000764,SRX5716468,SMARCA2,299
chr1,38000470,38000835,SRX5716467,SMARCA2,365
chr1,38000491,38000814,SRX5054309,FOSL2,323
chr1,38000534,38000820,SRX5020211,SMARCA2,286
chr1,38000565,38000758,SRX5054308,FOSL2,193
chr1,38005217,38005543,SRX20140895,INTS13,326
chr1,38009418,38009616,SRX5054309,FOSL2,198
chr1,38009444,38009624,SRX5054308,FOSL2,180
chr1,38012264,38013020,SRX20140869,INTS10,756
chr1,38012287,38013072,SRX20140895,INTS13,785
chr1,38012302,38013013,SRX20140897,INTS13,711
chr1,38012358,38012891,SRX20140868,INTS10,533
chr1,38012445,38012665,SRX5075174,SMARCA4,220
chr1,38012497,38013001,SRX20140867,INTS10,504
chr1,38012581,38012869,SRX5716451,SOX2,288
chr1,38012594,38012923,SRX20140881,CPSF3L,329
chr1,38016282,38016618,SRX5075176,SMARCA4,336
chr1,38016312,38016527,SRX5075170,SMARCA4,215
chr1,38018900,38019228,SRX16500062,CTCF,328
chr1,38018901,38019198,SRX16500059,CTCF,297
chr1,38018922,38019239,SRX16500060,CTCF,317
chr1,38018933,38019244,SRX16500061,CTCF,311
chr1,38018960,38019161,SRX5075176,SMARCA4,201
chr1,38018968,38019141,SRX5075174,SMARCA4,173
chr1,38026526,38027013,SRX16500060,CTCF,487
chr1,38026556,38027011,SRX16500062,CTCF,455
chr1,38026578,38027043,SRX16500059,CTCF,465
chr1,38026592,38026991,SRX16500061,CTCF,399
chr1,38026730,38026965,SRX4174629,CTCF,235
chr1,38026758,38026972,SRX5075174,SMARCA4,214
chr1,38029192,38029375,SRX5075176,SMARCA4,183
chr1,38029224,38029426,SRX5075174,SMARCA4,202
chr1,38029957,38030367,SRX5075175,SMARCA4,410
chr1,38029979,38030332,SRX5054308,FOSL2,353
chr1,38029996,38030464,SRX5075169,SMARCA4,468
chr1,38029999,38030477,SRX5075176,SMARCA4,478
chr1,38030007,38030263,SRX5054309,FOSL2,256
chr1,38030020,38030381,SRX5075170,SMARCA4,361
chr1,38030058,38030347,SRX5716470,SMARCA4,289
chr1,38030062,38030262,SRX5020211,SMARCA2,200
chr1,38030112,38030384,SRX5716469,SMARCA4,272
chr1,38039434,38039544,SRX1424892,POU3F2,110
chr1,38039437,38039580,SRX1424891,POU3F2,143
chr1,38047814,38048001,SRX5075175,SMARCA4,187
chr1,38047916,38048085,SRX5075170,SMARCA4,169
chr1,38053284,38053324,SRX1424891,POU3F2,40
chr1,38064251,38064604,SRX5075174,SMARCA4,353
chr1,38064283,38064645,SRX5075168,SMARCA4,362
chr1,38064307,38064683,SRX5054309,FOSL2,376
chr1,38064308,38064614,SRX5075176,SMARCA4,306
chr1,38064332,38064606,SRX5075169,SMARCA4,274
chr1,38064336,38064632,SRX5075170,SMARCA4,296
chr1,38064341,38064661,SRX5054308,FOSL2,320
chr1,38064356,38064691,SRX5075175,SMARCA4,335
chr1,38064419,38064619,SRX5020211,SMARCA2,200
chr1,38073498,38073896,SRX5716463,SMARCA4,398
chr1,38073498,38073969,SRX5075168,SMARCA4,471
chr1,38073552,38073853,SRX5075174,SMARCA4,301
chr1,38073738,38074007,SRX20140868,INTS10,269
chr1,38073752,38073966,SRX20140867,INTS10,214
chr1,38074014,38074198,SRX5075174,SMARCA4,184
chr1,38076094,38076339,SRX5075176,SMARCA4,245
chr1,38076133,38076392,SRX5716470,SMARCA4,259
chr1,38076137,38076385,SRX5075170,SMARCA4,248
chr1,38076150,38076360,SRX5075169,SMARCA4,210
chr1,38085940,38086300,SRX5075170,SMARCA4,360
chr1,38127492,38127695,SRX5054308,FOSL2,203
chr1,38127531,38127720,SRX5075176,SMARCA4,189
chr1,38129525,38129778,SRX16500059,CTCF,253
chr1,38138446,38138856,SRX5716470,SMARCA4,410
chr1,38138450,38138924,SRX5075176,SMARCA4,474
chr1,38138478,38138860,SRX5054309,FOSL2,382
chr1,38138478,38138927,SRX5075170,SMARCA4,449
chr1,38138481,38138842,SRX5716469,SMARCA4,361
chr1,38138482,38138929,SRX5075169,SMARCA4,447
chr1,38138509,38138948,SRX5075175,SMARCA4,439
chr1,38138528,38138853,SRX5716467,SMARCA2,325
chr1,38138531,38138808,SRX5716468,SMARCA2,277
chr1,38138535,38138820,SRX5054308,FOSL2,285
chr1,38138573,38138789,SRX5020211,SMARCA2,216
chr1,38179590,38179825,SRX5075176,SMARCA4,235
chr1,38179637,38179962,SRX5716470,SMARCA4,325
chr1,38179658,38179844,SRX5075170,SMARCA4,186
chr1,38181059,38181270,SRX5054309,FOSL2,211
chr1,38183056,38183607,SRX5075170,SMARCA4,551
chr1,38183093,38183546,SRX5075176,SMARCA4,453
chr1,38183109,38183577,SRX5075174,SMARCA4,468
chr1,38183119,38183479,SRX5716469,SMARCA4,360
chr1,38183138,38183522,SRX5075175,SMARCA4,384
chr1,38183151,38183453,SRX5075168,SMARCA4,302
chr1,38183154,38183500,SRX5075169,SMARCA4,346
chr1,38183195,38183491,SRX5020211,SMARCA2,296
chr1,38183201,38183483,SRX5054308,FOSL2,282
chr1,38183201,38183483,SRX5054309,FOSL2,282
chr1,38183226,38183457,SRX5716467,SMARCA2,231
chr1,38221026,38221372,SRX5075176,SMARCA4,346
chr1,38221041,38221252,SRX5716470,SMARCA4,211
chr1,38221045,38221482,SRX5075169,SMARCA4,437
chr1,38221066,38221295,SRX5716469,SMARCA4,229
chr1,38221069,38221497,SRX5075170,SMARCA4,428
chr1,38221117,38221392,SRX5075175,SMARCA4,275
chr1,38235739,38236083,SRX5075169,SMARCA4,344
chr1,38235791,38236080,SRX5054309,FOSL2,289
chr1,38235840,38236009,SRX5075170,SMARCA4,169
chr1,38235854,38236100,SRX5054308,FOSL2,246
chr1,38246796,38247375,SRX5075174,SMARCA4,579
chr1,38246807,38247460,SRX20140895,INTS13,653
chr1,38246851,38247432,SRX5075168,SMARCA4,581
chr1,38246874,38247360,SRX5716463,SMARCA4,486
chr1,38246886,38247412,SRX20140868,INTS10,526
chr1,38246921,38247277,SRX20140879,CPSF3L,356
chr1,38246959,38247164,SRX5716464,SMARCA4,205
chr1,38246974,38247194,SRX5716451,SOX2,220
chr1,38246985,38247325,SRX20140880,CPSF3L,340
chr1,38247020,38247271,SRX20140867,INTS10,251
chr1,38274897,38275444,SRX5075174,SMARCA4,547
chr1,38274911,38275504,SRX5075168,SMARCA4,593
chr1,38274946,38275355,SRX5716464,SMARCA4,409
chr1,38275009,38275419,SRX5716463,SMARCA4,410
chr1,38275014,38275482,SRX5075170,SMARCA4,468
chr1,38275038,38275362,SRX20140867,INTS10,324
chr1,38275053,38275255,SRX5716451,SOX2,202
chr1,38275054,38275380,SRX5075176,SMARCA4,326
chr1,38275055,38275290,SRX5716454,SOX3,235
chr1,38275076,38275409,SRX20140895,INTS13,333
chr1,38275090,38275383,SRX5054307,FOSL2,293
chr1,38275097,38275398,SRX5075175,SMARCA4,301
chr1,38275124,38275316,SRX5075169,SMARCA4,192
chr1,38287469,38287897,SRX5075174,SMARCA4,428
chr1,38287622,38287910,SRX5075168,SMARCA4,288
chr1,38292304,38292412,SRX1424891,POU3F2,108
chr1,38292308,38292411,SRX1424892,POU3F2,103
chr1,38297857,38298202,SRX5075169,SMARCA4,345
chr1,38297864,38298237,SRX5075176,SMARCA4,373
chr1,38297874,38298089,SRX5716467,SMARCA2,215
chr1,38297896,38298186,SRX5054308,FOSL2,290
chr1,38297908,38298201,SRX5075170,SMARCA4,293
chr1,38297927,38298216,SRX5054309,FOSL2,289
chr1,38297957,38298203,SRX5075175,SMARCA4,246
chr1,38418440,38418737,SRX20140868,INTS10,297
chr1,38444287,38444739,SRX5075176,SMARCA4,452
chr1,38444290,38444687,SRX5075170,SMARCA4,397
chr1,38444307,38444617,SRX5054309,FOSL2,310
chr1,38444312,38444564,SRX5054308,FOSL2,252
chr1,38444340,38444624,SRX5075169,SMARCA4,284
chr1,38444340,38444659,SRX5075175,SMARCA4,319
chr1,38444347,38444558,SRX5716470,SMARCA4,211
chr1,38445109,38445306,SRX5075174,SMARCA4,197
chr1,38445211,38445390,SRX5075168,SMARCA4,179
chr1,38451402,38451873,SRX5075168,SMARCA4,471
chr1,38451436,38451906,SRX5075169,SMARCA4,470
chr1,38451502,38451962,SRX5075175,SMARCA4,460
chr1,38451544,38451864,SRX5054308,FOSL2,320
chr1,38451560,38452005,SRX5075170,SMARCA4,445
chr1,38451563,38451927,SRX5075176,SMARCA4,364
chr1,38451579,38451993,SRX5075174,SMARCA4,414
chr1,38451600,38451925,SRX5054309,FOSL2,325
chr1,38455830,38456197,SRX5075168,SMARCA4,367
chr1,38455880,38456184,SRX5075174,SMARCA4,304
chr1,38476595,38476892,SRX20140895,INTS13,297
chr1,38476621,38476891,SRX5075168,SMARCA4,270
chr1,38476764,38476979,SRX5075174,SMARCA4,215
chr1,38486009,38486520,SRX5075174,SMARCA4,511
chr1,38486039,38486484,SRX5075168,SMARCA4,445
chr1,38486093,38486378,SRX5716463,SMARCA4,285
chr1,38486112,38486377,SRX5716454,SOX3,265
chr1,38486123,38486375,SRX5716451,SOX2,252
chr1,38486193,38486475,SRX5716464,SMARCA4,282
chr1,38489765,38490179,SRX16500061,CTCF,414
chr1,38489768,38490169,SRX16500060,CTCF,401
chr1,38489771,38490106,SRX16500062,CTCF,335
chr1,38489775,38490207,SRX16500059,CTCF,432
chr1,38489861,38490093,SRX5075174,SMARCA4,232
chr1,38500331,38500667,SRX16500060,CTCF,336
chr1,38500359,38500731,SRX16500059,CTCF,372
chr1,38500360,38500709,SRX16500062,CTCF,349
chr1,38500368,38500690,SRX16500061,CTCF,322
chr1,38522155,38522393,SRX16500060,CTCF,238
chr1,38541300,38541547,SRX5075170,SMARCA4,247
chr1,38541369,38541552,SRX5054309,FOSL2,183
chr1,38558173,38558360,SRX5075174,SMARCA4,187
chr1,38578541,38578818,SRX5075168,SMARCA4,277
chr1,38586962,38587486,SRX16500060,CTCF,524
chr1,38586989,38587445,SRX16500059,CTCF,456
chr1,38587004,38587492,SRX16500061,CTCF,488
chr1,38587010,38587468,SRX16500062,CTCF,458
chr1,38587054,38587383,SRX5075174,SMARCA4,329
chr1,38587057,38587385,SRX5075168,SMARCA4,328
chr1,38587100,38587319,SRX5716464,SMARCA4,219
chr1,38587126,38587397,SRX5716463,SMARCA4,271
chr1,38608202,38608665,SRX16500061,CTCF,463
chr1,38608212,38608757,SRX16500062,CTCF,545
chr1,38608220,38608751,SRX16500059,CTCF,531
chr1,38608249,38608675,SRX16500060,CTCF,426
chr1,38608279,38608695,SRX5075168,SMARCA4,416
chr1,38608299,38608637,SRX4174629,CTCF,338
chr1,38608306,38608646,SRX5075174,SMARCA4,340
chr1,38608375,38608610,SRX5716464,SMARCA4,235
chr1,38680832,38681015,SRX5054309,FOSL2,183
chr1,38680916,38681117,SRX5075170,SMARCA4,201
chr1,38690761,38691181,SRX5075174,SMARCA4,420
chr1,38690804,38691178,SRX5075168,SMARCA4,374
chr1,38690894,38691073,SRX5054307,FOSL2,179
chr1,38690957,38691145,SRX5054309,FOSL2,188
chr1,38727741,38727947,SRX5075174,SMARCA4,206
chr1,38727773,38727967,SRX5075168,SMARCA4,194
chr1,38727997,38728637,SRX5075169,SMARCA4,640
chr1,38728010,38728646,SRX5075170,SMARCA4,636
chr1,38728059,38728628,SRX5075175,SMARCA4,569
chr1,38728087,38728572,SRX5075176,SMARCA4,485
chr1,38728107,38728606,SRX5716469,SMARCA4,499
chr1,38728124,38728520,SRX5716470,SMARCA4,396
chr1,38728161,38728550,SRX5716467,SMARCA2,389
chr1,38728168,38728348,SRX5075168,SMARCA4,180
chr1,38728172,38728377,SRX5020214,SMARCA2,205
chr1,38728187,38728487,SRX5716468,SMARCA2,300
chr1,38728235,38728601,SRX5054309,FOSL2,366
chr1,38728246,38728497,SRX5075181,SMARCA2,251
chr1,38803908,38804481,SRX20140895,INTS13,573
chr1,38803991,38804420,SRX5075174,SMARCA4,429
chr1,38804043,38804223,SRX5075169,SMARCA4,180
chr1,38804055,38804413,SRX20140868,INTS10,358
chr1,38804139,38804455,SRX5075168,SMARCA4,316
chr1,38804169,38804358,SRX5075175,SMARCA4,189
chr1,38817960,38818660,SRX16500059,CTCF,700
chr1,38817977,38818649,SRX16500060,CTCF,672
chr1,38818003,38818560,SRX16500061,CTCF,557
chr1,38818010,38818583,SRX16500062,CTCF,573
chr1,38818026,38818370,SRX4174629,CTCF,344
chr1,38818106,38818489,SRX5075168,SMARCA4,383
chr1,38818110,38818502,SRX5075174,SMARCA4,392
chr1,38818146,38818441,SRX5075176,SMARCA4,295
chr1,38818159,38818430,SRX5716470,SMARCA4,271
chr1,38818166,38818489,SRX5075175,SMARCA4,323
chr1,38818171,38818424,SRX5075170,SMARCA4,253
chr1,38818197,38818422,SRX5075169,SMARCA4,225
chr1,38835121,38835676,SRX16500060,CTCF,555
chr1,38835178,38835655,SRX16500059,CTCF,477
chr1,38835190,38835650,SRX16500061,CTCF,460
chr1,38835201,38835621,SRX16500062,CTCF,420
chr1,38835273,38835562,SRX5075170,SMARCA4,289
chr1,38835273,38835591,SRX5075174,SMARCA4,318
chr1,38835274,38835633,SRX4174629,CTCF,359
chr1,38835276,38835555,SRX5075176,SMARCA4,279
chr1,38835282,38835469,SRX5075175,SMARCA4,187
chr1,38835292,38835598,SRX5075168,SMARCA4,306
chr1,38859065,38859274,SRX5075169,SMARCA4,209
chr1,38859553,38860230,SRX20140895,INTS13,677
chr1,38859642,38860119,SRX20140897,INTS13,477
chr1,38859663,38860121,SRX20140896,INTS13,458
chr1,38859728,38860089,SRX5075168,SMARCA4,361
chr1,38859741,38859923,SRX5054307,FOSL2,182
chr1,38859752,38860071,SRX5075170,SMARCA4,319
chr1,38859789,38860027,SRX5054309,FOSL2,238
chr1,38859806,38860165,SRX5075174,SMARCA4,359
chr1,38859822,38860124,SRX20140894,INTS13,302
chr1,38859863,38860098,SRX5075176,SMARCA4,235
chr1,38859919,38860148,SRX5716470,SMARCA4,229
chr1,38873150,38873554,SRX16500062,CTCF,404
chr1,38873161,38873577,SRX16500060,CTCF,416
chr1,38873180,38873558,SRX16500061,CTCF,378
chr1,38873181,38873697,SRX5075174,SMARCA4,516
chr1,38873220,38873649,SRX5075168,SMARCA4,429
chr1,38873226,38873593,SRX16500059,CTCF,367
chr1,38873345,38873563,SRX5716451,SOX2,218
chr1,38873389,38873585,SRX5075170,SMARCA4,196
chr1,38873403,38873615,SRX5716464,SMARCA4,212
chr1,38873443,38873695,SRX5075176,SMARCA4,252
chr1,38931509,38931816,SRX5716469,SMARCA4,307
chr1,38931518,38931836,SRX5075175,SMARCA4,318
chr1,38931519,38931828,SRX5075169,SMARCA4,309
chr1,38931521,38931829,SRX5075176,SMARCA4,308
chr1,38931525,38931757,SRX5054309,FOSL2,232
chr1,38931532,38931834,SRX5716470,SMARCA4,302
chr1,38931532,38931854,SRX5054308,FOSL2,322
chr1,38931546,38931781,SRX5716467,SMARCA2,235
chr1,38931552,38931763,SRX5716468,SMARCA2,211
chr1,38931560,38931771,SRX5075170,SMARCA4,211
chr1,38931623,38931836,SRX5075181,SMARCA2,213
chr1,38958981,38959324,SRX20140869,INTS10,343
chr1,38959022,38959312,SRX5054309,FOSL2,290
chr1,38986774,38987052,SRX5075169,SMARCA4,278
chr1,38986779,38987027,SRX5075176,SMARCA4,248
chr1,38986791,38987014,SRX5075175,SMARCA4,223
chr1,38990786,38991258,SRX20140868,INTS10,472
chr1,38990791,38991231,SRX5716463,SMARCA4,440
chr1,38990797,38991598,SRX20140895,INTS13,801
chr1,38990798,38991263,SRX5716470,SMARCA4,465
chr1,38990818,38991287,SRX5075168,SMARCA4,469
chr1,38990851,38991433,SRX5075174,SMARCA4,582
chr1,38990879,38991176,SRX5075176,SMARCA4,297
chr1,38990914,38991245,SRX5075170,SMARCA4,331
chr1,38990943,38991281,SRX5716464,SMARCA4,338
chr1,38990954,38991320,SRX16500060,CTCF,366
chr1,38990955,38991468,SRX20140881,CPSF3L,513
chr1,38990978,38991362,SRX16500061,CTCF,384
chr1,38990998,38991395,SRX16500062,CTCF,397
chr1,38991014,38991525,SRX16500059,CTCF,511
chr1,38991060,38991599,SRX20140867,INTS10,539
chr1,38991096,38991510,SRX20140897,INTS13,414
chr1,38991145,38991454,SRX20140896,INTS13,309
chr1,38991165,38991598,SRX20140869,INTS10,433
chr1,38991168,38991436,SRX20140879,CPSF3L,268
chr1,39025960,39026180,SRX5075169,SMARCA4,220
chr1,39025971,39026587,SRX5075170,SMARCA4,616
chr1,39026012,39026511,SRX5075174,SMARCA4,499
chr1,39026043,39026429,SRX5716470,SMARCA4,386
chr1,39026064,39026465,SRX5075168,SMARCA4,401
chr1,39026089,39026942,SRX20140869,INTS10,853
chr1,39026136,39027069,SRX20140895,INTS13,933
chr1,39026160,39026434,SRX5075176,SMARCA4,274
chr1,39026172,39026939,SRX20140897,INTS13,767
chr1,39026176,39026708,SRX20140868,INTS10,532
chr1,39026184,39026975,SRX20140867,INTS10,791
chr1,39026233,39026835,SRX20140881,CPSF3L,602
chr1,39026335,39026522,SRX5075175,SMARCA4,187
chr1,39026504,39026735,SRX5716470,SMARCA4,231
chr1,39026609,39026782,SRX5075174,SMARCA4,173
chr1,39026613,39026935,SRX5075176,SMARCA4,322
chr1,39027199,39027242,SRX1424893,POU3F2,43
chr1,39027201,39027241,SRX1424891,POU3F2,40
chr1,39027201,39027241,SRX1424892,POU3F2,40
chr1,39047356,39047938,SRX5075170,SMARCA4,582
chr1,39047422,39047712,SRX5716469,SMARCA4,290
chr1,39047470,39047731,SRX5075176,SMARCA4,261
chr1,39047520,39047711,SRX5075175,SMARCA4,191
chr1,39047547,39047888,SRX5716470,SMARCA4,341
chr1,39047583,39048242,SRX5075169,SMARCA4,659
chr1,39047594,39047897,SRX5716460,Epitope tags,303
chr1,39047861,39048272,SRX5075175,SMARCA4,411
chr1,39047919,39048258,SRX5075176,SMARCA4,339
chr1,39047926,39048198,SRX5054309,FOSL2,272
chr1,39047973,39048230,SRX5054308,FOSL2,257
chr1,39047991,39048194,SRX5075170,SMARCA4,203
chr1,39048004,39048278,SRX5716469,SMARCA4,274
chr1,39061967,39062229,SRX5054308,FOSL2,262
chr1,39061973,39062267,SRX5054309,FOSL2,294
chr1,39061976,39062351,SRX5075176,SMARCA4,375
chr1,39061986,39062278,SRX5075170,SMARCA4,292
chr1,39061999,39062276,SRX5716469,SMARCA4,277
chr1,39062025,39062245,SRX5075175,SMARCA4,220
chr1,39062033,39062287,SRX5075169,SMARCA4,254
chr1,39076221,39076412,SRX5054309,FOSL2,191
chr1,39081429,39081854,SRX5075174,SMARCA4,425
chr1,39081432,39081688,SRX20140895,INTS13,256
chr1,39081491,39081742,SRX5075169,SMARCA4,251
chr1,39081506,39081743,SRX5075175,SMARCA4,237
chr1,39086398,39086637,SRX5075169,SMARCA4,239
chr1,39086425,39086640,SRX5054309,FOSL2,215
chr1,39086472,39086793,SRX5075170,SMARCA4,321
chr1,39086967,39087415,SRX5075170,SMARCA4,448
chr1,39087057,39087413,SRX5075176,SMARCA4,356
chr1,39087121,39087384,SRX5075175,SMARCA4,263
chr1,39087154,39087360,SRX5075169,SMARCA4,206
chr1,39092321,39092725,SRX16500062,CTCF,404
chr1,39092325,39092746,SRX16500060,CTCF,421
chr1,39092331,39092752,SRX16500059,CTCF,421
chr1,39092354,39092762,SRX16500061,CTCF,408
chr1,39092383,39092653,SRX5075174,SMARCA4,270
chr1,39092389,39092665,SRX5075176,SMARCA4,276
chr1,39092401,39092620,SRX5075168,SMARCA4,219
chr1,39092428,39092611,SRX5075170,SMARCA4,183
chr1,39098489,39098940,SRX5075168,SMARCA4,451
chr1,39098491,39098989,SRX5075176,SMARCA4,498
chr1,39098495,39098865,SRX20140895,INTS13,370
chr1,39098507,39098932,SRX5716470,SMARCA4,425
chr1,39098537,39098965,SRX5075170,SMARCA4,428
chr1,39098544,39098955,SRX5075174,SMARCA4,411
chr1,39098572,39098864,SRX5716463,SMARCA4,292
chr1,39098582,39098871,SRX5716464,SMARCA4,289
chr1,39098591,39098935,SRX5075169,SMARCA4,344
chr1,39098631,39099079,SRX16500060,CTCF,448
chr1,39098633,39099080,SRX16500059,CTCF,447
chr1,39098656,39099035,SRX16500062,CTCF,379
chr1,39098660,39099049,SRX16500061,CTCF,389
chr1,39098704,39099022,SRX4174629,CTCF,318
chr1,39102468,39102893,SRX16500059,CTCF,425
chr1,39102476,39102874,SRX4174629,CTCF,398
chr1,39102481,39102950,SRX16500061,CTCF,469
chr1,39102498,39102951,SRX16500060,CTCF,453
chr1,39102515,39102905,SRX16500062,CTCF,390
chr1,39102616,39102924,SRX5075168,SMARCA4,308
chr1,39102647,39103133,SRX5075176,SMARCA4,486
chr1,39102650,39103090,SRX5075174,SMARCA4,440
chr1,39102659,39103073,SRX5075169,SMARCA4,414
chr1,39102691,39103095,SRX5075170,SMARCA4,404
chr1,39102733,39103018,SRX5716470,SMARCA4,285
chr1,39102736,39103056,SRX5075175,SMARCA4,320
chr1,39102844,39103099,SRX5716469,SMARCA4,255
chr1,39102870,39103080,SRX5075181,SMARCA2,210
chr1,39103229,39103607,SRX5054309,FOSL2,378
chr1,39103340,39103582,SRX5075175,SMARCA4,242
chr1,39103363,39103636,SRX5075176,SMARCA4,273
chr1,39103386,39103601,SRX5054308,FOSL2,215
chr1,39104777,39105999,SRX20140895,INTS13,1222
chr1,39104934,39105411,SRX20140867,INTS10,477
chr1,39104959,39105603,SRX20140868,INTS10,644
chr1,39110777,39111029,SRX5716470,SMARCA4,252
chr1,39110918,39111230,SRX5054309,FOSL2,312
chr1,39110961,39111209,SRX5054308,FOSL2,248
chr1,39127537,39127869,SRX5075168,SMARCA4,332
chr1,39127551,39127888,SRX5075174,SMARCA4,337
chr1,39127557,39127873,SRX5075170,SMARCA4,316
chr1,39127563,39127896,SRX5075176,SMARCA4,333
chr1,39127647,39127890,SRX5075169,SMARCA4,243
chr1,39130463,39130666,SRX5075175,SMARCA4,203
chr1,39132524,39132773,SRX5075168,SMARCA4,249
chr1,39132566,39132883,SRX5075174,SMARCA4,317
chr1,39132953,39133406,SRX5075174,SMARCA4,453
chr1,39133066,39133428,SRX16500060,CTCF,362
chr1,39133071,39133463,SRX16500059,CTCF,392
chr1,39133076,39133303,SRX5716464,SMARCA4,227
chr1,39133085,39133391,SRX5075168,SMARCA4,306
chr1,39133108,39133378,SRX5716463,SMARCA4,270
chr1,39141902,39142347,SRX5075174,SMARCA4,445
chr1,39141962,39142357,SRX5075168,SMARCA4,395
chr1,39141968,39142366,SRX5075175,SMARCA4,398
chr1,39141969,39142348,SRX5716470,SMARCA4,379
chr1,39141989,39142416,SRX5075169,SMARCA4,427
chr1,39142001,39142307,SRX5075176,SMARCA4,306
chr1,39142009,39142345,SRX5075170,SMARCA4,336
chr1,39142035,39142355,SRX5716469,SMARCA4,320
chr1,39142093,39142316,SRX5716467,SMARCA2,223
chr1,39165040,39165386,SRX5075170,SMARCA4,346
chr1,39165052,39165391,SRX5075176,SMARCA4,339
chr1,39165128,39165308,SRX5075169,SMARCA4,180
chr1,39173811,39174004,SRX5075174,SMARCA4,193
chr1,39178476,39178775,SRX5075169,SMARCA4,299
chr1,39178484,39178809,SRX5716470,SMARCA4,325
chr1,39178558,39178860,SRX5716469,SMARCA4,302
chr1,39178565,39178780,SRX5075175,SMARCA4,215
chr1,39178608,39178833,SRX5075174,SMARCA4,225
chr1,39178612,39178795,SRX5054309,FOSL2,183
chr1,39178708,39178887,SRX5075168,SMARCA4,179
chr1,39183749,39184011,SRX16500060,CTCF,262
chr1,39183754,39184201,SRX5075168,SMARCA4,447
chr1,39183757,39183990,SRX16500061,CTCF,233
chr1,39183765,39184093,SRX5075174,SMARCA4,328
chr1,39183788,39184086,SRX5075176,SMARCA4,298
chr1,39183804,39184100,SRX5075169,SMARCA4,296
chr1,39183816,39184027,SRX5716470,SMARCA4,211
chr1,39183828,39184100,SRX5075170,SMARCA4,272
chr1,39183839,39184056,SRX5054309,FOSL2,217
chr1,39185706,39185926,SRX5075170,SMARCA4,220
chr1,39191524,39192013,SRX16500061,CTCF,489
chr1,39191574,39191971,SRX16500059,CTCF,397
chr1,39191576,39191971,SRX16500060,CTCF,395
chr1,39191632,39191987,SRX16500062,CTCF,355
chr1,39191674,39191868,SRX5075168,SMARCA4,194
chr1,39191679,39191886,SRX5075176,SMARCA4,207
chr1,39191686,39191859,SRX5075174,SMARCA4,173
chr1,39191715,39191994,SRX4174629,CTCF,279
chr1,39192082,39192689,SRX5075170,SMARCA4,607
chr1,39192083,39192517,SRX5075169,SMARCA4,434
chr1,39192086,39192824,SRX5075174,SMARCA4,738
chr1,39192095,39192488,SRX5075175,SMARCA4,393
chr1,39192110,39192504,SRX5054309,FOSL2,394
chr1,39192117,39192482,SRX5054308,FOSL2,365
chr1,39192122,39192542,SRX5075176,SMARCA4,420
chr1,39192123,39192478,SRX5075168,SMARCA4,355
chr1,39192127,39192415,SRX5075182,SMARCA2,288
chr1,39192128,39192479,SRX5716469,SMARCA4,351
chr1,39192130,39192528,SRX5716467,SMARCA2,398
chr1,39192156,39192440,SRX5716470,SMARCA4,284
chr1,39192161,39192436,SRX5020211,SMARCA2,275
chr1,39192162,39192414,SRX5054307,FOSL2,252
chr1,39192191,39192433,SRX5716468,SMARCA2,242
chr1,39192245,39192508,SRX5716460,Epitope tags,263
chr1,39192351,39192877,SRX16500060,CTCF,526
chr1,39192387,39192980,SRX16500061,CTCF,593
chr1,39192409,39192909,SRX16500059,CTCF,500
chr1,39192439,39192915,SRX16500062,CTCF,476
chr1,39192578,39192776,SRX5075168,SMARCA4,198
chr1,39196884,39197182,SRX5075169,SMARCA4,298
chr1,39196910,39197171,SRX5075170,SMARCA4,261
chr1,39196912,39197202,SRX5075176,SMARCA4,290
chr1,39196917,39197158,SRX5075175,SMARCA4,241
chr1,39204429,39204927,SRX5716470,SMARCA4,498
chr1,39204434,39204951,SRX5075174,SMARCA4,517
chr1,39204447,39204818,SRX5075170,SMARCA4,371
chr1,39204459,39204917,SRX5075169,SMARCA4,458
chr1,39204469,39205108,SRX5075176,SMARCA4,639
chr1,39204471,39204690,SRX5716467,SMARCA2,219
chr1,39204483,39204905,SRX5716469,SMARCA4,422
chr1,39204499,39205034,SRX5075175,SMARCA4,535
chr1,39204564,39204932,SRX5075168,SMARCA4,368
chr1,39204568,39204884,SRX5054309,FOSL2,316
chr1,39205207,39205472,SRX5075176,SMARCA4,265
chr1,39205263,39205521,SRX5075170,SMARCA4,258
chr1,39213559,39213806,SRX5075169,SMARCA4,247
chr1,39213565,39213734,SRX5075170,SMARCA4,169
chr1,39213566,39213753,SRX5075175,SMARCA4,187
chr1,39213567,39213855,SRX5054309,FOSL2,288
chr1,39214131,39214480,SRX5075168,SMARCA4,349
chr1,39214271,39214547,SRX5075174,SMARCA4,276
chr1,39238365,39238903,SRX5075170,SMARCA4,538
chr1,39238414,39238921,SRX5075176,SMARCA4,507
chr1,39238457,39238902,SRX5075169,SMARCA4,445
chr1,39238461,39238817,SRX5075175,SMARCA4,356
chr1,39238587,39238816,SRX5716467,SMARCA2,229
chr1,39238597,39238855,SRX5716470,SMARCA4,258
chr1,39238602,39238827,SRX5716469,SMARCA4,225
chr1,39238617,39238797,SRX5054308,FOSL2,180
chr1,39250491,39250766,SRX5075176,SMARCA4,275
chr1,39250551,39250773,SRX5075170,SMARCA4,222
chr1,39250579,39250776,SRX5075169,SMARCA4,197
chr1,39255277,39255522,SRX5054309,FOSL2,245
chr1,39258549,39259069,SRX16500059,CTCF,520
chr1,39258551,39259055,SRX16500062,CTCF,504
chr1,39258578,39259092,SRX16500060,CTCF,514
chr1,39258580,39259058,SRX16500061,CTCF,478
chr1,39258585,39258860,SRX5716469,SMARCA4,275
chr1,39258621,39258931,SRX4174629,CTCF,310
chr1,39258623,39258944,SRX5075174,SMARCA4,321
chr1,39258633,39258981,SRX5075168,SMARCA4,348
chr1,39258648,39258887,SRX5075176,SMARCA4,239
chr1,39258657,39258883,SRX5075170,SMARCA4,226
chr1,39261761,39261982,SRX5075175,SMARCA4,221
chr1,39261797,39262028,SRX5075176,SMARCA4,231
chr1,39261820,39262048,SRX5075170,SMARCA4,228
chr1,39261850,39262039,SRX5075169,SMARCA4,189
chr1,39268211,39268481,SRX5716470,SMARCA4,270
chr1,39268223,39268523,SRX5075168,SMARCA4,300
chr1,39268229,39268527,SRX5075176,SMARCA4,298
chr1,39268237,39268512,SRX5075170,SMARCA4,275
chr1,39268341,39268572,SRX5075174,SMARCA4,231
chr1,39318019,39318638,SRX5075170,SMARCA4,619
chr1,39318137,39318687,SRX5075176,SMARCA4,550
chr1,39318182,39318620,SRX5716470,SMARCA4,438
chr1,39318376,39318572,SRX5075169,SMARCA4,196
chr1,39381829,39382038,SRX5075175,SMARCA4,209
chr1,39381854,39382101,SRX5075169,SMARCA4,247
chr1,39381856,39382159,SRX5075170,SMARCA4,303
chr1,39381906,39382088,SRX5054308,FOSL2,182
chr1,39387479,39387715,SRX5075174,SMARCA4,236
chr1,39387484,39387818,SRX5054309,FOSL2,334
chr1,39387495,39387779,SRX5054308,FOSL2,284
chr1,39387514,39387773,SRX5075168,SMARCA4,259
chr1,39387527,39387708,SRX5075176,SMARCA4,181
chr1,39387555,39387740,SRX5054307,FOSL2,185
chr1,39391987,39392452,SRX5075170,SMARCA4,465
chr1,39391991,39392407,SRX5075174,SMARCA4,416
chr1,39392080,39392458,SRX5075176,SMARCA4,378
chr1,39392089,39392451,SRX5075169,SMARCA4,362
chr1,39392090,39392423,SRX5075175,SMARCA4,333
chr1,39392102,39392313,SRX5716468,SMARCA2,211
chr1,39392135,39392458,SRX5075168,SMARCA4,323
chr1,39392140,39392441,SRX5054309,FOSL2,301
chr1,39392151,39392424,SRX5054308,FOSL2,273
chr1,39392153,39392493,SRX5716469,SMARCA4,340
chr1,39392156,39392388,SRX5716470,SMARCA4,232
chr1,39392156,39392395,SRX5716467,SMARCA2,239
chr1,39395586,39395801,SRX5075176,SMARCA4,215
chr1,39398451,39399034,SRX5075174,SMARCA4,583
chr1,39398454,39399010,SRX5716469,SMARCA4,556
chr1,39398489,39399151,SRX5075169,SMARCA4,662
chr1,39398502,39399179,SRX5075176,SMARCA4,677
chr1,39398516,39399023,SRX5075175,SMARCA4,507
chr1,39398520,39398817,SRX5020214,SMARCA2,297
chr1,39398525,39399103,SRX5075170,SMARCA4,578
chr1,39398529,39398974,SRX5054309,FOSL2,445
chr1,39398533,39399018,SRX5075168,SMARCA4,485
chr1,39398534,39398968,SRX5020211,SMARCA2,434
chr1,39398540,39399099,SRX5716470,SMARCA4,559
chr1,39398544,39398931,SRX5054308,FOSL2,387
chr1,39398620,39398983,SRX5716467,SMARCA2,363
chr1,39398657,39399020,SRX5716468,SMARCA2,363
chr1,39398704,39399008,SRX5075181,SMARCA2,304
chr1,39406704,39406950,SRX5075169,SMARCA4,246
chr1,39408445,39408701,SRX20140895,INTS13,256
chr1,39408524,39409308,SRX5075174,SMARCA4,784
chr1,39408535,39409117,SRX5075168,SMARCA4,582
chr1,39408629,39408827,SRX5075176,SMARCA4,198
chr1,39408736,39409124,SRX5075170,SMARCA4,388
chr1,39408784,39409051,SRX5716464,SMARCA4,267
chr1,39408810,39409501,SRX20140895,INTS13,691
chr1,39408876,39409075,SRX5716451,SOX2,199
chr1,39409077,39409338,SRX20140868,INTS10,261
chr1,39410837,39411243,SRX16500060,CTCF,406
chr1,39410866,39411225,SRX16500061,CTCF,359
chr1,39410929,39411256,SRX16500062,CTCF,327
chr1,39410950,39411304,SRX16500059,CTCF,354
chr1,39410981,39411173,SRX5075170,SMARCA4,192
chr1,39418183,39418599,SRX5716470,SMARCA4,416
chr1,39418220,39418527,SRX5054308,FOSL2,307
chr1,39418235,39418488,SRX5716469,SMARCA4,253
chr1,39418255,39418515,SRX5020211,SMARCA2,260
chr1,39418269,39418479,SRX5075175,SMARCA4,210
chr1,39418332,39418547,SRX5075169,SMARCA4,215
chr1,39491443,39491835,SRX5075174,SMARCA4,392
chr1,39491464,39491764,SRX5075168,SMARCA4,300
chr1,39507308,39507553,SRX16500060,CTCF,245
chr1,39516924,39517213,SRX5075174,SMARCA4,289
chr1,39516959,39517166,SRX5075168,SMARCA4,207
chr1,39519441,39519644,SRX5075168,SMARCA4,203
chr1,39539134,39539604,SRX16500059,CTCF,470
chr1,39539156,39539618,SRX16500060,CTCF,462
chr1,39539168,39539695,SRX16500061,CTCF,527
chr1,39539173,39539642,SRX16500062,CTCF,469
chr1,39539198,39539508,SRX4174629,CTCF,310
chr1,39539228,39539509,SRX5075169,SMARCA4,281
chr1,39539239,39539478,SRX5075168,SMARCA4,239
chr1,39539248,39539515,SRX5075170,SMARCA4,267
chr1,39539252,39539462,SRX5075174,SMARCA4,210
chr1,39576405,39577054,SRX20140895,INTS13,649
chr1,39576475,39576653,SRX5075176,SMARCA4,178
chr1,39576479,39577065,SRX20140868,INTS10,586
chr1,39576498,39576896,SRX20140869,INTS10,398
chr1,39576517,39576876,SRX20140881,CPSF3L,359
chr1,39576532,39576976,SRX20140897,INTS13,444
chr1,39576558,39577033,SRX20140867,INTS10,475
chr1,39576569,39576813,SRX20140879,CPSF3L,244
chr1,39576569,39577086,SRX5075168,SMARCA4,517
chr1,39576626,39576981,SRX20140896,INTS13,355
chr1,39576630,39577196,SRX16500060,CTCF,566
chr1,39576639,39576879,SRX20140880,CPSF3L,240
chr1,39576670,39577231,SRX16500059,CTCF,561
chr1,39576671,39577255,SRX16500061,CTCF,584
chr1,39576716,39577037,SRX5075170,SMARCA4,321
chr1,39576719,39577032,SRX5716469,SMARCA4,313
chr1,39576724,39577079,SRX5716470,SMARCA4,355
chr1,39576735,39577045,SRX5716463,SMARCA4,310
chr1,39576752,39577031,SRX5716464,SMARCA4,279
chr1,39576753,39577075,SRX5075176,SMARCA4,322
chr1,39576757,39577025,SRX5075169,SMARCA4,268
chr1,39576763,39577231,SRX16500062,CTCF,468
chr1,39576778,39577111,SRX5075174,SMARCA4,333
chr1,39576862,39577052,SRX5716451,SOX2,190
chr1,39606072,39606376,SRX4174629,CTCF,304
chr1,39606080,39606538,SRX16500060,CTCF,458
chr1,39606086,39606538,SRX16500059,CTCF,452
chr1,39606091,39606534,SRX16500061,CTCF,443
chr1,39606102,39606502,SRX16500062,CTCF,400
chr1,39606228,39606436,SRX5075169,SMARCA4,208
chr1,39606265,39606474,SRX5075176,SMARCA4,209
chr1,39609596,39609971,SRX16500060,CTCF,375
chr1,39609601,39609959,SRX16500059,CTCF,358
chr1,39609609,39609953,SRX16500061,CTCF,344
chr1,39609664,39609947,SRX16500062,CTCF,283
chr1,39632745,39633236,SRX20140895,INTS13,491
chr1,39632785,39633144,SRX20140881,CPSF3L,359
chr1,39632866,39633120,SRX5716470,SMARCA4,254
chr1,39632886,39633317,SRX5075170,SMARCA4,431
chr1,39632921,39633274,SRX5075168,SMARCA4,353
chr1,39632922,39633432,SRX5075175,SMARCA4,510
chr1,39632940,39633283,SRX5075174,SMARCA4,343
chr1,39632973,39633457,SRX5075169,SMARCA4,484
chr1,39633041,39633339,SRX5075176,SMARCA4,298
chr1,39639779,39640100,SRX5075168,SMARCA4,321
chr1,39639782,39640075,SRX16500059,CTCF,293
chr1,39639860,39640099,SRX16500061,CTCF,239
chr1,39639902,39640143,SRX16500062,CTCF,241
chr1,39639937,39640172,SRX16500060,CTCF,235
chr1,39646261,39646523,SRX5075170,SMARCA4,262
chr1,39646293,39646590,SRX5075169,SMARCA4,297
chr1,39646297,39646620,SRX5716468,SMARCA2,323
chr1,39646320,39646593,SRX5075176,SMARCA4,273
chr1,39653443,39653936,SRX16500061,CTCF,493
chr1,39653478,39653921,SRX16500060,CTCF,443
chr1,39653481,39653953,SRX16500059,CTCF,472
chr1,39653494,39653800,SRX4174629,CTCF,306
chr1,39653526,39653899,SRX16500062,CTCF,373
chr1,39653539,39653831,SRX5075174,SMARCA4,292
chr1,39653544,39653845,SRX5075168,SMARCA4,301
chr1,39653546,39653802,SRX5075176,SMARCA4,256
chr1,39653594,39653796,SRX5075170,SMARCA4,202
chr1,39653607,39653796,SRX5075175,SMARCA4,189
chr1,39658041,39658403,SRX16500062,CTCF,362
chr1,39658042,39658429,SRX16500060,CTCF,387
chr1,39658058,39658391,SRX16500059,CTCF,333
chr1,39658085,39658280,SRX5075168,SMARCA4,195
chr1,39658090,39658409,SRX16500061,CTCF,319
chr1,39658109,39658296,SRX5075174,SMARCA4,187
chr1,39672618,39672975,SRX16500060,CTCF,357
chr1,39672619,39672987,SRX16500062,CTCF,368
chr1,39672683,39673020,SRX16500059,CTCF,337
chr1,39672702,39673000,SRX16500061,CTCF,298
chr1,39691262,39691960,SRX5075174,SMARCA4,698
chr1,39691286,39691463,SRX5075170,SMARCA4,177
chr1,39691298,39691873,SRX5075168,SMARCA4,575
chr1,39691356,39691622,SRX20140895,INTS13,266
chr1,39691367,39691613,SRX5716463,SMARCA4,246
chr1,39691370,39691820,SRX5075176,SMARCA4,450
chr1,39691422,39691654,SRX5716464,SMARCA4,232
chr1,39691697,39691950,SRX5716470,SMARCA4,253
chr1,39701757,39702136,SRX5075174,SMARCA4,379
chr1,39701796,39702264,SRX16500060,CTCF,468
chr1,39701819,39702263,SRX16500061,CTCF,444
chr1,39701829,39702295,SRX16500059,CTCF,466
chr1,39701867,39702204,SRX16500062,CTCF,337
chr1,39701887,39702143,SRX4174629,CTCF,256
chr1,39719915,39720412,SRX16500059,CTCF,497
chr1,39719932,39720432,SRX16500060,CTCF,500
chr1,39719971,39720455,SRX16500062,CTCF,484
chr1,39719976,39720444,SRX16500061,CTCF,468
chr1,39738603,39739082,SRX20140895,INTS13,479
chr1,39738613,39739096,SRX5075168,SMARCA4,483
chr1,39738629,39739119,SRX5716470,SMARCA4,490
chr1,39738631,39738997,SRX20140868,INTS10,366
chr1,39738632,39739166,SRX5075174,SMARCA4,534
chr1,39738643,39739010,SRX5075170,SMARCA4,367
chr1,39738647,39739102,SRX5075176,SMARCA4,455
chr1,39738662,39739185,SRX5075175,SMARCA4,523
chr1,39738675,39738886,SRX5716464,SMARCA4,211
chr1,39738746,39739046,SRX5716463,SMARCA4,300
chr1,39738792,39739056,SRX20140897,INTS13,264
chr1,39769027,39769201,SRX5075174,SMARCA4,174
chr1,39799484,39800047,SRX16500062,CTCF,563
chr1,39799533,39800129,SRX16500059,CTCF,596
chr1,39799555,39800104,SRX16500061,CTCF,549
chr1,39799556,39800076,SRX16500060,CTCF,520
chr1,39799570,39799941,SRX4174629,CTCF,371
chr1,39799676,39799865,SRX5075168,SMARCA4,189
chr1,39799682,39799970,SRX5075174,SMARCA4,288
chr1,39799937,39800154,SRX5075169,SMARCA4,217
chr1,39816711,39817128,SRX5075174,SMARCA4,417
chr1,39816728,39817273,SRX16500061,CTCF,545
chr1,39816729,39817140,SRX5075168,SMARCA4,411
chr1,39816732,39817269,SRX16500059,CTCF,537
chr1,39816735,39816915,SRX5054308,FOSL2,180
chr1,39816737,39817267,SRX16500060,CTCF,530
chr1,39816743,39817261,SRX16500062,CTCF,518
chr1,39816788,39817233,SRX4174629,CTCF,445
chr1,39816789,39817020,SRX5716451,SOX2,231
chr1,39816849,39817032,SRX5075176,SMARCA4,183
chr1,39845556,39846070,SRX5075176,SMARCA4,514
chr1,39845569,39846051,SRX5075170,SMARCA4,482
chr1,39845628,39845925,SRX5075175,SMARCA4,297
chr1,39845645,39845988,SRX5716470,SMARCA4,343
chr1,39845655,39845925,SRX5075169,SMARCA4,270
chr1,39845985,39846467,SRX5075169,SMARCA4,482
chr1,39846070,39846406,SRX5716469,SMARCA4,336
chr1,39846143,39846421,SRX5075175,SMARCA4,278
chr1,39846218,39846447,SRX5054309,FOSL2,229
chr1,39883217,39883652,SRX20140895,INTS13,435
chr1,39883290,39883548,SRX20140879,CPSF3L,258
chr1,39883320,39883611,SRX20140868,INTS10,291
chr1,39883409,39883578,SRX5075170,SMARCA4,169
chr1,39883429,39883643,SRX5075168,SMARCA4,214
chr1,39886701,39887392,SRX5075174,SMARCA4,691
chr1,39886809,39887117,SRX20140895,INTS13,308
chr1,39886831,39887290,SRX5716464,SMARCA4,459
chr1,39886941,39887362,SRX5075168,SMARCA4,421
chr1,39886964,39887272,SRX5716451,SOX2,308
chr1,39886982,39887363,SRX5716463,SMARCA4,381
chr1,39893167,39893456,SRX5075175,SMARCA4,289
chr1,39893173,39893520,SRX5075174,SMARCA4,347
chr1,39893177,39893526,SRX5075168,SMARCA4,349
chr1,39893253,39893464,SRX5716470,SMARCA4,211
chr1,39893258,39893467,SRX5075169,SMARCA4,209
chr1,39893259,39893485,SRX5716463,SMARCA4,226
chr1,39898166,39898551,SRX5075168,SMARCA4,385
chr1,39898197,39898619,SRX5075174,SMARCA4,422
chr1,39898220,39898676,SRX20140895,INTS13,456
chr1,39898315,39898579,SRX20140868,INTS10,264
chr1,39898328,39898580,SRX5716454,SOX3,252
chr1,39898909,39899165,SRX20140895,INTS13,256
chr1,39898947,39899147,SRX5075174,SMARCA4,200
chr1,39898950,39899307,SRX5716451,SOX2,357
chr1,39899007,39899260,SRX5716454,SOX3,253
chr1,39899036,39899239,SRX5054307,FOSL2,203
chr1,39901800,39902021,SRX5716469,SMARCA4,221
chr1,39901808,39902022,SRX20140867,INTS10,214
chr1,39901918,39902114,SRX5075174,SMARCA4,196
chr1,39902098,39902624,SRX16500059,CTCF,526
chr1,39902104,39902545,SRX16500062,CTCF,441
chr1,39902108,39902628,SRX16500061,CTCF,520
chr1,39902144,39902619,SRX16500060,CTCF,475
chr1,39902256,39902462,SRX5075169,SMARCA4,206
chr1,39919406,39919893,SRX16500060,CTCF,487
chr1,39919420,39919847,SRX16500061,CTCF,427
chr1,39919431,39919863,SRX16500062,CTCF,432
chr1,39919454,39919979,SRX16500059,CTCF,525
chr1,39919636,39919846,SRX4174629,CTCF,210
chr1,39922294,39922687,SRX5075168,SMARCA4,393
chr1,39922458,39922683,SRX5075174,SMARCA4,225
chr1,39954888,39955247,SRX5075176,SMARCA4,359
chr1,39954954,39955779,SRX20140895,INTS13,825
chr1,39954974,39955228,SRX5075168,SMARCA4,254
chr1,39954988,39955281,SRX5075174,SMARCA4,293
chr1,39955003,39955378,SRX20140868,INTS10,375
chr1,39955031,39955395,SRX20140867,INTS10,364
chr1,39973383,39973971,SRX16500059,CTCF,588
chr1,39973440,39973989,SRX16500060,CTCF,549
chr1,39973463,39973944,SRX16500061,CTCF,481
chr1,39973471,39973907,SRX4174629,CTCF,436
chr1,39973491,39974001,SRX16500062,CTCF,510
chr1,39973537,39973824,SRX5075168,SMARCA4,287
chr1,39973567,39973809,SRX5075174,SMARCA4,242
chr1,39973593,39973795,SRX5075176,SMARCA4,202
chr1,39973594,39973784,SRX5075169,SMARCA4,190
chr1,39973622,39973800,SRX5075170,SMARCA4,178
chr1,39981999,39982241,SRX5716469,SMARCA4,242
chr1,39982058,39982356,SRX5075170,SMARCA4,298
chr1,39982115,39982295,SRX5075169,SMARCA4,180
chr1,39982136,39982329,SRX5054309,FOSL2,193
chr1,40004662,40005205,SRX5075168,SMARCA4,543
chr1,40004689,40005255,SRX5075174,SMARCA4,566
chr1,40004756,40005258,SRX5716463,SMARCA4,502
chr1,40004837,40005141,SRX5716451,SOX2,304
chr1,40004855,40005165,SRX5716454,SOX3,310
chr1,40004879,40005213,SRX5716464,SMARCA4,334
chr1,40015152,40015469,SRX5716460,Epitope tags,317
chr1,40015156,40015507,SRX5054308,FOSL2,351
chr1,40015185,40015594,SRX5075170,SMARCA4,409
chr1,40015192,40015542,SRX5075175,SMARCA4,350
chr1,40015193,40015436,SRX5054309,FOSL2,243
chr1,40015205,40015567,SRX5075169,SMARCA4,362
chr1,40015218,40015555,SRX5075176,SMARCA4,337
chr1,40015271,40015450,SRX5075168,SMARCA4,179
chr1,40015367,40015540,SRX5075174,SMARCA4,173
chr1,40032211,40032699,SRX16500059,CTCF,488
chr1,40032217,40032677,SRX16500060,CTCF,460
chr1,40032237,40032767,SRX16500062,CTCF,530
chr1,40032239,40032618,SRX5075174,SMARCA4,379
chr1,40032266,40032699,SRX16500061,CTCF,433
chr1,40032290,40032508,SRX5716469,SMARCA4,218
chr1,40032293,40032618,SRX5075168,SMARCA4,325
chr1,40032337,40032565,SRX5075169,SMARCA4,228
chr1,40032338,40032571,SRX5075176,SMARCA4,233
chr1,40032339,40032564,SRX4174629,CTCF,225
chr1,40032344,40032550,SRX5075170,SMARCA4,206
chr1,40032347,40032619,SRX5716463,SMARCA4,272
chr1,40039493,40040565,SRX20140881,CPSF3L,1072
chr1,40039557,40040773,SRX20140895,INTS13,1216
chr1,40039660,40040616,SRX20140868,INTS10,956
chr1,40039718,40040210,SRX5075168,SMARCA4,492
chr1,40039730,40040580,SRX20140867,INTS10,850
chr1,40039889,40040559,SRX20140896,INTS13,670
chr1,40039899,40040082,SRX5075174,SMARCA4,183
chr1,40039903,40040157,SRX5075176,SMARCA4,254
chr1,40039913,40040551,SRX20140897,INTS13,638
chr1,40040022,40040502,SRX20140879,CPSF3L,480
chr1,40040140,40040422,SRX20140894,INTS13,282
chr1,40040149,40040541,SRX20140869,INTS10,392
chr1,40040345,40040884,SRX5075168,SMARCA4,539
chr1,40040368,40040681,SRX5075176,SMARCA4,313
chr1,40040379,40040907,SRX5075174,SMARCA4,528
chr1,40040449,40040731,SRX5716464,SMARCA4,282
chr1,40040460,40040702,SRX5054307,FOSL2,242
chr1,40040462,40040711,SRX5075170,SMARCA4,249
chr1,40040585,40040827,SRX5716463,SMARCA4,242
chr1,40076885,40077322,SRX5075170,SMARCA4,437
chr1,40076890,40077300,SRX5054308,FOSL2,410
chr1,40076904,40077350,SRX5075175,SMARCA4,446
chr1,40076911,40077229,SRX5054309,FOSL2,318
chr1,40076914,40077360,SRX5075176,SMARCA4,446
chr1,40076925,40077361,SRX5075169,SMARCA4,436
chr1,40076974,40077246,SRX5716467,SMARCA2,272
chr1,40077000,40077442,SRX5716470,SMARCA4,442
chr1,40077037,40077319,SRX5716469,SMARCA4,282
chr1,40078471,40078921,SRX16500061,CTCF,450
chr1,40078483,40078945,SRX16500059,CTCF,462
chr1,40078485,40078940,SRX16500062,CTCF,455
chr1,40078487,40078921,SRX16500060,CTCF,434
chr1,40078585,40078840,SRX5075174,SMARCA4,255
chr1,40078585,40078896,SRX5075168,SMARCA4,311
chr1,40078642,40079044,SRX4174629,CTCF,402
chr1,40084612,40085165,SRX16500060,CTCF,553
chr1,40084620,40085123,SRX16500059,CTCF,503
chr1,40084644,40085099,SRX16500061,CTCF,455
chr1,40084646,40085128,SRX16500062,CTCF,482
chr1,40084674,40085025,SRX4174629,CTCF,351
chr1,40084738,40085051,SRX5075168,SMARCA4,313
chr1,40084742,40085035,SRX5075170,SMARCA4,293
chr1,40084751,40085021,SRX5075174,SMARCA4,270
chr1,40096815,40097469,SRX5075168,SMARCA4,654
chr1,40096892,40097483,SRX5075170,SMARCA4,591
chr1,40096899,40097576,SRX20140895,INTS13,677
chr1,40096927,40097441,SRX20140897,INTS13,514
chr1,40096958,40097495,SRX20140868,INTS10,537
chr1,40096964,40097407,SRX20140869,INTS10,443
chr1,40096978,40097410,SRX20140867,INTS10,432
chr1,40096980,40097524,SRX5716470,SMARCA4,544
chr1,40096984,40097343,SRX20140879,CPSF3L,359
chr1,40097000,40097458,SRX5075174,SMARCA4,458
chr1,40097030,40097234,SRX5716463,SMARCA4,204
chr1,40097085,40097656,SRX5075176,SMARCA4,571
chr1,40097103,40097461,SRX5075175,SMARCA4,358
chr1,40097133,40097438,SRX5075169,SMARCA4,305
chr1,40097265,40097508,SRX16500059,CTCF,243
chr1,40097274,40097515,SRX5716469,SMARCA4,241
chr1,40143955,40144413,SRX16500062,CTCF,458
chr1,40143974,40144460,SRX16500059,CTCF,486
chr1,40143978,40144429,SRX4174629,CTCF,451
chr1,40143981,40144451,SRX16500061,CTCF,470
chr1,40143991,40144449,SRX16500060,CTCF,458
chr1,40144004,40144332,SRX5075168,SMARCA4,328
chr1,40144009,40144349,SRX5075174,SMARCA4,340
chr1,40144083,40144317,SRX5075170,SMARCA4,234
chr1,40152879,40153502,SRX16500061,CTCF,623
chr1,40152946,40153464,SRX16500059,CTCF,518
chr1,40152949,40153410,SRX16500060,CTCF,461
chr1,40152992,40153232,SRX4174629,CTCF,240
chr1,40153034,40153374,SRX16500062,CTCF,340
chr1,40153061,40153359,SRX5075174,SMARCA4,298
chr1,40153077,40153326,SRX5075175,SMARCA4,249
chr1,40153093,40153377,SRX5075170,SMARCA4,284
chr1,40153102,40153354,SRX5075168,SMARCA4,252
chr1,40153115,40153370,SRX5075176,SMARCA4,255
chr1,40153116,40153410,SRX5716469,SMARCA4,294
chr1,40153132,40153343,SRX5716470,SMARCA4,211
chr1,40160915,40161408,SRX5075168,SMARCA4,493
chr1,40160938,40161503,SRX5075174,SMARCA4,565
chr1,40160942,40161453,SRX5716463,SMARCA4,511
chr1,40160980,40161349,SRX5716464,SMARCA4,369
chr1,40160999,40161457,SRX20140869,INTS10,458
chr1,40161036,40161451,SRX5075170,SMARCA4,415
chr1,40161043,40161587,SRX20140867,INTS10,544
chr1,40161044,40161352,SRX5716454,SOX3,308
chr1,40161046,40161456,SRX5716469,SMARCA4,410
chr1,40161055,40161551,SRX20140879,CPSF3L,496
chr1,40161061,40161299,SRX5716451,SOX2,238
chr1,40161074,40161421,SRX5075176,SMARCA4,347
chr1,40161075,40161697,SRX20140895,INTS13,622
chr1,40161092,40161566,SRX20140868,INTS10,474
chr1,40161122,40161534,SRX5075169,SMARCA4,412
chr1,40161147,40161647,SRX20140881,CPSF3L,500
chr1,40161157,40161670,SRX20140897,INTS13,513
chr1,40161161,40161365,SRX5054307,FOSL2,204
chr1,40161191,40161418,SRX5054309,FOSL2,227
chr1,40161196,40161443,SRX5075175,SMARCA4,247
chr1,40161201,40161609,SRX20140896,INTS13,408
chr1,40161241,40161459,SRX5054308,FOSL2,218
chr1,40161376,40161587,SRX5716470,SMARCA4,211
chr1,40183051,40183334,SRX16500060,CTCF,283
chr1,40183185,40183400,SRX16500062,CTCF,215
chr1,40241764,40242080,SRX5054309,FOSL2,316
chr1,40241777,40242038,SRX5075176,SMARCA4,261
chr1,40241793,40242054,SRX5075170,SMARCA4,261
chr1,40241798,40242052,SRX5054308,FOSL2,254
chr1,40241831,40242038,SRX5075169,SMARCA4,207
chr1,40257351,40257531,SRX5075169,SMARCA4,180
chr1,40257443,40258428,SRX20140895,INTS13,985
chr1,40257591,40258369,SRX20140868,INTS10,778
chr1,40257611,40258321,SRX20140869,INTS10,710
chr1,40257708,40258186,SRX20140897,INTS13,478
chr1,40257788,40258285,SRX5075170,SMARCA4,497
chr1,40257804,40258372,SRX5075168,SMARCA4,568
chr1,40257891,40258300,SRX20140867,INTS10,409
chr1,40257917,40258097,SRX5075176,SMARCA4,180
chr1,40257959,40258370,SRX5075174,SMARCA4,411
chr1,40258018,40258222,SRX5716463,SMARCA4,204
chr1,40258055,40258284,SRX5716464,SMARCA4,229
chr1,40267686,40268275,SRX5075176,SMARCA4,589
chr1,40267716,40268120,SRX5716467,SMARCA2,404
chr1,40267721,40268199,SRX5075175,SMARCA4,478
chr1,40267722,40268196,SRX5716469,SMARCA4,474
chr1,40267722,40268204,SRX5075170,SMARCA4,482
chr1,40267723,40268225,SRX5075169,SMARCA4,502
chr1,40267726,40268184,SRX5716470,SMARCA4,458
chr1,40267731,40268209,SRX5020211,SMARCA2,478
chr1,40267733,40268097,SRX5716468,SMARCA2,364
chr1,40267750,40268056,SRX5054308,FOSL2,306
chr1,40267799,40268017,SRX5054309,FOSL2,218
chr1,40267818,40268274,SRX5716459,Epitope tags,456
chr1,40267955,40268166,SRX5075181,SMARCA2,211
chr1,40314819,40315443,SRX5716469,SMARCA4,624
chr1,40314831,40315111,SRX5716470,SMARCA4,280
chr1,40314889,40315582,SRX5075176,SMARCA4,693
chr1,40314947,40315145,SRX5075175,SMARCA4,198
chr1,40314955,40315569,SRX5075170,SMARCA4,614
chr1,40314963,40315536,SRX5075169,SMARCA4,573
chr1,40315211,40315740,SRX16500059,CTCF,529
chr1,40315215,40315638,SRX20140895,INTS13,423
chr1,40315219,40315433,SRX20140867,INTS10,214
chr1,40315219,40315618,SRX5075174,SMARCA4,399
chr1,40315221,40315839,SRX16500060,CTCF,618
chr1,40315222,40315632,SRX5075168,SMARCA4,410
chr1,40315224,40315588,SRX20140868,INTS10,364
chr1,40315230,40315610,SRX5075175,SMARCA4,380
chr1,40315246,40315728,SRX16500061,CTCF,482
chr1,40315258,40315553,SRX5716470,SMARCA4,295
chr1,40315270,40315710,SRX16500062,CTCF,440
chr1,40315302,40315637,SRX5716463,SMARCA4,335
chr1,40315305,40315562,SRX4174629,CTCF,257
chr1,40315345,40315873,SRX20140881,CPSF3L,528
chr1,40315348,40315590,SRX5716464,SMARCA4,242
chr1,40338594,40339138,SRX16500059,CTCF,544
chr1,40338616,40339148,SRX16500062,CTCF,532
chr1,40338630,40339101,SRX16500061,CTCF,471
chr1,40338652,40339181,SRX16500060,CTCF,529
chr1,40338676,40339090,SRX4174629,CTCF,414
chr1,40338705,40339028,SRX5075168,SMARCA4,323
chr1,40338736,40339047,SRX5075174,SMARCA4,311
chr1,40338764,40339000,SRX5075170,SMARCA4,236
chr1,40362697,40363066,SRX5075175,SMARCA4,369
chr1,40362704,40363088,SRX5075169,SMARCA4,384
chr1,40362720,40363085,SRX5075176,SMARCA4,365
chr1,40362721,40363060,SRX5716469,SMARCA4,339
chr1,40362724,40363060,SRX5716467,SMARCA2,336
chr1,40362726,40363078,SRX5054309,FOSL2,352
chr1,40362730,40363081,SRX5075170,SMARCA4,351
chr1,40362732,40363012,SRX5716468,SMARCA2,280
chr1,40362746,40363011,SRX5054308,FOSL2,265
chr1,40362753,40363107,SRX5716470,SMARCA4,354
chr1,40362811,40363011,SRX5020211,SMARCA2,200
chr1,40362835,40363040,SRX5020214,SMARCA2,205
chr1,40373358,40373820,SRX5075168,SMARCA4,462
chr1,40373379,40373842,SRX5075174,SMARCA4,463
chr1,40373442,40373724,SRX5716463,SMARCA4,282
chr1,40373498,40373856,SRX5075176,SMARCA4,358
chr1,40373502,40373728,SRX5716464,SMARCA4,226
chr1,40373543,40373724,SRX5054307,FOSL2,181
chr1,40379942,40380463,SRX5054308,FOSL2,521
chr1,40379979,40380502,SRX5075176,SMARCA4,523
chr1,40379990,40380482,SRX5075170,SMARCA4,492
chr1,40380020,40380391,SRX5054309,FOSL2,371
chr1,40380044,40380460,SRX5075169,SMARCA4,416
chr1,40380049,40380454,SRX5716468,SMARCA2,405
chr1,40380058,40380454,SRX5716469,SMARCA4,396
chr1,40380062,40380489,SRX5075175,SMARCA4,427
chr1,40380070,40380438,SRX5716470,SMARCA4,368
chr1,40380072,40380471,SRX5716467,SMARCA2,399
chr1,40380084,40380462,SRX5075181,SMARCA2,378
chr1,40380088,40380423,SRX5020214,SMARCA2,335
chr1,40380105,40380420,SRX5020211,SMARCA2,315
chr1,40392166,40392650,SRX5075176,SMARCA4,484
chr1,40392196,40392500,SRX5054309,FOSL2,304
chr1,40392202,40392631,SRX5075170,SMARCA4,429
chr1,40392217,40392509,SRX5716467,SMARCA2,292
chr1,40392229,40392490,SRX5075169,SMARCA4,261
chr1,40392240,40392512,SRX5054308,FOSL2,272
chr1,40392266,40392584,SRX5075175,SMARCA4,318
chr1,40392280,40392492,SRX5716469,SMARCA4,212
chr1,40392289,40392547,SRX5716470,SMARCA4,258
chr1,40392295,40392470,SRX5075174,SMARCA4,175
chr1,40392300,40392522,SRX5075168,SMARCA4,222
chr1,40404744,40405288,SRX16500060,CTCF,544
chr1,40404749,40405305,SRX16500059,CTCF,556
chr1,40404775,40405298,SRX16500062,CTCF,523
chr1,40404784,40405364,SRX16500061,CTCF,580
chr1,40404843,40405139,SRX5075174,SMARCA4,296
chr1,40404853,40405128,SRX5075176,SMARCA4,275
chr1,40404870,40405067,SRX5075175,SMARCA4,197
chr1,40404890,40405190,SRX5075168,SMARCA4,300
chr1,40421298,40421721,SRX5075168,SMARCA4,423
chr1,40421316,40421765,SRX5075174,SMARCA4,449
chr1,40421472,40421707,SRX5716463,SMARCA4,235
chr1,40421487,40421728,SRX5716464,SMARCA4,241
chr1,40438370,40438793,SRX16500059,CTCF,423
chr1,40438406,40438795,SRX16500061,CTCF,389
chr1,40438411,40438792,SRX16500060,CTCF,381
chr1,40438413,40438775,SRX5075168,SMARCA4,362
chr1,40438440,40438864,SRX16500062,CTCF,424
chr1,40449679,40450471,SRX20140895,INTS13,792
chr1,40449726,40450241,SRX5716469,SMARCA4,515
chr1,40449756,40450480,SRX5075176,SMARCA4,724
chr1,40449764,40450477,SRX5075174,SMARCA4,713
chr1,40449772,40450399,SRX5075168,SMARCA4,627
chr1,40449776,40450509,SRX5716470,SMARCA4,733
chr1,40449780,40450353,SRX20140897,INTS13,573
chr1,40449795,40450420,SRX5075170,SMARCA4,625
chr1,40449800,40450448,SRX5075169,SMARCA4,648
chr1,40449801,40450119,SRX20140881,CPSF3L,318
chr1,40449802,40450350,SRX5716463,SMARCA4,548
chr1,40449832,40450019,SRX5075175,SMARCA4,187
chr1,40449857,40450348,SRX20140868,INTS10,491
chr1,40449884,40450311,SRX20140879,CPSF3L,427
chr1,40449942,40450268,SRX20140867,INTS10,326
chr1,40450086,40450444,SRX5075175,SMARCA4,358
chr1,40450971,40451309,SRX5054308,FOSL2,338
chr1,40451022,40451205,SRX5054309,FOSL2,183
chr1,40477070,40477443,SRX5075174,SMARCA4,373
chr1,40477071,40477555,SRX20140868,INTS10,484
chr1,40477079,40477687,SRX5075169,SMARCA4,608
chr1,40477084,40477733,SRX5075170,SMARCA4,649
chr1,40477094,40477711,SRX20140895,INTS13,617
chr1,40477121,40477476,SRX5075175,SMARCA4,355
chr1,40477125,40477759,SRX5075176,SMARCA4,634
chr1,40477131,40477640,SRX5075168,SMARCA4,509
chr1,40477143,40477422,SRX5716470,SMARCA4,279
chr1,40477530,40477717,SRX5075175,SMARCA4,187
chr1,40508357,40509121,SRX5075169,SMARCA4,764
chr1,40508461,40508874,SRX20140897,INTS13,413
chr1,40508489,40508779,SRX5075176,SMARCA4,290
chr1,40508489,40508912,SRX20140895,INTS13,423
chr1,40508524,40509081,SRX5716470,SMARCA4,557
chr1,40508536,40508963,SRX5075170,SMARCA4,427
chr1,40508539,40508792,SRX5075174,SMARCA4,253
chr1,40508558,40508871,SRX5075168,SMARCA4,313
chr1,40531169,40531380,SRX5716470,SMARCA4,211
chr1,40531250,40531764,SRX5075174,SMARCA4,514
chr1,40531275,40531589,SRX5075170,SMARCA4,314
chr1,40531321,40531864,SRX5075169,SMARCA4,543
chr1,40531332,40531779,SRX5075168,SMARCA4,447
chr1,40531375,40531749,SRX5075176,SMARCA4,374
chr1,40531379,40531641,SRX5716463,SMARCA4,262
chr1,40531390,40531800,SRX20140895,INTS13,410
chr1,40531591,40531823,SRX5075175,SMARCA4,232
chr1,40531606,40531874,SRX5716469,SMARCA4,268
chr1,40531614,40531840,SRX20140867,INTS10,226
chr1,40532720,40533163,SRX16500061,CTCF,443
chr1,40532732,40533249,SRX16500059,CTCF,517
chr1,40532802,40533192,SRX16500062,CTCF,390
chr1,40532821,40533218,SRX16500060,CTCF,397
chr1,40583395,40583971,SRX5716469,SMARCA4,576
chr1,40583444,40583894,SRX5716470,SMARCA4,450
chr1,40583449,40583794,SRX5054308,FOSL2,345
chr1,40583465,40583791,SRX5054309,FOSL2,326
chr1,40583469,40583806,SRX5075170,SMARCA4,337
chr1,40583474,40583771,SRX5075175,SMARCA4,297
chr1,40583508,40583761,SRX5716467,SMARCA2,253
chr1,40583512,40583817,SRX5075169,SMARCA4,305
chr1,40583521,40583832,SRX5020211,SMARCA2,311
chr1,40583526,40583782,SRX5075176,SMARCA4,256
chr1,40592105,40592518,SRX16500060,CTCF,413
chr1,40592206,40592561,SRX16500059,CTCF,355
chr1,40592211,40592500,SRX16500061,CTCF,289
chr1,40592258,40592509,SRX5075168,SMARCA4,251
chr1,40592280,40592452,SRX5075170,SMARCA4,172
chr1,40612206,40612787,SRX16500059,CTCF,581
chr1,40612237,40612741,SRX16500060,CTCF,504
chr1,40612260,40612663,SRX16500061,CTCF,403
chr1,40612269,40612709,SRX16500062,CTCF,440
chr1,40612274,40612618,SRX5075168,SMARCA4,344
chr1,40612306,40612602,SRX5075174,SMARCA4,296
chr1,40612335,40612610,SRX5075169,SMARCA4,275
chr1,40612337,40612620,SRX5716470,SMARCA4,283
chr1,40612341,40612606,SRX4174629,CTCF,265
chr1,40612342,40612641,SRX5716463,SMARCA4,299
chr1,40612366,40612580,SRX5075176,SMARCA4,214
chr1,40612391,40612604,SRX5075175,SMARCA4,213
chr1,40612411,40612595,SRX5075170,SMARCA4,184
chr1,40623348,40623624,SRX5075168,SMARCA4,276
chr1,40630548,40630848,SRX16500060,CTCF,300
chr1,40630579,40630882,SRX16500059,CTCF,303
chr1,40630599,40630851,SRX16500062,CTCF,252
chr1,40635324,40635546,SRX5054309,FOSL2,222
chr1,40650013,40650395,SRX16500060,CTCF,382
chr1,40650029,40650409,SRX16500059,CTCF,380
chr1,40650080,40650301,SRX16500061,CTCF,221
chr1,40650085,40650310,SRX16500062,CTCF,225
chr1,40650205,40650391,SRX5075174,SMARCA4,186
chr1,40650270,40650502,SRX5075168,SMARCA4,232
chr1,40665382,40665865,SRX20140895,INTS13,483
chr1,40665472,40665954,SRX5075168,SMARCA4,482
chr1,40665476,40665798,SRX20140868,INTS10,322
chr1,40665489,40665765,SRX20140867,INTS10,276
chr1,40665497,40665709,SRX5716463,SMARCA4,212
chr1,40665509,40665976,SRX5075174,SMARCA4,467
chr1,40665512,40665730,SRX5075170,SMARCA4,218
chr1,40668785,40669317,SRX16500060,CTCF,532
chr1,40668801,40669302,SRX16500062,CTCF,501
chr1,40668836,40669324,SRX16500061,CTCF,488
chr1,40668846,40669204,SRX5075174,SMARCA4,358
chr1,40668858,40669223,SRX5075168,SMARCA4,365
chr1,40668867,40669154,SRX5075176,SMARCA4,287
chr1,40668877,40669121,SRX5075170,SMARCA4,244
chr1,40668883,40669309,SRX16500059,CTCF,426
chr1,40668911,40669126,SRX5075175,SMARCA4,215
chr1,40668947,40669138,SRX5075169,SMARCA4,191
chr1,40676548,40676799,SRX5075170,SMARCA4,251
chr1,40691273,40691744,SRX5075168,SMARCA4,471
chr1,40691313,40691717,SRX5075174,SMARCA4,404
chr1,40691349,40691629,SRX5075176,SMARCA4,280
chr1,40691356,40691811,SRX5075170,SMARCA4,455
chr1,40691431,40691734,SRX5716463,SMARCA4,303
chr1,40691448,40692182,SRX20140879,CPSF3L,734
chr1,40691509,40692331,SRX20140895,INTS13,822
chr1,40691533,40692263,SRX20140897,INTS13,730
chr1,40691545,40692278,SRX20140868,INTS10,733
chr1,40691562,40692191,SRX20140881,CPSF3L,629
chr1,40691582,40692136,SRX20140896,INTS13,554
chr1,40691594,40692262,SRX20140867,INTS10,668
chr1,40691607,40692159,SRX20140869,INTS10,552
chr1,40691632,40692045,SRX20140880,CPSF3L,413
chr1,40691674,40691927,SRX5075169,SMARCA4,253
chr1,40691685,40692097,SRX20140894,INTS13,412
chr1,40691741,40692082,SRX20140870,INTS10,341
chr1,40691768,40692257,SRX5716469,SMARCA4,489
chr1,40691939,40692415,SRX5075168,SMARCA4,476
chr1,40691993,40692321,SRX5075174,SMARCA4,328
chr1,40692005,40692376,SRX5075169,SMARCA4,371
chr1,40692062,40692470,SRX5075175,SMARCA4,408
chr1,40692119,40692469,SRX5716470,SMARCA4,350
chr1,40703392,40703670,SRX5075169,SMARCA4,278
chr1,40703423,40703748,SRX5075176,SMARCA4,325
chr1,40703427,40703744,SRX5054309,FOSL2,317
chr1,40703441,40703704,SRX5054308,FOSL2,263
chr1,40703473,40703699,SRX5075170,SMARCA4,226
chr1,40703474,40703683,SRX5075175,SMARCA4,209
chr1,40703492,40703705,SRX5716469,SMARCA4,213
chr1,40709075,40709319,SRX5075170,SMARCA4,244
chr1,40709115,40709595,SRX20140895,INTS13,480
chr1,40709138,40709369,SRX5716454,SOX3,231
chr1,40709162,40709508,SRX20140868,INTS10,346
chr1,40709171,40709565,SRX5075174,SMARCA4,394
chr1,40709178,40709465,SRX5075168,SMARCA4,287
chr1,40709190,40709583,SRX20140881,CPSF3L,393
chr1,40709248,40709477,SRX5716451,SOX2,229
chr1,40727745,40727947,SRX5054309,FOSL2,202
chr1,40736015,40736537,SRX5075176,SMARCA4,522
chr1,40736116,40736553,SRX5075175,SMARCA4,437
chr1,40736119,40736331,SRX5716470,SMARCA4,212
chr1,40736139,40736407,SRX5075169,SMARCA4,268
chr1,40736303,40736534,SRX5075170,SMARCA4,231
chr1,40746440,40746660,SRX5054308,FOSL2,220
chr1,40774006,40774595,SRX16500059,CTCF,589
chr1,40774106,40774545,SRX16500061,CTCF,439
chr1,40774107,40774568,SRX16500060,CTCF,461
chr1,40774154,40774539,SRX16500062,CTCF,385
chr1,40782605,40782826,SRX16500060,CTCF,221
chr1,40783613,40783782,SRX5075170,SMARCA4,169
chr1,40802133,40802531,SRX20140895,INTS13,398
chr1,40802251,40802607,SRX5075168,SMARCA4,356
chr1,40802252,40802448,SRX5075175,SMARCA4,196
chr1,40802252,40802558,SRX5075170,SMARCA4,306
chr1,40802258,40802486,SRX5075176,SMARCA4,228
chr1,40802283,40802626,SRX5075174,SMARCA4,343
chr1,40802347,40802552,SRX5716464,SMARCA4,205
chr1,40824699,40825060,SRX5075169,SMARCA4,361
chr1,40824727,40825546,SRX5075174,SMARCA4,819
chr1,40824730,40825014,SRX5075175,SMARCA4,284
chr1,40824732,40825049,SRX5054309,FOSL2,317
chr1,40824765,40825520,SRX5075168,SMARCA4,755
chr1,40824811,40825152,SRX5075176,SMARCA4,341
chr1,40824844,40825422,SRX5716463,SMARCA4,578
chr1,40824913,40825354,SRX5716451,SOX2,441
chr1,40824944,40825276,SRX20140867,INTS10,332
chr1,40824951,40825388,SRX20140895,INTS13,437
chr1,40824957,40825459,SRX5716464,SMARCA4,502
chr1,40824977,40825307,SRX5716454,SOX3,330
chr1,40846953,40847421,SRX5716463,SMARCA4,468
chr1,40846965,40847348,SRX5075168,SMARCA4,383
chr1,40846979,40847234,SRX5716454,SOX3,255
chr1,40846996,40847291,SRX5075174,SMARCA4,295
chr1,40848515,40848916,SRX16500059,CTCF,401
chr1,40848524,40848970,SRX16500060,CTCF,446
chr1,40848542,40848877,SRX16500062,CTCF,335
chr1,40848555,40848925,SRX16500061,CTCF,370
chr1,40848706,40848911,SRX5075176,SMARCA4,205
chr1,40849934,40850415,SRX16500060,CTCF,481
chr1,40849951,40850389,SRX16500061,CTCF,438
chr1,40849966,40850429,SRX16500059,CTCF,463
chr1,40849974,40850405,SRX16500062,CTCF,431
chr1,40849975,40850360,SRX4174629,CTCF,385
chr1,40850104,40850284,SRX5075174,SMARCA4,180
chr1,40855519,40855749,SRX16500061,CTCF,230
chr1,40855541,40855889,SRX16500059,CTCF,348
chr1,40855558,40855835,SRX16500060,CTCF,277
chr1,40861901,40862502,SRX20140895,INTS13,601
chr1,40862056,40862437,SRX20140867,INTS10,381
chr1,40862119,40862549,SRX20140868,INTS10,430
chr1,40862130,40862504,SRX20140881,CPSF3L,374
chr1,40862153,40862422,SRX5716470,SMARCA4,269
chr1,40862229,40862693,SRX5075168,SMARCA4,464
chr1,40862229,40862715,SRX5075174,SMARCA4,486
chr1,40862262,40862721,SRX5075176,SMARCA4,459
chr1,40862279,40862534,SRX5716469,SMARCA4,255
chr1,40862291,40862612,SRX5075169,SMARCA4,321
chr1,40862347,40862527,SRX5054307,FOSL2,180
chr1,40862364,40862777,SRX5075170,SMARCA4,413
chr1,40862473,40862850,SRX16500059,CTCF,377
chr1,40862509,40862714,SRX5716463,SMARCA4,205
chr1,40862521,40862833,SRX16500062,CTCF,312
chr1,40862535,40862845,SRX16500060,CTCF,310
chr1,40862538,40862805,SRX16500061,CTCF,267
chr1,40870220,40870403,SRX5054309,FOSL2,183
chr1,40875669,40876137,SRX5054309,FOSL2,468
chr1,40875684,40876197,SRX5075176,SMARCA4,513
chr1,40875685,40876140,SRX5075170,SMARCA4,455
chr1,40875690,40876119,SRX5075175,SMARCA4,429
chr1,40875696,40876167,SRX5075169,SMARCA4,471
chr1,40875697,40876109,SRX5054308,FOSL2,412
chr1,40875697,40876119,SRX5716469,SMARCA4,422
chr1,40875704,40876100,SRX5716470,SMARCA4,396
chr1,40875708,40876117,SRX5020214,SMARCA2,409
chr1,40875725,40876038,SRX5075182,SMARCA2,313
chr1,40875735,40876083,SRX5716467,SMARCA2,348
chr1,40875758,40876105,SRX5020211,SMARCA2,347
chr1,40875799,40876090,SRX5075168,SMARCA4,291
chr1,40875815,40876076,SRX5075174,SMARCA4,261
chr1,40877751,40877970,SRX5075170,SMARCA4,219
chr1,40877787,40878055,SRX5075169,SMARCA4,268
chr1,40901936,40902333,SRX5075169,SMARCA4,397
chr1,40901989,40902294,SRX5075175,SMARCA4,305
chr1,40901993,40902406,SRX5075176,SMARCA4,413
chr1,40902005,40902242,SRX5020211,SMARCA2,237
chr1,40902010,40902353,SRX5716469,SMARCA4,343
chr1,40902027,40902363,SRX5075170,SMARCA4,336
chr1,40902029,40902318,SRX5054308,FOSL2,289
chr1,40902034,40902330,SRX5054309,FOSL2,296
chr1,40902045,40902322,SRX5716467,SMARCA2,277
chr1,40902051,40902262,SRX5716468,SMARCA2,211
chr1,40902077,40902358,SRX5716470,SMARCA4,281
chr1,40936982,40937151,SRX5075170,SMARCA4,169
chr1,40948701,40949163,SRX5075169,SMARCA4,462
chr1,40948833,40949130,SRX5075170,SMARCA4,297
chr1,40948838,40949149,SRX5075175,SMARCA4,311
chr1,40948844,40949117,SRX5054308,FOSL2,273
chr1,40948874,40949152,SRX5054309,FOSL2,278
chr1,40948914,40949257,SRX16500061,CTCF,343
chr1,40948918,40949151,SRX5075176,SMARCA4,233
chr1,40948949,40949265,SRX16500059,CTCF,316
chr1,40948953,40949283,SRX16500060,CTCF,330
chr1,40948964,40949176,SRX5075168,SMARCA4,212
chr1,40948969,40949208,SRX5075174,SMARCA4,239
chr1,40952333,40952877,SRX16500059,CTCF,544
chr1,40952377,40952849,SRX16500062,CTCF,472
chr1,40952435,40952856,SRX16500061,CTCF,421
chr1,40952450,40952902,SRX16500060,CTCF,452
chr1,40952471,40952690,SRX5075176,SMARCA4,219
chr1,40952488,40952686,SRX5075174,SMARCA4,198
chr1,40952503,40952775,SRX4174629,CTCF,272
chr1,40967530,40968292,SRX5075170,SMARCA4,762
chr1,40967666,40968374,SRX5075175,SMARCA4,708
chr1,40967733,40968340,SRX5075169,SMARCA4,607
chr1,40967736,40968243,SRX5054309,FOSL2,507
chr1,40967739,40968327,SRX5075176,SMARCA4,588
chr1,40967798,40968105,SRX5716470,SMARCA4,307
chr1,40967836,40968254,SRX5054308,FOSL2,418
chr1,40967842,40968287,SRX5716469,SMARCA4,445
chr1,40979078,40979525,SRX16500061,CTCF,447
chr1,40979202,40979576,SRX16500060,CTCF,374
chr1,40979203,40979466,SRX16500062,CTCF,263
chr1,40979206,40979546,SRX16500059,CTCF,340
chr1,40979264,40980357,SRX20140895,INTS13,1093
chr1,40979278,40980331,SRX20140868,INTS10,1053
chr1,40979322,40980273,SRX20140867,INTS10,951
chr1,40979331,40979686,SRX5075176,SMARCA4,355
chr1,40979342,40979532,SRX5075168,SMARCA4,190
chr1,40979366,40979577,SRX5075170,SMARCA4,211
chr1,40979386,40979884,SRX5075174,SMARCA4,498
chr1,40979684,40979897,SRX5716463,SMARCA4,213
chr1,40979704,40979909,SRX5075170,SMARCA4,205
chr1,40979803,40980062,SRX20140897,INTS13,259
chr1,40984119,40984324,SRX5075170,SMARCA4,205
chr1,40984151,40984384,SRX5075176,SMARCA4,233
chr1,41003599,41004048,SRX5716469,SMARCA4,449
chr1,41003601,41004061,SRX5075169,SMARCA4,460
chr1,41003623,41004022,SRX5075175,SMARCA4,399
chr1,41003625,41004042,SRX5075176,SMARCA4,417
chr1,41003637,41004104,SRX5075170,SMARCA4,467
chr1,41003640,41004003,SRX5716470,SMARCA4,363
chr1,41003665,41003988,SRX5054309,FOSL2,323
chr1,41003674,41003959,SRX5716467,SMARCA2,285
chr1,41003697,41003959,SRX5054308,FOSL2,262
chr1,41003710,41003943,SRX5716468,SMARCA2,233
chr1,41023330,41023554,SRX16500062,CTCF,224
chr1,41025082,41025325,SRX16500059,CTCF,243
chr1,41073965,41074372,SRX5075176,SMARCA4,407
chr1,41074005,41074360,SRX5075170,SMARCA4,355
chr1,41074012,41074304,SRX5054309,FOSL2,292
chr1,41074070,41074319,SRX5054308,FOSL2,249
chr1,41074077,41074362,SRX5075169,SMARCA4,285
chr1,41074114,41074342,SRX5075175,SMARCA4,228
chr1,41101966,41102531,SRX5716467,SMARCA2,565
chr1,41101987,41102623,SRX5075170,SMARCA4,636
chr1,41102010,41102505,SRX5716470,SMARCA4,495
chr1,41102029,41102601,SRX5075169,SMARCA4,572
chr1,41102047,41102511,SRX5716468,SMARCA2,464
chr1,41102051,41102629,SRX5075176,SMARCA4,578
chr1,41102054,41102499,SRX5716469,SMARCA4,445
chr1,41102078,41102590,SRX5075175,SMARCA4,512
chr1,41102414,41102597,SRX5054309,FOSL2,183
chr1,41109175,41110019,SRX5716470,SMARCA4,844
chr1,41109248,41109931,SRX5075175,SMARCA4,683
chr1,41109248,41109954,SRX5075170,SMARCA4,706
chr1,41109258,41109951,SRX5075176,SMARCA4,693
chr1,41109312,41109592,SRX5020211,SMARCA2,280
chr1,41109315,41109997,SRX5075169,SMARCA4,682
chr1,41109317,41110116,SRX5716469,SMARCA4,799
chr1,41109319,41109731,SRX5716459,Epitope tags,412
chr1,41109335,41109631,SRX5716468,SMARCA2,296
chr1,41109341,41109642,SRX5716467,SMARCA2,301
chr1,41109345,41110014,SRX5054309,FOSL2,669
chr1,41109359,41109935,SRX5054308,FOSL2,576
chr1,41109404,41109586,SRX5075182,SMARCA2,182
chr1,41109426,41109676,SRX5075181,SMARCA2,250
chr1,41109516,41110122,SRX5716460,Epitope tags,606
chr1,41117208,41117571,SRX16500059,CTCF,363
chr1,41117209,41117542,SRX16500061,CTCF,333
chr1,41117216,41117489,SRX16500060,CTCF,273
chr1,41122986,41123493,SRX16500059,CTCF,507
chr1,41123105,41123497,SRX16500062,CTCF,392
chr1,41123109,41123511,SRX16500060,CTCF,402
chr1,41123133,41123562,SRX5075170,SMARCA4,429
chr1,41123148,41123428,SRX16500061,CTCF,280
chr1,41123185,41123626,SRX5075176,SMARCA4,441
chr1,41123198,41123566,SRX5075168,SMARCA4,368
chr1,41123209,41123506,SRX5075174,SMARCA4,297
chr1,41123220,41123526,SRX5054308,FOSL2,306
chr1,41123227,41123610,SRX5075175,SMARCA4,383
chr1,41123237,41123628,SRX5054309,FOSL2,391
chr1,41123255,41123487,SRX5716469,SMARCA4,232
chr1,41123277,41123588,SRX5075169,SMARCA4,311
chr1,41152566,41153045,SRX5075169,SMARCA4,479
chr1,41152578,41152996,SRX5716470,SMARCA4,418
chr1,41152610,41153001,SRX5054309,FOSL2,391
chr1,41152613,41153060,SRX5075170,SMARCA4,447
chr1,41152628,41153048,SRX5075176,SMARCA4,420
chr1,41152631,41152973,SRX5054308,FOSL2,342
chr1,41152646,41153102,SRX5075175,SMARCA4,456
chr1,41152718,41152962,SRX5716467,SMARCA2,244
chr1,41238476,41238726,SRX5054308,FOSL2,250
chr1,41238485,41238749,SRX5054309,FOSL2,264
chr1,41241733,41242626,SRX20140895,INTS13,893
chr1,41242220,41242515,SRX20140867,INTS10,295
chr1,41242249,41242597,SRX20140868,INTS10,348
chr1,41242263,41242487,SRX5075174,SMARCA4,224
chr1,41256077,41256306,SRX5054308,FOSL2,229
chr1,41256107,41256326,SRX5054309,FOSL2,219
chr1,41256127,41256316,SRX5075169,SMARCA4,189
chr1,41256134,41256321,SRX5075175,SMARCA4,187
chr1,41263128,41263307,SRX5075168,SMARCA4,179
chr1,41265104,41265149,SRX1424893,POU3F2,45
chr1,41268094,41268599,SRX16500059,CTCF,505
chr1,41268127,41268610,SRX16500060,CTCF,483
chr1,41268128,41268617,SRX16500061,CTCF,489
chr1,41268149,41268631,SRX16500062,CTCF,482
chr1,41268190,41268558,SRX4174629,CTCF,368
chr1,41268191,41268542,SRX5075168,SMARCA4,351
chr1,41268205,41268509,SRX5075174,SMARCA4,304
chr1,41268225,41268500,SRX5716469,SMARCA4,275
chr1,41268249,41268445,SRX5075169,SMARCA4,196
chr1,41268251,41268495,SRX5716470,SMARCA4,244
chr1,41268262,41268526,SRX5075176,SMARCA4,264
chr1,41268266,41268521,SRX5075170,SMARCA4,255
chr1,41268266,41268531,SRX5075175,SMARCA4,265
chr1,41282589,41283162,SRX16500059,CTCF,573
chr1,41282590,41283182,SRX16500060,CTCF,592
chr1,41282651,41283153,SRX16500061,CTCF,502
chr1,41282735,41283130,SRX16500062,CTCF,395
chr1,41282760,41283012,SRX5075168,SMARCA4,252
chr1,41282779,41282983,SRX5075174,SMARCA4,204
chr1,41282807,41283012,SRX5075170,SMARCA4,205
chr1,41282821,41283016,SRX5075169,SMARCA4,195
chr1,41282863,41283081,SRX5716470,SMARCA4,218
chr1,41286597,41286808,SRX5075174,SMARCA4,211
chr1,41313591,41314055,SRX16500059,CTCF,464
chr1,41313631,41314080,SRX16500060,CTCF,449
chr1,41313663,41314017,SRX16500061,CTCF,354
chr1,41313670,41314039,SRX16500062,CTCF,369
chr1,41319435,41319692,SRX5075176,SMARCA4,257
chr1,41319466,41319729,SRX5075170,SMARCA4,263
chr1,41322866,41323247,SRX16500059,CTCF,381
chr1,41322900,41323188,SRX16500062,CTCF,288
chr1,41322935,41323256,SRX16500061,CTCF,321
chr1,41322944,41323270,SRX16500060,CTCF,326
chr1,41331281,41331627,SRX16500060,CTCF,346
chr1,41331293,41331572,SRX16500059,CTCF,279
chr1,41331338,41331557,SRX16500061,CTCF,219
chr1,41342146,41342343,SRX5075176,SMARCA4,197
chr1,41360834,41361569,SRX5075174,SMARCA4,735
chr1,41360888,41361567,SRX5075168,SMARCA4,679
chr1,41360941,41361278,SRX5716451,SOX2,337
chr1,41360947,41361400,SRX5075170,SMARCA4,453
chr1,41360959,41361225,SRX5716453,SOX2,266
chr1,41360966,41361425,SRX5075176,SMARCA4,459
chr1,41360972,41361337,SRX5716454,SOX3,365
chr1,41361003,41361419,SRX5054307,FOSL2,416
chr1,41361015,41361291,SRX5054308,FOSL2,276
chr1,41361017,41361419,SRX5716464,SMARCA4,402
chr1,41361021,41361374,SRX5716463,SMARCA4,353
chr1,41361024,41361479,SRX16500060,CTCF,455
chr1,41361035,41361437,SRX16500061,CTCF,402
chr1,41361037,41361479,SRX16500059,CTCF,442
chr1,41361062,41361272,SRX5054309,FOSL2,210
chr1,41361066,41361427,SRX16500062,CTCF,361
chr1,41361137,41361413,SRX5716470,SMARCA4,276
chr1,41361158,41361725,SRX20140895,INTS13,567
chr1,41361309,41361558,SRX20140867,INTS10,249
chr1,41371830,41372611,SRX5075170,SMARCA4,781
chr1,41371839,41372601,SRX5075176,SMARCA4,762
chr1,41372248,41372540,SRX5075175,SMARCA4,292
chr1,41372334,41372586,SRX5075169,SMARCA4,252
chr1,41381949,41382122,SRX5075174,SMARCA4,173
chr1,41387698,41388101,SRX5075170,SMARCA4,403
chr1,41387724,41388118,SRX5075176,SMARCA4,394
chr1,41387729,41388105,SRX5716469,SMARCA4,376
chr1,41387739,41388116,SRX5716470,SMARCA4,377
chr1,41387740,41388084,SRX5075169,SMARCA4,344
chr1,41387754,41388090,SRX5075175,SMARCA4,336
chr1,41387770,41388027,SRX5075181,SMARCA2,257
chr1,41387790,41388093,SRX5716467,SMARCA2,303
chr1,41387792,41388088,SRX5716468,SMARCA2,296
chr1,41395327,41395558,SRX5075174,SMARCA4,231
chr1,41404301,41404552,SRX5075168,SMARCA4,251
chr1,41404346,41404686,SRX5075174,SMARCA4,340
chr1,41404424,41404664,SRX5075170,SMARCA4,240
chr1,41404561,41404756,SRX5075169,SMARCA4,195
chr1,41417006,41417569,SRX16500060,CTCF,563
chr1,41417028,41417494,SRX16500061,CTCF,466
chr1,41417030,41417538,SRX16500059,CTCF,508
chr1,41417039,41417498,SRX16500062,CTCF,459
chr1,41417078,41417407,SRX5075168,SMARCA4,329
chr1,41417079,41417345,SRX5054309,FOSL2,266
chr1,41417090,41417347,SRX5075175,SMARCA4,257
chr1,41417100,41417473,SRX4174629,CTCF,373
chr1,41417106,41417336,SRX5075169,SMARCA4,230
chr1,41417115,41417421,SRX5075174,SMARCA4,306
chr1,41417121,41417372,SRX5075176,SMARCA4,251
chr1,41417143,41417342,SRX5075170,SMARCA4,199
chr1,41418896,41419134,SRX5716470,SMARCA4,238
chr1,41418919,41419188,SRX5075175,SMARCA4,269
chr1,41418935,41419228,SRX5075169,SMARCA4,293
chr1,41418942,41419143,SRX5075176,SMARCA4,201
chr1,41432653,41433138,SRX16500059,CTCF,485
chr1,41432669,41433120,SRX16500060,CTCF,451
chr1,41432700,41433110,SRX16500062,CTCF,410
chr1,41432705,41433158,SRX16500061,CTCF,453
chr1,41432716,41433210,SRX5075176,SMARCA4,494
chr1,41432755,41433199,SRX5054309,FOSL2,444
chr1,41432787,41433281,SRX5075170,SMARCA4,494
chr1,41432829,41433317,SRX5075175,SMARCA4,488
chr1,41433007,41433284,SRX5075169,SMARCA4,277
chr1,41435581,41436020,SRX5075174,SMARCA4,439
chr1,41435612,41436002,SRX5075168,SMARCA4,390
chr1,41440814,41441014,SRX5075176,SMARCA4,200
chr1,41444281,41444502,SRX16500060,CTCF,221
chr1,41444338,41444583,SRX16500061,CTCF,245
chr1,41444411,41444658,SRX16500059,CTCF,247
chr1,41454354,41454805,SRX5075170,SMARCA4,451
chr1,41454376,41454773,SRX5075176,SMARCA4,397
chr1,41454398,41454726,SRX5075175,SMARCA4,328
chr1,41454422,41454719,SRX5716469,SMARCA4,297
chr1,41454435,41454711,SRX5716470,SMARCA4,276
chr1,41454469,41454744,SRX5075169,SMARCA4,275
chr1,41474626,41474925,SRX5075176,SMARCA4,299
chr1,41474738,41475019,SRX5716470,SMARCA4,281
chr1,41474746,41474919,SRX5075174,SMARCA4,173
chr1,41477261,41477430,SRX5075170,SMARCA4,169
chr1,41486322,41487104,SRX5075174,SMARCA4,782
chr1,41486354,41486639,SRX5075175,SMARCA4,285
chr1,41486361,41486635,SRX5054309,FOSL2,274
chr1,41486366,41486653,SRX5075170,SMARCA4,287
chr1,41486370,41486772,SRX5075168,SMARCA4,402
chr1,41486379,41486595,SRX5075176,SMARCA4,216
chr1,41486396,41486624,SRX5716469,SMARCA4,228
chr1,41486462,41487106,SRX20140895,INTS13,644
chr1,41486466,41486712,SRX5075169,SMARCA4,246
chr1,41486610,41486959,SRX20140868,INTS10,349
chr1,41486933,41487112,SRX5075168,SMARCA4,179
chr1,41492282,41492564,SRX16500059,CTCF,282
chr1,41492346,41492574,SRX16500061,CTCF,228
chr1,41492366,41492605,SRX16500060,CTCF,239
chr1,41492373,41492583,SRX16500062,CTCF,210
chr1,41493123,41493396,SRX5054309,FOSL2,273
chr1,41493169,41493348,SRX5075170,SMARCA4,179
chr1,41493179,41493395,SRX5716469,SMARCA4,216
chr1,41496034,41496723,SRX20140895,INTS13,689
chr1,41496057,41496652,SRX5075174,SMARCA4,595
chr1,41496058,41496838,SRX20140868,INTS10,780
chr1,41496090,41496647,SRX20140867,INTS10,557
chr1,41496097,41496666,SRX5075168,SMARCA4,569
chr1,41496119,41496630,SRX5716463,SMARCA4,511
chr1,41496123,41496626,SRX5075169,SMARCA4,503
chr1,41496128,41496635,SRX5075176,SMARCA4,507
chr1,41496154,41496627,SRX5075170,SMARCA4,473
chr1,41496155,41496666,SRX5716470,SMARCA4,511
chr1,41496156,41496594,SRX5075175,SMARCA4,438
chr1,41496178,41496579,SRX5075181,SMARCA2,401
chr1,41496186,41496564,SRX5054307,FOSL2,378
chr1,41496202,41496589,SRX5716469,SMARCA4,387
chr1,41496206,41496670,SRX20140897,INTS13,464
chr1,41496208,41496575,SRX5716468,SMARCA2,367
chr1,41496211,41496579,SRX5054309,FOSL2,368
chr1,41496219,41496580,SRX5054308,FOSL2,361
chr1,41496221,41496477,SRX5020211,SMARCA2,256
chr1,41496221,41496480,SRX5716464,SMARCA4,259
chr1,41496222,41496610,SRX5716467,SMARCA2,388
chr1,41496226,41496497,SRX5716454,SOX3,271
chr1,41496265,41496784,SRX20140869,INTS10,519
chr1,41496298,41496577,SRX5020214,SMARCA2,279
chr1,41496369,41496627,SRX20140879,CPSF3L,258
chr1,41503902,41504385,SRX5075170,SMARCA4,483
chr1,41503950,41504420,SRX5075176,SMARCA4,470
chr1,41504057,41504343,SRX5716469,SMARCA4,286
chr1,41504066,41504288,SRX5075169,SMARCA4,222
chr1,41504073,41504372,SRX5075175,SMARCA4,299
chr1,41515981,41516395,SRX20140895,INTS13,414
chr1,41515991,41516442,SRX5075170,SMARCA4,451
chr1,41515996,41516495,SRX5075174,SMARCA4,499
chr1,41515998,41516461,SRX5075169,SMARCA4,463
chr1,41516007,41516448,SRX5075176,SMARCA4,441
chr1,41516016,41516464,SRX5075168,SMARCA4,448
chr1,41516027,41516552,SRX16500060,CTCF,525
chr1,41516032,41516323,SRX5716467,SMARCA2,291
chr1,41516043,41516515,SRX16500061,CTCF,472
chr1,41516044,41516566,SRX16500059,CTCF,522
chr1,41516047,41516422,SRX5075175,SMARCA4,375
chr1,41516062,41516503,SRX16500062,CTCF,441
chr1,41516076,41516454,SRX5716470,SMARCA4,378
chr1,41516079,41516528,SRX4174629,CTCF,449
chr1,41516090,41516434,SRX5716469,SMARCA4,344
chr1,41516101,41516435,SRX5716463,SMARCA4,334
chr1,41516103,41516447,SRX5716464,SMARCA4,344
chr1,41516116,41516341,SRX5716468,SMARCA2,225
chr1,41516119,41516437,SRX5020211,SMARCA2,318
chr1,41516134,41516322,SRX5054308,FOSL2,188
chr1,41537815,41538146,SRX5075170,SMARCA4,331
chr1,41537857,41538194,SRX5075176,SMARCA4,337
chr1,41537862,41538083,SRX5075175,SMARCA4,221
chr1,41537875,41538158,SRX5054309,FOSL2,283
chr1,41537922,41538168,SRX5075169,SMARCA4,246
chr1,41537975,41538155,SRX5054308,FOSL2,180
chr1,41574029,41574504,SRX16500060,CTCF,475
chr1,41574052,41574540,SRX16500059,CTCF,488
chr1,41574069,41574490,SRX16500062,CTCF,421
chr1,41574071,41574442,SRX4174629,CTCF,371
chr1,41574076,41574481,SRX16500061,CTCF,405
chr1,41574187,41574394,SRX5075175,SMARCA4,207
chr1,41574193,41574431,SRX5075168,SMARCA4,238
chr1,41574194,41574554,SRX5075170,SMARCA4,360
chr1,41574204,41574409,SRX5075174,SMARCA4,205
chr1,41574211,41574391,SRX5075176,SMARCA4,180
chr1,41574219,41574475,SRX5075169,SMARCA4,256
chr1,41579019,41579300,SRX16500059,CTCF,281
chr1,41579032,41579343,SRX16500062,CTCF,311
chr1,41579040,41579314,SRX16500060,CTCF,274
chr1,41579061,41579336,SRX16500061,CTCF,275
chr1,41599933,41600149,SRX5716470,SMARCA4,216
chr1,41599963,41600200,SRX5075174,SMARCA4,237
chr1,41599978,41600211,SRX5075170,SMARCA4,233
chr1,41599993,41600262,SRX16500059,CTCF,269
chr1,41600005,41600230,SRX16500060,CTCF,225
chr1,41600012,41600222,SRX5075175,SMARCA4,210
chr1,41600016,41600191,SRX5075176,SMARCA4,175
chr1,41600017,41600237,SRX5075169,SMARCA4,220
chr1,41600027,41600206,SRX5075168,SMARCA4,179
chr1,41600069,41600288,SRX16500061,CTCF,219
chr1,41608301,41608594,SRX5075175,SMARCA4,293
chr1,41608325,41608602,SRX5716467,SMARCA2,277
chr1,41608326,41608584,SRX5716470,SMARCA4,258
chr1,41608334,41608575,SRX5075176,SMARCA4,241
chr1,41608337,41608669,SRX5075170,SMARCA4,332
chr1,41608375,41608664,SRX5716468,SMARCA2,289
chr1,41608465,41608667,SRX5075169,SMARCA4,202
chr1,41619908,41620119,SRX5054309,FOSL2,211
chr1,41619934,41620165,SRX5075170,SMARCA4,231
chr1,41626157,41626671,SRX5075170,SMARCA4,514
chr1,41626179,41626490,SRX5075176,SMARCA4,311
chr1,41626297,41626513,SRX5075169,SMARCA4,216
chr1,41629654,41629921,SRX5075175,SMARCA4,267
chr1,41629680,41629935,SRX5075169,SMARCA4,255
chr1,41629786,41630001,SRX5716470,SMARCA4,215
chr1,41649639,41649808,SRX5075170,SMARCA4,169
chr1,41662415,41662688,SRX5075174,SMARCA4,273
chr1,41662415,41662984,SRX20140895,INTS13,569
chr1,41662496,41662748,SRX5075168,SMARCA4,252
chr1,41665327,41665623,SRX5054308,FOSL2,296
chr1,41665333,41665639,SRX5054309,FOSL2,306
chr1,41668172,41668402,SRX5075174,SMARCA4,230
chr1,41670561,41670747,SRX5054309,FOSL2,186
chr1,41672647,41673362,SRX5075170,SMARCA4,715
chr1,41672667,41673293,SRX5075175,SMARCA4,626
chr1,41672712,41673280,SRX5075176,SMARCA4,568
chr1,41672806,41673297,SRX5054309,FOSL2,491
chr1,41672856,41673266,SRX5716469,SMARCA4,410
chr1,41672858,41673226,SRX5054308,FOSL2,368
chr1,41672885,41673212,SRX5716470,SMARCA4,327
chr1,41672975,41673190,SRX5716467,SMARCA2,215
chr1,41673025,41673305,SRX5075169,SMARCA4,280
chr1,41678437,41678624,SRX5075175,SMARCA4,187
chr1,41713669,41714270,SRX5075169,SMARCA4,601
chr1,41713702,41714222,SRX5075175,SMARCA4,520
chr1,41713729,41714250,SRX5054309,FOSL2,521
chr1,41713796,41714252,SRX5075176,SMARCA4,456
chr1,41713869,41714284,SRX5075170,SMARCA4,415
chr1,41713900,41714115,SRX5716467,SMARCA2,215
chr1,41713952,41714239,SRX5716469,SMARCA4,287
chr1,41713956,41714230,SRX5716470,SMARCA4,274
chr1,41713979,41714212,SRX5075168,SMARCA4,233
chr1,41714009,41714212,SRX5075174,SMARCA4,203
chr1,41714010,41714271,SRX5020214,SMARCA2,261
chr1,41735548,41735984,SRX5075174,SMARCA4,436
chr1,41735580,41735981,SRX5075168,SMARCA4,401
chr1,41742250,41742564,SRX5075170,SMARCA4,314
chr1,41742259,41742557,SRX5075175,SMARCA4,298
chr1,41742264,41742543,SRX5716469,SMARCA4,279
chr1,41742266,41742541,SRX5075176,SMARCA4,275
chr1,41742266,41742566,SRX5075169,SMARCA4,300
chr1,41742280,41742491,SRX5716470,SMARCA4,211
chr1,41742285,41742541,SRX5054308,FOSL2,256
chr1,41752150,41752337,SRX5075175,SMARCA4,187
chr1,41758910,41759237,SRX5054309,FOSL2,327
chr1,41758962,41759203,SRX5075169,SMARCA4,241
chr1,41771417,41771701,SRX5075170,SMARCA4,284
chr1,41771443,41771682,SRX5075175,SMARCA4,239
chr1,41783139,41783512,SRX5075174,SMARCA4,373
chr1,41783151,41783651,SRX5075169,SMARCA4,500
chr1,41783170,41783537,SRX5716469,SMARCA4,367
chr1,41783173,41783489,SRX5054309,FOSL2,316
chr1,41783183,41783591,SRX5075175,SMARCA4,408
chr1,41783193,41783519,SRX5716470,SMARCA4,326
chr1,41783201,41783565,SRX5075176,SMARCA4,364
chr1,41783203,41783689,SRX5075168,SMARCA4,486
chr1,41783231,41783593,SRX5075170,SMARCA4,362
chr1,41783254,41783507,SRX5054308,FOSL2,253
chr1,41795460,41795655,SRX5054309,FOSL2,195
chr1,41810509,41810788,SRX5075176,SMARCA4,279
chr1,41810519,41810769,SRX5075170,SMARCA4,250
chr1,41810528,41810742,SRX5075175,SMARCA4,214
chr1,41810554,41810777,SRX5716470,SMARCA4,223
chr1,41810557,41810749,SRX5075169,SMARCA4,192
chr1,41811823,41812417,SRX16500059,CTCF,594
chr1,41811874,41812400,SRX16500060,CTCF,526
chr1,41811931,41812388,SRX16500062,CTCF,457
chr1,41811958,41812356,SRX16500061,CTCF,398
chr1,41812057,41812750,SRX5075174,SMARCA4,693
chr1,41812065,41812867,SRX5075168,SMARCA4,802
chr1,41812069,41812257,SRX5075176,SMARCA4,188
chr1,41812143,41812312,SRX5075170,SMARCA4,169
chr1,41812158,41812726,SRX5075169,SMARCA4,568
chr1,41812383,41812692,SRX5716470,SMARCA4,309
chr1,41812405,41812752,SRX5075176,SMARCA4,347
chr1,41812428,41812731,SRX5054309,FOSL2,303
chr1,41812437,41812727,SRX5075175,SMARCA4,290
chr1,41812441,41812732,SRX5054308,FOSL2,291
chr1,41812473,41812685,SRX5716469,SMARCA4,212
chr1,41812474,41812800,SRX5075170,SMARCA4,326
chr1,41812489,41812695,SRX5054307,FOSL2,206
chr1,41812489,41812728,SRX5716467,SMARCA2,239
chr1,41823472,41824108,SRX5075174,SMARCA4,636
chr1,41823485,41824013,SRX5075168,SMARCA4,528
chr1,41823562,41823804,SRX5716464,SMARCA4,242
chr1,41823571,41823900,SRX5716463,SMARCA4,329
chr1,41823613,41823899,SRX20140867,INTS10,286
chr1,41828291,41828542,SRX5054308,FOSL2,251
chr1,41843404,41843668,SRX5075169,SMARCA4,264
chr1,41843406,41843746,SRX5075176,SMARCA4,340
chr1,41843407,41843622,SRX5075174,SMARCA4,215
chr1,41843407,41843661,SRX5075175,SMARCA4,254
chr1,41843418,41843663,SRX5716470,SMARCA4,245
chr1,41843426,41843734,SRX5075170,SMARCA4,308
chr1,41843486,41843744,SRX5054308,FOSL2,258
chr1,41843506,41843747,SRX5054309,FOSL2,241
chr1,41846599,41846808,SRX5075169,SMARCA4,209
chr1,41846646,41846821,SRX5075176,SMARCA4,175
chr1,41851710,41851898,SRX5075170,SMARCA4,188
chr1,41856829,41857344,SRX5716469,SMARCA4,515
chr1,41856846,41857160,SRX5075170,SMARCA4,314
chr1,41856879,41857133,SRX5716470,SMARCA4,254
chr1,41856880,41857224,SRX5075176,SMARCA4,344
chr1,41856906,41857172,SRX5075175,SMARCA4,266
chr1,41856932,41857196,SRX5716468,SMARCA2,264
chr1,41862293,41862720,SRX5075175,SMARCA4,427
chr1,41862350,41862593,SRX5054309,FOSL2,243
chr1,41862363,41862619,SRX5075169,SMARCA4,256
chr1,41862412,41862592,SRX5075170,SMARCA4,180
chr1,41862438,41862660,SRX5075176,SMARCA4,222
chr1,41862918,41863321,SRX5075174,SMARCA4,403
chr1,41863118,41863328,SRX5075168,SMARCA4,210
chr1,41870103,41870460,SRX5054308,FOSL2,357
chr1,41870109,41870500,SRX5075170,SMARCA4,391
chr1,41870111,41870605,SRX5075174,SMARCA4,494
chr1,41870113,41870480,SRX5075169,SMARCA4,367
chr1,41870117,41870501,SRX5075176,SMARCA4,384
chr1,41870124,41870472,SRX5054309,FOSL2,348
chr1,41870158,41870427,SRX5716469,SMARCA4,269
chr1,41870173,41870501,SRX5075175,SMARCA4,328
chr1,41870183,41870545,SRX5075168,SMARCA4,362
chr1,41877191,41877370,SRX5075168,SMARCA4,179
chr1,41887845,41888025,SRX5054308,FOSL2,180
chr1,41900623,41900877,SRX5075176,SMARCA4,254
chr1,41900624,41900939,SRX5054309,FOSL2,315
chr1,41900653,41900865,SRX5075169,SMARCA4,212
chr1,41900657,41900896,SRX5075170,SMARCA4,239
chr1,41900675,41900885,SRX5054308,FOSL2,210
chr1,41900686,41900936,SRX5716469,SMARCA4,250
chr1,41902106,41902375,SRX5716470,SMARCA4,269
chr1,41902126,41902520,SRX5075169,SMARCA4,394
chr1,41902140,41902457,SRX5054308,FOSL2,317
chr1,41902160,41902372,SRX5716469,SMARCA4,212
chr1,41902173,41902477,SRX5054309,FOSL2,304
chr1,41902208,41902541,SRX5075175,SMARCA4,333
chr1,41902242,41902564,SRX5075174,SMARCA4,322
chr1,41917931,41918108,SRX5075174,SMARCA4,177
chr1,41918731,41919014,SRX16500062,CTCF,283
chr1,41918734,41919077,SRX16500059,CTCF,343
chr1,41919997,41920312,SRX5075168,SMARCA4,315
chr1,41920740,41921004,SRX5054309,FOSL2,264
chr1,41920758,41921074,SRX5054308,FOSL2,316
chr1,41935199,41935560,SRX5075174,SMARCA4,361
chr1,41935251,41935431,SRX5054308,FOSL2,180
chr1,41935256,41935520,SRX5075168,SMARCA4,264
chr1,41936011,41936491,SRX5075174,SMARCA4,480
chr1,41936089,41936419,SRX5075168,SMARCA4,330
chr1,41936110,41936468,SRX5054309,FOSL2,358
chr1,41936132,41936346,SRX5716469,SMARCA4,214
chr1,41936140,41936383,SRX5054308,FOSL2,243
chr1,41936150,41936478,SRX5075170,SMARCA4,328
chr1,41936161,41936419,SRX5075176,SMARCA4,258
chr1,41936189,41936450,SRX5075169,SMARCA4,261
chr1,41936238,41936491,SRX5075175,SMARCA4,253
chr1,41939311,41939480,SRX5075170,SMARCA4,169
chr1,41954513,41955003,SRX5075168,SMARCA4,490
chr1,41954591,41954991,SRX5075174,SMARCA4,400
chr1,41954657,41955036,SRX5075170,SMARCA4,379
chr1,41954703,41954963,SRX5075169,SMARCA4,260
chr1,41954731,41955004,SRX5054309,FOSL2,273
chr1,41954746,41955033,SRX5054308,FOSL2,287
chr1,41954763,41955017,SRX5075175,SMARCA4,254
chr1,41954764,41954989,SRX5020211,SMARCA2,225
chr1,41954767,41955000,SRX5075176,SMARCA4,233
chr1,41954773,41954985,SRX5716469,SMARCA4,212
chr1,41955371,41956100,SRX5716470,SMARCA4,729
chr1,41955390,41956110,SRX5716469,SMARCA4,720
chr1,41955392,41956039,SRX5075174,SMARCA4,647
chr1,41955411,41956107,SRX5075176,SMARCA4,696
chr1,41955412,41956170,SRX5075169,SMARCA4,758
chr1,41955440,41956152,SRX5075170,SMARCA4,712
chr1,41955448,41956223,SRX5075175,SMARCA4,775
chr1,41955468,41956046,SRX5716467,SMARCA2,578
chr1,41955479,41956078,SRX5054309,FOSL2,599
chr1,41955482,41955942,SRX5020214,SMARCA2,460
chr1,41955482,41956112,SRX5054308,FOSL2,630
chr1,41955492,41955907,SRX5716468,SMARCA2,415
chr1,41955510,41956066,SRX5075168,SMARCA4,556
chr1,41955642,41956102,SRX5020211,SMARCA2,460
chr1,41955672,41955982,SRX5075181,SMARCA2,310
chr1,41955674,41955873,SRX5075182,SMARCA2,199
chr1,42035446,42035816,SRX5075176,SMARCA4,370
chr1,42035449,42035715,SRX16500062,CTCF,266
chr1,42035466,42035829,SRX16500059,CTCF,363
chr1,42035475,42035832,SRX16500060,CTCF,357
chr1,42035483,42035886,SRX5075169,SMARCA4,403
chr1,42035511,42035857,SRX5075168,SMARCA4,346
chr1,42035609,42036329,SRX5075174,SMARCA4,720
chr1,42035661,42035861,SRX5075170,SMARCA4,200
chr1,42035667,42035975,SRX5075175,SMARCA4,308
chr1,42035732,42036181,SRX5716464,SMARCA4,449
chr1,42035879,42036282,SRX5075176,SMARCA4,403
chr1,42035921,42036235,SRX20140895,INTS13,314
chr1,42035941,42036292,SRX5075170,SMARCA4,351
chr1,42035942,42036197,SRX5054307,FOSL2,255
chr1,42035947,42036301,SRX5075168,SMARCA4,354
chr1,42146820,42147263,SRX16500059,CTCF,443
chr1,42146844,42147320,SRX16500061,CTCF,476
chr1,42146875,42147295,SRX16500060,CTCF,420
chr1,42146918,42147280,SRX16500062,CTCF,362
chr1,42146973,42147160,SRX5075174,SMARCA4,187
chr1,42165799,42166038,SRX5075170,SMARCA4,239
chr1,42165827,42166007,SRX5075169,SMARCA4,180
chr1,42173231,42173730,SRX16500061,CTCF,499
chr1,42173271,42173731,SRX16500062,CTCF,460
chr1,42173279,42173749,SRX16500059,CTCF,470
chr1,42173284,42173740,SRX16500060,CTCF,456
chr1,42173393,42173716,SRX5075174,SMARCA4,323
chr1,42173418,42173719,SRX5716463,SMARCA4,301
chr1,42173419,42173713,SRX5075168,SMARCA4,294
chr1,42173443,42173665,SRX4174629,CTCF,222
chr1,42176888,42177304,SRX16500060,CTCF,416
chr1,42176902,42177338,SRX16500059,CTCF,436
chr1,42176914,42177310,SRX16500062,CTCF,396
chr1,42176918,42177317,SRX16500061,CTCF,399
chr1,42177577,42177913,SRX5075176,SMARCA4,336
chr1,42177623,42177911,SRX5075170,SMARCA4,288
chr1,42177670,42177865,SRX5075169,SMARCA4,195
chr1,42177682,42177881,SRX5054309,FOSL2,199
chr1,42186068,42186580,SRX5075170,SMARCA4,512
chr1,42186106,42186527,SRX5075175,SMARCA4,421
chr1,42186113,42186596,SRX5075176,SMARCA4,483
chr1,42186141,42186471,SRX5716470,SMARCA4,330
chr1,42186144,42186710,SRX5075168,SMARCA4,566
chr1,42186154,42186444,SRX5716467,SMARCA2,290
chr1,42186158,42186536,SRX5075169,SMARCA4,378
chr1,42186162,42186494,SRX5716469,SMARCA4,332
chr1,42186171,42186611,SRX5075174,SMARCA4,440
chr1,42186184,42186513,SRX5054309,FOSL2,329
chr1,42186242,42186509,SRX5054308,FOSL2,267
chr1,42314457,42314856,SRX16500059,CTCF,399
chr1,42314541,42314772,SRX16500060,CTCF,231
chr1,42314571,42314783,SRX5075168,SMARCA4,212
chr1,42314571,42314805,SRX16500061,CTCF,234
chr1,42334311,42335587,SRX20140895,INTS13,1276
chr1,42334969,42335502,SRX20140897,INTS13,533
chr1,42335022,42335558,SRX20140867,INTS10,536
chr1,42335102,42335458,SRX5075176,SMARCA4,356
chr1,42335113,42335489,SRX20140869,INTS10,376
chr1,42335133,42335575,SRX20140881,CPSF3L,442
chr1,42335144,42335451,SRX20140879,CPSF3L,307
chr1,42335165,42335551,SRX20140868,INTS10,386
chr1,42335168,42335498,SRX5075168,SMARCA4,330
chr1,42335212,42335502,SRX5075170,SMARCA4,290
chr1,42335230,42335555,SRX5075174,SMARCA4,325
chr1,42335328,42335566,SRX5075169,SMARCA4,238
chr1,42344178,42344638,SRX16500060,CTCF,460
chr1,42344216,42344619,SRX16500059,CTCF,403
chr1,42344299,42344582,SRX16500061,CTCF,283
chr1,42344311,42344613,SRX16500062,CTCF,302
chr1,42344358,42344537,SRX5075174,SMARCA4,179
chr1,42379811,42380129,SRX5054309,FOSL2,318
chr1,42379852,42380137,SRX5054308,FOSL2,285
chr1,42379883,42380052,SRX5075170,SMARCA4,169
chr1,42380480,42380851,SRX5075168,SMARCA4,371
chr1,42380944,42381173,SRX5075168,SMARCA4,229
chr1,42420877,42421453,SRX5075176,SMARCA4,576
chr1,42420879,42421240,SRX5075169,SMARCA4,361
chr1,42420902,42421305,SRX5075175,SMARCA4,403
chr1,42420934,42421274,SRX5716470,SMARCA4,340
chr1,42420943,42421255,SRX5716467,SMARCA2,312
chr1,42420944,42421373,SRX5075170,SMARCA4,429
chr1,42420966,42421367,SRX5716468,SMARCA2,401
chr1,42421062,42421266,SRX5020211,SMARCA2,204
chr1,42422793,42422981,SRX5075170,SMARCA4,188
chr1,42439951,42440231,SRX5054309,FOSL2,280
chr1,42439968,42440199,SRX5054308,FOSL2,231
chr1,42440004,42440244,SRX5075169,SMARCA4,240
chr1,42455810,42456858,SRX20140895,INTS13,1048
chr1,42455928,42456172,SRX20140897,INTS13,244
chr1,42456277,42456820,SRX5075175,SMARCA4,543
chr1,42456335,42456661,SRX5075176,SMARCA4,326
chr1,42456375,42456674,SRX5716470,SMARCA4,299
chr1,42456483,42456717,SRX5075174,SMARCA4,234
chr1,42456490,42456860,SRX5075170,SMARCA4,370
chr1,42456554,42456765,SRX5075169,SMARCA4,211
chr1,42456560,42456774,SRX20140867,INTS10,214
chr1,42462772,42463449,SRX5075176,SMARCA4,677
chr1,42462799,42463507,SRX5075174,SMARCA4,708
chr1,42462799,42463514,SRX5075168,SMARCA4,715
chr1,42462814,42463025,SRX5716470,SMARCA4,211
chr1,42462864,42463442,SRX20140895,INTS13,578
chr1,42462881,42463453,SRX5075170,SMARCA4,572
chr1,42462929,42463198,SRX5716463,SMARCA4,269
chr1,42463006,42463348,SRX5716451,SOX2,342
chr1,42463027,42463232,SRX5716454,SOX3,205
chr1,42463033,42463274,SRX5054307,FOSL2,241
chr1,42463107,42463495,SRX5716469,SMARCA4,388
chr1,42463242,42463600,SRX5075169,SMARCA4,358
chr1,42484499,42484720,SRX5054309,FOSL2,221
chr1,42511613,42511894,SRX16500059,CTCF,281
chr1,42511627,42511898,SRX16500060,CTCF,271
chr1,42577875,42578430,SRX16500060,CTCF,555
chr1,42577900,42578465,SRX16500061,CTCF,565
chr1,42577901,42578354,SRX16500062,CTCF,453
chr1,42577912,42578449,SRX16500059,CTCF,537
chr1,42578007,42578263,SRX5075170,SMARCA4,256
chr1,42578041,42578216,SRX5075174,SMARCA4,175
chr1,42578046,42578254,SRX5075168,SMARCA4,208
chr1,42657939,42658356,SRX5075169,SMARCA4,417
chr1,42657992,42658644,SRX20140895,INTS13,652
chr1,42658004,42658471,SRX5075168,SMARCA4,467
chr1,42658018,42658456,SRX5075170,SMARCA4,438
chr1,42658031,42658332,SRX5716469,SMARCA4,301
chr1,42658041,42658310,SRX5716470,SMARCA4,269
chr1,42658054,42658562,SRX20140868,INTS10,508
chr1,42658082,42658458,SRX16500060,CTCF,376
chr1,42658096,42658422,SRX5075176,SMARCA4,326
chr1,42658098,42658492,SRX5075174,SMARCA4,394
chr1,42658131,42658436,SRX16500059,CTCF,305
chr1,42658160,42658416,SRX16500061,CTCF,256
chr1,42658165,42658509,SRX5716463,SMARCA4,344
chr1,42681878,42682736,SRX20140895,INTS13,858
chr1,42681921,42682610,SRX20140881,CPSF3L,689
chr1,42681939,42682569,SRX20140897,INTS13,630
chr1,42681940,42682596,SRX20140879,CPSF3L,656
chr1,42681941,42682546,SRX20140868,INTS10,605
chr1,42682005,42682743,SRX20140867,INTS10,738
chr1,42682039,42682342,SRX20140869,INTS10,303
chr1,42682086,42682484,SRX20140894,INTS13,398
chr1,42682124,42682565,SRX20140896,INTS13,441
chr1,42682349,42682666,SRX20140880,CPSF3L,317
chr1,42683018,42683260,SRX5075168,SMARCA4,242
chr1,42709146,42709189,SRX1424893,POU3F2,43
chr1,42709146,42709191,SRX1424892,POU3F2,45
chr1,42709147,42709190,SRX1424894,POU3F2,43
chr1,42709148,42709188,SRX1424891,POU3F2,40
chr1,42742949,42743124,SRX5075176,SMARCA4,175
chr1,42747135,42747465,SRX16500061,CTCF,330
chr1,42747143,42747491,SRX16500060,CTCF,348
chr1,42747172,42747482,SRX16500062,CTCF,310
chr1,42747191,42747537,SRX16500059,CTCF,346
chr1,42756903,42757387,SRX16500060,CTCF,484
chr1,42756906,42757392,SRX16500059,CTCF,486
chr1,42756911,42757401,SRX16500062,CTCF,490
chr1,42756934,42757320,SRX5075168,SMARCA4,386
chr1,42756943,42757324,SRX4174629,CTCF,381
chr1,42756949,42757247,SRX5075174,SMARCA4,298
chr1,42756967,42757417,SRX16500061,CTCF,450
chr1,42756973,42757193,SRX5716463,SMARCA4,220
chr1,42757037,42757213,SRX5075170,SMARCA4,176
chr1,42765836,42766251,SRX16500060,CTCF,415
chr1,42765837,42766172,SRX16500062,CTCF,335
chr1,42765871,42766320,SRX16500059,CTCF,449
chr1,42765879,42766268,SRX16500061,CTCF,389
chr1,42765962,42766147,SRX5075170,SMARCA4,185
chr1,42765969,42766201,SRX5075176,SMARCA4,232
chr1,42766798,42767567,SRX20140895,INTS13,769
chr1,42766853,42767162,SRX20140897,INTS13,309
chr1,42766958,42767393,SRX5075174,SMARCA4,435
chr1,42767019,42767364,SRX5716463,SMARCA4,345
chr1,42767046,42767298,SRX5075176,SMARCA4,252
chr1,42767053,42767252,SRX5716451,SOX2,199
chr1,42767058,42767299,SRX5054307,FOSL2,241
chr1,42767066,42767281,SRX5716464,SMARCA4,215
chr1,42767067,42767432,SRX5075168,SMARCA4,365
chr1,42767069,42767292,SRX5716454,SOX3,223
chr1,42767087,42767457,SRX5075170,SMARCA4,370
chr1,42767245,42767559,SRX20140868,INTS10,314
chr1,42767276,42767547,SRX20140879,CPSF3L,271
chr1,42777772,42778312,SRX16500059,CTCF,540
chr1,42777800,42778316,SRX16500060,CTCF,516
chr1,42777828,42778267,SRX16500062,CTCF,439
chr1,42777885,42778262,SRX16500061,CTCF,377
chr1,42777958,42778168,SRX4174629,CTCF,210
chr1,42816783,42817477,SRX20140895,INTS13,694
chr1,42816833,42817341,SRX5716470,SMARCA4,508
chr1,42816855,42817626,SRX5075168,SMARCA4,771
chr1,42816866,42817313,SRX5075176,SMARCA4,447
chr1,42816874,42817396,SRX5716469,SMARCA4,522
chr1,42816879,42817624,SRX5075174,SMARCA4,745
chr1,42816884,42817365,SRX5075175,SMARCA4,481
chr1,42816888,42817618,SRX5075170,SMARCA4,730
chr1,42816914,42817475,SRX5075169,SMARCA4,561
chr1,42816945,42817289,SRX20140896,INTS13,344
chr1,42816950,42817399,SRX20140867,INTS10,449
chr1,42816960,42817303,SRX20140869,INTS10,343
chr1,42816960,42817405,SRX20140868,INTS10,445
chr1,42817014,42817342,SRX20140897,INTS13,328
chr1,42817163,42817386,SRX5716464,SMARCA4,223
chr1,42817179,42817562,SRX5716463,SMARCA4,383
chr1,42822738,42823259,SRX5075170,SMARCA4,521
chr1,42822817,42823177,SRX5716470,SMARCA4,360
chr1,42822835,42823173,SRX5075169,SMARCA4,338
chr1,42822837,42823124,SRX5075176,SMARCA4,287
chr1,42822870,42823165,SRX5716469,SMARCA4,295
chr1,42822890,42823168,SRX5075175,SMARCA4,278
chr1,42846105,42846397,SRX5716470,SMARCA4,292
chr1,42846161,42846408,SRX5075169,SMARCA4,247
chr1,42846192,42846368,SRX5075176,SMARCA4,176
chr1,42846255,42846679,SRX5075174,SMARCA4,424
chr1,42846438,42846622,SRX5054307,FOSL2,184
chr1,42846460,42846872,SRX20140895,INTS13,412
chr1,42846462,42846778,SRX16500061,CTCF,316
chr1,42846485,42846843,SRX16500059,CTCF,358
chr1,42846489,42846805,SRX16500060,CTCF,316
chr1,42846507,42846852,SRX5075170,SMARCA4,345
chr1,42846610,42846839,SRX5075169,SMARCA4,229
chr1,42913389,42913748,SRX16500062,CTCF,359
chr1,42913394,42913786,SRX16500059,CTCF,392
chr1,42913396,42913749,SRX16500060,CTCF,353
chr1,42913405,42913748,SRX16500061,CTCF,343
chr1,42913417,42913737,SRX4174629,CTCF,320
chr1,42913462,42913693,SRX5075168,SMARCA4,231
chr1,42913479,42913735,SRX5075174,SMARCA4,256
chr1,42913484,42913659,SRX5075176,SMARCA4,175
chr1,42922797,42923294,SRX16500062,CTCF,497
chr1,42922856,42923365,SRX16500059,CTCF,509
chr1,42922875,42923338,SRX16500060,CTCF,463
chr1,42922894,42923369,SRX16500061,CTCF,475
chr1,42922983,42923268,SRX5075168,SMARCA4,285
chr1,42923014,42923276,SRX5075176,SMARCA4,262
chr1,42923051,42923281,SRX5075170,SMARCA4,230
chr1,42923080,42923296,SRX4174629,CTCF,216
chr1,42923100,42923281,SRX5075169,SMARCA4,181
chr1,42924186,42924736,SRX20140895,INTS13,550
chr1,42924204,42924513,SRX5716470,SMARCA4,309
chr1,42924433,42924619,SRX5075170,SMARCA4,186
chr1,42930992,42931432,SRX16500062,CTCF,440
chr1,42931035,42931366,SRX16500061,CTCF,331
chr1,42931040,42931447,SRX16500059,CTCF,407
chr1,42931060,42931413,SRX16500060,CTCF,353
chr1,42936389,42936722,SRX5075170,SMARCA4,333
chr1,42936401,42936819,SRX5075176,SMARCA4,418
chr1,42936447,42936725,SRX5075169,SMARCA4,278
chr1,42936489,42936823,SRX5075175,SMARCA4,334
chr1,42940893,42941422,SRX5075174,SMARCA4,529
chr1,42940974,42941371,SRX5054309,FOSL2,397
chr1,42940974,42941421,SRX5075168,SMARCA4,447
chr1,42940989,42941422,SRX5075169,SMARCA4,433
chr1,42941007,42941336,SRX5054308,FOSL2,329
chr1,42941022,42941334,SRX5054307,FOSL2,312
chr1,42941027,42941323,SRX5075176,SMARCA4,296
chr1,42941034,42941332,SRX5075175,SMARCA4,298
chr1,42941036,42941316,SRX5075170,SMARCA4,280
chr1,42941037,42941282,SRX5716463,SMARCA4,245
chr1,42941042,42941275,SRX5716470,SMARCA4,233
chr1,42941084,42941295,SRX5716468,SMARCA2,211
chr1,42941089,42941350,SRX5716469,SMARCA4,261
chr1,42941707,42942041,SRX5075176,SMARCA4,334
chr1,42941708,42942019,SRX5075169,SMARCA4,311
chr1,42941724,42942001,SRX5075170,SMARCA4,277
chr1,42950119,42950456,SRX5054309,FOSL2,337
chr1,42950134,42950575,SRX5075175,SMARCA4,441
chr1,42950156,42950566,SRX5075169,SMARCA4,410
chr1,42950280,42950526,SRX5075170,SMARCA4,246
chr1,42950300,42950561,SRX5716470,SMARCA4,261
chr1,42950384,42950578,SRX5075176,SMARCA4,194
chr1,42958311,42959138,SRX20140895,INTS13,827
chr1,42958695,42959079,SRX20140867,INTS10,384
chr1,42958716,42959171,SRX20140868,INTS10,455
chr1,42958719,42958993,SRX20140897,INTS13,274
chr1,42958836,42959294,SRX5075174,SMARCA4,458
chr1,42958842,42959197,SRX5075168,SMARCA4,355
chr1,42963613,42963866,SRX5716469,SMARCA4,253
chr1,42963634,42963883,SRX5075170,SMARCA4,249
chr1,42963647,42963992,SRX5075176,SMARCA4,345
chr1,42963660,42963936,SRX5075175,SMARCA4,276
chr1,42963694,42963917,SRX5716470,SMARCA4,223
chr1,42967084,42967437,SRX5054309,FOSL2,353
chr1,42967086,42967536,SRX5075170,SMARCA4,450
chr1,42967087,42967534,SRX5075169,SMARCA4,447
chr1,42967097,42967496,SRX5075175,SMARCA4,399
chr1,42967100,42967528,SRX5075176,SMARCA4,428
chr1,42967103,42967506,SRX5716469,SMARCA4,403
chr1,42967130,42967404,SRX5716467,SMARCA2,274
chr1,42967134,42967429,SRX5716470,SMARCA4,295
chr1,42967147,42967481,SRX5054308,FOSL2,334
chr1,42967167,42967523,SRX5075168,SMARCA4,356
chr1,42967191,42967407,SRX5075174,SMARCA4,216
chr1,42967205,42967418,SRX5020211,SMARCA2,213
chr1,42967228,42967408,SRX5075182,SMARCA2,180
chr1,42971785,42972055,SRX5075170,SMARCA4,270
chr1,42971803,42972009,SRX5075169,SMARCA4,206
chr1,42971831,42972176,SRX5075176,SMARCA4,345
chr1,42973242,42973564,SRX5075174,SMARCA4,322
chr1,42973256,42973563,SRX5075168,SMARCA4,307
chr1,42978526,42978751,SRX5075176,SMARCA4,225
chr1,42978652,42978900,SRX5075169,SMARCA4,248
chr1,42983872,42984104,SRX5716470,SMARCA4,232
chr1,42999333,42999623,SRX5054309,FOSL2,290
chr1,42999434,42999637,SRX5075169,SMARCA4,203
chr1,43006001,43006446,SRX20140895,INTS13,445
chr1,43008128,43008507,SRX20140868,INTS10,379
chr1,43008157,43008413,SRX16500059,CTCF,256
chr1,43008200,43008498,SRX16500060,CTCF,298
chr1,43008232,43008515,SRX16500062,CTCF,283
chr1,43008263,43008589,SRX16500061,CTCF,326
chr1,43008299,43009172,SRX20140895,INTS13,873
chr1,43008403,43009443,SRX5075168,SMARCA4,1040
chr1,43008514,43008872,SRX20140867,INTS10,358
chr1,43008619,43009330,SRX5075174,SMARCA4,711
chr1,43008622,43009144,SRX20140868,INTS10,522
chr1,43008624,43009232,SRX5716463,SMARCA4,608
chr1,43008768,43008948,SRX5075176,SMARCA4,180
chr1,43008813,43009192,SRX5716451,SOX2,379
chr1,43008892,43009138,SRX5716454,SOX3,246
chr1,43028282,43028571,SRX5075168,SMARCA4,289
chr1,43028319,43028614,SRX5075174,SMARCA4,295
chr1,43036074,43036457,SRX20140895,INTS13,383
chr1,43058519,43058759,SRX5716469,SMARCA4,240
chr1,43058571,43059084,SRX5716470,SMARCA4,513
chr1,43058589,43058916,SRX5075170,SMARCA4,327
chr1,43058610,43058961,SRX5075176,SMARCA4,351
chr1,43058615,43058855,SRX5075169,SMARCA4,240
chr1,43058637,43058939,SRX5075175,SMARCA4,302
chr1,43069698,43070089,SRX5075176,SMARCA4,391
chr1,43069778,43070020,SRX5716469,SMARCA4,242
chr1,43073557,43074092,SRX16500060,CTCF,535
chr1,43073564,43074059,SRX16500059,CTCF,495
chr1,43073589,43074042,SRX16500061,CTCF,453
chr1,43073592,43074098,SRX16500062,CTCF,506
chr1,43073614,43074100,SRX4174629,CTCF,486
chr1,43073643,43073888,SRX5075174,SMARCA4,245
chr1,43120066,43120634,SRX20140895,INTS13,568
chr1,43143509,43143958,SRX16500059,CTCF,449
chr1,43143568,43143969,SRX16500061,CTCF,401
chr1,43143589,43143961,SRX16500062,CTCF,372
chr1,43143606,43143901,SRX16500060,CTCF,295
chr1,43147542,43147885,SRX5075170,SMARCA4,343
chr1,43147543,43148056,SRX5075174,SMARCA4,513
chr1,43147586,43148116,SRX5075168,SMARCA4,530
chr1,43147633,43148102,SRX5075169,SMARCA4,469
chr1,43147640,43148129,SRX5716464,SMARCA4,489
chr1,43147664,43147872,SRX5075175,SMARCA4,208
chr1,43147666,43147992,SRX5716470,SMARCA4,326
chr1,43147692,43148111,SRX5716463,SMARCA4,419
chr1,43147706,43147925,SRX5716454,SOX3,219
chr1,43147710,43148121,SRX20140895,INTS13,411
chr1,43172160,43172519,SRX5075174,SMARCA4,359
chr1,43172219,43172464,SRX5075176,SMARCA4,245
chr1,43172233,43172461,SRX5716451,SOX2,228
chr1,43172618,43172854,SRX5075168,SMARCA4,236
chr1,43205803,43205986,SRX5054309,FOSL2,183
chr1,43205803,43206050,SRX5075176,SMARCA4,247
chr1,43205804,43206096,SRX5075169,SMARCA4,292
chr1,43205877,43206133,SRX5075170,SMARCA4,256
chr1,43206640,43207315,SRX5075168,SMARCA4,675
chr1,43206667,43207309,SRX5075175,SMARCA4,642
chr1,43206690,43207295,SRX5075176,SMARCA4,605
chr1,43206732,43207245,SRX5075170,SMARCA4,513
chr1,43206806,43207396,SRX5716470,SMARCA4,590
chr1,43206807,43207435,SRX5075169,SMARCA4,628
chr1,43206822,43207155,SRX5716469,SMARCA4,333
chr1,43206832,43207346,SRX5054309,FOSL2,514
chr1,43206835,43207328,SRX5075174,SMARCA4,493
chr1,43206858,43207059,SRX5075181,SMARCA2,201
chr1,43206875,43207180,SRX5054308,FOSL2,305
chr1,43206960,43207196,SRX5716463,SMARCA4,236
chr1,43206995,43207213,SRX5020211,SMARCA2,218
chr1,43207032,43207247,SRX5716467,SMARCA2,215
chr1,43227175,43227654,SRX4174629,CTCF,479
chr1,43227205,43227701,SRX16500059,CTCF,496
chr1,43227216,43227703,SRX16500060,CTCF,487
chr1,43227219,43227704,SRX16500061,CTCF,485
chr1,43227249,43227684,SRX16500062,CTCF,435
chr1,43227294,43227623,SRX5075168,SMARCA4,329
chr1,43227297,43227513,SRX5716464,SMARCA4,216
chr1,43227315,43227539,SRX5075170,SMARCA4,224
chr1,43227315,43227565,SRX5075174,SMARCA4,250
chr1,43227396,43227582,SRX5075176,SMARCA4,186
chr1,43232048,43232384,SRX5054308,FOSL2,336
chr1,43232093,43232421,SRX5054309,FOSL2,328
chr1,43232154,43232402,SRX5075169,SMARCA4,248
chr1,43238064,43238461,SRX16500059,CTCF,397
chr1,43238081,43238441,SRX16500061,CTCF,360
chr1,43238088,43238520,SRX16500060,CTCF,432
chr1,43238115,43238454,SRX16500062,CTCF,339
chr1,43243859,43244130,SRX5075174,SMARCA4,271
chr1,43274318,43274610,SRX5075170,SMARCA4,292
chr1,43274363,43274688,SRX5075176,SMARCA4,325
chr1,43294485,43294665,SRX5054308,FOSL2,180
chr1,43330192,43330546,SRX5075175,SMARCA4,354
chr1,43330211,43330509,SRX5075170,SMARCA4,298
chr1,43330219,43330498,SRX5054309,FOSL2,279
chr1,43330221,43330522,SRX5054308,FOSL2,301
chr1,43330232,43330471,SRX5075176,SMARCA4,239
chr1,43330240,43330495,SRX5075169,SMARCA4,255
chr1,43348884,43349241,SRX5075174,SMARCA4,357
chr1,43349015,43349355,SRX20140895,INTS13,340
chr1,43349147,43349436,SRX5075168,SMARCA4,289
chr1,43350136,43350379,SRX5054309,FOSL2,243
chr1,43358077,43358452,SRX16500060,CTCF,375
chr1,43358079,43358535,SRX16500059,CTCF,456
chr1,43358176,43358392,SRX16500062,CTCF,216
chr1,43358210,43358723,SRX5075169,SMARCA4,513
chr1,43358401,43359190,SRX20140895,INTS13,789
chr1,43358473,43359035,SRX5075174,SMARCA4,562
chr1,43358516,43358939,SRX20140868,INTS10,423
chr1,43358533,43358759,SRX20140867,INTS10,226
chr1,43358536,43358809,SRX5716470,SMARCA4,273
chr1,43358544,43358810,SRX20140869,INTS10,266
chr1,43358561,43358759,SRX5075170,SMARCA4,198
chr1,43358586,43358970,SRX5075176,SMARCA4,384
chr1,43358600,43358787,SRX5075175,SMARCA4,187
chr1,43358622,43358938,SRX5075168,SMARCA4,316
chr1,43367868,43368393,SRX5075176,SMARCA4,525
chr1,43367906,43368614,SRX5075170,SMARCA4,708
chr1,43367923,43368501,SRX5075174,SMARCA4,578
chr1,43367948,43368494,SRX20140868,INTS10,546
chr1,43367968,43368419,SRX5075169,SMARCA4,451
chr1,43367970,43368582,SRX20140895,INTS13,612
chr1,43367996,43368466,SRX5075168,SMARCA4,470
chr1,43368163,43368393,SRX5716470,SMARCA4,230
chr1,43368196,43368464,SRX20140867,INTS10,268
chr1,43373081,43373273,SRX5075175,SMARCA4,192
chr1,43373087,43373329,SRX5054309,FOSL2,242
chr1,43373119,43373397,SRX5075169,SMARCA4,278
chr1,43373122,43373382,SRX5075176,SMARCA4,260
chr1,43373140,43373320,SRX5054308,FOSL2,180
chr1,43373154,43373425,SRX5075170,SMARCA4,271
chr1,43389626,43390074,SRX5716469,SMARCA4,448
chr1,43389684,43390226,SRX20140895,INTS13,542
chr1,43389690,43390025,SRX20140897,INTS13,335
chr1,43389717,43390127,SRX20140868,INTS10,410
chr1,43389719,43390150,SRX5075174,SMARCA4,431
chr1,43389753,43390150,SRX20140867,INTS10,397
chr1,43389784,43390141,SRX5075168,SMARCA4,357
chr1,43389808,43390119,SRX5075176,SMARCA4,311
chr1,43389850,43390066,SRX5716464,SMARCA4,216
chr1,43389850,43390159,SRX20140881,CPSF3L,309
chr1,43389907,43390178,SRX5075175,SMARCA4,271
chr1,43389919,43390256,SRX5075170,SMARCA4,337
chr1,43389928,43390173,SRX5716470,SMARCA4,245
chr1,43389971,43390215,SRX5075169,SMARCA4,244
chr1,43414544,43415103,SRX16500059,CTCF,559
chr1,43414594,43415028,SRX16500060,CTCF,434
chr1,43414619,43415015,SRX16500062,CTCF,396
chr1,43414622,43414968,SRX4174629,CTCF,346
chr1,43414626,43415008,SRX16500061,CTCF,382
chr1,43414769,43414942,SRX5075174,SMARCA4,173
chr1,43436124,43436854,SRX5075174,SMARCA4,730
chr1,43436149,43436790,SRX5075168,SMARCA4,641
chr1,43436183,43436688,SRX5716464,SMARCA4,505
chr1,43436292,43436703,SRX5716463,SMARCA4,411
chr1,43436339,43436677,SRX5716451,SOX2,338
chr1,43436430,43436720,SRX5716454,SOX3,290
chr1,43453831,43454175,SRX20140895,INTS13,344
chr1,43453891,43454085,SRX5075170,SMARCA4,194
chr1,43453908,43454196,SRX5075176,SMARCA4,288
chr1,43453910,43454158,SRX5075169,SMARCA4,248
chr1,43472338,43472715,SRX5075170,SMARCA4,377
chr1,43472373,43472747,SRX5075174,SMARCA4,374
chr1,43472392,43473097,SRX5075176,SMARCA4,705
chr1,43472393,43473108,SRX5075175,SMARCA4,715
chr1,43472398,43473177,SRX5075169,SMARCA4,779
chr1,43472473,43472797,SRX5716469,SMARCA4,324
chr1,43472477,43472926,SRX5716470,SMARCA4,449
chr1,43472484,43472759,SRX5054308,FOSL2,275
chr1,43472500,43473098,SRX5054309,FOSL2,598
chr1,43472534,43473156,SRX5075168,SMARCA4,622
chr1,43472805,43473036,SRX5075174,SMARCA4,231
chr1,43472805,43473115,SRX5075170,SMARCA4,310
chr1,43475913,43476253,SRX5075169,SMARCA4,340
chr1,43475984,43476257,SRX5075170,SMARCA4,273
chr1,43475998,43476381,SRX5054309,FOSL2,383
chr1,43476012,43476238,SRX5075168,SMARCA4,226
chr1,43476013,43476266,SRX5075175,SMARCA4,253
chr1,43476022,43476277,SRX5075174,SMARCA4,255
chr1,43476055,43476265,SRX5054308,FOSL2,210
chr1,43494044,43494277,SRX5075174,SMARCA4,233
chr1,43494124,43494365,SRX5075168,SMARCA4,241
chr1,43526105,43526402,SRX5054309,FOSL2,297
chr1,43526206,43526404,SRX5054308,FOSL2,198
chr1,43529054,43529530,SRX16500061,CTCF,476
chr1,43529086,43529505,SRX16500062,CTCF,419
chr1,43529089,43529555,SRX16500059,CTCF,466
chr1,43529100,43529550,SRX16500060,CTCF,450
chr1,43529117,43529391,SRX5054308,FOSL2,274
chr1,43529129,43529430,SRX5075169,SMARCA4,301
chr1,43529160,43529356,SRX5054309,FOSL2,196
chr1,43529162,43529399,SRX5075176,SMARCA4,237
chr1,43529177,43529469,SRX5075170,SMARCA4,292
chr1,43529183,43529456,SRX5075168,SMARCA4,273
chr1,43529196,43529488,SRX5075174,SMARCA4,292
chr1,43529210,43529424,SRX5075175,SMARCA4,214
chr1,43529234,43529511,SRX5716464,SMARCA4,277
chr1,43529235,43529549,SRX4174629,CTCF,314
chr1,43530643,43530844,SRX5075168,SMARCA4,201
chr1,43530658,43530831,SRX5075174,SMARCA4,173
chr1,43545774,43546092,SRX5716464,SMARCA4,318
chr1,43545797,43546238,SRX5075174,SMARCA4,441
chr1,43545811,43546127,SRX5075168,SMARCA4,316
chr1,43545826,43546084,SRX5716463,SMARCA4,258
chr1,43554447,43554745,SRX16500060,CTCF,298
chr1,43554517,43554750,SRX5075174,SMARCA4,233
chr1,43554528,43554748,SRX5075170,SMARCA4,220
chr1,43554546,43554754,SRX5075176,SMARCA4,208
chr1,43558326,43558676,SRX5716469,SMARCA4,350
chr1,43558464,43558766,SRX5075175,SMARCA4,302
chr1,43558498,43558844,SRX5075169,SMARCA4,346
chr1,43558511,43558778,SRX5075170,SMARCA4,267
chr1,43558557,43558778,SRX5716470,SMARCA4,221
chr1,43565637,43566053,SRX5075168,SMARCA4,416
chr1,43565637,43566080,SRX5075174,SMARCA4,443
chr1,43565759,43566065,SRX5716463,SMARCA4,306
chr1,43572981,43573322,SRX5075175,SMARCA4,341
chr1,43573036,43573374,SRX5075170,SMARCA4,338
chr1,43573078,43573289,SRX5716470,SMARCA4,211
chr1,43573085,43573332,SRX5716467,SMARCA2,247
chr1,43573102,43573373,SRX5075176,SMARCA4,271
chr1,43573183,43573388,SRX5020211,SMARCA2,205
chr1,43582231,43582599,SRX5075176,SMARCA4,368
chr1,43582243,43582603,SRX5075170,SMARCA4,360
chr1,43582243,43582653,SRX5716470,SMARCA4,410
chr1,43582244,43582580,SRX5054309,FOSL2,336
chr1,43582245,43582605,SRX5075169,SMARCA4,360
chr1,43582267,43582593,SRX5054308,FOSL2,326
chr1,43582277,43582637,SRX5716469,SMARCA4,360
chr1,43582277,43582638,SRX5075175,SMARCA4,361
chr1,43582318,43582576,SRX5716467,SMARCA2,258
chr1,43582336,43582529,SRX5054307,FOSL2,193
chr1,43649701,43649980,SRX5075176,SMARCA4,279
chr1,43649732,43650099,SRX5075168,SMARCA4,367
chr1,43649793,43649988,SRX5075170,SMARCA4,195
chr1,43649810,43650307,SRX5075174,SMARCA4,497
chr1,43649884,43650144,SRX5054307,FOSL2,260
chr1,43650010,43650254,SRX5716451,SOX2,244
chr1,43650010,43650884,SRX20140895,INTS13,874
chr1,43650148,43650830,SRX20140897,INTS13,682
chr1,43650150,43650803,SRX20140868,INTS10,653
chr1,43650181,43650879,SRX20140881,CPSF3L,698
chr1,43650199,43650784,SRX20140867,INTS10,585
chr1,43650202,43650882,SRX20140869,INTS10,680
chr1,43650256,43650804,SRX20140896,INTS13,548
chr1,43650272,43650751,SRX20140870,INTS10,479
chr1,43650280,43650853,SRX20140879,CPSF3L,573
chr1,43650284,43650779,SRX20140894,INTS13,495
chr1,43650287,43650767,SRX20140882,CPSF3L,480
chr1,43650301,43650812,SRX5075168,SMARCA4,511
chr1,43650311,43650770,SRX20140880,CPSF3L,459
chr1,43650360,43650666,SRX5075174,SMARCA4,306
chr1,43688674,43689031,SRX5075176,SMARCA4,357
chr1,43688698,43688953,SRX5075169,SMARCA4,255
chr1,43688715,43689037,SRX5075170,SMARCA4,322
chr1,43688776,43689028,SRX5054308,FOSL2,252
chr1,43707196,43708029,SRX20140895,INTS13,833
chr1,43707223,43707932,SRX5075168,SMARCA4,709
chr1,43707250,43707771,SRX5075174,SMARCA4,521
chr1,43707308,43707861,SRX20140868,INTS10,553
chr1,43707317,43707951,SRX20140867,INTS10,634
chr1,43707323,43707741,SRX20140896,INTS13,418
chr1,43707337,43707537,SRX5075170,SMARCA4,200
chr1,43707341,43707888,SRX20140897,INTS13,547
chr1,43707474,43707679,SRX5716464,SMARCA4,205
chr1,43707517,43707770,SRX20140879,CPSF3L,253
chr1,43707534,43707821,SRX20140869,INTS10,287
chr1,43707542,43707806,SRX20140881,CPSF3L,264
chr1,43707811,43708015,SRX5075170,SMARCA4,204
chr1,43707824,43708144,SRX5075169,SMARCA4,320
chr1,43707866,43708163,SRX5075174,SMARCA4,297
chr1,43711561,43711858,SRX5054309,FOSL2,297
chr1,43711617,43711825,SRX5054308,FOSL2,208
chr1,43720107,43720324,SRX5075169,SMARCA4,217
chr1,43763368,43763895,SRX16500059,CTCF,527
chr1,43763371,43763861,SRX16500060,CTCF,490
chr1,43763388,43763860,SRX16500062,CTCF,472
chr1,43763422,43763749,SRX5075176,SMARCA4,327
chr1,43763423,43763871,SRX4174629,CTCF,448
chr1,43763423,43763913,SRX16500061,CTCF,490
chr1,43763468,43763729,SRX5075170,SMARCA4,261
chr1,43763492,43763738,SRX5075169,SMARCA4,246
chr1,43763512,43763748,SRX5716470,SMARCA4,236
chr1,43763519,43763748,SRX5075174,SMARCA4,229
chr1,43763558,43763773,SRX5075168,SMARCA4,215
chr1,43766084,43766267,SRX5075174,SMARCA4,183
chr1,43766182,43766382,SRX5075168,SMARCA4,200
chr1,43766831,43767181,SRX5075174,SMARCA4,350
chr1,43766895,43767175,SRX5075168,SMARCA4,280
chr1,43774476,43774659,SRX5054309,FOSL2,183
chr1,43776445,43776887,SRX5716469,SMARCA4,442
chr1,43776446,43776922,SRX5075170,SMARCA4,476
chr1,43776447,43776872,SRX5075169,SMARCA4,425
chr1,43776463,43776896,SRX5716470,SMARCA4,433
chr1,43776463,43776945,SRX5075176,SMARCA4,482
chr1,43776474,43776806,SRX5054309,FOSL2,332
chr1,43776476,43776956,SRX5075175,SMARCA4,480
chr1,43776490,43776760,SRX5716468,SMARCA2,270
chr1,43776491,43776779,SRX5054308,FOSL2,288
chr1,43776492,43776814,SRX5716467,SMARCA2,322
chr1,43776508,43776754,SRX5020211,SMARCA2,246
chr1,43796039,43796527,SRX5075170,SMARCA4,488
chr1,43796044,43796617,SRX5716469,SMARCA4,573
chr1,43796051,43796543,SRX5075176,SMARCA4,492
chr1,43796052,43796543,SRX5075169,SMARCA4,491
chr1,43796100,43796624,SRX5716470,SMARCA4,524
chr1,43796146,43796588,SRX5075175,SMARCA4,442
chr1,43796158,43796568,SRX5716467,SMARCA2,410
chr1,43796166,43796514,SRX5716468,SMARCA2,348
chr1,43796233,43796523,SRX5075181,SMARCA2,290
chr1,43800209,43800501,SRX5716470,SMARCA4,292
chr1,43800211,43800588,SRX5075169,SMARCA4,377
chr1,43800224,43800525,SRX5075175,SMARCA4,301
chr1,43800227,43800580,SRX5716469,SMARCA4,353
chr1,43800238,43800600,SRX5075176,SMARCA4,362
chr1,43800242,43800624,SRX5716467,SMARCA2,382
chr1,43800246,43800590,SRX5020211,SMARCA2,344
chr1,43800249,43800598,SRX5054309,FOSL2,349
chr1,43800251,43800566,SRX5075170,SMARCA4,315
chr1,43800253,43800561,SRX5054308,FOSL2,308
chr1,43800289,43800555,SRX5075181,SMARCA2,266
chr1,43800335,43800546,SRX5020214,SMARCA2,211
chr1,43821936,43822386,SRX5075174,SMARCA4,450
chr1,43821954,43822448,SRX5075170,SMARCA4,494
chr1,43821976,43822458,SRX5075176,SMARCA4,482
chr1,43821987,43822475,SRX5054308,FOSL2,488
chr1,43821997,43822528,SRX5075169,SMARCA4,531
chr1,43822001,43822540,SRX5716469,SMARCA4,539
chr1,43822003,43822386,SRX5716467,SMARCA2,383
chr1,43822023,43822433,SRX5075168,SMARCA4,410
chr1,43822032,43822425,SRX5054309,FOSL2,393
chr1,43822046,43822483,SRX5716470,SMARCA4,437
chr1,43822061,43822426,SRX5075175,SMARCA4,365
chr1,43822071,43822520,SRX5716460,Epitope tags,449
chr1,43822078,43822350,SRX5020211,SMARCA2,272
chr1,43822085,43822305,SRX5075181,SMARCA2,220
chr1,43822089,43822345,SRX5716468,SMARCA2,256
chr1,43822091,43822368,SRX5020214,SMARCA2,277
chr1,43822101,43822360,SRX5075182,SMARCA2,259
chr1,43822142,43822348,SRX5054307,FOSL2,206
chr1,43834987,43835448,SRX5075176,SMARCA4,461
chr1,43835046,43835454,SRX5075169,SMARCA4,408
chr1,43835090,43835472,SRX5075170,SMARCA4,382
chr1,43835104,43835398,SRX5716470,SMARCA4,294
chr1,43835105,43835508,SRX5075175,SMARCA4,403
chr1,43835160,43835513,SRX5054309,FOSL2,353
chr1,43835169,43835448,SRX5054308,FOSL2,279
chr1,43835176,43835459,SRX5716469,SMARCA4,283
chr1,43836467,43836777,SRX5075176,SMARCA4,310
chr1,43853332,43853767,SRX5075175,SMARCA4,435
chr1,43853410,43853665,SRX5075176,SMARCA4,255
chr1,43853420,43853759,SRX5075169,SMARCA4,339
chr1,43853597,43853780,SRX5054309,FOSL2,183
chr1,43853622,43853870,SRX5075170,SMARCA4,248
chr1,43858268,43858693,SRX5075169,SMARCA4,425
chr1,43858270,43858662,SRX5075176,SMARCA4,392
chr1,43858278,43858689,SRX5716470,SMARCA4,411
chr1,43858282,43858660,SRX5716469,SMARCA4,378
chr1,43858320,43858626,SRX5020211,SMARCA2,306
chr1,43858323,43858728,SRX5075170,SMARCA4,405
chr1,43858323,43858772,SRX5075175,SMARCA4,449
chr1,43858336,43858675,SRX5716468,SMARCA2,339
chr1,43858364,43858646,SRX5075181,SMARCA2,282
chr1,43858368,43858663,SRX5054308,FOSL2,295
chr1,43858374,43858681,SRX5716467,SMARCA2,307
chr1,43858378,43858666,SRX5020214,SMARCA2,288
chr1,43858386,43858565,SRX5075182,SMARCA2,179
chr1,43858447,43858648,SRX5054309,FOSL2,201
chr1,43865400,43865583,SRX5054309,FOSL2,183
chr1,43865482,43865920,SRX5054308,FOSL2,438
chr1,43865497,43865727,SRX5075169,SMARCA4,230
chr1,43865503,43865771,SRX5075175,SMARCA4,268
chr1,43865650,43865942,SRX5054309,FOSL2,292
chr1,43868595,43868945,SRX5716470,SMARCA4,350
chr1,43868670,43868946,SRX5075169,SMARCA4,276
chr1,43868676,43869019,SRX5075176,SMARCA4,343
chr1,43868679,43868960,SRX5716467,SMARCA2,281
chr1,43868738,43868982,SRX5075170,SMARCA4,244
chr1,43921909,43922145,SRX5054309,FOSL2,236
chr1,43921937,43922163,SRX5075169,SMARCA4,226
chr1,43929591,43929903,SRX5075175,SMARCA4,312
chr1,43929598,43929911,SRX5054309,FOSL2,313
chr1,43929601,43929839,SRX5075169,SMARCA4,238
chr1,43929601,43929880,SRX5054308,FOSL2,279
chr1,43929601,43929911,SRX5075176,SMARCA4,310
chr1,43929647,43929935,SRX5075170,SMARCA4,288
chr1,43929653,43929882,SRX5716469,SMARCA4,229
chr1,43934638,43935145,SRX16500062,CTCF,507
chr1,43934655,43935202,SRX16500059,CTCF,547
chr1,43934692,43935172,SRX16500061,CTCF,480
chr1,43934695,43935205,SRX16500060,CTCF,510
chr1,43934741,43935167,SRX4174629,CTCF,426
chr1,43934784,43935067,SRX5075174,SMARCA4,283
chr1,43946138,43947079,SRX5075176,SMARCA4,941
chr1,43946209,43946633,SRX5075175,SMARCA4,424
chr1,43946255,43946651,SRX5716470,SMARCA4,396
chr1,43946266,43946912,SRX5075174,SMARCA4,646
chr1,43946275,43946856,SRX16500060,CTCF,581
chr1,43946280,43946867,SRX16500061,CTCF,587
chr1,43946295,43946535,SRX5716469,SMARCA4,240
chr1,43946300,43946823,SRX16500062,CTCF,523
chr1,43946309,43947134,SRX5075168,SMARCA4,825
chr1,43946311,43947179,SRX20140895,INTS13,868
chr1,43946330,43946877,SRX16500059,CTCF,547
chr1,43946346,43947044,SRX5075170,SMARCA4,698
chr1,43946349,43946612,SRX4174629,CTCF,263
chr1,43946354,43946589,SRX20140879,CPSF3L,235
chr1,43946374,43947101,SRX5716463,SMARCA4,727
chr1,43946416,43947007,SRX20140897,INTS13,591
chr1,43946430,43946610,SRX5075169,SMARCA4,180
chr1,43946439,43947052,SRX20140868,INTS10,613
chr1,43946444,43946811,SRX5716464,SMARCA4,367
chr1,43946483,43946965,SRX20140869,INTS10,482
chr1,43946492,43947108,SRX20140867,INTS10,616
chr1,43946658,43947128,SRX20140879,CPSF3L,470
chr1,43946664,43947179,SRX20140881,CPSF3L,515
chr1,43946696,43947042,SRX20140896,INTS13,346
chr1,43946746,43946936,SRX5716451,SOX2,190
chr1,43969625,43969835,SRX16500062,CTCF,210
chr1,43969675,43969869,SRX5075174,SMARCA4,194
chr1,43969709,43969953,SRX5075168,SMARCA4,244
chr1,43969782,43969996,SRX5054307,FOSL2,214
chr1,43974606,43975243,SRX20140895,INTS13,637
chr1,43974653,43975163,SRX20140897,INTS13,510
chr1,43974656,43975031,SRX5075168,SMARCA4,375
chr1,43974695,43975081,SRX5075174,SMARCA4,386
chr1,43974722,43975093,SRX20140896,INTS13,371
chr1,43974736,43975031,SRX20140868,INTS10,295
chr1,43974781,43975124,SRX5075170,SMARCA4,343
chr1,43974812,43975059,SRX20140894,INTS13,247
chr1,43991387,43991933,SRX5075174,SMARCA4,546
chr1,43991428,43991686,SRX5075176,SMARCA4,258
chr1,43991455,43991912,SRX20140895,INTS13,457
chr1,43991459,43991962,SRX5075168,SMARCA4,503
chr1,44005557,44006075,SRX16500059,CTCF,518
chr1,44005569,44006055,SRX16500062,CTCF,486
chr1,44005581,44006116,SRX16500060,CTCF,535
chr1,44005599,44005959,SRX4174629,CTCF,360
chr1,44005625,44006072,SRX16500061,CTCF,447
chr1,44005682,44006036,SRX5075168,SMARCA4,354
chr1,44005710,44006000,SRX5075174,SMARCA4,290
chr1,44005736,44005991,SRX5075170,SMARCA4,255
chr1,44005745,44005982,SRX5716464,SMARCA4,237
chr1,44005745,44005987,SRX5075169,SMARCA4,242
chr1,44005753,44006033,SRX5075176,SMARCA4,280
chr1,44005787,44006005,SRX5075175,SMARCA4,218
chr1,44005828,44006039,SRX5716470,SMARCA4,211
chr1,44016589,44016822,SRX5716451,SOX2,233
chr1,44016631,44016867,SRX5075174,SMARCA4,236
chr1,44016632,44016869,SRX5075168,SMARCA4,237
chr1,44029904,44030907,SRX20140895,INTS13,1003
chr1,44029922,44030282,SRX20140897,INTS13,360
chr1,44029923,44030200,SRX5075169,SMARCA4,277
chr1,44029960,44030856,SRX20140868,INTS10,896
chr1,44029970,44030265,SRX20140881,CPSF3L,295
chr1,44029994,44030319,SRX20140867,INTS10,325
chr1,44030073,44030427,SRX20140869,INTS10,354
chr1,44030103,44030321,SRX5075170,SMARCA4,218
chr1,44030143,44030328,SRX5075176,SMARCA4,185
chr1,44030777,44031008,SRX16500060,CTCF,231
chr1,44031561,44031789,SRX5075170,SMARCA4,228
chr1,44031671,44031859,SRX5075174,SMARCA4,188
chr1,44036424,44036981,SRX16500060,CTCF,557
chr1,44036450,44037008,SRX16500059,CTCF,558
chr1,44036485,44037031,SRX4174629,CTCF,546
chr1,44036534,44037023,SRX16500062,CTCF,489
chr1,44036563,44036981,SRX16500061,CTCF,418
chr1,44036598,44036918,SRX5075174,SMARCA4,320
chr1,44036630,44036903,SRX5075168,SMARCA4,273
chr1,44037205,44037729,SRX5075170,SMARCA4,524
chr1,44037271,44037745,SRX5075176,SMARCA4,474
chr1,44037348,44037636,SRX5716467,SMARCA2,288
chr1,44037360,44037633,SRX5716468,SMARCA2,273
chr1,44037360,44037696,SRX5716470,SMARCA4,336
chr1,44037411,44037635,SRX5075175,SMARCA4,224
chr1,44047557,44048080,SRX16500059,CTCF,523
chr1,44047589,44047846,SRX4174629,CTCF,257
chr1,44047589,44048045,SRX16500060,CTCF,456
chr1,44047634,44048024,SRX16500062,CTCF,390
chr1,44047644,44048059,SRX16500061,CTCF,415
chr1,44047693,44047943,SRX5075174,SMARCA4,250
chr1,44047696,44047952,SRX5075168,SMARCA4,256
chr1,44047739,44047914,SRX5075176,SMARCA4,175
chr1,44048209,44048430,SRX5075169,SMARCA4,221
chr1,44048253,44048491,SRX5075174,SMARCA4,238
chr1,44048296,44048519,SRX5075175,SMARCA4,223
chr1,44048312,44048544,SRX5054309,FOSL2,232
chr1,44049840,44050110,SRX5075170,SMARCA4,270
chr1,44049848,44050158,SRX5075176,SMARCA4,310
chr1,44049856,44050120,SRX5075169,SMARCA4,264
chr1,44049885,44050094,SRX5054308,FOSL2,209
chr1,44072178,44072552,SRX5075169,SMARCA4,374
chr1,44072191,44072506,SRX5054308,FOSL2,315
chr1,44072213,44072530,SRX5075175,SMARCA4,317
chr1,44072234,44072556,SRX5054309,FOSL2,322
chr1,44072251,44072486,SRX5716469,SMARCA4,235
chr1,44072254,44072515,SRX5075176,SMARCA4,261
chr1,44072260,44072541,SRX5075170,SMARCA4,281
chr1,44085327,44085576,SRX5054309,FOSL2,249
chr1,44085409,44085599,SRX5054308,FOSL2,190
chr1,44092244,44092609,SRX16500059,CTCF,365
chr1,44092250,44092529,SRX16500062,CTCF,279
chr1,44092257,44092569,SRX16500061,CTCF,312
chr1,44092298,44092549,SRX16500060,CTCF,251
chr1,44103423,44103708,SRX16500060,CTCF,285
chr1,44103490,44103700,SRX16500062,CTCF,210
chr1,44103513,44103752,SRX16500061,CTCF,239
chr1,44170353,44170713,SRX5075174,SMARCA4,360
chr1,44170362,44170732,SRX5075168,SMARCA4,370
chr1,44213131,44213433,SRX5716470,SMARCA4,302
chr1,44213153,44213389,SRX5075169,SMARCA4,236
chr1,44213167,44213661,SRX5075174,SMARCA4,494
chr1,44213199,44213583,SRX5075176,SMARCA4,384
chr1,44213199,44213609,SRX5075168,SMARCA4,410
chr1,44213214,44213628,SRX20140895,INTS13,414
chr1,44213243,44213678,SRX5716464,SMARCA4,435
chr1,44213252,44213494,SRX5716469,SMARCA4,242
chr1,44213264,44213533,SRX5075170,SMARCA4,269
chr1,44213284,44213544,SRX20140867,INTS10,260
chr1,44217664,44218209,SRX16500060,CTCF,545
chr1,44217679,44218154,SRX16500059,CTCF,475
chr1,44217700,44218153,SRX16500061,CTCF,453
chr1,44217704,44218116,SRX16500062,CTCF,412
chr1,44217814,44218100,SRX4174629,CTCF,286
chr1,44217856,44218025,SRX5075170,SMARCA4,169
chr1,44238125,44238532,SRX16500060,CTCF,407
chr1,44238127,44238632,SRX16500059,CTCF,505
chr1,44238164,44238451,SRX16500062,CTCF,287
chr1,44238188,44238540,SRX16500061,CTCF,352
chr1,44239339,44239825,SRX5075169,SMARCA4,486
chr1,44239344,44239754,SRX5075176,SMARCA4,410
chr1,44239416,44239590,SRX5075170,SMARCA4,174
chr1,44239430,44239661,SRX5075174,SMARCA4,231
chr1,44239783,44240044,SRX5075168,SMARCA4,261
chr1,44289563,44289774,SRX5716470,SMARCA4,211
chr1,44289578,44289796,SRX5075176,SMARCA4,218
chr1,44289594,44289782,SRX5075170,SMARCA4,188
chr1,44294777,44295029,SRX16500060,CTCF,252
chr1,44294806,44295062,SRX16500059,CTCF,256
chr1,44296118,44296359,SRX5075168,SMARCA4,241
chr1,44296141,44296340,SRX5075174,SMARCA4,199
chr1,44312869,44313147,SRX20140881,CPSF3L,278
chr1,44318203,44318691,SRX16500059,CTCF,488
chr1,44318204,44318688,SRX16500060,CTCF,484
chr1,44318214,44318639,SRX16500062,CTCF,425
chr1,44318221,44318669,SRX16500061,CTCF,448
chr1,44318361,44318614,SRX4174629,CTCF,253
chr1,44327720,44328349,SRX5075175,SMARCA4,629
chr1,44327725,44328246,SRX5054309,FOSL2,521
chr1,44327736,44328410,SRX5075176,SMARCA4,674
chr1,44327778,44328519,SRX5075170,SMARCA4,741
chr1,44327785,44328423,SRX5075169,SMARCA4,638
chr1,44327817,44328261,SRX5054308,FOSL2,444
chr1,44327837,44328220,SRX5020214,SMARCA2,383
chr1,44327837,44328396,SRX5716469,SMARCA4,559
chr1,44327874,44328250,SRX5020211,SMARCA2,376
chr1,44327876,44328356,SRX5716470,SMARCA4,480
chr1,44327886,44328335,SRX5716467,SMARCA2,449
chr1,44327920,44328181,SRX5075181,SMARCA2,261
chr1,44327920,44328215,SRX5716459,Epitope tags,295
chr1,44327929,44328265,SRX5716468,SMARCA2,336
chr1,44354871,44355449,SRX5075168,SMARCA4,578
chr1,44354896,44355390,SRX5075174,SMARCA4,494
chr1,44354909,44355482,SRX20140895,INTS13,573
chr1,44355002,44355308,SRX20140881,CPSF3L,306
chr1,44355006,44355375,SRX20140867,INTS10,369
chr1,44355038,44355410,SRX20140879,CPSF3L,372
chr1,44355045,44355294,SRX5075176,SMARCA4,249
chr1,44355068,44355256,SRX5075175,SMARCA4,188
chr1,44355076,44355395,SRX20140896,INTS13,319
chr1,44355082,44355293,SRX5716470,SMARCA4,211
chr1,44355102,44355435,SRX5716464,SMARCA4,333
chr1,44355103,44355492,SRX5716463,SMARCA4,389
chr1,44355141,44355425,SRX20140897,INTS13,284
chr1,44355169,44355390,SRX5054309,FOSL2,221
chr1,44355260,44355467,SRX5054307,FOSL2,207
chr1,44368541,44368816,SRX5075168,SMARCA4,275
chr1,44368545,44368869,SRX5075174,SMARCA4,324
chr1,44378114,44378633,SRX16500060,CTCF,519
chr1,44378147,44378605,SRX16500059,CTCF,458
chr1,44378148,44378603,SRX16500061,CTCF,455
chr1,44378197,44378608,SRX16500062,CTCF,411
chr1,44378280,44378495,SRX5075174,SMARCA4,215
chr1,44378319,44378588,SRX4174629,CTCF,269
chr1,44390091,44390661,SRX5075170,SMARCA4,570
chr1,44390195,44390685,SRX5075169,SMARCA4,490
chr1,44390210,44390636,SRX5075176,SMARCA4,426
chr1,44390248,44390633,SRX5075175,SMARCA4,385
chr1,44390267,44390611,SRX5716469,SMARCA4,344
chr1,44390278,44390630,SRX5054309,FOSL2,352
chr1,44390283,44390635,SRX5054308,FOSL2,352
chr1,44390309,44390584,SRX5020211,SMARCA2,275
chr1,44390324,44390589,SRX5716467,SMARCA2,265
chr1,44405011,44405357,SRX5075168,SMARCA4,346
chr1,44405052,44405391,SRX5075174,SMARCA4,339
chr1,44405240,44405561,SRX5075169,SMARCA4,321
chr1,44405262,44405431,SRX5075170,SMARCA4,169
chr1,44417422,44417808,SRX5075174,SMARCA4,386
chr1,44417445,44417708,SRX5075168,SMARCA4,263
chr1,44417495,44417751,SRX20140895,INTS13,256
chr1,44421368,44421721,SRX5075174,SMARCA4,353
chr1,44472686,44472880,SRX5075168,SMARCA4,194
chr1,44485135,44485417,SRX5075174,SMARCA4,282
chr1,44485199,44485542,SRX5075176,SMARCA4,343
chr1,44485203,44485531,SRX5075170,SMARCA4,328
chr1,44485204,44485993,SRX5075169,SMARCA4,789
chr1,44485213,44486079,SRX5716469,SMARCA4,866
chr1,44485226,44485466,SRX5075168,SMARCA4,240
chr1,44485226,44485484,SRX5716470,SMARCA4,258
chr1,44485228,44485474,SRX5716467,SMARCA2,246
chr1,44485240,44485441,SRX5075181,SMARCA2,201
chr1,44485242,44485422,SRX5054308,FOSL2,180
chr1,44485243,44485512,SRX5075175,SMARCA4,269
chr1,44485252,44485499,SRX5054309,FOSL2,247
chr1,44485631,44485942,SRX5075170,SMARCA4,311
chr1,44485634,44485993,SRX5075176,SMARCA4,359
chr1,44485680,44486018,SRX5054308,FOSL2,338
chr1,44485690,44486022,SRX5075175,SMARCA4,332
chr1,44485712,44486000,SRX5054309,FOSL2,288
chr1,44485716,44485933,SRX5716467,SMARCA2,217
chr1,44485744,44485980,SRX5716470,SMARCA4,236
chr1,44489626,44489844,SRX5075168,SMARCA4,218
chr1,44489729,44489916,SRX5075174,SMARCA4,187
chr1,44500605,44500980,SRX5075174,SMARCA4,375
chr1,44500644,44500950,SRX16500060,CTCF,306
chr1,44501113,44501451,SRX5075174,SMARCA4,338
chr1,44501136,44501409,SRX5716451,SOX2,273
chr1,44501184,44501418,SRX5075168,SMARCA4,234
chr1,44505433,44505884,SRX20140895,INTS13,451
chr1,44505466,44505932,SRX20140868,INTS10,466
chr1,44505472,44505924,SRX20140867,INTS10,452
chr1,44505514,44505881,SRX20140880,CPSF3L,367
chr1,44507533,44507997,SRX5075174,SMARCA4,464
chr1,44507640,44507989,SRX5075168,SMARCA4,349
chr1,44507706,44507911,SRX5716454,SOX3,205
chr1,44524154,44524682,SRX5075174,SMARCA4,528
chr1,44524244,44524605,SRX5075168,SMARCA4,361
chr1,44525174,44525364,SRX5075174,SMARCA4,190
chr1,44532120,44532337,SRX5075168,SMARCA4,217
chr1,44532157,44532417,SRX5054309,FOSL2,260
chr1,44532170,44532428,SRX5075174,SMARCA4,258
chr1,44542730,44543620,SRX5075168,SMARCA4,890
chr1,44542811,44543670,SRX5075174,SMARCA4,859
chr1,44543067,44543536,SRX20140868,INTS10,469
chr1,44543102,44543522,SRX20140895,INTS13,420
chr1,44543125,44543447,SRX16500060,CTCF,322
chr1,44543216,44543447,SRX5716454,SOX3,231
chr1,44543226,44543433,SRX5716464,SMARCA4,207
chr1,44543234,44543564,SRX20140879,CPSF3L,330
chr1,44543264,44543468,SRX5716463,SMARCA4,204
chr1,44543281,44543532,SRX20140867,INTS10,251
chr1,44572044,44572426,SRX16500061,CTCF,382
chr1,44572052,44572495,SRX16500059,CTCF,443
chr1,44572078,44572311,SRX16500062,CTCF,233
chr1,44572078,44572459,SRX16500060,CTCF,381
chr1,44576499,44576859,SRX5075170,SMARCA4,360
chr1,44576536,44576827,SRX5075175,SMARCA4,291
chr1,44576561,44576827,SRX5075176,SMARCA4,266
chr1,44576598,44576834,SRX5075169,SMARCA4,236
chr1,44595038,44595577,SRX16500059,CTCF,539
chr1,44595062,44595539,SRX16500062,CTCF,477
chr1,44595063,44595592,SRX16500060,CTCF,529
chr1,44595096,44595548,SRX16500061,CTCF,452
chr1,44595102,44595510,SRX4174629,CTCF,408
chr1,44595122,44595301,SRX5075168,SMARCA4,179
chr1,44595164,44595405,SRX5075174,SMARCA4,241
chr1,44595206,44595429,SRX5716463,SMARCA4,223
chr1,44606083,44606268,SRX5075170,SMARCA4,185
chr1,44609373,44609820,SRX16500060,CTCF,447
chr1,44609396,44609802,SRX16500059,CTCF,406
chr1,44609438,44609808,SRX16500062,CTCF,370
chr1,44609444,44609787,SRX16500061,CTCF,343
chr1,44617401,44617572,SRX5075170,SMARCA4,171
chr1,44631550,44632355,SRX20140869,INTS10,805
chr1,44631594,44632565,SRX20140895,INTS13,971
chr1,44631694,44632321,SRX20140868,INTS10,627
chr1,44631711,44632565,SRX5075168,SMARCA4,854
chr1,44631718,44631901,SRX5075174,SMARCA4,183
chr1,44631724,44632554,SRX20140897,INTS13,830
chr1,44631737,44632519,SRX20140867,INTS10,782
chr1,44631781,44631991,SRX5075170,SMARCA4,210
chr1,44631805,44632227,SRX20140896,INTS13,422
chr1,44631876,44632252,SRX20140881,CPSF3L,376
chr1,44631958,44632640,SRX5075176,SMARCA4,682
chr1,44632021,44632524,SRX5075174,SMARCA4,503
chr1,44632114,44632359,SRX5716463,SMARCA4,245
chr1,44632270,44632599,SRX5075175,SMARCA4,329
chr1,44632278,44632612,SRX5075170,SMARCA4,334
chr1,44632299,44632637,SRX5716469,SMARCA4,338
chr1,44632328,44632636,SRX5075169,SMARCA4,308
chr1,44637850,44638352,SRX20140895,INTS13,502
chr1,44637864,44638365,SRX20140868,INTS10,501
chr1,44652747,44653265,SRX16500060,CTCF,518
chr1,44652785,44653253,SRX16500059,CTCF,468
chr1,44652787,44653275,SRX16500061,CTCF,488
chr1,44652817,44653253,SRX16500062,CTCF,436
chr1,44652819,44653214,SRX4174629,CTCF,395
chr1,44652850,44653203,SRX5075174,SMARCA4,353
chr1,44652891,44653160,SRX5075170,SMARCA4,269
chr1,44652905,44653112,SRX5075169,SMARCA4,207
chr1,44652913,44653164,SRX5075168,SMARCA4,251
chr1,44652913,44653175,SRX5075176,SMARCA4,262
chr1,44652948,44653159,SRX5716463,SMARCA4,211
chr1,44655513,44655855,SRX16500061,CTCF,342
chr1,44655531,44655893,SRX16500059,CTCF,362
chr1,44655552,44655883,SRX16500060,CTCF,331
chr1,44655563,44655900,SRX16500062,CTCF,337
chr1,44672244,44672651,SRX5075168,SMARCA4,407
chr1,44672271,44672636,SRX5075174,SMARCA4,365
chr1,44672318,44672635,SRX5075170,SMARCA4,317
chr1,44672339,44672566,SRX5054309,FOSL2,227
chr1,44672340,44672555,SRX5054308,FOSL2,215
chr1,44672384,44672607,SRX5075176,SMARCA4,223
chr1,44673875,44674416,SRX5075168,SMARCA4,541
chr1,44673931,44674142,SRX5716470,SMARCA4,211
chr1,44673932,44674461,SRX5075176,SMARCA4,529
chr1,44673956,44674395,SRX5075170,SMARCA4,439
chr1,44673962,44674348,SRX5075174,SMARCA4,386
chr1,44673966,44674203,SRX5075169,SMARCA4,237
chr1,44673999,44674654,SRX20140895,INTS13,655
chr1,44674009,44674198,SRX5075175,SMARCA4,189
chr1,44674027,44674413,SRX5716463,SMARCA4,386
chr1,44674090,44674374,SRX5716464,SMARCA4,284
chr1,44674281,44674572,SRX20140867,INTS10,291
chr1,44674283,44674534,SRX20140897,INTS13,251
chr1,44674391,44674703,SRX5054307,FOSL2,312
chr1,44674585,44674845,SRX5075174,SMARCA4,260
chr1,44677045,44677531,SRX16500060,CTCF,486
chr1,44677101,44677508,SRX16500061,CTCF,407
chr1,44677166,44677477,SRX16500062,CTCF,311
chr1,44677193,44677474,SRX16500059,CTCF,281
chr1,44707131,44707546,SRX5075170,SMARCA4,415
chr1,44707142,44707499,SRX5075169,SMARCA4,357
chr1,44707145,44707525,SRX5075176,SMARCA4,380
chr1,44707149,44707508,SRX5075175,SMARCA4,359
chr1,44707169,44707495,SRX5054309,FOSL2,326
chr1,44707193,44707513,SRX5716469,SMARCA4,320
chr1,44707199,44707450,SRX5054308,FOSL2,251
chr1,44707953,44708166,SRX16500062,CTCF,213
chr1,44707978,44708164,SRX5075176,SMARCA4,186
chr1,44707983,44708195,SRX5075174,SMARCA4,212
chr1,44714858,44715437,SRX16500059,CTCF,579
chr1,44714903,44715529,SRX16500060,CTCF,626
chr1,44714917,44715430,SRX16500062,CTCF,513
chr1,44714934,44715458,SRX16500061,CTCF,524
chr1,44714960,44715356,SRX5075174,SMARCA4,396
chr1,44714974,44715344,SRX5075168,SMARCA4,370
chr1,44715010,44715343,SRX5075170,SMARCA4,333
chr1,44715023,44715281,SRX5075176,SMARCA4,258
chr1,44715027,44715285,SRX5716463,SMARCA4,258
chr1,44715034,44715317,SRX5075169,SMARCA4,283
chr1,44715046,44715305,SRX5716464,SMARCA4,259
chr1,44715055,44715301,SRX5716469,SMARCA4,246
chr1,44715071,44715338,SRX5075175,SMARCA4,267
chr1,44715073,44715284,SRX5716470,SMARCA4,211
chr1,44715098,44715395,SRX4174629,CTCF,297
chr1,44721056,44722097,SRX20140879,CPSF3L,1041
chr1,44721061,44722012,SRX20140867,INTS10,951
chr1,44721097,44722074,SRX20140894,INTS13,977
chr1,44721158,44721973,SRX20140881,CPSF3L,815
chr1,44721296,44722087,SRX20140895,INTS13,791
chr1,44721395,44722008,SRX20140896,INTS13,613
chr1,44721430,44721888,SRX20140897,INTS13,458
chr1,44721448,44721851,SRX20140869,INTS10,403
chr1,44721487,44721955,SRX20140868,INTS10,468
chr1,44729227,44729684,SRX16500060,CTCF,457
chr1,44729250,44729650,SRX16500062,CTCF,400
chr1,44729262,44729696,SRX16500059,CTCF,434
chr1,44729299,44729538,SRX5075168,SMARCA4,239
chr1,44729299,44729642,SRX16500061,CTCF,343
chr1,44729328,44729568,SRX4174629,CTCF,240
chr1,44730098,44731313,SRX20140881,CPSF3L,1215
chr1,44730126,44731366,SRX20140895,INTS13,1240
chr1,44730132,44731366,SRX20140894,INTS13,1234
chr1,44730138,44731350,SRX20140879,CPSF3L,1212
chr1,44730181,44731309,SRX20140867,INTS10,1128
chr1,44730271,44731361,SRX20140869,INTS10,1090
chr1,44730344,44731315,SRX20140868,INTS10,971
chr1,44730409,44731216,SRX20140896,INTS13,807
chr1,44730543,44731318,SRX20140897,INTS13,775
chr1,44730641,44731207,SRX20140880,CPSF3L,566
chr1,44730908,44731555,SRX5716470,SMARCA4,647
chr1,44730978,44731553,SRX5075175,SMARCA4,575
chr1,44731136,44731543,SRX5075169,SMARCA4,407
chr1,44731144,44731539,SRX5054309,FOSL2,395
chr1,44731154,44731527,SRX5054308,FOSL2,373
chr1,44731161,44731376,SRX5716451,SOX2,215
chr1,44731175,44731663,SRX16500060,CTCF,488
chr1,44731200,44731591,SRX5075176,SMARCA4,391
chr1,44731205,44731546,SRX5054307,FOSL2,341
chr1,44731205,44731582,SRX5075168,SMARCA4,377
chr1,44731209,44731582,SRX5075174,SMARCA4,373
chr1,44731219,44731590,SRX5075170,SMARCA4,371
chr1,44731221,44731666,SRX16500061,CTCF,445
chr1,44731222,44731645,SRX16500062,CTCF,423
chr1,44731230,44731527,SRX5020211,SMARCA2,297
chr1,44731243,44731676,SRX16500059,CTCF,433
chr1,44731272,44731552,SRX5716464,SMARCA4,280
chr1,44731290,44731571,SRX5716469,SMARCA4,281
chr1,44731377,44731591,SRX5716463,SMARCA4,214
chr1,44739393,44739712,SRX20140869,INTS10,319
chr1,44739416,44740009,SRX5075174,SMARCA4,593
chr1,44739420,44739780,SRX5075169,SMARCA4,360
chr1,44739434,44740066,SRX20140895,INTS13,632
chr1,44739451,44739950,SRX5075168,SMARCA4,499
chr1,44739459,44739883,SRX5716470,SMARCA4,424
chr1,44739459,44739900,SRX5075170,SMARCA4,441
chr1,44739490,44739867,SRX5075176,SMARCA4,377
chr1,44739496,44739841,SRX5075175,SMARCA4,345
chr1,44739512,44739745,SRX5716469,SMARCA4,233
chr1,44739544,44739833,SRX5716463,SMARCA4,289
chr1,44739548,44739940,SRX5716464,SMARCA4,392
chr1,44739560,44739902,SRX20140867,INTS10,342
chr1,44739584,44739856,SRX5054309,FOSL2,272
chr1,44739659,44739838,SRX5054307,FOSL2,179
chr1,44739662,44739989,SRX20140881,CPSF3L,327
chr1,44739671,44739859,SRX5054308,FOSL2,188
chr1,44775126,44775513,SRX5716463,SMARCA4,387
chr1,44775126,44775626,SRX5075170,SMARCA4,500
chr1,44775179,44775709,SRX5075176,SMARCA4,530
chr1,44775179,44775750,SRX5075168,SMARCA4,571
chr1,44775243,44775968,SRX20140868,INTS10,725
chr1,44775249,44775460,SRX5716464,SMARCA4,211
chr1,44775251,44775843,SRX20140897,INTS13,592
chr1,44775255,44775876,SRX20140881,CPSF3L,621
chr1,44775257,44775987,SRX20140895,INTS13,730
chr1,44775258,44775818,SRX5075174,SMARCA4,560
chr1,44775258,44775906,SRX20140869,INTS10,648
chr1,44775260,44775874,SRX20140896,INTS13,614
chr1,44775264,44775479,SRX5716469,SMARCA4,215
chr1,44775301,44775885,SRX20140879,CPSF3L,584
chr1,44775322,44775603,SRX5716454,SOX3,281
chr1,44775334,44775658,SRX20140894,INTS13,324
chr1,44775336,44775651,SRX5075175,SMARCA4,315
chr1,44775339,44775915,SRX20140867,INTS10,576
chr1,44775349,44775565,SRX5716451,SOX2,216
chr1,44786019,44786553,SRX16500059,CTCF,534
chr1,44786029,44786546,SRX16500061,CTCF,517
chr1,44786036,44786507,SRX16500060,CTCF,471
chr1,44786045,44786526,SRX16500062,CTCF,481
chr1,44786118,44786374,SRX5075168,SMARCA4,256
chr1,44786160,44786466,SRX5075174,SMARCA4,306
chr1,44786233,44786492,SRX5716463,SMARCA4,259
chr1,44786268,44786471,SRX5075176,SMARCA4,203
chr1,44793647,44794077,SRX16500059,CTCF,430
chr1,44793699,44794024,SRX16500060,CTCF,325
chr1,44793704,44793949,SRX5075170,SMARCA4,245
chr1,44793713,44793945,SRX5075174,SMARCA4,232
chr1,44793719,44794065,SRX16500061,CTCF,346
chr1,44793759,44793983,SRX16500062,CTCF,224
chr1,44796798,44797003,SRX5054308,FOSL2,205
chr1,44799577,44800175,SRX16500059,CTCF,598
chr1,44799590,44800154,SRX16500060,CTCF,564
chr1,44799605,44800129,SRX16500061,CTCF,524
chr1,44799649,44800493,SRX5075174,SMARCA4,844
chr1,44799657,44800564,SRX5075168,SMARCA4,907
chr1,44799660,44800142,SRX16500062,CTCF,482
chr1,44799664,44800490,SRX5075170,SMARCA4,826
chr1,44799671,44800503,SRX5075176,SMARCA4,832
chr1,44799704,44800329,SRX5075175,SMARCA4,625
chr1,44799707,44800232,SRX5075169,SMARCA4,525
chr1,44799718,44799991,SRX4174629,CTCF,273
chr1,44799731,44800160,SRX5716470,SMARCA4,429
chr1,44799732,44800181,SRX5716464,SMARCA4,449
chr1,44799764,44800562,SRX20140868,INTS10,798
chr1,44799781,44800558,SRX20140895,INTS13,777
chr1,44799796,44800138,SRX5075181,SMARCA2,342
chr1,44799816,44800155,SRX5716468,SMARCA2,339
chr1,44799829,44800192,SRX20140869,INTS10,363
chr1,44799831,44800508,SRX20140867,INTS10,677
chr1,44799843,44800205,SRX20140897,INTS13,362
chr1,44799853,44800177,SRX20140881,CPSF3L,324
chr1,44799875,44800166,SRX20140894,INTS13,291
chr1,44799888,44800276,SRX20140879,CPSF3L,388
chr1,44799958,44800166,SRX5716463,SMARCA4,208
chr1,44799959,44800224,SRX5716469,SMARCA4,265
chr1,44799977,44800200,SRX5054307,FOSL2,223
chr1,44799989,44800233,SRX5054308,FOSL2,244
chr1,44800138,44800369,SRX5054309,FOSL2,231
chr1,44800277,44800534,SRX5716469,SMARCA4,257
chr1,44800287,44800493,SRX5075169,SMARCA4,206
chr1,44802444,44802740,SRX5075174,SMARCA4,296
chr1,44807095,44807981,SRX5075170,SMARCA4,886
chr1,44807096,44807945,SRX5716469,SMARCA4,849
chr1,44807134,44807941,SRX5075176,SMARCA4,807
chr1,44807159,44807884,SRX5075169,SMARCA4,725
chr1,44807172,44807828,SRX5054308,FOSL2,656
chr1,44807177,44807582,SRX5020211,SMARCA2,405
chr1,44807184,44807862,SRX5054309,FOSL2,678
chr1,44807193,44807591,SRX5075174,SMARCA4,398
chr1,44807200,44808122,SRX5075175,SMARCA4,922
chr1,44807215,44808252,SRX5716470,SMARCA4,1037
chr1,44807241,44807921,SRX5075168,SMARCA4,680
chr1,44807247,44807626,SRX5716467,SMARCA2,379
chr1,44807248,44807529,SRX5716468,SMARCA2,281
chr1,44807296,44807505,SRX5020214,SMARCA2,209
chr1,44807441,44807718,SRX20140869,INTS10,277
chr1,44807491,44807761,SRX20140897,INTS13,270
chr1,44807680,44807897,SRX5020214,SMARCA2,217
chr1,44807726,44808054,SRX5075174,SMARCA4,328
chr1,44808305,44808582,SRX5075168,SMARCA4,277
chr1,44808329,44808709,SRX20140895,INTS13,380
chr1,44808363,44808643,SRX5075174,SMARCA4,280
chr1,44811825,44812037,SRX5054309,FOSL2,212
chr1,44811831,44812011,SRX5054308,FOSL2,180
chr1,44819249,44820194,SRX20140867,INTS10,945
chr1,44819270,44820158,SRX20140869,INTS10,888
chr1,44819276,44820201,SRX20140881,CPSF3L,925
chr1,44819280,44820114,SRX20140896,INTS13,834
chr1,44819300,44820165,SRX20140879,CPSF3L,865
chr1,44819341,44820218,SRX20140895,INTS13,877
chr1,44819344,44819852,SRX5075170,SMARCA4,508
chr1,44819381,44820145,SRX20140894,INTS13,764
chr1,44819421,44819609,SRX5075175,SMARCA4,188
chr1,44819423,44819773,SRX5075176,SMARCA4,350
chr1,44819440,44819908,SRX20140880,CPSF3L,468
chr1,44819451,44820139,SRX20140897,INTS13,688
chr1,44819470,44820198,SRX20140868,INTS10,728
chr1,44819518,44819867,SRX5075174,SMARCA4,349
chr1,44819518,44819972,SRX5075169,SMARCA4,454
chr1,44835649,44836301,SRX16500059,CTCF,652
chr1,44835697,44836282,SRX16500060,CTCF,585
chr1,44835710,44836263,SRX16500062,CTCF,553
chr1,44835765,44836311,SRX16500061,CTCF,546
chr1,44835812,44836196,SRX4174629,CTCF,384
chr1,44835884,44836226,SRX5075168,SMARCA4,342
chr1,44835905,44836204,SRX5075174,SMARCA4,299
chr1,44835907,44836267,SRX5075170,SMARCA4,360
chr1,44835919,44836210,SRX5075169,SMARCA4,291
chr1,44835944,44836290,SRX5075175,SMARCA4,346
chr1,44835952,44836243,SRX5075176,SMARCA4,291
chr1,44835978,44836190,SRX5716463,SMARCA4,212
chr1,44835982,44836223,SRX5716464,SMARCA4,241
chr1,44842965,44843483,SRX20140895,INTS13,518
chr1,44843017,44843498,SRX5075169,SMARCA4,481
chr1,44843024,44843647,SRX5075174,SMARCA4,623
chr1,44843046,44843618,SRX5075168,SMARCA4,572
chr1,44843062,44843572,SRX5716470,SMARCA4,510
chr1,44843095,44843523,SRX5075176,SMARCA4,428
chr1,44843121,44843525,SRX5075175,SMARCA4,404
chr1,44843122,44843522,SRX20140868,INTS10,400
chr1,44843126,44843509,SRX5716463,SMARCA4,383
chr1,44843138,44843515,SRX5716464,SMARCA4,377
chr1,44843143,44843571,SRX5075170,SMARCA4,428
chr1,44843172,44843453,SRX5716469,SMARCA4,281
chr1,44843241,44843448,SRX5054307,FOSL2,207
chr1,44884843,44885097,SRX5075176,SMARCA4,254
chr1,44884915,44885150,SRX5075170,SMARCA4,235
chr1,44903207,44903760,SRX5075176,SMARCA4,553
chr1,44903226,44903736,SRX5075170,SMARCA4,510
chr1,44903259,44903548,SRX5075169,SMARCA4,289
chr1,44903280,44903683,SRX5075175,SMARCA4,403
chr1,44903295,44903540,SRX5716469,SMARCA4,245
chr1,44903300,44903721,SRX5716467,SMARCA2,421
chr1,44903392,44903613,SRX5716468,SMARCA2,221
chr1,44903436,44903747,SRX5716470,SMARCA4,311
chr1,44910050,44910408,SRX5075176,SMARCA4,358
chr1,44924765,44925108,SRX5054308,FOSL2,343
chr1,44924776,44925148,SRX5054309,FOSL2,372
chr1,44924801,44925167,SRX5075176,SMARCA4,366
chr1,44924809,44925208,SRX5075169,SMARCA4,399
chr1,44924841,44925264,SRX5075170,SMARCA4,423
chr1,44925174,44925417,SRX16500059,CTCF,243
chr1,44926302,44926903,SRX5075170,SMARCA4,601
chr1,44926324,44926883,SRX5075176,SMARCA4,559
chr1,44926331,44926847,SRX5075169,SMARCA4,516
chr1,44926341,44926657,SRX5716469,SMARCA4,316
chr1,44926364,44926801,SRX5716467,SMARCA2,437
chr1,44926377,44926802,SRX5716470,SMARCA4,425
chr1,44926382,44926856,SRX5075175,SMARCA4,474
chr1,44926480,44926752,SRX5054308,FOSL2,272
chr1,44929543,44929921,SRX5075169,SMARCA4,378
chr1,44929548,44929876,SRX5075175,SMARCA4,328
chr1,44929576,44929865,SRX5716467,SMARCA2,289
chr1,44929583,44929927,SRX5075176,SMARCA4,344
chr1,44929588,44929882,SRX5716469,SMARCA4,294
chr1,44929600,44929910,SRX5075170,SMARCA4,310
chr1,44929625,44929864,SRX5054308,FOSL2,239
chr1,44929631,44929847,SRX5020211,SMARCA2,216
chr1,44929643,44929828,SRX5054309,FOSL2,185
chr1,44929661,44929901,SRX5716470,SMARCA4,240
chr1,44947065,44947838,SRX5075170,SMARCA4,773
chr1,44947072,44947724,SRX5716470,SMARCA4,652
chr1,44947189,44947779,SRX5075169,SMARCA4,590
chr1,44947287,44947817,SRX5075176,SMARCA4,530
chr1,44947304,44947673,SRX5716468,SMARCA2,369
chr1,44947348,44947651,SRX5716467,SMARCA2,303
chr1,44947363,44947769,SRX5716469,SMARCA4,406
chr1,44947376,44947801,SRX5075175,SMARCA4,425
chr1,44947436,44947696,SRX5020211,SMARCA2,260
chr1,44947447,44947672,SRX5075181,SMARCA2,225
chr1,44947469,44947660,SRX5054308,FOSL2,191
chr1,44986340,44986869,SRX5075169,SMARCA4,529
chr1,44986353,44986873,SRX5075176,SMARCA4,520
chr1,44986374,44986645,SRX20140897,INTS13,271
chr1,44986381,44986843,SRX5075170,SMARCA4,462
chr1,44986404,44986887,SRX5075168,SMARCA4,483
chr1,44986407,44986974,SRX20140895,INTS13,567
chr1,44986428,44986917,SRX5075174,SMARCA4,489
chr1,44986438,44986796,SRX20140879,CPSF3L,358
chr1,44986438,44986899,SRX5716470,SMARCA4,461
chr1,44986451,44986671,SRX20140867,INTS10,220
chr1,44986469,44986777,SRX5716464,SMARCA4,308
chr1,44986503,44986968,SRX5075175,SMARCA4,465
chr1,44986504,44986800,SRX5054309,FOSL2,296
chr1,44986527,44986799,SRX5716463,SMARCA4,272
chr1,44986537,44986754,SRX5716469,SMARCA4,217
chr1,45011927,45012450,SRX20140895,INTS13,523
chr1,45011936,45012355,SRX5075174,SMARCA4,419
chr1,45012012,45012383,SRX20140897,INTS13,371
chr1,45012021,45012223,SRX5075170,SMARCA4,202
chr1,45012044,45012305,SRX5075168,SMARCA4,261
chr1,45012067,45012332,SRX5716464,SMARCA4,265
chr1,45012079,45012290,SRX5075176,SMARCA4,211
chr1,45014362,45014897,SRX16500059,CTCF,535
chr1,45014419,45014872,SRX16500060,CTCF,453
chr1,45014443,45014836,SRX16500062,CTCF,393
chr1,45014448,45014829,SRX16500061,CTCF,381
chr1,45014484,45014938,SRX4174629,CTCF,454
chr1,45014591,45014920,SRX5075176,SMARCA4,329
chr1,45014605,45014795,SRX5075174,SMARCA4,190
chr1,45014615,45014899,SRX5075170,SMARCA4,284
chr1,45014620,45014839,SRX5075169,SMARCA4,219
chr1,45014630,45014943,SRX5716469,SMARCA4,313
chr1,45014637,45014848,SRX5716470,SMARCA4,211
chr1,45014649,45014884,SRX5075175,SMARCA4,235
chr1,45018627,45019036,SRX16500059,CTCF,409
chr1,45018631,45018960,SRX16500062,CTCF,329
chr1,45018643,45019011,SRX16500060,CTCF,368
chr1,45018672,45019044,SRX16500061,CTCF,372
chr1,45206005,45206715,SRX20140895,INTS13,710
chr1,45206099,45206704,SRX20140868,INTS10,605
chr1,45206125,45206644,SRX20140867,INTS10,519
chr1,45206363,45206805,SRX5075174,SMARCA4,442
chr1,45206391,45206659,SRX5075176,SMARCA4,268
chr1,45206447,45206836,SRX5075168,SMARCA4,389
chr1,45206477,45206664,SRX5075175,SMARCA4,187
chr1,45206505,45206731,SRX5716470,SMARCA4,226
chr1,45266353,45266638,SRX5716469,SMARCA4,285
chr1,45266401,45266688,SRX5054308,FOSL2,287
chr1,45266440,45266687,SRX5075169,SMARCA4,247
chr1,45266473,45266689,SRX5075175,SMARCA4,216
chr1,45297607,45298006,SRX20140895,INTS13,399
chr1,45297750,45298004,SRX5075174,SMARCA4,254
chr1,45300226,45300648,SRX16500062,CTCF,422
chr1,45300248,45300717,SRX16500060,CTCF,469
chr1,45300291,45300658,SRX16500061,CTCF,367
chr1,45300291,45300741,SRX4174629,CTCF,450
chr1,45300300,45300717,SRX16500059,CTCF,417
chr1,45303333,45303675,SRX5054309,FOSL2,342
chr1,45303348,45303560,SRX5716469,SMARCA4,212
chr1,45303350,45303767,SRX5054308,FOSL2,417
chr1,45303366,45303626,SRX5075175,SMARCA4,260
chr1,45303394,45304116,SRX5075168,SMARCA4,722
chr1,45303404,45304208,SRX5075174,SMARCA4,804
chr1,45303406,45304018,SRX5075170,SMARCA4,612
chr1,45303418,45303633,SRX5075169,SMARCA4,215
chr1,45303425,45304078,SRX5075176,SMARCA4,653
chr1,45303453,45303764,SRX5716470,SMARCA4,311
chr1,45303472,45303768,SRX5716464,SMARCA4,296
chr1,45303499,45303955,SRX5716463,SMARCA4,456
chr1,45303521,45303847,SRX5054307,FOSL2,326
chr1,45303715,45304153,SRX5075169,SMARCA4,438
chr1,45303767,45304252,SRX20140895,INTS13,485
chr1,45303801,45304191,SRX20140868,INTS10,390
chr1,45303816,45304170,SRX5716470,SMARCA4,354
chr1,45303817,45304078,SRX5075175,SMARCA4,261
chr1,45303840,45304131,SRX20140897,INTS13,291
chr1,45303846,45304175,SRX20140867,INTS10,329
chr1,45303875,45304272,SRX5716469,SMARCA4,397
chr1,45303875,45304273,SRX16500060,CTCF,398
chr1,45303880,45304322,SRX16500059,CTCF,442
chr1,45303883,45304286,SRX16500061,CTCF,403
chr1,45303885,45304237,SRX16500062,CTCF,352
chr1,45303893,45304252,SRX4174629,CTCF,359
chr1,45329445,45329853,SRX5075168,SMARCA4,408
chr1,45329454,45329787,SRX5075174,SMARCA4,333
chr1,45339611,45340428,SRX5075168,SMARCA4,817
chr1,45339613,45340572,SRX20140895,INTS13,959
chr1,45339709,45340205,SRX5716470,SMARCA4,496
chr1,45339729,45340046,SRX5075175,SMARCA4,317
chr1,45339749,45340183,SRX5075170,SMARCA4,434
chr1,45339781,45340450,SRX20140867,INTS10,669
chr1,45339795,45340386,SRX5075174,SMARCA4,591
chr1,45339803,45340533,SRX20140868,INTS10,730
chr1,45339806,45340488,SRX20140879,CPSF3L,682
chr1,45339839,45340154,SRX5716463,SMARCA4,315
chr1,45339846,45340306,SRX5075176,SMARCA4,460
chr1,45339885,45340343,SRX20140897,INTS13,458
chr1,45339941,45340480,SRX20140881,CPSF3L,539
chr1,45339973,45340359,SRX5075169,SMARCA4,386
chr1,45340011,45340400,SRX20140869,INTS10,389
chr1,45340120,45340453,SRX20140894,INTS13,333
chr1,45359705,45360153,SRX4174629,CTCF,448
chr1,45359706,45360243,SRX16500060,CTCF,537
chr1,45359722,45360210,SRX16500059,CTCF,488
chr1,45359757,45360255,SRX16500062,CTCF,498
chr1,45359766,45360286,SRX16500061,CTCF,520
chr1,45359907,45360097,SRX5075170,SMARCA4,190
chr1,45359943,45360118,SRX5075176,SMARCA4,175
chr1,45361102,45361304,SRX5075170,SMARCA4,202
chr1,45442178,45442478,SRX5054308,FOSL2,300
chr1,45442202,45442547,SRX5054309,FOSL2,345
chr1,45442217,45442588,SRX5716469,SMARCA4,371
chr1,45442235,45442645,SRX5075170,SMARCA4,410
chr1,45442246,45442662,SRX5075176,SMARCA4,416
chr1,45442247,45442670,SRX5075169,SMARCA4,423
chr1,45442250,45442576,SRX5075175,SMARCA4,326
chr1,45442267,45442638,SRX5716470,SMARCA4,371
chr1,45442288,45442597,SRX5716467,SMARCA2,309
chr1,45490747,45491206,SRX5716470,SMARCA4,459
chr1,45490751,45491244,SRX5075175,SMARCA4,493
chr1,45490970,45491495,SRX20140895,INTS13,525
chr1,45490979,45491243,SRX5075170,SMARCA4,264
chr1,45490995,45491439,SRX5075168,SMARCA4,444
chr1,45491019,45491282,SRX5075169,SMARCA4,263
chr1,45491059,45491596,SRX5075174,SMARCA4,537
chr1,45491084,45491368,SRX20140897,INTS13,284
chr1,45491134,45491449,SRX5075176,SMARCA4,315
chr1,45491137,45491488,SRX5054307,FOSL2,351
chr1,45491177,45491465,SRX5716451,SOX2,288
chr1,45491219,45491468,SRX5054308,FOSL2,249
chr1,45491220,45491444,SRX5716463,SMARCA4,224
chr1,45491232,45491475,SRX5716454,SOX3,243
chr1,45493044,45493536,SRX4174629,CTCF,492
chr1,45493089,45493503,SRX16500060,CTCF,414
chr1,45493091,45493551,SRX16500059,CTCF,460
chr1,45493112,45493482,SRX16500061,CTCF,370
chr1,45493140,45493513,SRX16500062,CTCF,373
chr1,45499879,45500494,SRX5075174,SMARCA4,615
chr1,45499896,45500484,SRX5075176,SMARCA4,588
chr1,45499913,45500103,SRX5075168,SMARCA4,190
chr1,45499920,45500401,SRX5075170,SMARCA4,481
chr1,45500005,45500222,SRX5716463,SMARCA4,217
chr1,45500038,45500562,SRX20140895,INTS13,524
chr1,45500042,45500281,SRX5716451,SOX2,239
chr1,45500042,45500515,SRX20140868,INTS10,473
chr1,45500074,45500570,SRX20140869,INTS10,496
chr1,45500076,45500348,SRX5054309,FOSL2,272
chr1,45500076,45500391,SRX20140881,CPSF3L,315
chr1,45500089,45500377,SRX5054308,FOSL2,288
chr1,45500114,45500622,SRX20140897,INTS13,508
chr1,45500137,45500445,SRX20140879,CPSF3L,308
chr1,45500187,45500409,SRX20140867,INTS10,222
chr1,45500220,45500478,SRX5075168,SMARCA4,258
chr1,45500223,45500549,SRX20140894,INTS13,326
chr1,45512474,45513015,SRX16500059,CTCF,541
chr1,45512497,45512965,SRX16500061,CTCF,468
chr1,45512513,45513025,SRX16500060,CTCF,512
chr1,45512539,45512964,SRX16500062,CTCF,425
chr1,45512567,45512954,SRX4174629,CTCF,387
chr1,45512695,45512886,SRX5075168,SMARCA4,191
chr1,45521436,45522200,SRX20140895,INTS13,764
chr1,45521440,45522237,SRX20140881,CPSF3L,797
chr1,45521533,45522174,SRX20140868,INTS10,641
chr1,45521534,45522092,SRX20140879,CPSF3L,558
chr1,45521568,45522039,SRX20140896,INTS13,471
chr1,45521579,45522204,SRX20140867,INTS10,625
chr1,45521596,45522288,SRX20140897,INTS13,692
chr1,45521617,45522124,SRX20140869,INTS10,507
chr1,45521641,45521998,SRX20140880,CPSF3L,357
chr1,45521652,45522000,SRX20140894,INTS13,348
chr1,45521707,45522188,SRX5075174,SMARCA4,481
chr1,45521721,45522310,SRX5075176,SMARCA4,589
chr1,45521771,45522055,SRX20140882,CPSF3L,284
chr1,45521771,45522231,SRX5075168,SMARCA4,460
chr1,45521774,45522074,SRX5716463,SMARCA4,300
chr1,45521820,45522252,SRX5075169,SMARCA4,432
chr1,45521847,45522249,SRX5075175,SMARCA4,402
chr1,45521881,45522230,SRX5075170,SMARCA4,349
chr1,45521890,45522107,SRX5054309,FOSL2,217
chr1,45521908,45522292,SRX5716470,SMARCA4,384
chr1,45521913,45522095,SRX5054308,FOSL2,182
chr1,45521996,45522195,SRX5075181,SMARCA2,199
chr1,45522040,45522288,SRX5716469,SMARCA4,248
chr1,45550453,45551140,SRX20140868,INTS10,687
chr1,45550491,45551000,SRX5075169,SMARCA4,509
chr1,45550531,45551167,SRX20140895,INTS13,636
chr1,45550532,45550994,SRX5075174,SMARCA4,462
chr1,45550545,45550808,SRX5075170,SMARCA4,263
chr1,45550559,45551211,SRX5075176,SMARCA4,652
chr1,45550578,45551150,SRX5075168,SMARCA4,572
chr1,45550580,45550871,SRX5716464,SMARCA4,291
chr1,45550596,45550941,SRX5716470,SMARCA4,345
chr1,45550620,45551112,SRX20140867,INTS10,492
chr1,45550626,45551072,SRX20140897,INTS13,446
chr1,45550871,45551083,SRX5716469,SMARCA4,212
chr1,45550879,45551121,SRX5075170,SMARCA4,242
chr1,45569965,45570576,SRX16500060,CTCF,611
chr1,45569976,45570530,SRX16500059,CTCF,554
chr1,45570006,45570468,SRX16500061,CTCF,462
chr1,45570014,45570359,SRX5075176,SMARCA4,345
chr1,45570044,45570284,SRX5716463,SMARCA4,240
chr1,45570045,45570431,SRX5075174,SMARCA4,386
chr1,45570045,45570546,SRX16500062,CTCF,501
chr1,45570052,45570349,SRX5075168,SMARCA4,297
chr1,45570053,45570462,SRX4174629,CTCF,409
chr1,45570080,45570355,SRX5075170,SMARCA4,275
chr1,45570103,45570338,SRX5075169,SMARCA4,235
chr1,45570115,45570321,SRX5716464,SMARCA4,206
chr1,45583273,45583507,SRX5075174,SMARCA4,234
chr1,45583312,45583495,SRX5075170,SMARCA4,183
chr1,45583322,45583586,SRX5075168,SMARCA4,264
chr1,45583812,45584977,SRX20140895,INTS13,1165
chr1,45583828,45584596,SRX20140867,INTS10,768
chr1,45583830,45584626,SRX20140868,INTS10,796
chr1,45583877,45584514,SRX20140881,CPSF3L,637
chr1,45583904,45584643,SRX20140897,INTS13,739
chr1,45583945,45584325,SRX20140896,INTS13,380
chr1,45583955,45584473,SRX20140869,INTS10,518
chr1,45583978,45584467,SRX20140879,CPSF3L,489
chr1,45583986,45584306,SRX20140880,CPSF3L,320
chr1,45584032,45584445,SRX20140894,INTS13,413
chr1,45584282,45584518,SRX16500060,CTCF,236
chr1,45584608,45584833,SRX5075176,SMARCA4,225
chr1,45584656,45585227,SRX5075174,SMARCA4,571
chr1,45584737,45584962,SRX20140867,INTS10,225
chr1,45584742,45584986,SRX5716451,SOX2,244
chr1,45584805,45585215,SRX5075168,SMARCA4,410
chr1,45584836,45585195,SRX20140879,CPSF3L,359
chr1,45601853,45602296,SRX5075169,SMARCA4,443
chr1,45601864,45602163,SRX5054309,FOSL2,299
chr1,45601876,45602200,SRX5054308,FOSL2,324
chr1,45601910,45602417,SRX5075170,SMARCA4,507
chr1,45601935,45602333,SRX5716469,SMARCA4,398
chr1,45601962,45602236,SRX5075175,SMARCA4,274
chr1,45601970,45602463,SRX5075176,SMARCA4,493
chr1,45602042,45602257,SRX5716467,SMARCA2,215
chr1,45602176,45602405,SRX5716470,SMARCA4,229
chr1,45617682,45617882,SRX5054308,FOSL2,200
chr1,45686327,45687147,SRX20140895,INTS13,820
chr1,45686377,45686563,SRX5075174,SMARCA4,186
chr1,45686484,45686695,SRX5075168,SMARCA4,211
chr1,45686704,45687509,SRX20140897,INTS13,805
chr1,45686925,45687139,SRX20140867,INTS10,214
chr1,45687051,45687316,SRX5075168,SMARCA4,265
chr1,45687067,45687344,SRX5075174,SMARCA4,277
chr1,45687179,45687440,SRX20140868,INTS10,261
chr1,45687195,45687563,SRX20140895,INTS13,368
chr1,45688042,45688338,SRX5075174,SMARCA4,296
chr1,45750159,45751037,SRX5075174,SMARCA4,878
chr1,45750264,45750740,SRX5716470,SMARCA4,476
chr1,45750288,45751024,SRX5075170,SMARCA4,736
chr1,45750300,45751042,SRX20140868,INTS10,742
chr1,45750332,45751162,SRX20140895,INTS13,830
chr1,45750345,45751077,SRX5075168,SMARCA4,732
chr1,45750366,45751070,SRX20140869,INTS10,704
chr1,45750393,45750673,SRX5716469,SMARCA4,280
chr1,45750415,45751035,SRX20140867,INTS10,620
chr1,45750444,45751037,SRX20140879,CPSF3L,593
chr1,45750452,45750764,SRX20140881,CPSF3L,312
chr1,45750477,45751049,SRX5075176,SMARCA4,572
chr1,45750488,45751000,SRX20140897,INTS13,512
chr1,45750550,45750766,SRX5075175,SMARCA4,216
chr1,45750577,45751003,SRX5075169,SMARCA4,426
chr1,45750599,45750782,SRX5054309,FOSL2,183
chr1,45750719,45750970,SRX5716463,SMARCA4,251
chr1,45750825,45751037,SRX5075175,SMARCA4,212
chr1,45767106,45767294,SRX5054309,FOSL2,188
chr1,45767175,45767355,SRX5054308,FOSL2,180
chr1,45767241,45767432,SRX5075170,SMARCA4,191
chr1,45802669,45803134,SRX5075176,SMARCA4,465
chr1,45802691,45803168,SRX5075169,SMARCA4,477
chr1,45802700,45803178,SRX5075170,SMARCA4,478
chr1,45802716,45803131,SRX5075175,SMARCA4,415
chr1,45802720,45803151,SRX5054309,FOSL2,431
chr1,45802724,45803194,SRX5716469,SMARCA4,470
chr1,45802730,45803066,SRX5075174,SMARCA4,336
chr1,45802752,45803074,SRX5054308,FOSL2,322
chr1,45802767,45803097,SRX5716470,SMARCA4,330
chr1,45802772,45803068,SRX5075168,SMARCA4,296
chr1,45802773,45803043,SRX5020211,SMARCA2,270
chr1,45802831,45803091,SRX5716467,SMARCA2,260
chr1,45802833,45803012,SRX5054307,FOSL2,179
chr1,45803323,45803631,SRX5716464,SMARCA4,308
chr1,45803323,45803715,SRX5075168,SMARCA4,392
chr1,45803337,45803666,SRX5075176,SMARCA4,329
chr1,45803361,45803705,SRX5075174,SMARCA4,344
chr1,45803367,45803931,SRX20140868,INTS10,564
chr1,45803379,45803672,SRX5075170,SMARCA4,293
chr1,45803383,45804097,SRX20140895,INTS13,714
chr1,45803413,45803646,SRX5716463,SMARCA4,233
chr1,45803458,45803840,SRX20140867,INTS10,382
chr1,45843618,45843862,SRX5075170,SMARCA4,244
chr1,45843703,45843925,SRX16500060,CTCF,222
chr1,45864218,45864544,SRX5075168,SMARCA4,326
chr1,45872170,45872538,SRX5075169,SMARCA4,368
chr1,45872204,45872497,SRX5075170,SMARCA4,293
chr1,45872204,45872556,SRX5075175,SMARCA4,352
chr1,45872240,45872499,SRX5075176,SMARCA4,259
chr1,45872306,45872557,SRX5054309,FOSL2,251
chr1,45872346,45872580,SRX5716469,SMARCA4,234
chr1,45872360,45872544,SRX5054308,FOSL2,184
chr1,45881563,45881916,SRX16500059,CTCF,353
chr1,45881570,45881968,SRX16500061,CTCF,398
chr1,45881578,45881960,SRX16500060,CTCF,382
chr1,45881591,45881920,SRX5716470,SMARCA4,329
chr1,45881602,45881898,SRX5075169,SMARCA4,296
chr1,45881606,45881898,SRX5075170,SMARCA4,292
chr1,45881611,45881889,SRX5075168,SMARCA4,278
chr1,45881619,45881945,SRX16500062,CTCF,326
chr1,45881635,45881917,SRX5075174,SMARCA4,282
chr1,45881643,45881890,SRX5075176,SMARCA4,247
chr1,45881738,45881944,SRX5716464,SMARCA4,206
chr1,45892272,45892680,SRX5716470,SMARCA4,408
chr1,45892289,45892708,SRX5054308,FOSL2,419
chr1,45892299,45892758,SRX5075170,SMARCA4,459
chr1,45892301,45892774,SRX5075176,SMARCA4,473
chr1,45892327,45892793,SRX5075168,SMARCA4,466
chr1,45892342,45892800,SRX5075169,SMARCA4,458
chr1,45892349,45892756,SRX5075175,SMARCA4,407
chr1,45892359,45892664,SRX5020211,SMARCA2,305
chr1,45892393,45892743,SRX5054309,FOSL2,350
chr1,45892407,45892647,SRX5716467,SMARCA2,240
chr1,45892420,45892688,SRX5716469,SMARCA4,268
chr1,45892515,45892711,SRX5075174,SMARCA4,196
chr1,45909677,45909721,SRX1424892,POU3F2,44
chr1,45909680,45909722,SRX1424891,POU3F2,42
chr1,45909690,45909731,SRX1424894,POU3F2,41
chr1,45913078,45913548,SRX5075169,SMARCA4,470
chr1,45913139,45913564,SRX5716467,SMARCA2,425
chr1,45913216,45913488,SRX5075175,SMARCA4,272
chr1,45913217,45913520,SRX5075170,SMARCA4,303
chr1,45913220,45913574,SRX5716470,SMARCA4,354
chr1,45913275,45913512,SRX5075176,SMARCA4,237
chr1,45913301,45913747,SRX5716469,SMARCA4,446
chr1,45929169,45929643,SRX5716469,SMARCA4,474
chr1,45929174,45929648,SRX5075170,SMARCA4,474
chr1,45929186,45929636,SRX5075169,SMARCA4,450
chr1,45929188,45929616,SRX5075175,SMARCA4,428
chr1,45929194,45929633,SRX5054309,FOSL2,439
chr1,45929224,45929617,SRX5054308,FOSL2,393
chr1,45929230,45929666,SRX5075176,SMARCA4,436
chr1,45929241,45929563,SRX5075168,SMARCA4,322
chr1,45929241,45929586,SRX5020214,SMARCA2,345
chr1,45929283,45929600,SRX5075174,SMARCA4,317
chr1,45929284,45929690,SRX5716470,SMARCA4,406
chr1,45929304,45929493,SRX5075182,SMARCA2,189
chr1,45929305,45929596,SRX5716467,SMARCA2,291
chr1,45945457,45945793,SRX5716467,SMARCA2,336
chr1,45945458,45945860,SRX5054309,FOSL2,402
chr1,45945462,45945862,SRX5075176,SMARCA4,400
chr1,45945490,45945835,SRX5075170,SMARCA4,345
chr1,45945494,45945863,SRX5075175,SMARCA4,369
chr1,45945545,45945832,SRX5054308,FOSL2,287
chr1,45945571,45945771,SRX5020211,SMARCA2,200
chr1,45945613,45945927,SRX5075169,SMARCA4,314
chr1,45945618,45945830,SRX5716469,SMARCA4,212
chr1,45953902,45954308,SRX5075170,SMARCA4,406
chr1,45953921,45954301,SRX5075176,SMARCA4,380
chr1,45953955,45954308,SRX5075169,SMARCA4,353
chr1,45954023,45954269,SRX5075175,SMARCA4,246
chr1,45954065,45954308,SRX5716467,SMARCA2,243
chr1,45954081,45954374,SRX5716470,SMARCA4,293
chr1,45954399,45954879,SRX5716469,SMARCA4,480
chr1,45954431,45954901,SRX5075169,SMARCA4,470
chr1,45954441,45954919,SRX5075170,SMARCA4,478
chr1,45954500,45954901,SRX5075176,SMARCA4,401
chr1,45954517,45954864,SRX5075175,SMARCA4,347
chr1,45954572,45954836,SRX5054308,FOSL2,264
chr1,45954578,45954892,SRX5054309,FOSL2,314
chr1,45954594,45954851,SRX5716470,SMARCA4,257
chr1,45954638,45954843,SRX5020211,SMARCA2,205
chr1,45979034,45979401,SRX5075170,SMARCA4,367
chr1,45979100,45979412,SRX5075175,SMARCA4,312
chr1,45979112,45979486,SRX5075176,SMARCA4,374
chr1,45979140,45979392,SRX5075169,SMARCA4,252
chr1,45979179,45979407,SRX5054308,FOSL2,228
chr1,45979241,45979424,SRX5054309,FOSL2,183
chr1,46020082,46020347,SRX5075176,SMARCA4,265
chr1,46020085,46020425,SRX5075170,SMARCA4,340
chr1,46036932,46037478,SRX16500060,CTCF,546
chr1,46036964,46037440,SRX16500062,CTCF,476
chr1,46036990,46037513,SRX16500059,CTCF,523
chr1,46037029,46037462,SRX16500061,CTCF,433
chr1,46037112,46037364,SRX5075170,SMARCA4,252
chr1,46037115,46037388,SRX4174629,CTCF,273
chr1,46037130,46037429,SRX5075174,SMARCA4,299
chr1,46037165,46037398,SRX5075168,SMARCA4,233
chr1,46039757,46040028,SRX5075170,SMARCA4,271
chr1,46084654,46084874,SRX5075169,SMARCA4,220
chr1,46132154,46133108,SRX20140895,INTS13,954
chr1,46132238,46132979,SRX20140881,CPSF3L,741
chr1,46132264,46132905,SRX20140879,CPSF3L,641
chr1,46132296,46132964,SRX20140897,INTS13,668
chr1,46132297,46133072,SRX20140867,INTS10,775
chr1,46132311,46132834,SRX20140880,CPSF3L,523
chr1,46132337,46132885,SRX20140894,INTS13,548
chr1,46132340,46133117,SRX20140868,INTS10,777
chr1,46132388,46132997,SRX20140869,INTS10,609
chr1,46132406,46132889,SRX20140896,INTS13,483
chr1,46132617,46132936,SRX20140870,INTS10,319
chr1,46132941,46133365,SRX5716451,SOX2,424
chr1,46132972,46133196,SRX5054307,FOSL2,224
chr1,46133022,46133402,SRX5716454,SOX3,380
chr1,46133033,46133399,SRX5075174,SMARCA4,366
chr1,46133103,46133472,SRX5075168,SMARCA4,369
chr1,46134812,46135113,SRX5054308,FOSL2,301
chr1,46134873,46135068,SRX5054309,FOSL2,195
chr1,46134915,46135147,SRX5075176,SMARCA4,232
chr1,46137780,46138297,SRX5075169,SMARCA4,517
chr1,46137883,46138159,SRX5075175,SMARCA4,276
chr1,46137914,46138291,SRX5075170,SMARCA4,377
chr1,46137932,46138300,SRX5075176,SMARCA4,368
chr1,46137969,46138270,SRX5020211,SMARCA2,301
chr1,46137978,46138294,SRX5716470,SMARCA4,316
chr1,46173592,46173867,SRX5075176,SMARCA4,275
chr1,46179439,46179935,SRX16500059,CTCF,496
chr1,46179475,46179926,SRX16500060,CTCF,451
chr1,46179492,46179999,SRX4174629,CTCF,507
chr1,46179510,46179937,SRX16500061,CTCF,427
chr1,46179515,46179910,SRX16500062,CTCF,395
chr1,46179521,46179784,SRX5075174,SMARCA4,263
chr1,46179527,46179793,SRX5075176,SMARCA4,266
chr1,46179540,46179881,SRX5075168,SMARCA4,341
chr1,46179564,46179817,SRX5075170,SMARCA4,253
chr1,46179600,46179810,SRX5716463,SMARCA4,210
chr1,46183094,46183632,SRX5075169,SMARCA4,538
chr1,46183111,46183594,SRX5075176,SMARCA4,483
chr1,46183169,46183590,SRX5075175,SMARCA4,421
chr1,46183172,46183646,SRX5075170,SMARCA4,474
chr1,46183222,46183492,SRX5716470,SMARCA4,270
chr1,46183235,46183613,SRX5716469,SMARCA4,378
chr1,46183259,46183552,SRX5054309,FOSL2,293
chr1,46183304,46183535,SRX5054308,FOSL2,231
chr1,46194084,46194311,SRX5075170,SMARCA4,227
chr1,46198115,46198820,SRX20140895,INTS13,705
chr1,46198136,46198708,SRX5075174,SMARCA4,572
chr1,46198142,46198665,SRX5075168,SMARCA4,523
chr1,46198159,46198760,SRX20140868,INTS10,601
chr1,46198178,46198620,SRX5075169,SMARCA4,442
chr1,46198211,46198637,SRX20140867,INTS10,426
chr1,46198456,46198697,SRX5075170,SMARCA4,241
chr1,46198473,46198698,SRX5716464,SMARCA4,225
chr1,46203150,46203472,SRX5075174,SMARCA4,322
chr1,46203176,46203650,SRX5075168,SMARCA4,474
chr1,46203303,46203501,SRX5075169,SMARCA4,198
chr1,46221739,46222140,SRX5075168,SMARCA4,401
chr1,46221772,46222045,SRX5075174,SMARCA4,273
chr1,46223352,46223975,SRX16500059,CTCF,623
chr1,46223369,46223921,SRX16500061,CTCF,552
chr1,46223378,46223927,SRX16500062,CTCF,549
chr1,46223380,46223959,SRX16500060,CTCF,579
chr1,46223411,46223936,SRX4174629,CTCF,525
chr1,46223521,46223807,SRX5075170,SMARCA4,286
chr1,46223528,46223822,SRX5075174,SMARCA4,294
chr1,46223539,46223854,SRX5075169,SMARCA4,315
chr1,46223544,46223813,SRX5075168,SMARCA4,269
chr1,46223598,46223868,SRX5075175,SMARCA4,270
chr1,46238864,46239219,SRX5054309,FOSL2,355
chr1,46238891,46239246,SRX5020214,SMARCA2,355
chr1,46238946,46239145,SRX5054308,FOSL2,199
chr1,46238958,46239152,SRX5075169,SMARCA4,194
chr1,46238978,46239165,SRX5075175,SMARCA4,187
chr1,46247004,46247219,SRX5075175,SMARCA4,215
chr1,46247116,46247355,SRX5075169,SMARCA4,239
chr1,46247159,46247386,SRX5716470,SMARCA4,227
chr1,46247169,46247389,SRX5075176,SMARCA4,220
chr1,46247176,46247408,SRX5075170,SMARCA4,232
chr1,46247203,46247800,SRX5075174,SMARCA4,597
chr1,46247223,46247847,SRX5075168,SMARCA4,624
chr1,46247511,46247766,SRX5054307,FOSL2,255
chr1,46247560,46247746,SRX5054308,FOSL2,186
chr1,46247642,46247965,SRX20140881,CPSF3L,323
chr1,46248102,46248425,SRX16500059,CTCF,323
chr1,46248104,46248519,SRX16500060,CTCF,415
chr1,46248150,46248454,SRX16500062,CTCF,304
chr1,46248228,46248499,SRX16500061,CTCF,271
chr1,46289507,46289548,SRX1424893,POU3F2,41
chr1,46302898,46303630,SRX20140869,INTS10,732
chr1,46302934,46303722,SRX20140895,INTS13,788
chr1,46302977,46303541,SRX20140881,CPSF3L,564
chr1,46303000,46303695,SRX20140868,INTS10,695
chr1,46303027,46303627,SRX20140867,INTS10,600
chr1,46303048,46303615,SRX20140897,INTS13,567
chr1,46303087,46303500,SRX20140879,CPSF3L,413
chr1,46303088,46303606,SRX20140896,INTS13,518
chr1,46303115,46303533,SRX20140894,INTS13,418
chr1,46303165,46303577,SRX5075174,SMARCA4,412
chr1,46303337,46303716,SRX5054308,FOSL2,379
chr1,46303462,46303735,SRX5054309,FOSL2,273
chr1,46333539,46333809,SRX16500060,CTCF,270
chr1,46333548,46333775,SRX16500062,CTCF,227
chr1,46333565,46333847,SRX16500059,CTCF,282
chr1,46333567,46333806,SRX5075174,SMARCA4,239
chr1,46333584,46333793,SRX5075176,SMARCA4,209
chr1,46340281,46340905,SRX20140867,INTS10,624
chr1,46340296,46340996,SRX20140895,INTS13,700
chr1,46340399,46341040,SRX20140868,INTS10,641
chr1,46340402,46340975,SRX20140869,INTS10,573
chr1,46340404,46341069,SRX5075174,SMARCA4,665
chr1,46340431,46341082,SRX5716470,SMARCA4,651
chr1,46340455,46341126,SRX5075168,SMARCA4,671
chr1,46340481,46341165,SRX5075176,SMARCA4,684
chr1,46340520,46340987,SRX5075170,SMARCA4,467
chr1,46340554,46341010,SRX20140897,INTS13,456
chr1,46340556,46340895,SRX5716464,SMARCA4,339
chr1,46340561,46340912,SRX5075169,SMARCA4,351
chr1,46340565,46340946,SRX5075175,SMARCA4,381
chr1,46340570,46341022,SRX16500060,CTCF,452
chr1,46340575,46340934,SRX5716469,SMARCA4,359
chr1,46340579,46340915,SRX20140894,INTS13,336
chr1,46340602,46341094,SRX4174629,CTCF,492
chr1,46340607,46341006,SRX16500062,CTCF,399
chr1,46340622,46341042,SRX16500061,CTCF,420
chr1,46340625,46341061,SRX16500059,CTCF,436
chr1,46340658,46341010,SRX5716463,SMARCA4,352
chr1,46340697,46340991,SRX20140881,CPSF3L,294
chr1,46347998,46348592,SRX16500059,CTCF,594
chr1,46348025,46348568,SRX16500061,CTCF,543
chr1,46348068,46348418,SRX5075168,SMARCA4,350
chr1,46348077,46348476,SRX5075176,SMARCA4,399
chr1,46348091,46348534,SRX16500060,CTCF,443
chr1,46348099,46348377,SRX5075170,SMARCA4,278
chr1,46348103,46348548,SRX16500062,CTCF,445
chr1,46348121,46348383,SRX5075169,SMARCA4,262
chr1,46348126,46348432,SRX5075174,SMARCA4,306
chr1,46348146,46348345,SRX5075175,SMARCA4,199
chr1,46348147,46348381,SRX5716464,SMARCA4,234
chr1,46348149,46348418,SRX4174629,CTCF,269
chr1,46351754,46351802,SRX1424892,POU3F2,48
chr1,46351757,46351798,SRX1424894,POU3F2,41
chr1,46351757,46351799,SRX1424893,POU3F2,42
chr1,46351758,46351798,SRX1424891,POU3F2,40
chr1,46394072,46394585,SRX5075175,SMARCA4,513
chr1,46394102,46394542,SRX5075170,SMARCA4,440
chr1,46394105,46394453,SRX5075169,SMARCA4,348
chr1,46394116,46394514,SRX20140895,INTS13,398
chr1,46394130,46394524,SRX5075174,SMARCA4,394
chr1,46394136,46394495,SRX5075168,SMARCA4,359
chr1,46394154,46394480,SRX5075176,SMARCA4,326
chr1,46394208,46394549,SRX5716469,SMARCA4,341
chr1,46402302,46402489,SRX5075176,SMARCA4,187
chr1,46402349,46402561,SRX5075170,SMARCA4,212
chr1,46406235,46406743,SRX16500062,CTCF,508
chr1,46406236,46406788,SRX16500060,CTCF,552
chr1,46406286,46406769,SRX16500059,CTCF,483
chr1,46406294,46406743,SRX16500061,CTCF,449
chr1,46406401,46406629,SRX5075168,SMARCA4,228
chr1,46406409,46406696,SRX20140895,INTS13,287
chr1,46406412,46406614,SRX5075176,SMARCA4,202
chr1,46406415,46406676,SRX4174629,CTCF,261
chr1,46406426,46406665,SRX5075174,SMARCA4,239
chr1,46406428,46406626,SRX5075175,SMARCA4,198
chr1,46406430,46406641,SRX5716470,SMARCA4,211
chr1,46406442,46406645,SRX5075170,SMARCA4,203
chr1,46412014,46412336,SRX16500060,CTCF,322
chr1,46412015,46412311,SRX16500059,CTCF,296
chr1,46412019,46412315,SRX16500061,CTCF,296
chr1,46413655,46413919,SRX16500060,CTCF,264
chr1,46442310,46443000,SRX16500061,CTCF,690
chr1,46442319,46443052,SRX16500059,CTCF,733
chr1,46442337,46443034,SRX16500060,CTCF,697
chr1,46442343,46443011,SRX16500062,CTCF,668
chr1,46442391,46442948,SRX4174629,CTCF,557
chr1,46442665,46442964,SRX5075174,SMARCA4,299
chr1,46442683,46442910,SRX5075170,SMARCA4,227
chr1,46442709,46442956,SRX5075168,SMARCA4,247
chr1,46442785,46443002,SRX5716463,SMARCA4,217
chr1,46442798,46442978,SRX5075169,SMARCA4,180
chr1,46446763,46447227,SRX16500060,CTCF,464
chr1,46446803,46447206,SRX16500059,CTCF,403
chr1,46446805,46447198,SRX16500062,CTCF,393
chr1,46446851,46447199,SRX16500061,CTCF,348
chr1,46446897,46447123,SRX4174629,CTCF,226
chr1,46446911,46447162,SRX5075174,SMARCA4,251
chr1,46446941,46447190,SRX5075168,SMARCA4,249
chr1,46466322,46466944,SRX20140895,INTS13,622
chr1,46466419,46466917,SRX5075168,SMARCA4,498
chr1,46466476,46466953,SRX20140868,INTS10,477
chr1,46477370,46477848,SRX16500059,CTCF,478
chr1,46477378,46477884,SRX16500061,CTCF,506
chr1,46477402,46477871,SRX16500060,CTCF,469
chr1,46477419,46477888,SRX16500062,CTCF,469
chr1,46477485,46477727,SRX4174629,CTCF,242
chr1,46477532,46477717,SRX5075174,SMARCA4,185
chr1,46485572,46485799,SRX5075174,SMARCA4,227
chr1,46487723,46488059,SRX16500060,CTCF,336
chr1,46487758,46488063,SRX16500061,CTCF,305
chr1,46487791,46488167,SRX16500059,CTCF,376
chr1,46487824,46488054,SRX16500062,CTCF,230
chr1,46507205,46507512,SRX5075174,SMARCA4,307
chr1,46507226,46507430,SRX5075168,SMARCA4,204
chr1,46520561,46520834,SRX5075175,SMARCA4,273
chr1,46520565,46520843,SRX5054309,FOSL2,278
chr1,46520606,46520830,SRX5075176,SMARCA4,224
chr1,46520633,46520835,SRX5075169,SMARCA4,202
chr1,46527959,46528470,SRX16500059,CTCF,511
chr1,46527977,46528401,SRX16500062,CTCF,424
chr1,46527980,46528492,SRX16500060,CTCF,512
chr1,46527993,46528383,SRX16500061,CTCF,390
chr1,46528004,46528445,SRX4174629,CTCF,441
chr1,46528063,46528246,SRX5075174,SMARCA4,183
chr1,46528103,46528283,SRX5075169,SMARCA4,180
chr1,46528112,46528287,SRX5075176,SMARCA4,175
chr1,46532801,46533154,SRX16500059,CTCF,353
chr1,46532813,46533154,SRX16500060,CTCF,341
chr1,46532825,46533113,SRX16500062,CTCF,288
chr1,46532825,46533147,SRX16500061,CTCF,322
chr1,46532869,46533177,SRX5075170,SMARCA4,308
chr1,46532901,46533101,SRX5075169,SMARCA4,200
chr1,46532907,46533260,SRX5075176,SMARCA4,353
chr1,46532920,46533140,SRX5075168,SMARCA4,220
chr1,46532951,46533262,SRX5075175,SMARCA4,311
chr1,46533159,46533348,SRX5075169,SMARCA4,189
chr1,46547934,46548331,SRX16500059,CTCF,397
chr1,46547935,46548379,SRX16500062,CTCF,444
chr1,46547960,46548373,SRX16500060,CTCF,413
chr1,46547973,46548390,SRX16500061,CTCF,417
chr1,46549618,46549791,SRX5075170,SMARCA4,173
chr1,46549654,46549915,SRX5075174,SMARCA4,261
chr1,46549654,46550030,SRX5075168,SMARCA4,376
chr1,46549730,46549950,SRX5716470,SMARCA4,220
chr1,46558397,46558793,SRX20140895,INTS13,396
chr1,46603901,46604313,SRX16500061,CTCF,412
chr1,46603903,46604317,SRX16500059,CTCF,414
chr1,46603929,46604318,SRX16500060,CTCF,389
chr1,46603952,46604289,SRX5716470,SMARCA4,337
chr1,46603984,46604607,SRX5075174,SMARCA4,623
chr1,46604000,46604566,SRX5075176,SMARCA4,566
chr1,46604005,46604241,SRX5716469,SMARCA4,236
chr1,46604024,46604431,SRX5716464,SMARCA4,407
chr1,46604043,46604270,SRX5075175,SMARCA4,227
chr1,46604048,46604543,SRX5075170,SMARCA4,495
chr1,46604059,46604605,SRX5075168,SMARCA4,546
chr1,46604062,46604334,SRX16500062,CTCF,272
chr1,46604105,46604607,SRX20140895,INTS13,502
chr1,46604132,46604378,SRX20140879,CPSF3L,246
chr1,46604138,46604554,SRX5716463,SMARCA4,416
chr1,46613891,46614067,SRX5075170,SMARCA4,176
chr1,46613897,46614072,SRX5075176,SMARCA4,175
chr1,46616523,46617068,SRX5075174,SMARCA4,545
chr1,46616592,46616787,SRX5075175,SMARCA4,195
chr1,46616662,46616903,SRX5075169,SMARCA4,241
chr1,46616687,46617014,SRX5075176,SMARCA4,327
chr1,46616828,46617082,SRX5075170,SMARCA4,254
chr1,46622422,46622706,SRX5075170,SMARCA4,284
chr1,46622455,46622652,SRX5075176,SMARCA4,197
chr1,46643260,46643705,SRX5075176,SMARCA4,445
chr1,46643265,46643781,SRX5075170,SMARCA4,516
chr1,46643290,46643650,SRX5075175,SMARCA4,360
chr1,46643293,46643731,SRX5716470,SMARCA4,438
chr1,46643315,46643606,SRX5716469,SMARCA4,291
chr1,46643335,46643580,SRX5716467,SMARCA2,245
chr1,46643335,46643711,SRX5075169,SMARCA4,376
chr1,46643361,46643560,SRX5054309,FOSL2,199
chr1,46643400,46643669,SRX5716468,SMARCA2,269
chr1,46667978,46668658,SRX20140895,INTS13,680
chr1,46667980,46668691,SRX5075174,SMARCA4,711
chr1,46667991,46668323,SRX5716470,SMARCA4,332
chr1,46668105,46668592,SRX20140868,INTS10,487
chr1,46668116,46668310,SRX5075176,SMARCA4,194
chr1,46668149,46668447,SRX20140867,INTS10,298
chr1,46668227,46668708,SRX5075170,SMARCA4,481
chr1,46668242,46668724,SRX5075168,SMARCA4,482
chr1,46668279,46668580,SRX5075169,SMARCA4,301
chr1,46668320,46668565,SRX5716469,SMARCA4,245
chr1,46668335,46668614,SRX5075175,SMARCA4,279
chr1,46668417,46668592,SRX5075176,SMARCA4,175
chr1,46691025,46691353,SRX5075169,SMARCA4,328
chr1,46691071,46691337,SRX5716470,SMARCA4,266
chr1,46691090,46691332,SRX5075176,SMARCA4,242
chr1,46691114,46691325,SRX5075175,SMARCA4,211
chr1,46718828,46719372,SRX20140895,INTS13,544
chr1,46718901,46719120,SRX5716470,SMARCA4,219
chr1,46718907,46719498,SRX5075170,SMARCA4,591
chr1,46718948,46719503,SRX5075174,SMARCA4,555
chr1,46718950,46719509,SRX5075176,SMARCA4,559
chr1,46718952,46719486,SRX5075175,SMARCA4,534
chr1,46718964,46719219,SRX20140897,INTS13,255
chr1,46719000,46719376,SRX5075168,SMARCA4,376
chr1,46719023,46719286,SRX20140867,INTS10,263
chr1,46719037,46719331,SRX20140868,INTS10,294
chr1,46719091,46719424,SRX5716464,SMARCA4,333
chr1,46719181,46719386,SRX5075169,SMARCA4,205
chr1,46719209,46719417,SRX5716463,SMARCA4,208
chr1,46725153,46725561,SRX16500059,CTCF,408
chr1,46725175,46725588,SRX16500060,CTCF,413
chr1,46725190,46725556,SRX16500062,CTCF,366
chr1,46725191,46725537,SRX16500061,CTCF,346
chr1,46725274,46725555,SRX4174629,CTCF,281
chr1,46725292,46725492,SRX5075174,SMARCA4,200
chr1,46725297,46725478,SRX5075170,SMARCA4,181
chr1,46735732,46736010,SRX5716464,SMARCA4,278
chr1,46735740,46736024,SRX5716463,SMARCA4,284
chr1,46735756,46736038,SRX5075168,SMARCA4,282
chr1,46735766,46736051,SRX5716470,SMARCA4,285
chr1,46735767,46736056,SRX5075169,SMARCA4,289
chr1,46735767,46736066,SRX5075174,SMARCA4,299
chr1,46735768,46736026,SRX5075176,SMARCA4,258
chr1,46735768,46736059,SRX5075170,SMARCA4,291
chr1,46735777,46736023,SRX5075175,SMARCA4,246
chr1,46735825,46736035,SRX16500062,CTCF,210
chr1,46747622,46748051,SRX16500062,CTCF,429
chr1,46747656,46748076,SRX16500060,CTCF,420
chr1,46747666,46748072,SRX16500059,CTCF,406
chr1,46747684,46748065,SRX16500061,CTCF,381
chr1,46747710,46747959,SRX4174629,CTCF,249
chr1,46747813,46747986,SRX5075174,SMARCA4,173
chr1,46876059,46876418,SRX16500060,CTCF,359
chr1,46876077,46876432,SRX16500061,CTCF,355
chr1,46876118,46876395,SRX16500062,CTCF,277
chr1,46876118,46876481,SRX16500059,CTCF,363
chr1,46878035,46878300,SRX4174629,CTCF,265
chr1,46878187,46878632,SRX16500061,CTCF,445
chr1,46878196,46878624,SRX16500062,CTCF,428
chr1,46878207,46878631,SRX16500060,CTCF,424
chr1,46878207,46878676,SRX16500059,CTCF,469
chr1,46878273,46878528,SRX5075168,SMARCA4,255
chr1,46878307,46878526,SRX5075174,SMARCA4,219
chr1,46934840,46935226,SRX16500060,CTCF,386
chr1,46934858,46935233,SRX16500059,CTCF,375
chr1,46934911,46935189,SRX16500062,CTCF,278
chr1,46934923,46935142,SRX16500061,CTCF,219
chr1,46991084,46991382,SRX16500059,CTCF,298
chr1,46991088,46991343,SRX16500061,CTCF,255
chr1,46991097,46991448,SRX16500060,CTCF,351
chr1,46991124,46991377,SRX16500062,CTCF,253
chr1,47089223,47089835,SRX16500060,CTCF,612
chr1,47089245,47089756,SRX16500059,CTCF,511
chr1,47089265,47089819,SRX16500061,CTCF,554
chr1,47089293,47089849,SRX16500062,CTCF,556
chr1,47089431,47089606,SRX5075174,SMARCA4,175
chr1,47089637,47089959,SRX4174629,CTCF,322
chr1,47091445,47091849,SRX16500060,CTCF,404
chr1,47091505,47091808,SRX16500061,CTCF,303
chr1,47091510,47091843,SRX16500062,CTCF,333
chr1,47091521,47091860,SRX16500059,CTCF,339
chr1,47143741,47143978,SRX16500061,CTCF,237
chr1,47173836,47174173,SRX16500060,CTCF,337
chr1,47173848,47174191,SRX16500059,CTCF,343
chr1,47173900,47174166,SRX16500061,CTCF,266
chr1,47173916,47174132,SRX16500062,CTCF,216
chr1,47175319,47175749,SRX16500059,CTCF,430
chr1,47175325,47175724,SRX16500062,CTCF,399
chr1,47175337,47175725,SRX16500060,CTCF,388
chr1,47175342,47175581,SRX4174629,CTCF,239
chr1,47175346,47175780,SRX16500061,CTCF,434
chr1,47175356,47175599,SRX5075174,SMARCA4,243
chr1,47179136,47179471,SRX5075170,SMARCA4,335
chr1,47179142,47179436,SRX5716470,SMARCA4,294
chr1,47179156,47179506,SRX5075168,SMARCA4,350
chr1,47179158,47179478,SRX5716469,SMARCA4,320
chr1,47179161,47179468,SRX5075174,SMARCA4,307
chr1,47179169,47179481,SRX4174629,CTCF,312
chr1,47179169,47179537,SRX16500060,CTCF,368
chr1,47179172,47179505,SRX5075169,SMARCA4,333
chr1,47179172,47179610,SRX16500059,CTCF,438
chr1,47179173,47179574,SRX5075176,SMARCA4,401
chr1,47179175,47179422,SRX5075175,SMARCA4,247
chr1,47179179,47179488,SRX5716463,SMARCA4,309
chr1,47179182,47179511,SRX16500061,CTCF,329
chr1,47179210,47179566,SRX16500062,CTCF,356
chr1,47192786,47193382,SRX16500060,CTCF,596
chr1,47192842,47193345,SRX16500059,CTCF,503
chr1,47192854,47193348,SRX16500062,CTCF,494
chr1,47192862,47193296,SRX16500061,CTCF,434
chr1,47192864,47193209,SRX4174629,CTCF,345
chr1,47192927,47193328,SRX5075168,SMARCA4,401
chr1,47192935,47193244,SRX5075176,SMARCA4,309
chr1,47192942,47193361,SRX5075174,SMARCA4,419
chr1,47192957,47193242,SRX5075175,SMARCA4,285
chr1,47192958,47193242,SRX5716464,SMARCA4,284
chr1,47192968,47193225,SRX5075170,SMARCA4,257
chr1,47192968,47193248,SRX5075169,SMARCA4,280
chr1,47192974,47193253,SRX5716470,SMARCA4,279
chr1,47192991,47193246,SRX5716463,SMARCA4,255
chr1,47208481,47208793,SRX5075168,SMARCA4,312
chr1,47208545,47208756,SRX5075174,SMARCA4,211
chr1,47262745,47263237,SRX16500060,CTCF,492
chr1,47262749,47263262,SRX16500062,CTCF,513
chr1,47262766,47263266,SRX16500059,CTCF,500
chr1,47262780,47263224,SRX16500061,CTCF,444
chr1,47275905,47276127,SRX5054309,FOSL2,222
chr1,47313789,47314195,SRX20140881,CPSF3L,406
chr1,47313834,47314532,SRX20140895,INTS13,698
chr1,47313859,47314258,SRX20140867,INTS10,399
chr1,47313887,47314545,SRX5075174,SMARCA4,658
chr1,47314114,47314410,SRX5054307,FOSL2,296
chr1,47314126,47314692,SRX5075168,SMARCA4,566
chr1,47314278,47314484,SRX5716464,SMARCA4,206
chr1,47314359,47314570,SRX5075170,SMARCA4,211
chr1,47333415,47333863,SRX5075168,SMARCA4,448
chr1,47333469,47334317,SRX20140895,INTS13,848
chr1,47333473,47333957,SRX5075174,SMARCA4,484
chr1,47333505,47333874,SRX5075176,SMARCA4,369
chr1,47333566,47334011,SRX5075170,SMARCA4,445
chr1,47333600,47333867,SRX5075169,SMARCA4,267
chr1,47333807,47334117,SRX20140867,INTS10,310
chr1,47334499,47334817,SRX20140895,INTS13,318
chr1,47334654,47334929,SRX5075174,SMARCA4,275
chr1,47334662,47334963,SRX5075169,SMARCA4,301
chr1,47334681,47334854,SRX5075170,SMARCA4,173
chr1,47334699,47334928,SRX5075175,SMARCA4,229
chr1,47339453,47339674,SRX16500060,CTCF,221
chr1,47339474,47339731,SRX16500059,CTCF,257
chr1,47339501,47339739,SRX16500061,CTCF,238
chr1,47379630,47379871,SRX5075169,SMARCA4,241
chr1,47379650,47379899,SRX5075175,SMARCA4,249
chr1,47379654,47379864,SRX5020211,SMARCA2,210
chr1,47379670,47379902,SRX5716470,SMARCA4,232
chr1,47379699,47379911,SRX5716469,SMARCA4,212
chr1,47388387,47388562,SRX5075176,SMARCA4,175
chr1,47388721,47389179,SRX16500060,CTCF,458
chr1,47388729,47389176,SRX16500059,CTCF,447
chr1,47388734,47389199,SRX16500061,CTCF,465
chr1,47388745,47389224,SRX16500062,CTCF,479
chr1,47388819,47389128,SRX4174629,CTCF,309
chr1,47388909,47389104,SRX5075168,SMARCA4,195
chr1,47388924,47389114,SRX5075174,SMARCA4,190
chr1,47424255,47424836,SRX16500060,CTCF,581
chr1,47424260,47424802,SRX16500062,CTCF,542
chr1,47424288,47424826,SRX16500061,CTCF,538
chr1,47424300,47424865,SRX16500059,CTCF,565
chr1,47424434,47424696,SRX4174629,CTCF,262
chr1,47424480,47424669,SRX5075174,SMARCA4,189
chr1,47424481,47424705,SRX5075168,SMARCA4,224
chr1,47432352,47432783,SRX16500059,CTCF,431
chr1,47432375,47432804,SRX16500061,CTCF,429
chr1,47432376,47432812,SRX16500060,CTCF,436
chr1,47432384,47432775,SRX16500062,CTCF,391
chr1,47432424,47432800,SRX4174629,CTCF,376
chr1,47432458,47432691,SRX5075174,SMARCA4,233
chr1,47432459,47432646,SRX5075175,SMARCA4,187
chr1,47432470,47432710,SRX5075169,SMARCA4,240
chr1,47432479,47432658,SRX5075176,SMARCA4,179
chr1,47432479,47432740,SRX5075168,SMARCA4,261
chr1,47432538,47432707,SRX5075170,SMARCA4,169
chr1,47436455,47436779,SRX16500060,CTCF,324
chr1,47436480,47436819,SRX16500059,CTCF,339
chr1,47436483,47436755,SRX16500061,CTCF,272
chr1,47436499,47436750,SRX16500062,CTCF,251
chr1,47436538,47436769,SRX5075174,SMARCA4,231
chr1,47437675,47438211,SRX16500059,CTCF,536
chr1,47437686,47438186,SRX16500060,CTCF,500
chr1,47437730,47438124,SRX5075168,SMARCA4,394
chr1,47437735,47438174,SRX16500061,CTCF,439
chr1,47437761,47438237,SRX16500062,CTCF,476
chr1,47437786,47438018,SRX5075174,SMARCA4,232
chr1,47437801,47438066,SRX20140895,INTS13,265
chr1,47449855,47450262,SRX16500061,CTCF,407
chr1,47449900,47450295,SRX16500059,CTCF,395
chr1,47449972,47450272,SRX16500062,CTCF,300
chr1,47449975,47450319,SRX16500060,CTCF,344
chr1,47529463,47529920,SRX16500059,CTCF,457
chr1,47529473,47529861,SRX16500062,CTCF,388
chr1,47529479,47529967,SRX16500061,CTCF,488
chr1,47529483,47529903,SRX16500060,CTCF,420
chr1,47533056,47533453,SRX5075168,SMARCA4,397
chr1,47533091,47533542,SRX5075176,SMARCA4,451
chr1,47533148,47533386,SRX5716469,SMARCA4,238
chr1,47533148,47533545,SRX5075170,SMARCA4,397
chr1,47533157,47533464,SRX20140895,INTS13,307
chr1,47533158,47533464,SRX5075175,SMARCA4,306
chr1,47533188,47533417,SRX5716470,SMARCA4,229
chr1,47533191,47533507,SRX5075169,SMARCA4,316
chr1,47533716,47533899,SRX5075174,SMARCA4,183
chr1,47569795,47570147,SRX5075175,SMARCA4,352
chr1,47569832,47570147,SRX5054309,FOSL2,315
chr1,47569898,47570168,SRX5075169,SMARCA4,270
chr1,47650190,47650445,SRX5075170,SMARCA4,255
chr1,47650191,47650659,SRX5075176,SMARCA4,468
chr1,47650256,47650696,SRX5075169,SMARCA4,440
chr1,47650262,47650566,SRX5054308,FOSL2,304
chr1,47650270,47650649,SRX5075175,SMARCA4,379
chr1,47650282,47650585,SRX5054309,FOSL2,303
chr1,47650514,47650683,SRX5075170,SMARCA4,169
chr1,47684870,47685184,SRX5716470,SMARCA4,314
chr1,47684909,47685169,SRX5075169,SMARCA4,260
chr1,47696975,47697440,SRX5075168,SMARCA4,465
chr1,47697043,47697394,SRX5075174,SMARCA4,351
chr1,47704055,47704288,SRX5054309,FOSL2,233
chr1,47704255,47704521,SRX16500059,CTCF,266
chr1,47709607,47709932,SRX16500059,CTCF,325
chr1,47709611,47709821,SRX16500062,CTCF,210
chr1,47709649,47709868,SRX16500061,CTCF,219
chr1,47710406,47710907,SRX16500059,CTCF,501
chr1,47710414,47710927,SRX16500060,CTCF,513
chr1,47710441,47710884,SRX16500061,CTCF,443
chr1,47710450,47710891,SRX16500062,CTCF,441
chr1,47710460,47710878,SRX4174629,CTCF,418
chr1,47710492,47710694,SRX5075174,SMARCA4,202
chr1,47710541,47710765,SRX5075168,SMARCA4,224
chr1,47710543,47710730,SRX5075175,SMARCA4,187
chr1,47710575,47710793,SRX5075176,SMARCA4,218
chr1,47710602,47710795,SRX5075170,SMARCA4,193
chr1,47726136,47726690,SRX16500061,CTCF,554
chr1,47726142,47726662,SRX16500059,CTCF,520
chr1,47726160,47726696,SRX16500060,CTCF,536
chr1,47726198,47726618,SRX4174629,CTCF,420
chr1,47726213,47726505,SRX5075170,SMARCA4,292
chr1,47726220,47726659,SRX16500062,CTCF,439
chr1,47726288,47726501,SRX5075175,SMARCA4,213
chr1,47726306,47726587,SRX5075174,SMARCA4,281
chr1,47738513,47739022,SRX16500060,CTCF,509
chr1,47738527,47739033,SRX16500059,CTCF,506
chr1,47738552,47738992,SRX16500061,CTCF,440
chr1,47738553,47738968,SRX16500062,CTCF,415
chr1,47738572,47738959,SRX4174629,CTCF,387
chr1,47738667,47738888,SRX5075174,SMARCA4,221
chr1,47738681,47738887,SRX5075169,SMARCA4,206
chr1,47738683,47738947,SRX5075170,SMARCA4,264
chr1,47755415,47755695,SRX16500059,CTCF,280
chr1,47755431,47755771,SRX16500062,CTCF,340
chr1,47755503,47755789,SRX16500060,CTCF,286
chr1,47755513,47755833,SRX16500061,CTCF,320
chr1,47776737,47776997,SRX5075170,SMARCA4,260
chr1,47776740,47777090,SRX5075176,SMARCA4,350
chr1,47782379,47782731,SRX5075176,SMARCA4,352
chr1,47782409,47782969,SRX5075170,SMARCA4,560
chr1,47782417,47782634,SRX5716469,SMARCA4,217
chr1,47782435,47782636,SRX5075175,SMARCA4,201
chr1,47782457,47782675,SRX5075169,SMARCA4,218
chr1,47785615,47785850,SRX16500059,CTCF,235
chr1,47797501,47797962,SRX5075170,SMARCA4,461
chr1,47797503,47797881,SRX5075176,SMARCA4,378
chr1,47797524,47797830,SRX5075169,SMARCA4,306
chr1,47797527,47797838,SRX5716467,SMARCA2,311
chr1,47797537,47797837,SRX5716470,SMARCA4,300
chr1,47797539,47797770,SRX5716469,SMARCA4,231
chr1,47805891,47806144,SRX5075176,SMARCA4,253
chr1,47805975,47806253,SRX5075170,SMARCA4,278
chr1,47812916,47813267,SRX5075170,SMARCA4,351
chr1,47812923,47813226,SRX5020211,SMARCA2,303
chr1,47813001,47813345,SRX5075176,SMARCA4,344
chr1,47813003,47813310,SRX5716470,SMARCA4,307
chr1,47813005,47813192,SRX5075175,SMARCA4,187
chr1,47813039,47813219,SRX5054308,FOSL2,180
chr1,47813131,47813333,SRX5075169,SMARCA4,202
chr1,47881920,47882117,SRX5075175,SMARCA4,197
chr1,47906088,47906348,SRX5054309,FOSL2,260
chr1,47906614,47906896,SRX20140867,INTS10,282
chr1,47934348,47934632,SRX5075169,SMARCA4,284
chr1,47934377,47934673,SRX5075175,SMARCA4,296
chr1,47934432,47934643,SRX5716470,SMARCA4,211
chr1,47934446,47934671,SRX5075170,SMARCA4,225
chr1,47938519,47938932,SRX5075170,SMARCA4,413
chr1,47938582,47938880,SRX5075176,SMARCA4,298
chr1,47940823,47941009,SRX5075169,SMARCA4,186
chr1,47948151,47948395,SRX16500060,CTCF,244
chr1,47991240,47991434,SRX5054309,FOSL2,194
chr1,47992712,47992958,SRX20140867,INTS10,246
chr1,47992866,47993064,SRX5075176,SMARCA4,198
chr1,47997510,47997853,SRX20140895,INTS13,343
chr1,47997544,47998098,SRX16500059,CTCF,554
chr1,47997570,47998158,SRX16500060,CTCF,588
chr1,47997575,47998053,SRX16500061,CTCF,478
chr1,47997587,47998035,SRX16500062,CTCF,448
chr1,47997607,47997995,SRX5075168,SMARCA4,388
chr1,47997613,47997986,SRX5075174,SMARCA4,373
chr1,47997617,47997980,SRX5075176,SMARCA4,363
chr1,47997626,47997959,SRX5716464,SMARCA4,333
chr1,47997629,47997967,SRX5716470,SMARCA4,338
chr1,47997629,47997979,SRX5075170,SMARCA4,350
chr1,47997634,47997978,SRX5716463,SMARCA4,344
chr1,47997648,47997958,SRX5075175,SMARCA4,310
chr1,47997651,47997982,SRX5075169,SMARCA4,331
chr1,47997715,47997970,SRX5716469,SMARCA4,255
chr1,47997722,47997974,SRX5716467,SMARCA2,252
chr1,48004157,48004468,SRX5716470,SMARCA4,311
chr1,48006353,48006623,SRX5054308,FOSL2,270
chr1,48006387,48006570,SRX5054309,FOSL2,183
chr1,48019974,48020184,SRX5075170,SMARCA4,210
chr1,48019979,48020155,SRX5075176,SMARCA4,176
chr1,48023684,48023864,SRX5054308,FOSL2,180
chr1,48035466,48035661,SRX5075170,SMARCA4,195
chr1,48036690,48037004,SRX5054309,FOSL2,314
chr1,48036714,48036985,SRX5075176,SMARCA4,271
chr1,48036718,48037018,SRX5075170,SMARCA4,300
chr1,48036745,48037061,SRX5054308,FOSL2,316
chr1,48036760,48036995,SRX5020211,SMARCA2,235
chr1,48036762,48037072,SRX5075169,SMARCA4,310
chr1,48036765,48037034,SRX5075175,SMARCA4,269
chr1,48036771,48036976,SRX5020214,SMARCA2,205
chr1,48048073,48048424,SRX5075169,SMARCA4,351
chr1,48048101,48048383,SRX5075176,SMARCA4,282
chr1,48048101,48048446,SRX5054309,FOSL2,345
chr1,48048114,48048390,SRX5075175,SMARCA4,276
chr1,48048123,48048384,SRX5054308,FOSL2,261
chr1,48048125,48048381,SRX5075170,SMARCA4,256
chr1,48051487,48051722,SRX5075176,SMARCA4,235
chr1,48051573,48051745,SRX5075170,SMARCA4,172
chr1,48052356,48052843,SRX5716467,SMARCA2,487
chr1,48052433,48052852,SRX5075175,SMARCA4,419
chr1,48052437,48052870,SRX5075170,SMARCA4,433
chr1,48052452,48052722,SRX5716469,SMARCA4,270
chr1,48052456,48052923,SRX5075176,SMARCA4,467
chr1,48052463,48052942,SRX5716470,SMARCA4,479
chr1,48052471,48052806,SRX5075169,SMARCA4,335
chr1,48052509,48052776,SRX5075181,SMARCA2,267
chr1,48052520,48052771,SRX5716468,SMARCA2,251
chr1,48052584,48052789,SRX5020214,SMARCA2,205
chr1,48061114,48061579,SRX16500060,CTCF,465
chr1,48061114,48061615,SRX16500059,CTCF,501
chr1,48061124,48061627,SRX16500062,CTCF,503
chr1,48061128,48061598,SRX16500061,CTCF,470
chr1,48061185,48061420,SRX4174629,CTCF,235
chr1,48069641,48069826,SRX5075169,SMARCA4,185
chr1,48093592,48094149,SRX16500061,CTCF,557
chr1,48093607,48094129,SRX16500059,CTCF,522
chr1,48093649,48094067,SRX16500062,CTCF,418
chr1,48093654,48094104,SRX16500060,CTCF,450
chr1,48093741,48094085,SRX4174629,CTCF,344
chr1,48109308,48109867,SRX16500059,CTCF,559
chr1,48109344,48109770,SRX16500062,CTCF,426
chr1,48109363,48109799,SRX16500060,CTCF,436
chr1,48109373,48109825,SRX16500061,CTCF,452
chr1,48109515,48109703,SRX5075170,SMARCA4,188
chr1,48201953,48202333,SRX5054309,FOSL2,380
chr1,48201962,48202264,SRX5020214,SMARCA2,302
chr1,48201976,48202324,SRX5054308,FOSL2,348
chr1,48201998,48202198,SRX5020211,SMARCA2,200
chr1,48202048,48202408,SRX5075175,SMARCA4,360
chr1,48202084,48202435,SRX5716469,SMARCA4,351
chr1,48202098,48202597,SRX16500060,CTCF,499
chr1,48202106,48202443,SRX5075169,SMARCA4,337
chr1,48202125,48202460,SRX5075176,SMARCA4,335
chr1,48202130,48202621,SRX16500059,CTCF,491
chr1,48202132,48202521,SRX16500062,CTCF,389
chr1,48202139,48202525,SRX16500061,CTCF,386
chr1,48202155,48202580,SRX4174629,CTCF,425
chr1,48202165,48202472,SRX5075168,SMARCA4,307
chr1,48202192,48202478,SRX5075174,SMARCA4,286
chr1,48202197,48202486,SRX5075170,SMARCA4,289
chr1,48202216,48202478,SRX5716464,SMARCA4,262
chr1,48203187,48203593,SRX4174629,CTCF,406
chr1,48203282,48203690,SRX16500060,CTCF,408
chr1,48203286,48203779,SRX16500062,CTCF,493
chr1,48203308,48203739,SRX16500059,CTCF,431
chr1,48203314,48203675,SRX16500061,CTCF,361
chr1,48203409,48203590,SRX5075174,SMARCA4,181
chr1,48228222,48228478,SRX16500059,CTCF,256
chr1,48236731,48237234,SRX16500061,CTCF,503
chr1,48236750,48237219,SRX16500059,CTCF,469
chr1,48236864,48237216,SRX16500062,CTCF,352
chr1,48236867,48237274,SRX16500060,CTCF,407
chr1,48394377,48394546,SRX5075170,SMARCA4,169
chr1,48394378,48394572,SRX5075176,SMARCA4,194
chr1,48450449,48450644,SRX5075176,SMARCA4,195
chr1,48450475,48450675,SRX5075170,SMARCA4,200
chr1,48470068,48470279,SRX5716470,SMARCA4,211
chr1,48470068,48470347,SRX5075169,SMARCA4,279
chr1,48470095,48470401,SRX5075170,SMARCA4,306
chr1,48470122,48470379,SRX5075176,SMARCA4,257
chr1,48471659,48472572,SRX20140895,INTS13,913
chr1,48471823,48472208,SRX5075169,SMARCA4,385
chr1,48471976,48472540,SRX5075174,SMARCA4,564
chr1,48472004,48472534,SRX5075176,SMARCA4,530
chr1,48472020,48472460,SRX5716463,SMARCA4,440
chr1,48472060,48472612,SRX5075168,SMARCA4,552
chr1,48472115,48472489,SRX5075170,SMARCA4,374
chr1,48472203,48472382,SRX5054307,FOSL2,179
chr1,48494209,48494754,SRX5075175,SMARCA4,545
chr1,48494217,48494849,SRX5075176,SMARCA4,632
chr1,48494235,48494790,SRX5075170,SMARCA4,555
chr1,48494282,48494780,SRX5075169,SMARCA4,498
chr1,48494308,48494596,SRX20140869,INTS10,288
chr1,48494319,48494714,SRX5716469,SMARCA4,395
chr1,48494323,48494782,SRX5716470,SMARCA4,459
chr1,48494339,48494709,SRX5716467,SMARCA2,370
chr1,48494408,48494683,SRX5716468,SMARCA2,275
chr1,48494425,48494732,SRX5054309,FOSL2,307
chr1,48494448,48494671,SRX5075181,SMARCA2,223
chr1,48498018,48498751,SRX16500062,CTCF,733
chr1,48498019,48498812,SRX16500059,CTCF,793
chr1,48498031,48498822,SRX16500060,CTCF,791
chr1,48498045,48498739,SRX16500061,CTCF,694
chr1,48498110,48498352,SRX5075168,SMARCA4,242
chr1,48498110,48498387,SRX5075174,SMARCA4,277
chr1,48498165,48498797,SRX4174629,CTCF,632
chr1,48530607,48531126,SRX16500059,CTCF,519
chr1,48530689,48531132,SRX16500061,CTCF,443
chr1,48530690,48531164,SRX16500060,CTCF,474
chr1,48530707,48531124,SRX16500062,CTCF,417
chr1,48530736,48531005,SRX5716463,SMARCA4,269
chr1,48530748,48531093,SRX5075174,SMARCA4,345
chr1,48530775,48531061,SRX4174629,CTCF,286
chr1,48530803,48531067,SRX5075168,SMARCA4,264
chr1,48530808,48531022,SRX5075176,SMARCA4,214
chr1,48530817,48531106,SRX5716464,SMARCA4,289
chr1,48530832,48531066,SRX5075170,SMARCA4,234
chr1,48530858,48531070,SRX5075169,SMARCA4,212
chr1,48533061,48533320,SRX5075174,SMARCA4,259
chr1,48560133,48560550,SRX5075174,SMARCA4,417
chr1,48560172,48560417,SRX5075168,SMARCA4,245
chr1,48560256,48560443,SRX5054307,FOSL2,187
chr1,48572614,48573067,SRX16500061,CTCF,453
chr1,48572615,48573066,SRX16500060,CTCF,451
chr1,48572624,48573074,SRX16500059,CTCF,450
chr1,48572628,48573021,SRX16500062,CTCF,393
chr1,48572660,48573040,SRX4174629,CTCF,380
chr1,48588807,48588852,SRX1424892,POU3F2,45
chr1,48588817,48588858,SRX1424894,POU3F2,41
chr1,48610957,48611329,SRX20140895,INTS13,372
chr1,48617322,48617509,SRX5075175,SMARCA4,187
chr1,48619470,48619715,SRX5075176,SMARCA4,245
chr1,48619482,48619793,SRX5054309,FOSL2,311
chr1,48619493,48619745,SRX5075170,SMARCA4,252
chr1,48619530,48619806,SRX5075175,SMARCA4,276
chr1,48627487,48627796,SRX5716470,SMARCA4,309
chr1,48627518,48627845,SRX5075176,SMARCA4,327
chr1,48627535,48627822,SRX5075170,SMARCA4,287
chr1,48674649,48675003,SRX5075170,SMARCA4,354
chr1,48674660,48674956,SRX5075169,SMARCA4,296
chr1,48674695,48675010,SRX5075176,SMARCA4,315
chr1,48674707,48674925,SRX5054309,FOSL2,218
chr1,48674729,48674942,SRX5075175,SMARCA4,213
chr1,48674733,48674965,SRX5054308,FOSL2,232
chr1,48677277,48677700,SRX16500061,CTCF,423
chr1,48677300,48677721,SRX16500059,CTCF,421
chr1,48677307,48677721,SRX16500060,CTCF,414
chr1,48677309,48677696,SRX16500062,CTCF,387
chr1,48677390,48677723,SRX4174629,CTCF,333
chr1,48677402,48677600,SRX5075174,SMARCA4,198
chr1,48688316,48688755,SRX16500060,CTCF,439
chr1,48688397,48688662,SRX16500062,CTCF,265
chr1,48697031,48697542,SRX16500059,CTCF,511
chr1,48697039,48697501,SRX16500061,CTCF,462
chr1,48697064,48697498,SRX16500060,CTCF,434
chr1,48697090,48697539,SRX16500062,CTCF,449
chr1,48697122,48697372,SRX5075174,SMARCA4,250
chr1,48697145,48697448,SRX4174629,CTCF,303
chr1,48735638,48736030,SRX5075168,SMARCA4,392
chr1,48761470,48761661,SRX5054309,FOSL2,191
chr1,48776536,48777044,SRX5075174,SMARCA4,508
chr1,48776557,48776794,SRX5075169,SMARCA4,237
chr1,48776558,48776975,SRX20140895,INTS13,417
chr1,48776601,48776862,SRX20140868,INTS10,261
chr1,48776680,48777271,SRX5075168,SMARCA4,591
chr1,48776714,48776976,SRX5716470,SMARCA4,262
chr1,48776718,48777243,SRX5075170,SMARCA4,525
chr1,48776784,48777164,SRX5075175,SMARCA4,380
chr1,48776834,48777188,SRX5075176,SMARCA4,354
chr1,48817447,48817933,SRX16500059,CTCF,486
chr1,48817496,48817965,SRX16500062,CTCF,469
chr1,48817497,48817918,SRX16500060,CTCF,421
chr1,48817508,48817822,SRX5075174,SMARCA4,314
chr1,48817520,48817867,SRX16500061,CTCF,347
chr1,48817547,48817801,SRX5075168,SMARCA4,254
chr1,48817569,48817790,SRX5075175,SMARCA4,221
chr1,48817581,48817825,SRX5075176,SMARCA4,244
chr1,48817610,48817817,SRX5075170,SMARCA4,207
chr1,48870575,48870987,SRX16500059,CTCF,412
chr1,48870607,48870978,SRX16500060,CTCF,371
chr1,48870647,48871008,SRX16500062,CTCF,361
chr1,48870659,48870966,SRX16500061,CTCF,307
chr1,48878449,48878709,SRX5075170,SMARCA4,260
chr1,48878475,48878749,SRX5054309,FOSL2,274
chr1,48878480,48878702,SRX5075169,SMARCA4,222
chr1,48878492,48878831,SRX5075176,SMARCA4,339
chr1,48916187,48916381,SRX5075176,SMARCA4,194
chr1,48916198,48916409,SRX5716470,SMARCA4,211
chr1,48916208,48916912,SRX16500060,CTCF,704
chr1,48916214,48916939,SRX16500062,CTCF,725
chr1,48916217,48916723,SRX4174629,CTCF,506
chr1,48916222,48916416,SRX5075170,SMARCA4,194
chr1,48916401,48916990,SRX16500059,CTCF,589
chr1,48916496,48916980,SRX16500061,CTCF,484
chr1,48932454,48932676,SRX5716468,SMARCA2,222
chr1,48932466,48932637,SRX5075170,SMARCA4,171
chr1,49060717,49061350,SRX5075170,SMARCA4,633
chr1,49060755,49061269,SRX5075176,SMARCA4,514
chr1,49060757,49061157,SRX5075169,SMARCA4,400
chr1,49060779,49061100,SRX5020214,SMARCA2,321
chr1,49060798,49061026,SRX5716470,SMARCA4,228
chr1,49060832,49061207,SRX5054309,FOSL2,375
chr1,49060860,49061168,SRX5020211,SMARCA2,308
chr1,49060861,49061154,SRX5716469,SMARCA4,293
chr1,49060870,49061185,SRX5054308,FOSL2,315
chr1,49060879,49061200,SRX5716467,SMARCA2,321
chr1,49060889,49061092,SRX5075181,SMARCA2,203
chr1,49102818,49103113,SRX5054309,FOSL2,295
chr1,49257199,49257677,SRX20140895,INTS13,478
chr1,50023673,50024015,SRX20140895,INTS13,342
chr1,50047791,50048170,SRX16500059,CTCF,379
chr1,50047824,50048128,SRX16500060,CTCF,304
chr1,50047830,50048122,SRX16500062,CTCF,292
chr1,50047850,50048142,SRX16500061,CTCF,292
chr1,50080944,50081313,SRX16500059,CTCF,369
chr1,50080949,50081335,SRX16500060,CTCF,386
chr1,50080986,50081279,SRX16500062,CTCF,293
chr1,50081037,50081395,SRX4174629,CTCF,358
chr1,50081038,50081306,SRX16500061,CTCF,268
chr1,50099779,50100014,SRX16500060,CTCF,235
chr1,50105340,50105805,SRX16500061,CTCF,465
chr1,50105367,50105773,SRX16500059,CTCF,406
chr1,50105425,50105850,SRX16500060,CTCF,425
chr1,50105477,50105756,SRX16500062,CTCF,279
chr1,50110748,50110962,SRX5075174,SMARCA4,214
chr1,50110794,50111020,SRX5075168,SMARCA4,226
chr1,50251718,50252158,SRX5075174,SMARCA4,440
chr1,50251740,50252205,SRX5075168,SMARCA4,465
chr1,50251747,50252105,SRX5716464,SMARCA4,358
chr1,50251786,50252284,SRX20140895,INTS13,498
chr1,50251826,50252104,SRX20140867,INTS10,278
chr1,50251840,50252133,SRX5716463,SMARCA4,293
chr1,50251846,50251967,SRX1424894,POU3F2,121
chr1,50251893,50252086,SRX1424893,POU3F2,193
chr1,50252016,50252063,SRX1424894,POU3F2,47
chr1,50271946,50272412,SRX16500059,CTCF,466
chr1,50271947,50272473,SRX16500060,CTCF,526
chr1,50271951,50272438,SRX16500062,CTCF,487
chr1,50271976,50272484,SRX16500061,CTCF,508
chr1,50272032,50272243,SRX5075168,SMARCA4,211
chr1,50272068,50272263,SRX5075174,SMARCA4,195
chr1,50308887,50309170,SRX5716470,SMARCA4,283
chr1,50308904,50309135,SRX5716464,SMARCA4,231
chr1,50308906,50309219,SRX5075168,SMARCA4,313
chr1,50308910,50309215,SRX5075170,SMARCA4,305
chr1,50308926,50309195,SRX5075174,SMARCA4,269
chr1,50308943,50309151,SRX5075169,SMARCA4,208
chr1,50308947,50309180,SRX5075175,SMARCA4,233
chr1,50308961,50309166,SRX5716463,SMARCA4,205
chr1,50308963,50309197,SRX5075176,SMARCA4,234
chr1,50332950,50333210,SRX5716460,Epitope tags,260
chr1,50332970,50333276,SRX5716463,SMARCA4,306
chr1,50332977,50333452,SRX4174629,CTCF,475
chr1,50332986,50333322,SRX5716470,SMARCA4,336
chr1,50332986,50333333,SRX5075170,SMARCA4,347
chr1,50332987,50333322,SRX5716464,SMARCA4,335
chr1,50332988,50333964,SRX16500060,CTCF,976
chr1,50332992,50333315,SRX5075176,SMARCA4,323
chr1,50332996,50333985,SRX16500062,CTCF,989
chr1,50332997,50333961,SRX16500061,CTCF,964
chr1,50332997,50333973,SRX16500059,CTCF,976
chr1,50333003,50333317,SRX5075174,SMARCA4,314
chr1,50333006,50333339,SRX5075175,SMARCA4,333
chr1,50333009,50333301,SRX5075168,SMARCA4,292
chr1,50333020,50333243,SRX5716469,SMARCA4,223
chr1,50333024,50333325,SRX5075169,SMARCA4,301
chr1,50333617,50333831,SRX5075174,SMARCA4,214
chr1,50333619,50333809,SRX5075168,SMARCA4,190
chr1,50333623,50333836,SRX5075169,SMARCA4,213
chr1,50348610,50349140,SRX16500059,CTCF,530
chr1,50348616,50349106,SRX16500061,CTCF,490
chr1,50348661,50349110,SRX16500060,CTCF,449
chr1,50348684,50349109,SRX16500062,CTCF,425
chr1,50348731,50349078,SRX4174629,CTCF,347
chr1,50348743,50348980,SRX5075168,SMARCA4,237
chr1,50348750,50348961,SRX5075175,SMARCA4,211
chr1,50348762,50348969,SRX5075170,SMARCA4,207
chr1,50348771,50348998,SRX5075174,SMARCA4,227
chr1,50348778,50348959,SRX5075176,SMARCA4,181
chr1,50368359,50368882,SRX16500060,CTCF,523
chr1,50368396,50368869,SRX16500059,CTCF,473
chr1,50368402,50368891,SRX16500061,CTCF,489
chr1,50368435,50368860,SRX16500062,CTCF,425
chr1,50368438,50368856,SRX4174629,CTCF,418
chr1,50423256,50423569,SRX20140895,INTS13,313
chr1,50570095,50570307,SRX5716469,SMARCA4,212
chr1,50570096,50570306,SRX5075175,SMARCA4,210
chr1,50570169,50570465,SRX5075169,SMARCA4,296
chr1,50603494,50603940,SRX5054309,FOSL2,446
chr1,50603506,50603809,SRX5075176,SMARCA4,303
chr1,50603622,50603991,SRX5075170,SMARCA4,369
chr1,50603703,50603934,SRX5075169,SMARCA4,231
chr1,50603713,50604001,SRX5054308,FOSL2,288
chr1,50605454,50605829,SRX16500061,CTCF,375
chr1,50605479,50605891,SRX16500060,CTCF,412
chr1,50605484,50605845,SRX16500059,CTCF,361
chr1,50605601,50605849,SRX16500062,CTCF,248
chr1,50605609,50605823,SRX4174629,CTCF,214
chr1,50620557,50620884,SRX16500060,CTCF,327
chr1,50620594,50620876,SRX16500059,CTCF,282
chr1,50633460,50633656,SRX5075174,SMARCA4,196
chr1,50658381,50658794,SRX5075174,SMARCA4,413
chr1,50658393,50658810,SRX5075168,SMARCA4,417
chr1,50658456,50658746,SRX5716463,SMARCA4,290
chr1,50658535,50658750,SRX5716454,SOX3,215
chr1,50703899,50704500,SRX16500059,CTCF,601
chr1,50703907,50704488,SRX16500061,CTCF,581
chr1,50703978,50704492,SRX16500060,CTCF,514
chr1,50703998,50704451,SRX16500062,CTCF,453
chr1,50704030,50704384,SRX4174629,CTCF,354
chr1,50704130,50704338,SRX5075168,SMARCA4,208
chr1,50704131,50704334,SRX5075174,SMARCA4,203
chr1,50735275,50735765,SRX16500059,CTCF,490
chr1,50735313,50735778,SRX16500062,CTCF,465
chr1,50735322,50735748,SRX16500061,CTCF,426
chr1,50735349,50735759,SRX16500060,CTCF,410
chr1,50749895,50750318,SRX16500061,CTCF,423
chr1,50749902,50750301,SRX16500060,CTCF,399
chr1,50749980,50750315,SRX16500059,CTCF,335
chr1,50774636,50775192,SRX16500060,CTCF,556
chr1,50774657,50775154,SRX16500062,CTCF,497
chr1,50774658,50775167,SRX16500061,CTCF,509
chr1,50774722,50775189,SRX16500059,CTCF,467
chr1,50774835,50775040,SRX5716464,SMARCA4,205
chr1,50774845,50775106,SRX5075176,SMARCA4,261
chr1,50774847,50775077,SRX5075169,SMARCA4,230
chr1,50774849,50775143,SRX5075174,SMARCA4,294
chr1,50774867,50775095,SRX5075170,SMARCA4,228
chr1,50774879,50775093,SRX5075175,SMARCA4,214
chr1,50774894,50775142,SRX5075168,SMARCA4,248
chr1,50829286,50829667,SRX5075170,SMARCA4,381
chr1,50829370,50829581,SRX5716470,SMARCA4,211
chr1,50829372,50829681,SRX5075176,SMARCA4,309
chr1,50829399,50829598,SRX5075175,SMARCA4,199
chr1,50841750,50842120,SRX5716469,SMARCA4,370
chr1,50841760,50842236,SRX5075174,SMARCA4,476
chr1,50841800,50842042,SRX5716467,SMARCA2,242
chr1,50841801,50842120,SRX5075170,SMARCA4,319
chr1,50841805,50842146,SRX5716470,SMARCA4,341
chr1,50841807,50842263,SRX5075168,SMARCA4,456
chr1,50841812,50842031,SRX5075175,SMARCA4,219
chr1,50841814,50842097,SRX5716463,SMARCA4,283
chr1,50841830,50842106,SRX5075169,SMARCA4,276
chr1,50841833,50842164,SRX5075176,SMARCA4,331
chr1,50873324,50873715,SRX16500060,CTCF,391
chr1,50873328,50873715,SRX16500059,CTCF,387
chr1,50873374,50873645,SRX5075168,SMARCA4,271
chr1,50873423,50873694,SRX5075174,SMARCA4,271
chr1,50873425,50873635,SRX16500062,CTCF,210
chr1,50873444,50873638,SRX5075170,SMARCA4,194
chr1,50873445,50873747,SRX16500061,CTCF,302
chr1,50873457,50873907,SRX4174629,CTCF,450
chr1,50873512,50873723,SRX5075176,SMARCA4,211
chr1,50873548,50873852,SRX5075169,SMARCA4,304
chr1,50873593,50873937,SRX5054309,FOSL2,344
chr1,50873649,50873907,SRX5054308,FOSL2,258
chr1,50929279,50929775,SRX16500059,CTCF,496
chr1,50929281,50929742,SRX16500060,CTCF,461
chr1,50929289,50929774,SRX16500062,CTCF,485
chr1,50929312,50929812,SRX16500061,CTCF,500
chr1,50929458,50929677,SRX5075168,SMARCA4,219
chr1,50960016,50960621,SRX20140895,INTS13,605
chr1,50960043,50960503,SRX5075170,SMARCA4,460
chr1,50960106,50960554,SRX20140897,INTS13,448
chr1,50960109,50960494,SRX5075174,SMARCA4,385
chr1,50960131,50960536,SRX5075168,SMARCA4,405
chr1,50960186,50960499,SRX20140896,INTS13,313
chr1,50960213,50960528,SRX5075176,SMARCA4,315
chr1,50960219,50960510,SRX20140867,INTS10,291
chr1,50960262,50960622,SRX16500059,CTCF,360
chr1,50960281,50960470,SRX5054309,FOSL2,189
chr1,50960314,50960585,SRX16500060,CTCF,271
chr1,50960368,50960601,SRX16500061,CTCF,233
chr1,50960376,50960637,SRX16500062,CTCF,261
chr1,50967957,50968466,SRX16500061,CTCF,509
chr1,50967994,50968481,SRX16500059,CTCF,487
chr1,50968035,50968647,SRX20140895,INTS13,612
chr1,50968036,50968310,SRX5075174,SMARCA4,274
chr1,50968037,50968306,SRX16500060,CTCF,269
chr1,50968045,50968431,SRX16500062,CTCF,386
chr1,50968224,50968596,SRX5075170,SMARCA4,372
chr1,50968227,50968414,SRX5075175,SMARCA4,187
chr1,50968272,50968555,SRX20140868,INTS10,283
chr1,50968489,50968668,SRX5075168,SMARCA4,179
chr1,50977771,50977988,SRX5716470,SMARCA4,217
chr1,51019843,51020166,SRX5075170,SMARCA4,323
chr1,51019850,51020202,SRX5075176,SMARCA4,352
chr1,51019883,51020068,SRX5075169,SMARCA4,185
chr1,51019898,51020112,SRX5716470,SMARCA4,214
chr1,51019921,51020115,SRX5075175,SMARCA4,194
chr1,51063055,51063500,SRX5716470,SMARCA4,445
chr1,51063086,51063485,SRX5054309,FOSL2,399
chr1,51063119,51063453,SRX5054308,FOSL2,334
chr1,51063185,51063387,SRX5075169,SMARCA4,202
chr1,51063206,51063413,SRX5075181,SMARCA2,207
chr1,51063234,51063421,SRX5075175,SMARCA4,187
chr1,51189399,51189844,SRX16500060,CTCF,445
chr1,51189408,51189819,SRX16500062,CTCF,411
chr1,51189411,51189843,SRX16500061,CTCF,432
chr1,51189415,51189868,SRX16500059,CTCF,453
chr1,51189468,51189689,SRX5075170,SMARCA4,221
chr1,51189485,51189711,SRX5075168,SMARCA4,226
chr1,51189498,51189702,SRX5075174,SMARCA4,204
chr1,51189502,51189688,SRX5075169,SMARCA4,186
chr1,51189519,51189696,SRX5075176,SMARCA4,177
chr1,51192182,51192610,SRX16500059,CTCF,428
chr1,51192186,51192709,SRX16500060,CTCF,523
chr1,51192212,51192615,SRX16500061,CTCF,403
chr1,51192217,51192552,SRX16500062,CTCF,335
chr1,51192225,51192519,SRX5075176,SMARCA4,294
chr1,51192241,51192519,SRX5716463,SMARCA4,278
chr1,51192256,51192470,SRX5075170,SMARCA4,214
chr1,51192257,51192556,SRX5075174,SMARCA4,299
chr1,51192264,51192507,SRX5075168,SMARCA4,243
chr1,51192286,51192483,SRX5075169,SMARCA4,197
chr1,51214542,51214841,SRX5075170,SMARCA4,299
chr1,51214551,51214833,SRX5075176,SMARCA4,282
chr1,51214606,51214817,SRX5716470,SMARCA4,211
chr1,51235977,51236437,SRX5075170,SMARCA4,460
chr1,51235978,51236421,SRX5716470,SMARCA4,443
chr1,51236003,51236215,SRX5716469,SMARCA4,212
chr1,51236014,51236418,SRX5075176,SMARCA4,404
chr1,51236036,51236476,SRX5075168,SMARCA4,440
chr1,51236040,51236276,SRX5075169,SMARCA4,236
chr1,51236044,51236529,SRX5075174,SMARCA4,485
chr1,51236095,51236423,SRX5716463,SMARCA4,328
chr1,51236102,51236786,SRX20140895,INTS13,684
chr1,51236119,51236377,SRX5716464,SMARCA4,258
chr1,51236138,51236583,SRX20140869,INTS10,445
chr1,51236147,51236499,SRX20140879,CPSF3L,352
chr1,51236150,51236606,SRX20140867,INTS10,456
chr1,51236170,51236606,SRX20140868,INTS10,436
chr1,51236216,51236590,SRX20140881,CPSF3L,374
chr1,51236254,51236586,SRX20140897,INTS13,332
chr1,51236255,51236530,SRX20140896,INTS13,275
chr1,51261103,51261589,SRX5075174,SMARCA4,486
chr1,51261120,51261651,SRX5075168,SMARCA4,531
chr1,51261191,51261647,SRX5716463,SMARCA4,456
chr1,51261213,51261571,SRX5716464,SMARCA4,358
chr1,51261226,51261552,SRX5075176,SMARCA4,326
chr1,51261234,51261490,SRX5716469,SMARCA4,256
chr1,51261239,51261565,SRX5075169,SMARCA4,326
chr1,51261249,51261566,SRX5075170,SMARCA4,317
chr1,51261265,51261547,SRX5054308,FOSL2,282
chr1,51261265,51261557,SRX5075175,SMARCA4,292
chr1,51261270,51261514,SRX5020211,SMARCA2,244
chr1,51261275,51261554,SRX5020214,SMARCA2,279
chr1,51261278,51261595,SRX5054309,FOSL2,317
chr1,51261303,51261493,SRX5716451,SOX2,190
chr1,51261303,51261551,SRX5054307,FOSL2,248
chr1,51261308,51261542,SRX5716470,SMARCA4,234
chr1,51264441,51264852,SRX5075176,SMARCA4,411
chr1,51264466,51264908,SRX5075170,SMARCA4,442
chr1,51264468,51264839,SRX5075169,SMARCA4,371
chr1,51264476,51264859,SRX5716470,SMARCA4,383
chr1,51264485,51264820,SRX5716469,SMARCA4,335
chr1,51264489,51264826,SRX5020211,SMARCA2,337
chr1,51264499,51264815,SRX5075175,SMARCA4,316
chr1,51264544,51264823,SRX5054309,FOSL2,279
chr1,51264564,51264822,SRX5054308,FOSL2,258
chr1,51268090,51268415,SRX5054309,FOSL2,325
chr1,51268120,51268327,SRX5075175,SMARCA4,207
chr1,51268125,51268359,SRX5054308,FOSL2,234
chr1,51296697,51297231,SRX16500059,CTCF,534
chr1,51296739,51297233,SRX16500060,CTCF,494
chr1,51296751,51297206,SRX16500062,CTCF,455
chr1,51296768,51297298,SRX16500061,CTCF,530
chr1,51296790,51297248,SRX5075174,SMARCA4,458
chr1,51296791,51297152,SRX5075170,SMARCA4,361
chr1,51296805,51297232,SRX5075168,SMARCA4,427
chr1,51296815,51297177,SRX5075176,SMARCA4,362
chr1,51296817,51297142,SRX5716463,SMARCA4,325
chr1,51296833,51297113,SRX5075175,SMARCA4,280
chr1,51296864,51297113,SRX4174629,CTCF,249
chr1,51296868,51297120,SRX5716464,SMARCA4,252
chr1,51296915,51297125,SRX5075169,SMARCA4,210
chr1,51313422,51313886,SRX16500061,CTCF,464
chr1,51313447,51313806,SRX16500060,CTCF,359
chr1,51313486,51313817,SRX16500059,CTCF,331
chr1,51314318,51314615,SRX5075170,SMARCA4,297
chr1,51314426,51314647,SRX5075169,SMARCA4,221
chr1,51331288,51331573,SRX5054309,FOSL2,285
chr1,51331296,51331546,SRX5054308,FOSL2,250
chr1,51331300,51331552,SRX5075176,SMARCA4,252
chr1,51331306,51331534,SRX5075174,SMARCA4,228
chr1,51331321,51331581,SRX5075170,SMARCA4,260
chr1,51331397,51331584,SRX5075175,SMARCA4,187
chr1,51331413,51331603,SRX5075168,SMARCA4,190
chr1,51351827,51352113,SRX5716470,SMARCA4,286
chr1,51351886,51352080,SRX5075170,SMARCA4,194
chr1,51351921,51352096,SRX5075176,SMARCA4,175
chr1,51410997,51411517,SRX5716463,SMARCA4,520
chr1,51411087,51411298,SRX5716470,SMARCA4,211
chr1,51411111,51411345,SRX5075169,SMARCA4,234
chr1,51411124,51411490,SRX5075174,SMARCA4,366
chr1,51411138,51411512,SRX5075168,SMARCA4,374
chr1,51421842,51422042,SRX5075176,SMARCA4,200
chr1,51421896,51422225,SRX5075174,SMARCA4,329
chr1,51422042,51422273,SRX5075170,SMARCA4,231
chr1,51422060,51422308,SRX5075168,SMARCA4,248
chr1,51433726,51433948,SRX5075176,SMARCA4,222
chr1,51453149,51453344,SRX5075176,SMARCA4,195
chr1,51472389,51472665,SRX5075170,SMARCA4,276
chr1,51472422,51472789,SRX5075176,SMARCA4,367
chr1,51506465,51506910,SRX5075170,SMARCA4,445
chr1,51506474,51507032,SRX5075176,SMARCA4,558
chr1,51506495,51506931,SRX5075175,SMARCA4,436
chr1,51506509,51506746,SRX5075169,SMARCA4,237
chr1,51506543,51506768,SRX5054308,FOSL2,225
chr1,51506556,51506768,SRX5716470,SMARCA4,212
chr1,51506591,51506882,SRX5716467,SMARCA2,291
chr1,51518893,51519617,SRX5075174,SMARCA4,724
chr1,51518971,51519547,SRX20140895,INTS13,576
chr1,51519029,51519635,SRX5075168,SMARCA4,606
chr1,51519240,51519640,SRX5075176,SMARCA4,400
chr1,51519261,51519598,SRX5075170,SMARCA4,337
chr1,51519281,51519563,SRX5075169,SMARCA4,282
chr1,51519334,51519552,SRX5716463,SMARCA4,218
chr1,51535003,51535459,SRX16500060,CTCF,456
chr1,51535020,51535311,SRX5075176,SMARCA4,291
chr1,51535031,51535311,SRX5075169,SMARCA4,280
chr1,51535039,51535287,SRX5075170,SMARCA4,248
chr1,51548959,51549161,SRX5075169,SMARCA4,202
chr1,51549043,51549220,SRX5075176,SMARCA4,177
chr1,51558271,51558540,SRX5075168,SMARCA4,269
chr1,51558298,51558489,SRX5075174,SMARCA4,191
chr1,51558324,51558613,SRX5075175,SMARCA4,289
chr1,51558359,51558539,SRX5075169,SMARCA4,180
chr1,51558416,51558650,SRX5075170,SMARCA4,234
chr1,51567568,51568008,SRX5075175,SMARCA4,440
chr1,51567665,51568049,SRX5716470,SMARCA4,384
chr1,51567680,51568034,SRX5716468,SMARCA2,354
chr1,51567682,51568084,SRX5716469,SMARCA4,402
chr1,51567686,51568098,SRX5075176,SMARCA4,412
chr1,51567699,51567987,SRX5054309,FOSL2,288
chr1,51567699,51568067,SRX5075170,SMARCA4,368
chr1,51567707,51568057,SRX5075169,SMARCA4,350
chr1,51567718,51567992,SRX5075181,SMARCA2,274
chr1,51567736,51568014,SRX5716467,SMARCA2,278
chr1,51567779,51567959,SRX5054308,FOSL2,180
chr1,51567794,51568020,SRX5020211,SMARCA2,226
chr1,51569804,51570099,SRX5054309,FOSL2,295
chr1,51569813,51570083,SRX5075175,SMARCA4,270
chr1,51569819,51570007,SRX5075169,SMARCA4,188
chr1,51569830,51570042,SRX5075168,SMARCA4,212
chr1,51569831,51570076,SRX5054308,FOSL2,245
chr1,51569835,51570044,SRX5075176,SMARCA4,209
chr1,51569841,51570097,SRX5075170,SMARCA4,256
chr1,51575500,51575776,SRX5075175,SMARCA4,276
chr1,51575501,51575736,SRX5075170,SMARCA4,235
chr1,51575508,51575865,SRX5075169,SMARCA4,357
chr1,51575510,51575758,SRX5054309,FOSL2,248
chr1,51575511,51575806,SRX5075176,SMARCA4,295
chr1,51575536,51575770,SRX5054308,FOSL2,234
chr1,51583347,51584012,SRX5075170,SMARCA4,665
chr1,51583368,51584046,SRX5075176,SMARCA4,678
chr1,51583444,51583897,SRX5075175,SMARCA4,453
chr1,51583457,51583906,SRX5075169,SMARCA4,449
chr1,51583474,51583960,SRX5716470,SMARCA4,486
chr1,51583498,51583874,SRX5716469,SMARCA4,376
chr1,51583528,51583899,SRX5716467,SMARCA2,371
chr1,51583545,51583892,SRX5054309,FOSL2,347
chr1,51583562,51583800,SRX5020211,SMARCA2,238
chr1,51583579,51583854,SRX5054308,FOSL2,275
chr1,51583608,51583826,SRX5716468,SMARCA2,218
chr1,51586396,51586627,SRX5075170,SMARCA4,231
chr1,51592595,51593117,SRX5075176,SMARCA4,522
chr1,51592698,51592896,SRX5075170,SMARCA4,198
chr1,51616820,51617185,SRX5075168,SMARCA4,365
chr1,51616831,51617384,SRX5075174,SMARCA4,553
chr1,51616844,51617205,SRX5075176,SMARCA4,361
chr1,51616885,51617099,SRX5075170,SMARCA4,214
chr1,51616891,51617383,SRX20140895,INTS13,492
chr1,51616960,51617179,SRX5075169,SMARCA4,219
chr1,51616963,51617242,SRX5716451,SOX2,279
chr1,51616985,51617190,SRX5716454,SOX3,205
chr1,51616988,51617171,SRX5054309,FOSL2,183
chr1,51617048,51617275,SRX20140867,INTS10,227
chr1,51622482,51622770,SRX5075170,SMARCA4,288
chr1,51622493,51622772,SRX5054309,FOSL2,279
chr1,51622509,51622697,SRX5075176,SMARCA4,188
chr1,51627719,51627985,SRX16500062,CTCF,266
chr1,51637037,51637435,SRX5075175,SMARCA4,398
chr1,51637061,51637465,SRX5075169,SMARCA4,404
chr1,51637103,51637426,SRX5716469,SMARCA4,323
chr1,51637104,51637421,SRX5054309,FOSL2,317
chr1,51637130,51637467,SRX5075170,SMARCA4,337
chr1,51637150,51637452,SRX5075176,SMARCA4,302
chr1,51637173,51637414,SRX5054308,FOSL2,241
chr1,51642648,51643132,SRX5075170,SMARCA4,484
chr1,51642689,51643095,SRX5075176,SMARCA4,406
chr1,51642696,51643187,SRX5716469,SMARCA4,491
chr1,51642700,51643072,SRX5716467,SMARCA2,372
chr1,51642713,51643148,SRX5716470,SMARCA4,435
chr1,51642721,51643057,SRX5075181,SMARCA2,336
chr1,51642724,51643115,SRX5075175,SMARCA4,391
chr1,51642747,51643176,SRX5075169,SMARCA4,429
chr1,51642761,51643072,SRX5020211,SMARCA2,311
chr1,51642793,51643002,SRX5054308,FOSL2,209
chr1,51642798,51643052,SRX5020214,SMARCA2,254
chr1,51642803,51643001,SRX5054309,FOSL2,198
chr1,51642813,51643115,SRX5716468,SMARCA2,302
chr1,51644571,51644854,SRX5054308,FOSL2,283
chr1,51644587,51644791,SRX5075175,SMARCA4,204
chr1,51644603,51644886,SRX5054309,FOSL2,283
chr1,51644622,51644853,SRX5075170,SMARCA4,231
chr1,51644634,51644869,SRX5075176,SMARCA4,235
chr1,51648440,51648645,SRX5075174,SMARCA4,205
chr1,51648516,51648744,SRX5075168,SMARCA4,228
chr1,51660940,51661582,SRX5075170,SMARCA4,642
chr1,51660955,51661622,SRX5075176,SMARCA4,667
chr1,51660957,51661598,SRX5075169,SMARCA4,641
chr1,51660973,51661584,SRX5716469,SMARCA4,611
chr1,51660988,51661514,SRX5020211,SMARCA2,526
chr1,51661002,51661552,SRX5075175,SMARCA4,550
chr1,51661005,51661383,SRX5716460,Epitope tags,378
chr1,51661006,51661477,SRX5075181,SMARCA2,471
chr1,51661021,51661560,SRX5020214,SMARCA2,539
chr1,51661028,51661629,SRX5716467,SMARCA2,601
chr1,51661035,51661580,SRX5716459,Epitope tags,545
chr1,51661044,51661562,SRX5054308,FOSL2,518
chr1,51661056,51661585,SRX5054309,FOSL2,529
chr1,51661059,51661514,SRX5716470,SMARCA4,455
chr1,51661060,51661552,SRX5716468,SMARCA2,492
chr1,51661076,51661595,SRX5075174,SMARCA4,519
chr1,51661090,51661348,SRX5075182,SMARCA2,258
chr1,51661203,51661576,SRX5075168,SMARCA4,373
chr1,51661276,51661542,SRX5054307,FOSL2,266
chr1,51689688,51690058,SRX5716463,SMARCA4,370
chr1,51689758,51690031,SRX5075168,SMARCA4,273
chr1,51689788,51690037,SRX5075174,SMARCA4,249
chr1,51729328,51729596,SRX5075169,SMARCA4,268
chr1,51729385,51729785,SRX5075168,SMARCA4,400
chr1,51729393,51730208,SRX20140895,INTS13,815
chr1,51729441,51729669,SRX5716470,SMARCA4,228
chr1,51729444,51729934,SRX5075174,SMARCA4,490
chr1,51729539,51729806,SRX20140897,INTS13,267
chr1,51736889,51737144,SRX5075170,SMARCA4,255
chr1,51750237,51750565,SRX5054308,FOSL2,328
chr1,51750286,51750551,SRX5054309,FOSL2,265
chr1,51750296,51750495,SRX5075169,SMARCA4,199
chr1,51768906,51769434,SRX16500059,CTCF,528
chr1,51768945,51769444,SRX16500060,CTCF,499
chr1,51768951,51769364,SRX16500061,CTCF,413
chr1,51768979,51769416,SRX16500062,CTCF,437
chr1,51769044,51769223,SRX5075168,SMARCA4,179
chr1,51769055,51769282,SRX5075174,SMARCA4,227
chr1,51769059,51769254,SRX5075170,SMARCA4,195
chr1,51769062,51769265,SRX5075176,SMARCA4,203
chr1,51769080,51769518,SRX4174629,CTCF,438
chr1,51861708,51862004,SRX5054308,FOSL2,296
chr1,51861752,51861982,SRX5054309,FOSL2,230
chr1,51867841,51868010,SRX5075170,SMARCA4,169
chr1,51878328,51879359,SRX20140895,INTS13,1031
chr1,51878329,51879235,SRX20140881,CPSF3L,906
chr1,51878422,51879328,SRX20140868,INTS10,906
chr1,51878454,51879278,SRX20140867,INTS10,824
chr1,51878480,51879427,SRX20140897,INTS13,947
chr1,51878481,51878932,SRX20140879,CPSF3L,451
chr1,51878547,51878720,SRX5075174,SMARCA4,173
chr1,51878549,51879206,SRX5075168,SMARCA4,657
chr1,51878582,51878966,SRX5075170,SMARCA4,384
chr1,51878597,51879365,SRX5075176,SMARCA4,768
chr1,51878600,51878871,SRX20140896,INTS13,271
chr1,51878758,51878939,SRX5054307,FOSL2,181
chr1,51878870,51879533,SRX5075169,SMARCA4,663
chr1,51878943,51879296,SRX5716469,SMARCA4,353
chr1,51878952,51879337,SRX5054309,FOSL2,385
chr1,51879007,51879305,SRX5054308,FOSL2,298
chr1,51879014,51879564,SRX20140869,INTS10,550
chr1,51879045,51879548,SRX5075170,SMARCA4,503
chr1,51879229,51879470,SRX5075175,SMARCA4,241
chr1,51896760,51897255,SRX16500060,CTCF,495
chr1,51896785,51897313,SRX16500059,CTCF,528
chr1,51896829,51897270,SRX16500061,CTCF,441
chr1,51896847,51897260,SRX16500062,CTCF,413
chr1,51896868,51897228,SRX4174629,CTCF,360
chr1,51896931,51897194,SRX5075170,SMARCA4,263
chr1,51896939,51897180,SRX5075174,SMARCA4,241
chr1,51896951,51897157,SRX5075168,SMARCA4,206
chr1,51896957,51897182,SRX5075176,SMARCA4,225
chr1,51896979,51897178,SRX5075169,SMARCA4,199
chr1,51897645,51898010,SRX5075169,SMARCA4,365
chr1,51897646,51897959,SRX5020214,SMARCA2,313
chr1,51897651,51897983,SRX5054309,FOSL2,332
chr1,51897679,51897922,SRX5075176,SMARCA4,243
chr1,51897693,51897947,SRX5054308,FOSL2,254
chr1,51898281,51898694,SRX5075176,SMARCA4,413
chr1,51898282,51898661,SRX5054309,FOSL2,379
chr1,51898335,51898696,SRX5075169,SMARCA4,361
chr1,51898343,51898560,SRX5054308,FOSL2,217
chr1,51898350,51898672,SRX5075170,SMARCA4,322
chr1,51898373,51898588,SRX5716467,SMARCA2,215
chr1,51898394,51898605,SRX5716468,SMARCA2,211
chr1,51898394,51898685,SRX5075175,SMARCA4,291
chr1,51898401,51898659,SRX5716469,SMARCA4,258
chr1,51898404,51898715,SRX5716470,SMARCA4,311
chr1,51899309,51899678,SRX5075168,SMARCA4,369
chr1,51899384,51899634,SRX5716463,SMARCA4,250
chr1,51899455,51899717,SRX5075174,SMARCA4,262
chr1,51906449,51906629,SRX5075169,SMARCA4,180
chr1,51919247,51919609,SRX20140867,INTS10,362
chr1,51919252,51919686,SRX5075174,SMARCA4,434
chr1,51919266,51919706,SRX5075168,SMARCA4,440
chr1,51919299,51919669,SRX20140895,INTS13,370
chr1,51919309,51919581,SRX20140868,INTS10,272
chr1,51919358,51919674,SRX5716463,SMARCA4,316
chr1,51919366,51919656,SRX5716464,SMARCA4,290
chr1,51920240,51920420,SRX5054308,FOSL2,180
chr1,51926190,51926553,SRX16500060,CTCF,363
chr1,51926217,51926528,SRX16500062,CTCF,311
chr1,51926219,51926483,SRX16500061,CTCF,264
chr1,51926221,51926542,SRX16500059,CTCF,321
chr1,51953207,51953442,SRX5075176,SMARCA4,235
chr1,51953230,51953401,SRX5075170,SMARCA4,171
chr1,51956607,51956795,SRX5075169,SMARCA4,188
chr1,51956678,51956847,SRX5075170,SMARCA4,169
chr1,51970479,51970737,SRX5054308,FOSL2,258
chr1,51970486,51970686,SRX5020211,SMARCA2,200
chr1,51970493,51970730,SRX5075169,SMARCA4,237
chr1,51970507,51970754,SRX5054309,FOSL2,247
chr1,51981550,51981847,SRX5716463,SMARCA4,297
chr1,51981593,51981887,SRX5075174,SMARCA4,294
chr1,51981652,51981867,SRX5075168,SMARCA4,215
chr1,51990373,51990830,SRX5075176,SMARCA4,457
chr1,51990394,51990666,SRX5075169,SMARCA4,272
chr1,51990418,51990860,SRX5075170,SMARCA4,442
chr1,51990424,51990829,SRX5075174,SMARCA4,405
chr1,51990482,51990874,SRX5075175,SMARCA4,392
chr1,51990509,51990934,SRX5075168,SMARCA4,425
chr1,52002166,52002707,SRX16500059,CTCF,541
chr1,52002206,52002720,SRX16500060,CTCF,514
chr1,52002211,52002683,SRX16500062,CTCF,472
chr1,52002259,52002690,SRX16500061,CTCF,431
chr1,52002340,52002583,SRX5075168,SMARCA4,243
chr1,52002341,52002608,SRX5075174,SMARCA4,267
chr1,52002351,52002596,SRX5075170,SMARCA4,245
chr1,52002365,52002604,SRX5716470,SMARCA4,239
chr1,52002418,52002665,SRX4174629,CTCF,247
chr1,52002425,52002619,SRX5075176,SMARCA4,194
chr1,52005548,52005929,SRX5054309,FOSL2,381
chr1,52005577,52005973,SRX5075169,SMARCA4,396
chr1,52005623,52005828,SRX5020214,SMARCA2,205
chr1,52005630,52005908,SRX5075175,SMARCA4,278
chr1,52005665,52005879,SRX5075170,SMARCA4,214
chr1,52005669,52005879,SRX5054308,FOSL2,210
chr1,52005677,52005911,SRX5716469,SMARCA4,234
chr1,52005691,52005889,SRX5075176,SMARCA4,198
chr1,52033505,52033958,SRX20140895,INTS13,453
chr1,52033607,52033913,SRX20140897,INTS13,306
chr1,52033639,52033870,SRX20140867,INTS10,231
chr1,52033654,52034106,SRX5075168,SMARCA4,452
chr1,52033739,52034055,SRX5075174,SMARCA4,316
chr1,52033826,52034085,SRX5075176,SMARCA4,259
chr1,52033854,52034052,SRX5075170,SMARCA4,198
chr1,52055015,52055782,SRX20140895,INTS13,767
chr1,52055070,52055324,SRX5075174,SMARCA4,254
chr1,52055139,52055424,SRX20140897,INTS13,285
chr1,52055200,52055561,SRX20140867,INTS10,361
chr1,52055203,52055745,SRX20140868,INTS10,542
chr1,52055415,52055704,SRX20140881,CPSF3L,289
chr1,52056041,52056587,SRX20140895,INTS13,546
chr1,52056061,52056287,SRX5075174,SMARCA4,226
chr1,52056095,52056443,SRX5075168,SMARCA4,348
chr1,52056268,52056628,SRX20140897,INTS13,360
chr1,52056341,52056677,SRX20140869,INTS10,336
chr1,52056474,52056715,SRX16500059,CTCF,241
chr1,52059402,52059631,SRX5054308,FOSL2,229
chr1,52059452,52059670,SRX5054309,FOSL2,218
chr1,52098052,52098518,SRX20140895,INTS13,466
chr1,52098056,52098540,SRX5075168,SMARCA4,484
chr1,52098085,52098573,SRX5716463,SMARCA4,488
chr1,52098106,52098603,SRX5075174,SMARCA4,497
chr1,52098173,52098459,SRX5716464,SMARCA4,286
chr1,52098176,52098573,SRX20140868,INTS10,397
chr1,52098190,52098532,SRX20140879,CPSF3L,342
chr1,52098212,52098504,SRX20140860,SOX2,292
chr1,52098233,52098511,SRX20140894,INTS13,278
chr1,52098236,52098491,SRX5716454,SOX3,255
chr1,52098240,52098515,SRX5716451,SOX2,275
chr1,52098261,52098560,SRX20140867,INTS10,299
chr1,52119811,52120095,SRX5075168,SMARCA4,284
chr1,52119955,52120128,SRX5075174,SMARCA4,173
chr1,52127412,52127820,SRX16500061,CTCF,408
chr1,52127455,52127800,SRX16500059,CTCF,345
chr1,52127457,52127797,SRX16500062,CTCF,340
chr1,52127480,52127712,SRX5075176,SMARCA4,232
chr1,52127484,52127759,SRX16500060,CTCF,275
chr1,52127500,52127830,SRX5075169,SMARCA4,330
chr1,52127513,52127842,SRX5716470,SMARCA4,329
chr1,52127528,52127781,SRX5075168,SMARCA4,253
chr1,52127550,52127749,SRX5075174,SMARCA4,199
chr1,52127568,52127809,SRX5075170,SMARCA4,241
chr1,52127577,52127852,SRX5716469,SMARCA4,275
chr1,52127667,52127879,SRX4174629,CTCF,212
chr1,52139837,52140089,SRX5054309,FOSL2,252
chr1,52139852,52140082,SRX5054308,FOSL2,230
chr1,52139853,52140120,SRX5075169,SMARCA4,267
chr1,52139873,52140076,SRX5075176,SMARCA4,203
chr1,52139879,52140096,SRX5075175,SMARCA4,217
chr1,52139894,52140106,SRX5716469,SMARCA4,212
chr1,52139907,52140116,SRX5075170,SMARCA4,209
chr1,52141736,52142854,SRX20140895,INTS13,1118
chr1,52141774,52142317,SRX5075174,SMARCA4,543
chr1,52141781,52142340,SRX5716470,SMARCA4,559
chr1,52141782,52142353,SRX16500059,CTCF,571
chr1,52141787,52142375,SRX16500060,CTCF,588
chr1,52141791,52142130,SRX5075175,SMARCA4,339
chr1,52141793,52142223,SRX5716469,SMARCA4,430
chr1,52141802,52142258,SRX5075168,SMARCA4,456
chr1,52141819,52142248,SRX5075169,SMARCA4,429
chr1,52141838,52142285,SRX16500061,CTCF,447
chr1,52141843,52142250,SRX5075170,SMARCA4,407
chr1,52141851,52142289,SRX16500062,CTCF,438
chr1,52141855,52142468,SRX20140867,INTS10,613
chr1,52141878,52142743,SRX20140868,INTS10,865
chr1,52141897,52142174,SRX5075176,SMARCA4,277
chr1,52142238,52142481,SRX5075176,SMARCA4,243
chr1,52182484,52182777,SRX20140895,INTS13,293
chr1,52237448,52237777,SRX5054309,FOSL2,329
chr1,52237486,52237787,SRX5075169,SMARCA4,301
chr1,52237500,52237749,SRX5075170,SMARCA4,249
chr1,52237504,52237779,SRX5075175,SMARCA4,275
chr1,52237508,52237788,SRX5054308,FOSL2,280
chr1,52237519,52237712,SRX5075176,SMARCA4,193
chr1,52237530,52237742,SRX5716469,SMARCA4,212
chr1,52237572,52237784,SRX5020211,SMARCA2,212
chr1,52263184,52263353,SRX5075170,SMARCA4,169
chr1,52296193,52296641,SRX16500059,CTCF,448
chr1,52296217,52296659,SRX16500060,CTCF,442
chr1,52296251,52296609,SRX16500061,CTCF,358
chr1,52296283,52296599,SRX16500062,CTCF,316
chr1,52296340,52296539,SRX5075174,SMARCA4,199
chr1,52348676,52348914,SRX16500059,CTCF,238
chr1,52348687,52348960,SRX16500060,CTCF,273
chr1,52348749,52349034,SRX4174629,CTCF,285
chr1,52350904,52351433,SRX5075168,SMARCA4,529
chr1,52350907,52351394,SRX5075174,SMARCA4,487
chr1,52351043,52351302,SRX5716451,SOX2,259
chr1,52365228,52365511,SRX5054309,FOSL2,283
chr1,52365268,52365544,SRX5054308,FOSL2,276
chr1,52365863,52366096,SRX5716469,SMARCA4,233
chr1,52365864,52366465,SRX20140895,INTS13,601
chr1,52365918,52366340,SRX20140868,INTS10,422
chr1,52365953,52366385,SRX20140897,INTS13,432
chr1,52365981,52366192,SRX5716470,SMARCA4,211
chr1,52365983,52366230,SRX20140894,INTS13,247
chr1,52366012,52366630,SRX5075168,SMARCA4,618
chr1,52366025,52366637,SRX5075174,SMARCA4,612
chr1,52366039,52366530,SRX5075176,SMARCA4,491
chr1,52366067,52366547,SRX5075170,SMARCA4,480
chr1,52366295,52366506,SRX5716470,SMARCA4,211
chr1,52366311,52366500,SRX5054307,FOSL2,189
chr1,52366324,52366511,SRX5075175,SMARCA4,187
chr1,52366341,52366546,SRX5716464,SMARCA4,205
chr1,52368482,52368662,SRX5075169,SMARCA4,180
chr1,52403659,52403839,SRX5054308,FOSL2,180
chr1,52403691,52403917,SRX5054309,FOSL2,226
chr1,52404005,52404838,SRX20140895,INTS13,833
chr1,52404069,52404557,SRX5075170,SMARCA4,488
chr1,52404226,52404838,SRX5075174,SMARCA4,612
chr1,52404248,52404688,SRX20140868,INTS10,440
chr1,52404351,52404639,SRX5075168,SMARCA4,288
chr1,52404412,52404595,SRX5054309,FOSL2,183
chr1,52404443,52404674,SRX5716451,SOX2,231
chr1,52404486,52404775,SRX20140897,INTS13,289
chr1,52404559,52404921,SRX20140869,INTS10,362
chr1,52404648,52405119,SRX16500059,CTCF,471
chr1,52404651,52405113,SRX16500060,CTCF,462
chr1,52404696,52405024,SRX16500062,CTCF,328
chr1,52404723,52404944,SRX16500061,CTCF,221
chr1,52404735,52404984,SRX5075170,SMARCA4,249
chr1,52404735,52404995,SRX5716470,SMARCA4,260
chr1,52404775,52405151,SRX4174629,CTCF,376
chr1,52426371,52426722,SRX5075175,SMARCA4,351
chr1,52426451,52426693,SRX5075176,SMARCA4,242
chr1,52426466,52426746,SRX5075169,SMARCA4,280
chr1,52426475,52426753,SRX5054309,FOSL2,278
chr1,52426495,52426689,SRX5075170,SMARCA4,194
chr1,52426536,52426748,SRX5716469,SMARCA4,212
chr1,52498265,52498355,SRX1424893,POU3F2,90
chr1,52552802,52554004,SRX20140895,INTS13,1202
chr1,52552982,52553155,SRX5075174,SMARCA4,173
chr1,52553225,52553456,SRX5716470,SMARCA4,231
chr1,52553226,52553979,SRX20140868,INTS10,753
chr1,52553252,52553797,SRX5075174,SMARCA4,545
chr1,52553265,52553783,SRX5075176,SMARCA4,518
chr1,52553299,52553893,SRX5075170,SMARCA4,594
chr1,52553466,52553804,SRX20140867,INTS10,338
chr1,52553469,52553740,SRX5075168,SMARCA4,271
chr1,52553480,52553834,SRX5075175,SMARCA4,354
chr1,52553485,52553789,SRX5075169,SMARCA4,304
chr1,52553522,52553763,SRX5716470,SMARCA4,241
chr1,52553524,52553736,SRX5716469,SMARCA4,212
chr1,52574549,52574909,SRX5716470,SMARCA4,360
chr1,52574559,52574943,SRX5716469,SMARCA4,384
chr1,52574566,52575014,SRX5075176,SMARCA4,448
chr1,52574567,52574898,SRX5716467,SMARCA2,331
chr1,52574594,52574968,SRX5054308,FOSL2,374
chr1,52574598,52574941,SRX5075170,SMARCA4,343
chr1,52574603,52574948,SRX5054309,FOSL2,345
chr1,52574603,52574980,SRX5075169,SMARCA4,377
chr1,52574605,52574926,SRX5075174,SMARCA4,321
chr1,52574605,52574927,SRX5020211,SMARCA2,322
chr1,52574613,52574880,SRX5075168,SMARCA4,267
chr1,52574620,52574941,SRX5075175,SMARCA4,321
chr1,52574630,52574980,SRX5716460,Epitope tags,350
chr1,52590197,52590704,SRX5075168,SMARCA4,507
chr1,52590267,52590631,SRX5075176,SMARCA4,364
chr1,52590307,52590554,SRX20140879,CPSF3L,247
chr1,52590314,52590768,SRX5075174,SMARCA4,454
chr1,52590356,52590606,SRX5716463,SMARCA4,250
chr1,52590359,52590620,SRX20140868,INTS10,261
chr1,52590369,52590652,SRX20140895,INTS13,283
chr1,52602342,52602604,SRX5075169,SMARCA4,262
chr1,52629092,52629296,SRX5075174,SMARCA4,204
chr1,52629190,52629777,SRX20140895,INTS13,587
chr1,52629351,52629611,SRX5075168,SMARCA4,260
chr1,52629378,52629717,SRX5075174,SMARCA4,339
chr1,52629451,52629672,SRX5716464,SMARCA4,221
chr1,52633120,52633334,SRX5716470,SMARCA4,214
chr1,52633130,52633414,SRX5075170,SMARCA4,284
chr1,52640592,52640963,SRX5075168,SMARCA4,371
chr1,52640672,52641033,SRX5075174,SMARCA4,361
chr1,52662621,52663277,SRX5075168,SMARCA4,656
chr1,52662630,52663241,SRX20140895,INTS13,611
chr1,52662662,52662863,SRX5075175,SMARCA4,201
chr1,52662689,52662980,SRX5075176,SMARCA4,291
chr1,52662690,52663265,SRX5075174,SMARCA4,575
chr1,52662692,52662891,SRX5054309,FOSL2,199
chr1,52662695,52662979,SRX5716470,SMARCA4,284
chr1,52662721,52662965,SRX5075169,SMARCA4,244
chr1,52662734,52662945,SRX5075170,SMARCA4,211
chr1,52662767,52663081,SRX20140868,INTS10,314
chr1,52662768,52663071,SRX20140879,CPSF3L,303
chr1,52662771,52663065,SRX20140867,INTS10,294
chr1,52662827,52663241,SRX5716463,SMARCA4,414
chr1,52665016,52665872,SRX5075176,SMARCA4,856
chr1,52665042,52665837,SRX5075170,SMARCA4,795
chr1,52665416,52665660,SRX5075175,SMARCA4,244
chr1,52665456,52665678,SRX5075169,SMARCA4,222
chr1,52665688,52665904,SRX5054308,FOSL2,216
chr1,52670743,52670936,SRX5075169,SMARCA4,193
chr1,52670762,52671023,SRX5020211,SMARCA2,261
chr1,52670777,52670995,SRX5075181,SMARCA2,218
chr1,52674759,52674963,SRX5075169,SMARCA4,204
chr1,52674811,52675252,SRX5054308,FOSL2,441
chr1,52674824,52675114,SRX5075175,SMARCA4,290
chr1,52674842,52675113,SRX5054309,FOSL2,271
chr1,52674879,52675065,SRX5075170,SMARCA4,186
chr1,52686131,52686658,SRX16500059,CTCF,527
chr1,52686150,52686637,SRX16500060,CTCF,487
chr1,52686164,52686611,SRX16500061,CTCF,447
chr1,52686190,52686487,SRX5075176,SMARCA4,297
chr1,52686211,52686649,SRX16500062,CTCF,438
chr1,52686218,52686497,SRX5075168,SMARCA4,279
chr1,52686220,52686593,SRX5075174,SMARCA4,373
chr1,52686234,52686530,SRX5075170,SMARCA4,296
chr1,52686271,52686489,SRX5075169,SMARCA4,218
chr1,52686277,52686527,SRX5075175,SMARCA4,250
chr1,52697906,52698650,SRX20140895,INTS13,744
chr1,52697967,52698425,SRX20140897,INTS13,458
chr1,52698069,52698543,SRX20140868,INTS10,474
chr1,52698094,52698567,SRX5075169,SMARCA4,473
chr1,52698104,52698598,SRX5075168,SMARCA4,494
chr1,52698113,52698417,SRX20140867,INTS10,304
chr1,52698178,52698485,SRX5716470,SMARCA4,307
chr1,52698195,52698573,SRX5075175,SMARCA4,378
chr1,52698204,52698601,SRX5075174,SMARCA4,397
chr1,52698228,52698644,SRX5075176,SMARCA4,416
chr1,52698229,52698623,SRX5075170,SMARCA4,394
chr1,52700770,52701286,SRX16500059,CTCF,516
chr1,52700789,52701262,SRX16500062,CTCF,473
chr1,52700820,52701279,SRX16500060,CTCF,459
chr1,52700847,52701257,SRX16500061,CTCF,410
chr1,52702982,52703542,SRX5075174,SMARCA4,560
chr1,52703259,52703522,SRX20140897,INTS13,263
chr1,52703266,52703626,SRX20140895,INTS13,360
chr1,52726170,52726613,SRX5075170,SMARCA4,443
chr1,52726182,52726679,SRX5075174,SMARCA4,497
chr1,52726189,52726703,SRX5075176,SMARCA4,514
chr1,52726204,52726823,SRX5075168,SMARCA4,619
chr1,52726237,52726656,SRX5075169,SMARCA4,419
chr1,52726277,52726707,SRX5716463,SMARCA4,430
chr1,52726365,52726896,SRX20140895,INTS13,531
chr1,52726379,52726729,SRX20140867,INTS10,350
chr1,52726393,52726610,SRX5716464,SMARCA4,217
chr1,52726439,52726735,SRX20140897,INTS13,296
chr1,52726458,52726772,SRX20140868,INTS10,314
chr1,52726460,52726694,SRX5716470,SMARCA4,234
chr1,52726534,52726721,SRX5075175,SMARCA4,187
chr1,52748211,52748469,SRX16500061,CTCF,258
chr1,52751664,52751914,SRX5075176,SMARCA4,250
chr1,52752437,52752670,SRX5054309,FOSL2,233
chr1,52752499,52752681,SRX5054308,FOSL2,182
chr1,52825883,52826153,SRX16500061,CTCF,270
chr1,52825975,52826243,SRX16500060,CTCF,268
chr1,52842526,52842962,SRX16500059,CTCF,436
chr1,52842585,52843217,SRX5075170,SMARCA4,632
chr1,52842590,52842919,SRX5075174,SMARCA4,329
chr1,52842592,52843051,SRX5075168,SMARCA4,459
chr1,52842601,52843008,SRX16500062,CTCF,407
chr1,52842644,52842819,SRX5075176,SMARCA4,175
chr1,52842645,52842941,SRX16500061,CTCF,296
chr1,52842645,52843106,SRX16500060,CTCF,461
chr1,52842693,52842897,SRX5716463,SMARCA4,204
chr1,52842700,52842933,SRX5716464,SMARCA4,233
chr1,52842790,52843238,SRX5075169,SMARCA4,448
chr1,52842797,52843107,SRX20140881,CPSF3L,310
chr1,52904790,52905223,SRX16500060,CTCF,433
chr1,52904845,52905167,SRX16500061,CTCF,322
chr1,52904882,52905253,SRX16500059,CTCF,371
chr1,52904955,52905172,SRX16500062,CTCF,217
chr1,52921608,52921828,SRX5075175,SMARCA4,220
chr1,52927078,52927473,SRX5075168,SMARCA4,395
chr1,52927105,52927481,SRX5075174,SMARCA4,376
chr1,52927153,52927416,SRX5075170,SMARCA4,263
chr1,52927153,52927459,SRX5075176,SMARCA4,306
chr1,52927346,52927568,SRX5716470,SMARCA4,222
chr1,52927378,52927565,SRX5075169,SMARCA4,187
chr1,52955119,52955851,SRX5075176,SMARCA4,732
chr1,52955177,52955828,SRX5075170,SMARCA4,651
chr1,52955218,52955665,SRX5020211,SMARCA2,447
chr1,52955249,52955784,SRX5716470,SMARCA4,535
chr1,52955263,52955745,SRX5075169,SMARCA4,482
chr1,52955266,52955767,SRX5075175,SMARCA4,501
chr1,52955328,52955774,SRX5716469,SMARCA4,446
chr1,52955397,52955768,SRX5716467,SMARCA2,371
chr1,52955464,52955768,SRX5054309,FOSL2,304
chr1,52955491,52955743,SRX5716468,SMARCA2,252
chr1,52970087,52970356,SRX16500061,CTCF,269
chr1,52970087,52970387,SRX16500059,CTCF,300
chr1,52970095,52970375,SRX16500062,CTCF,280
chr1,52970145,52970382,SRX16500060,CTCF,237
chr1,52976186,52976545,SRX5075174,SMARCA4,359
chr1,52976224,52976656,SRX5075168,SMARCA4,432
chr1,53014648,53015067,SRX5075174,SMARCA4,419
chr1,53014680,53015060,SRX5075169,SMARCA4,380
chr1,53014688,53015049,SRX5716470,SMARCA4,361
chr1,53014697,53015064,SRX5075168,SMARCA4,367
chr1,53014716,53015112,SRX5075176,SMARCA4,396
chr1,53014730,53015081,SRX5075170,SMARCA4,351
chr1,53014761,53015065,SRX5716464,SMARCA4,304
chr1,53014800,53015056,SRX5075175,SMARCA4,256
chr1,53025053,53025325,SRX5075168,SMARCA4,272
chr1,53025105,53025427,SRX5075169,SMARCA4,322
chr1,53025108,53025449,SRX5075176,SMARCA4,341
chr1,53025115,53025384,SRX5075170,SMARCA4,269
chr1,53025117,53025388,SRX5075175,SMARCA4,271
chr1,53025118,53025433,SRX5716469,SMARCA4,315
chr1,53025138,53025406,SRX5075174,SMARCA4,268
chr1,53025192,53025496,SRX5716470,SMARCA4,304
chr1,53025229,53025412,SRX5054309,FOSL2,183
chr1,53043289,53043592,SRX5075170,SMARCA4,303
chr1,53043305,53043588,SRX5075176,SMARCA4,283
chr1,53043309,53043516,SRX5075175,SMARCA4,207
chr1,53047009,53047424,SRX5075176,SMARCA4,415
chr1,53047041,53047347,SRX5716470,SMARCA4,306
chr1,53047063,53047327,SRX5075170,SMARCA4,264
chr1,53047075,53047326,SRX5075169,SMARCA4,251
chr1,53047111,53047338,SRX5075175,SMARCA4,227
chr1,53047127,53047396,SRX5716469,SMARCA4,269
chr1,53047128,53047322,SRX5054309,FOSL2,194
chr1,53047732,53048089,SRX5075168,SMARCA4,357
chr1,53047763,53048044,SRX5075174,SMARCA4,281
chr1,53047768,53048045,SRX5075170,SMARCA4,277
chr1,53047814,53047997,SRX5054309,FOSL2,183
chr1,53087835,53088079,SRX16500059,CTCF,244
chr1,53089393,53089777,SRX5075169,SMARCA4,384
chr1,53089438,53089695,SRX5054309,FOSL2,257
chr1,53089444,53089743,SRX5075170,SMARCA4,299
chr1,53104201,53104836,SRX5716463,SMARCA4,635
chr1,53104270,53104900,SRX5075168,SMARCA4,630
chr1,53104339,53104984,SRX5075174,SMARCA4,645
chr1,53104369,53104703,SRX5716451,SOX2,334
chr1,53104395,53104867,SRX20140895,INTS13,472
chr1,53104550,53104874,SRX5716454,SOX3,324
chr1,53112502,53112760,SRX5054309,FOSL2,258
chr1,53121497,53122007,SRX5075176,SMARCA4,510
chr1,53121532,53121987,SRX5075170,SMARCA4,455
chr1,53121557,53121875,SRX5075174,SMARCA4,318
chr1,53121661,53121986,SRX5716468,SMARCA2,325
chr1,53121667,53121961,SRX5716467,SMARCA2,294
chr1,53121668,53121997,SRX5075169,SMARCA4,329
chr1,53121670,53121973,SRX5716469,SMARCA4,303
chr1,53121672,53121883,SRX5716470,SMARCA4,211
chr1,53121680,53121960,SRX5054309,FOSL2,280
chr1,53121710,53121988,SRX5075175,SMARCA4,278
chr1,53121727,53121979,SRX5054308,FOSL2,252
chr1,53129695,53130092,SRX20140868,INTS10,397
chr1,53129721,53130142,SRX20140867,INTS10,421
chr1,53129721,53130153,SRX20140895,INTS13,432
chr1,53135748,53136051,SRX5075169,SMARCA4,303
chr1,53135844,53136031,SRX5075175,SMARCA4,187
chr1,53140007,53140202,SRX5054308,FOSL2,195
chr1,53145814,53146697,SRX5075169,SMARCA4,883
chr1,53145826,53146641,SRX5075170,SMARCA4,815
chr1,53145880,53146605,SRX5716467,SMARCA2,725
chr1,53145884,53146657,SRX5075176,SMARCA4,773
chr1,53145912,53146716,SRX5716470,SMARCA4,804
chr1,53145935,53146714,SRX5716469,SMARCA4,779
chr1,53145936,53146569,SRX5716468,SMARCA2,633
chr1,53146015,53146551,SRX5075181,SMARCA2,536
chr1,53146094,53146676,SRX5075175,SMARCA4,582
chr1,53146216,53146616,SRX5020211,SMARCA2,400
chr1,53146219,53146640,SRX5054309,FOSL2,421
chr1,53146251,53146620,SRX5020214,SMARCA2,369
chr1,53146280,53146611,SRX5054308,FOSL2,331
chr1,53146308,53146572,SRX5075182,SMARCA2,264
chr1,53146363,53146571,SRX5075168,SMARCA4,208
chr1,53181959,53182428,SRX16500061,CTCF,469
chr1,53181970,53182450,SRX16500060,CTCF,480
chr1,53181971,53182443,SRX16500059,CTCF,472
chr1,53181994,53182420,SRX16500062,CTCF,426
chr1,53182038,53182345,SRX5075174,SMARCA4,307
chr1,53182044,53182284,SRX5075168,SMARCA4,240
chr1,53182051,53182315,SRX4174629,CTCF,264
chr1,53182063,53182299,SRX5716463,SMARCA4,236
chr1,53182079,53182288,SRX5075176,SMARCA4,209
chr1,53182079,53182306,SRX5075170,SMARCA4,227
chr1,53182139,53182344,SRX5716464,SMARCA4,205
chr1,53185670,53186145,SRX16500060,CTCF,475
chr1,53185684,53186139,SRX16500062,CTCF,455
chr1,53185685,53186118,SRX16500061,CTCF,433
chr1,53185689,53186120,SRX16500059,CTCF,431
chr1,53185693,53185947,SRX5075175,SMARCA4,254
chr1,53185716,53186011,SRX4174629,CTCF,295
chr1,53185732,53185984,SRX5075174,SMARCA4,252
chr1,53185741,53185984,SRX5075168,SMARCA4,243
chr1,53185743,53185965,SRX5075169,SMARCA4,222
chr1,53185759,53185944,SRX5075170,SMARCA4,185
chr1,53185773,53185959,SRX5075176,SMARCA4,186
chr1,53196453,53197006,SRX5075174,SMARCA4,553
chr1,53196489,53196963,SRX5075168,SMARCA4,474
chr1,53196490,53196875,SRX5716463,SMARCA4,385
chr1,53196501,53197013,SRX5075170,SMARCA4,512
chr1,53196503,53196869,SRX5716464,SMARCA4,366
chr1,53196511,53197013,SRX5075176,SMARCA4,502
chr1,53196524,53196945,SRX5075169,SMARCA4,421
chr1,53196540,53197041,SRX5075175,SMARCA4,501
chr1,53196563,53197126,SRX20140895,INTS13,563
chr1,53196564,53197018,SRX5716470,SMARCA4,454
chr1,53196578,53196849,SRX5054307,FOSL2,271
chr1,53196585,53196957,SRX5716469,SMARCA4,372
chr1,53196744,53197021,SRX20140868,INTS10,277
chr1,53220126,53220349,SRX5075170,SMARCA4,223
chr1,53220145,53220878,SRX5075174,SMARCA4,733
chr1,53220160,53220890,SRX20140895,INTS13,730
chr1,53220160,53220898,SRX5075168,SMARCA4,738
chr1,53220179,53220857,SRX5075175,SMARCA4,678
chr1,53220182,53220861,SRX5075176,SMARCA4,679
chr1,53220225,53220967,SRX5075169,SMARCA4,742
chr1,53220239,53220714,SRX20140868,INTS10,475
chr1,53220268,53220656,SRX20140897,INTS13,388
chr1,53220292,53220844,SRX20140867,INTS10,552
chr1,53220294,53220598,SRX20140881,CPSF3L,304
chr1,53220308,53220653,SRX20140869,INTS10,345
chr1,53220309,53220844,SRX20140879,CPSF3L,535
chr1,53220331,53220644,SRX20140894,INTS13,313
chr1,53220424,53220800,SRX5716463,SMARCA4,376
chr1,53220428,53220939,SRX5075170,SMARCA4,511
chr1,53220487,53220722,SRX5716464,SMARCA4,235
chr1,53220734,53220996,SRX5716470,SMARCA4,262
chr1,53238300,53238893,SRX20140869,INTS10,593
chr1,53238333,53238975,SRX20140868,INTS10,642
chr1,53238334,53238762,SRX20140867,INTS10,428
chr1,53238386,53238856,SRX5075174,SMARCA4,470
chr1,53238426,53238988,SRX20140895,INTS13,562
chr1,53238438,53238745,SRX20140881,CPSF3L,307
chr1,53238441,53238901,SRX5075168,SMARCA4,460
chr1,53238464,53238836,SRX5075170,SMARCA4,372
chr1,53238484,53238689,SRX5716454,SOX3,205
chr1,53238487,53238764,SRX5716451,SOX2,277
chr1,53238499,53238877,SRX5075176,SMARCA4,378
chr1,53238506,53238771,SRX5716463,SMARCA4,265
chr1,53238510,53238760,SRX5716464,SMARCA4,250
chr1,53238538,53238828,SRX20140879,CPSF3L,290
chr1,53238543,53238855,SRX5075169,SMARCA4,312
chr1,53238584,53238934,SRX20140897,INTS13,350
chr1,53238729,53238942,SRX5716470,SMARCA4,213
chr1,53265968,53266387,SRX16500060,CTCF,419
chr1,53266022,53266355,SRX16500059,CTCF,333
chr1,53266092,53266317,SRX16500062,CTCF,225
chr1,53278130,53278722,SRX16500059,CTCF,592
chr1,53278171,53278665,SRX16500062,CTCF,494
chr1,53278183,53278708,SRX16500061,CTCF,525
chr1,53278195,53278694,SRX16500060,CTCF,499
chr1,53278205,53278655,SRX4174629,CTCF,450
chr1,53278216,53278399,SRX5075176,SMARCA4,183
chr1,53278312,53278544,SRX5075174,SMARCA4,232
chr1,53278354,53278534,SRX5075169,SMARCA4,180
chr1,53288201,53289073,SRX20140895,INTS13,872
chr1,53288216,53288686,SRX5075174,SMARCA4,470
chr1,53288293,53288480,SRX5075168,SMARCA4,187
chr1,53288658,53289004,SRX20140868,INTS10,346
chr1,53288825,53289124,SRX16500059,CTCF,299
chr1,53296407,53296843,SRX5075168,SMARCA4,436
chr1,53296498,53296756,SRX5075174,SMARCA4,258
chr1,53303796,53304122,SRX5075176,SMARCA4,326
chr1,53326015,53326475,SRX5075170,SMARCA4,460
chr1,53326035,53326335,SRX5075176,SMARCA4,300
chr1,53326035,53326439,SRX5075174,SMARCA4,404
chr1,53326071,53326773,SRX20140895,INTS13,702
chr1,53326107,53326368,SRX5075168,SMARCA4,261
chr1,53326154,53326334,SRX5075169,SMARCA4,180
chr1,53327471,53327685,SRX20140867,INTS10,214
chr1,53328695,53328969,SRX16500059,CTCF,274
chr1,53328717,53329070,SRX16500060,CTCF,353
chr1,53328755,53329007,SRX16500062,CTCF,252
chr1,53346502,53346846,SRX5716470,SMARCA4,344
chr1,53346562,53346836,SRX5075170,SMARCA4,274
chr1,53346569,53346827,SRX5716469,SMARCA4,258
chr1,53346654,53346829,SRX5075176,SMARCA4,175
chr1,53381752,53382256,SRX5075169,SMARCA4,504
chr1,53381780,53382064,SRX5716460,Epitope tags,284
chr1,53381792,53382078,SRX5054309,FOSL2,286
chr1,53381797,53382121,SRX5075176,SMARCA4,324
chr1,53381809,53382153,SRX5075175,SMARCA4,344
chr1,53381814,53382119,SRX5075170,SMARCA4,305
chr1,53381855,53382076,SRX5716469,SMARCA4,221
chr1,53381906,53382092,SRX5054308,FOSL2,186
chr1,53393228,53393777,SRX16500060,CTCF,549
chr1,53393249,53393743,SRX16500061,CTCF,494
chr1,53393255,53393732,SRX16500059,CTCF,477
chr1,53393284,53393744,SRX16500062,CTCF,460
chr1,53393318,53393648,SRX5075168,SMARCA4,330
chr1,53393325,53393636,SRX4174629,CTCF,311
chr1,53393341,53393721,SRX5075174,SMARCA4,380
chr1,53393378,53393577,SRX5075169,SMARCA4,199
chr1,53393417,53393596,SRX5075170,SMARCA4,179
chr1,53396553,53396759,SRX5075170,SMARCA4,206
chr1,53410108,53410400,SRX5075174,SMARCA4,292
chr1,53410153,53410463,SRX5075168,SMARCA4,310
chr1,53413234,53413515,SRX5075175,SMARCA4,281
chr1,53413262,53413445,SRX5054309,FOSL2,183
chr1,53413335,53413532,SRX5075169,SMARCA4,197
chr1,53413378,53413578,SRX5054308,FOSL2,200
chr1,53413634,53413869,SRX5054309,FOSL2,235
chr1,53413642,53413853,SRX5054308,FOSL2,211
chr1,53417192,53417388,SRX5075174,SMARCA4,196
chr1,53417262,53417518,SRX20140895,INTS13,256
chr1,53417285,53417551,SRX20140868,INTS10,266
chr1,53444467,53444967,SRX16500059,CTCF,500
chr1,53444510,53445004,SRX16500061,CTCF,494
chr1,53444521,53445003,SRX16500062,CTCF,482
chr1,53444558,53445021,SRX16500060,CTCF,463
chr1,53448399,53449390,SRX5075174,SMARCA4,991
chr1,53448419,53448902,SRX5075168,SMARCA4,483
chr1,53448527,53448758,SRX5716464,SMARCA4,231
chr1,53448565,53448885,SRX5716463,SMARCA4,320
chr1,53449029,53449215,SRX5075176,SMARCA4,186
chr1,53449030,53449348,SRX5075169,SMARCA4,318
chr1,53449083,53449352,SRX5075168,SMARCA4,269
chr1,53449085,53449329,SRX5054309,FOSL2,244
chr1,53449120,53449310,SRX5075170,SMARCA4,190
chr1,53450234,53450510,SRX16500059,CTCF,276
chr1,53450270,53450526,SRX16500060,CTCF,256
chr1,53469959,53470568,SRX16500060,CTCF,609
chr1,53469989,53470501,SRX16500061,CTCF,512
chr1,53469997,53470528,SRX16500062,CTCF,531
chr1,53470002,53470587,SRX16500059,CTCF,585
chr1,53470065,53470495,SRX5075168,SMARCA4,430
chr1,53470082,53470463,SRX4174629,CTCF,381
chr1,53470148,53470573,SRX5075174,SMARCA4,425
chr1,53470171,53470352,SRX5075169,SMARCA4,181
chr1,53470173,53470490,SRX20140895,INTS13,317
chr1,53470203,53470445,SRX5075176,SMARCA4,242
chr1,53470211,53470380,SRX5075170,SMARCA4,169
chr1,53470225,53470492,SRX20140867,INTS10,267
chr1,53470245,53470465,SRX5716464,SMARCA4,220
chr1,53477804,53478160,SRX5716470,SMARCA4,356
chr1,53477855,53478187,SRX5075176,SMARCA4,332
chr1,53477855,53478192,SRX5716469,SMARCA4,337
chr1,53477873,53478221,SRX5075170,SMARCA4,348
chr1,53485383,53485928,SRX16500060,CTCF,545
chr1,53485389,53485913,SRX16500061,CTCF,524
chr1,53485398,53485919,SRX16500059,CTCF,521
chr1,53485405,53485876,SRX16500062,CTCF,471
chr1,53485443,53485774,SRX4174629,CTCF,331
chr1,53485515,53485760,SRX5075170,SMARCA4,245
chr1,53485535,53485818,SRX5075174,SMARCA4,283
chr1,53485560,53485773,SRX5075176,SMARCA4,213
chr1,53512199,53512690,SRX5716470,SMARCA4,491
chr1,53512220,53512746,SRX5075170,SMARCA4,526
chr1,53512227,53512760,SRX5075169,SMARCA4,533
chr1,53512234,53512829,SRX5075176,SMARCA4,595
chr1,53512255,53512512,SRX5054308,FOSL2,257
chr1,53512303,53512755,SRX5075175,SMARCA4,452
chr1,53512341,53512599,SRX5716469,SMARCA4,258
chr1,53512388,53512670,SRX5716467,SMARCA2,282
chr1,53521990,53522395,SRX5075170,SMARCA4,405
chr1,53521999,53522297,SRX5716470,SMARCA4,298
chr1,53522005,53522436,SRX5075176,SMARCA4,431
chr1,53522028,53522273,SRX5716469,SMARCA4,245
chr1,53522042,53522342,SRX5716468,SMARCA2,300
chr1,53522092,53522350,SRX5716467,SMARCA2,258
chr1,53522103,53522360,SRX5075169,SMARCA4,257
chr1,53541779,53542109,SRX16500060,CTCF,330
chr1,53541805,53542024,SRX16500061,CTCF,219
chr1,53541850,53542091,SRX16500062,CTCF,241
chr1,53542061,53542499,SRX5716469,SMARCA4,438
chr1,53542181,53542486,SRX5716470,SMARCA4,305
chr1,53542188,53542578,SRX5075169,SMARCA4,390
chr1,53542192,53542457,SRX5716467,SMARCA2,265
chr1,53542196,53542469,SRX5075175,SMARCA4,273
chr1,53542201,53542518,SRX5054308,FOSL2,317
chr1,53542202,53542510,SRX5075170,SMARCA4,308
chr1,53542202,53542563,SRX5075176,SMARCA4,361
chr1,53542234,53542503,SRX5054309,FOSL2,269
chr1,53542249,53542467,SRX5020211,SMARCA2,218
chr1,53552240,53552526,SRX5716470,SMARCA4,286
chr1,53552249,53552638,SRX5075170,SMARCA4,389
chr1,53552285,53552636,SRX5075175,SMARCA4,351
chr1,53552325,53552735,SRX5075169,SMARCA4,410
chr1,53552331,53552713,SRX5075176,SMARCA4,382
chr1,53555613,53556902,SRX20140895,INTS13,1289
chr1,53572533,53572748,SRX5716467,SMARCA2,215
chr1,53572545,53572759,SRX5075169,SMARCA4,214
chr1,53572627,53572840,SRX5716469,SMARCA4,213
chr1,53572639,53572826,SRX5075175,SMARCA4,187
chr1,53583559,53583988,SRX5075176,SMARCA4,429
chr1,53583687,53583965,SRX5716467,SMARCA2,278
chr1,53583716,53584027,SRX5075170,SMARCA4,311
chr1,53590849,53591158,SRX5075176,SMARCA4,309
chr1,53594001,53594496,SRX16500062,CTCF,495
chr1,53594032,53594488,SRX16500059,CTCF,456
chr1,53594050,53594473,SRX16500061,CTCF,423
chr1,53594066,53594484,SRX16500060,CTCF,418
chr1,53625016,53625318,SRX5075169,SMARCA4,302
chr1,53625016,53625413,SRX5075176,SMARCA4,397
chr1,53625080,53625425,SRX5075170,SMARCA4,345
chr1,53625119,53625330,SRX5075175,SMARCA4,211
chr1,53627461,53627708,SRX5075176,SMARCA4,247
chr1,53656234,53656741,SRX5075170,SMARCA4,507
chr1,53656271,53656753,SRX5716469,SMARCA4,482
chr1,53656289,53656762,SRX5075176,SMARCA4,473
chr1,53656316,53656712,SRX5075175,SMARCA4,396
chr1,53656322,53656783,SRX5716470,SMARCA4,461
chr1,53656334,53656780,SRX5075169,SMARCA4,446
chr1,53656339,53656711,SRX5716467,SMARCA2,372
chr1,53656372,53656631,SRX5075181,SMARCA2,259
chr1,53656384,53656715,SRX5716468,SMARCA2,331
chr1,53656390,53656634,SRX5054309,FOSL2,244
chr1,53656392,53656696,SRX5020214,SMARCA2,304
chr1,53656445,53656654,SRX5020211,SMARCA2,209
chr1,53656460,53656640,SRX5054308,FOSL2,180
chr1,53682002,53682266,SRX5075170,SMARCA4,264
chr1,53682059,53682234,SRX5075176,SMARCA4,175
chr1,53682076,53682506,SRX16500060,CTCF,430
chr1,53682077,53682500,SRX16500059,CTCF,423
chr1,53682099,53682416,SRX4174629,CTCF,317
chr1,53682101,53682482,SRX16500061,CTCF,381
chr1,53682173,53682509,SRX16500062,CTCF,336
chr1,53685305,53685592,SRX5075174,SMARCA4,287
chr1,53685797,53685977,SRX5075169,SMARCA4,180
chr1,53696052,53696380,SRX5075175,SMARCA4,328
chr1,53696060,53696378,SRX5075170,SMARCA4,318
chr1,53696102,53696383,SRX5716470,SMARCA4,281
chr1,53696105,53696406,SRX5075176,SMARCA4,301
chr1,53696144,53696359,SRX5716469,SMARCA4,215
chr1,53696172,53696356,SRX5075169,SMARCA4,184
chr1,53713156,53713446,SRX20140870,INTS10,290
chr1,53715506,53715852,SRX16500060,CTCF,346
chr1,53732961,53733380,SRX5075170,SMARCA4,419
chr1,53732976,53733381,SRX5075176,SMARCA4,405
chr1,53732993,53733345,SRX5075169,SMARCA4,352
chr1,53733001,53733359,SRX5054308,FOSL2,358
chr1,53733015,53733345,SRX5075175,SMARCA4,330
chr1,53733023,53733367,SRX5054309,FOSL2,344
chr1,53733025,53733325,SRX5716469,SMARCA4,300
chr1,53733039,53733297,SRX5716470,SMARCA4,258
chr1,53733061,53733281,SRX5075182,SMARCA2,220
chr1,53733066,53733323,SRX5716467,SMARCA2,257
chr1,53733075,53733338,SRX5020214,SMARCA2,263
chr1,53734108,53734291,SRX5054309,FOSL2,183
chr1,53739085,53739510,SRX5075174,SMARCA4,425
chr1,53739107,53739655,SRX5075168,SMARCA4,548
chr1,53739174,53739396,SRX5054307,FOSL2,222
chr1,53754614,53755147,SRX16500060,CTCF,533
chr1,53754644,53755087,SRX16500062,CTCF,443
chr1,53754649,53755114,SRX16500059,CTCF,465
chr1,53754657,53755119,SRX16500061,CTCF,462
chr1,53754696,53754980,SRX5075170,SMARCA4,284
chr1,53754710,53754966,SRX5075176,SMARCA4,256
chr1,53754721,53755014,SRX5075168,SMARCA4,293
chr1,53754749,53754948,SRX5075175,SMARCA4,199
chr1,53754761,53755017,SRX5075174,SMARCA4,256
chr1,53754765,53755010,SRX4174629,CTCF,245
chr1,53754801,53754998,SRX5075169,SMARCA4,197
chr1,53754803,53755046,SRX5716463,SMARCA4,243
chr1,53765716,53765952,SRX5075169,SMARCA4,236
chr1,53765759,53766033,SRX5075176,SMARCA4,274
chr1,53765777,53765971,SRX5075170,SMARCA4,194
chr1,53766845,53767193,SRX5075176,SMARCA4,348
chr1,53766846,53767104,SRX5075169,SMARCA4,258
chr1,53766849,53767102,SRX5054308,FOSL2,253
chr1,53766886,53767143,SRX5075175,SMARCA4,257
chr1,53766913,53767206,SRX5075170,SMARCA4,293
chr1,53771745,53772027,SRX5075170,SMARCA4,282
chr1,53771760,53771972,SRX5716469,SMARCA4,212
chr1,53771773,53772045,SRX5054308,FOSL2,272
chr1,53771780,53772057,SRX5075176,SMARCA4,277
chr1,53771801,53772010,SRX5054309,FOSL2,209
chr1,53781668,53781891,SRX5054309,FOSL2,223
chr1,53837263,53837484,SRX5054308,FOSL2,221
chr1,53837973,53838669,SRX20140895,INTS13,696
chr1,53838043,53838294,SRX5075168,SMARCA4,251
chr1,53838086,53838605,SRX20140867,INTS10,519
chr1,53838098,53838342,SRX5075170,SMARCA4,244
chr1,53838118,53838643,SRX20140868,INTS10,525
chr1,53838120,53838805,SRX5075174,SMARCA4,685
chr1,53838122,53838597,SRX20140879,CPSF3L,475
chr1,53838182,53838686,SRX20140869,INTS10,504
chr1,53838183,53838582,SRX20140894,INTS13,399
chr1,53838192,53838602,SRX20140897,INTS13,410
chr1,53838225,53838587,SRX20140881,CPSF3L,362
chr1,53838235,53838605,SRX16500060,CTCF,370
chr1,53838246,53838551,SRX5716464,SMARCA4,305
chr1,53838311,53838551,SRX20140880,CPSF3L,240
chr1,53838341,53838777,SRX5716463,SMARCA4,436
chr1,53838369,53838663,SRX16500062,CTCF,294
chr1,53838369,53838789,SRX5075168,SMARCA4,420
chr1,53838531,53838721,SRX5716451,SOX2,190
chr1,53860811,53861346,SRX16500059,CTCF,535
chr1,53860816,53861313,SRX16500060,CTCF,497
chr1,53860840,53861276,SRX16500062,CTCF,436
chr1,53860849,53861315,SRX16500061,CTCF,466
chr1,53860911,53861228,SRX4174629,CTCF,317
chr1,53860936,53861204,SRX5075174,SMARCA4,268
chr1,53860952,53861231,SRX5075168,SMARCA4,279
chr1,53860975,53861156,SRX5075169,SMARCA4,181
chr1,53860975,53861236,SRX5075170,SMARCA4,261
chr1,53871258,53871476,SRX5075170,SMARCA4,218
chr1,53871280,53871576,SRX5075176,SMARCA4,296
chr1,53878413,53878992,SRX16500061,CTCF,579
chr1,53878461,53878980,SRX16500060,CTCF,519
chr1,53878470,53878889,SRX16500062,CTCF,419
chr1,53878476,53878921,SRX16500059,CTCF,445
chr1,53878689,53878868,SRX5075168,SMARCA4,179
chr1,53889395,53889779,SRX20140869,INTS10,384
chr1,53889503,53890181,SRX5075168,SMARCA4,678
chr1,53889606,53889955,SRX5075169,SMARCA4,349
chr1,53889607,53890354,SRX5075176,SMARCA4,747
chr1,53889621,53889960,SRX5716463,SMARCA4,339
chr1,53889622,53890096,SRX5716469,SMARCA4,474
chr1,53889640,53890048,SRX5075174,SMARCA4,408
chr1,53889644,53890181,SRX5075175,SMARCA4,537
chr1,53889656,53890008,SRX5716470,SMARCA4,352
chr1,53889658,53890207,SRX5075170,SMARCA4,549
chr1,53889701,53889985,SRX20140895,INTS13,284
chr1,53889737,53889966,SRX5716464,SMARCA4,229
chr1,53889947,53890263,SRX5054309,FOSL2,316
chr1,53890085,53890265,SRX5054308,FOSL2,180
chr1,53896688,53897004,SRX5075176,SMARCA4,316
chr1,53896715,53897053,SRX5075170,SMARCA4,338
chr1,53896748,53896958,SRX5054308,FOSL2,210
chr1,53896752,53896997,SRX5075169,SMARCA4,245
chr1,53896829,53897044,SRX5716467,SMARCA2,215
chr1,53899146,53899538,SRX5075176,SMARCA4,392
chr1,53899152,53899557,SRX5716470,SMARCA4,405
chr1,53899161,53899497,SRX5075170,SMARCA4,336
chr1,53899168,53899471,SRX5075175,SMARCA4,303
chr1,53899202,53899473,SRX5716467,SMARCA2,271
chr1,53899220,53899463,SRX5716469,SMARCA4,243
chr1,53899250,53899516,SRX5075181,SMARCA2,266
chr1,53899253,53899436,SRX5075169,SMARCA4,183
chr1,53899356,53899556,SRX5020211,SMARCA2,200
chr1,53901392,53901587,SRX5075174,SMARCA4,195
chr1,53901416,53901614,SRX5075168,SMARCA4,198
chr1,53945634,53946043,SRX5075168,SMARCA4,409
chr1,53945689,53946296,SRX5075174,SMARCA4,607
chr1,53945706,53945956,SRX5075170,SMARCA4,250
chr1,53945718,53946033,SRX5716464,SMARCA4,315
chr1,53945764,53946317,SRX5716463,SMARCA4,553
chr1,53945789,53946209,SRX5054307,FOSL2,420
chr1,53946020,53946417,SRX20140895,INTS13,397
chr1,53946040,53946256,SRX5716470,SMARCA4,216
chr1,53946076,53946325,SRX5075175,SMARCA4,249
chr1,53946144,53946513,SRX5075176,SMARCA4,369
chr1,53948997,53949412,SRX16500061,CTCF,415
chr1,53949006,53949411,SRX16500060,CTCF,405
chr1,53949016,53949413,SRX16500059,CTCF,397
chr1,53949054,53949391,SRX16500062,CTCF,337
chr1,53949142,53949360,SRX4174629,CTCF,218
chr1,53959635,53960020,SRX16500059,CTCF,385
chr1,53959641,53960008,SRX16500060,CTCF,367
chr1,53959643,53959953,SRX16500062,CTCF,310
chr1,53959701,53959947,SRX16500061,CTCF,246
chr1,53982393,53982831,SRX5075170,SMARCA4,438
chr1,53982429,53982916,SRX5075176,SMARCA4,487
chr1,53982443,53982798,SRX5075169,SMARCA4,355
chr1,53982448,53982865,SRX5716470,SMARCA4,417
chr1,53982472,53982698,SRX5716469,SMARCA4,226
chr1,53982486,53982736,SRX5075174,SMARCA4,250
chr1,53982486,53982742,SRX5075168,SMARCA4,256
chr1,53982507,53982871,SRX5075175,SMARCA4,364
chr1,54037564,54037733,SRX5075170,SMARCA4,169
chr1,54052698,54053844,SRX20140895,INTS13,1146
chr1,54053020,54053601,SRX20140869,INTS10,581
chr1,54053024,54053470,SRX20140897,INTS13,446
chr1,54053160,54053485,SRX5075170,SMARCA4,325
chr1,54053188,54053768,SRX5075174,SMARCA4,580
chr1,54053221,54053620,SRX5075168,SMARCA4,399
chr1,54053246,54053431,SRX5075176,SMARCA4,185
chr1,54053546,54053743,SRX5075170,SMARCA4,197
chr1,54069761,54070722,SRX4174629,CTCF,961
chr1,54069988,54070524,SRX16500062,CTCF,536
chr1,54070034,54070579,SRX16500060,CTCF,545
chr1,54070044,54070531,SRX16500059,CTCF,487
chr1,54070072,54070529,SRX16500061,CTCF,457
chr1,54070122,54070373,SRX5075170,SMARCA4,251
chr1,54070165,54070357,SRX5075168,SMARCA4,192
chr1,54070172,54070386,SRX5075174,SMARCA4,214
chr1,54070186,54070381,SRX5075176,SMARCA4,195
chr1,54081602,54082084,SRX16500059,CTCF,482
chr1,54081632,54082054,SRX16500061,CTCF,422
chr1,54081632,54082057,SRX16500060,CTCF,425
chr1,54081656,54082090,SRX16500062,CTCF,434
chr1,54081716,54081937,SRX5075168,SMARCA4,221
chr1,54081722,54081959,SRX5075174,SMARCA4,237
chr1,54081740,54081979,SRX4174629,CTCF,239
chr1,54095899,54096252,SRX5075168,SMARCA4,353
chr1,54095984,54096190,SRX5075174,SMARCA4,206
chr1,54121412,54121895,SRX5716470,SMARCA4,483
chr1,54121437,54121914,SRX16500059,CTCF,477
chr1,54121480,54121962,SRX16500060,CTCF,482
chr1,54121520,54121892,SRX5075174,SMARCA4,372
chr1,54121527,54121888,SRX16500062,CTCF,361
chr1,54121530,54121849,SRX5075169,SMARCA4,319
chr1,54121532,54121912,SRX5075170,SMARCA4,380
chr1,54121540,54121930,SRX16500061,CTCF,390
chr1,54121557,54121857,SRX5075175,SMARCA4,300
chr1,54121561,54121855,SRX5075176,SMARCA4,294
chr1,54121581,54121882,SRX5716464,SMARCA4,301
chr1,54121595,54121949,SRX5075168,SMARCA4,354
chr1,54121658,54122014,SRX4174629,CTCF,356
chr1,54135518,54135714,SRX5075168,SMARCA4,196
chr1,54135574,54135776,SRX5075174,SMARCA4,202
chr1,54137666,54138120,SRX5075170,SMARCA4,454
chr1,54137710,54138063,SRX5075169,SMARCA4,353
chr1,54137721,54138058,SRX5075175,SMARCA4,337
chr1,54137812,54138080,SRX5716470,SMARCA4,268
chr1,54137852,54138088,SRX5075176,SMARCA4,236
chr1,54148490,54148670,SRX5075170,SMARCA4,180
chr1,54148547,54148722,SRX5075176,SMARCA4,175
chr1,54153771,54154005,SRX5075176,SMARCA4,234
chr1,54153864,54154079,SRX5716467,SMARCA2,215
chr1,54181618,54182041,SRX16500061,CTCF,423
chr1,54181679,54181999,SRX16500062,CTCF,320
chr1,54181685,54182034,SRX16500060,CTCF,349
chr1,54181708,54182004,SRX16500059,CTCF,296
chr1,54181813,54181993,SRX5075168,SMARCA4,180
chr1,54199817,54200005,SRX5075176,SMARCA4,188
chr1,54199883,54200381,SRX5075174,SMARCA4,498
chr1,54199886,54200485,SRX20140895,INTS13,599
chr1,54199931,54200171,SRX5716463,SMARCA4,240
chr1,54199955,54200354,SRX5075168,SMARCA4,399
chr1,54199972,54200293,SRX5716464,SMARCA4,321
chr1,54200018,54200340,SRX20140867,INTS10,322
chr1,54200049,54200310,SRX20140868,INTS10,261
chr1,54200052,54200455,SRX20140881,CPSF3L,403
chr1,54200114,54200423,SRX20140897,INTS13,309
chr1,54227343,54227603,SRX5075175,SMARCA4,260
chr1,54228115,54228350,SRX16500059,CTCF,235
chr1,54229173,54229497,SRX5075170,SMARCA4,324
chr1,54229254,54229527,SRX5075176,SMARCA4,273
chr1,54229306,54229823,SRX5075169,SMARCA4,517
chr1,54229486,54229783,SRX5054309,FOSL2,297
chr1,54229557,54229803,SRX5054308,FOSL2,246
chr1,54229632,54229829,SRX5075175,SMARCA4,197
chr1,54250186,54250437,SRX5075170,SMARCA4,251
chr1,54253446,54253854,SRX5075176,SMARCA4,408
chr1,54253495,54253895,SRX5075169,SMARCA4,400
chr1,54253497,54253861,SRX5075175,SMARCA4,364
chr1,54253501,54253871,SRX5054309,FOSL2,370
chr1,54253503,54253851,SRX5075170,SMARCA4,348
chr1,54253511,54253859,SRX5054308,FOSL2,348
chr1,54253526,54253771,SRX5716470,SMARCA4,245
chr1,54253544,54253823,SRX5716467,SMARCA2,279
chr1,54253545,54253850,SRX5716469,SMARCA4,305
chr1,54253547,54253792,SRX5020211,SMARCA2,245
chr1,54253593,54253826,SRX5020214,SMARCA2,233
chr1,54254218,54254393,SRX5075176,SMARCA4,175
chr1,54272885,54273308,SRX16500061,CTCF,423
chr1,54272888,54273291,SRX16500059,CTCF,403
chr1,54272913,54273252,SRX16500062,CTCF,339
chr1,54272943,54273354,SRX16500060,CTCF,411
chr1,54272947,54273660,SRX20140895,INTS13,713
chr1,54272952,54273780,SRX5075174,SMARCA4,828
chr1,54272962,54273468,SRX5075169,SMARCA4,506
chr1,54272983,54273676,SRX5716463,SMARCA4,693
chr1,54272990,54273699,SRX5075168,SMARCA4,709
chr1,54272993,54273620,SRX20140868,INTS10,627
chr1,54273003,54273460,SRX5075176,SMARCA4,457
chr1,54273006,54273341,SRX5075170,SMARCA4,335
chr1,54273022,54273287,SRX5075175,SMARCA4,265
chr1,54273036,54273382,SRX5716469,SMARCA4,346
chr1,54273042,54273325,SRX5716470,SMARCA4,283
chr1,54273076,54273256,SRX5054308,FOSL2,180
chr1,54273082,54273312,SRX4174629,CTCF,230
chr1,54273130,54273571,SRX5716464,SMARCA4,441
chr1,54273131,54273586,SRX20140879,CPSF3L,455
chr1,54273234,54273550,SRX20140867,INTS10,316
chr1,54273290,54273589,SRX5716451,SOX2,299
chr1,54275412,54275590,SRX5075176,SMARCA4,178
chr1,54287283,54287553,SRX5075169,SMARCA4,270
chr1,54287298,54287530,SRX5075170,SMARCA4,232
chr1,54301402,54301676,SRX5075168,SMARCA4,274
chr1,54301487,54301686,SRX5075174,SMARCA4,199
chr1,54309429,54310046,SRX5075174,SMARCA4,617
chr1,54309591,54309950,SRX20140895,INTS13,359
chr1,54309657,54310058,SRX5075168,SMARCA4,401
chr1,54309694,54309992,SRX20140868,INTS10,298
chr1,54309748,54309952,SRX5716463,SMARCA4,204
chr1,54309749,54309975,SRX5716451,SOX2,226
chr1,54310893,54311382,SRX16500060,CTCF,489
chr1,54310953,54311354,SRX16500061,CTCF,401
chr1,54310956,54311327,SRX16500059,CTCF,371
chr1,54310959,54311344,SRX16500062,CTCF,385
chr1,54311079,54311286,SRX5075174,SMARCA4,207
chr1,54312753,54313294,SRX5075176,SMARCA4,541
chr1,54312802,54313359,SRX5075170,SMARCA4,557
chr1,54312842,54313094,SRX5716468,SMARCA2,252
chr1,54312849,54313256,SRX20140895,INTS13,407
chr1,54312853,54313089,SRX5716469,SMARCA4,236
chr1,54312901,54313190,SRX5075169,SMARCA4,289
chr1,54312919,54313236,SRX5716470,SMARCA4,317
chr1,54312979,54313194,SRX5716467,SMARCA2,215
chr1,54327428,54327844,SRX5075175,SMARCA4,416
chr1,54327430,54327641,SRX5716470,SMARCA4,211
chr1,54327432,54327750,SRX5716469,SMARCA4,318
chr1,54327450,54327836,SRX5075169,SMARCA4,386
chr1,54327452,54327812,SRX5075170,SMARCA4,360
chr1,54327465,54327855,SRX5075176,SMARCA4,390
chr1,54327513,54327810,SRX5054309,FOSL2,297
chr1,54327513,54327834,SRX5054308,FOSL2,321
chr1,54331147,54331469,SRX5075170,SMARCA4,322
chr1,54331157,54331427,SRX5075176,SMARCA4,270
chr1,54335715,54336026,SRX5075176,SMARCA4,311
chr1,54335729,54336028,SRX5075175,SMARCA4,299
chr1,54335813,54336058,SRX5075170,SMARCA4,245
chr1,54335826,54336050,SRX5075169,SMARCA4,224
chr1,54355891,54356229,SRX5075174,SMARCA4,338
chr1,54355941,54356145,SRX5075168,SMARCA4,204
chr1,54378366,54379140,SRX20140895,INTS13,774
chr1,54378386,54378963,SRX20140868,INTS10,577
chr1,54378425,54379041,SRX5075174,SMARCA4,616
chr1,54378488,54379025,SRX5075168,SMARCA4,537
chr1,54378652,54378857,SRX5716454,SOX3,205
chr1,54378706,54378927,SRX5716451,SOX2,221
chr1,54391547,54391808,SRX20140867,INTS10,261
chr1,54391673,54391854,SRX5075168,SMARCA4,181
chr1,54391721,54391899,SRX5075174,SMARCA4,178
chr1,54406343,54406833,SRX20140895,INTS13,490
chr1,54406470,54406737,SRX20140868,INTS10,267
chr1,54406483,54406705,SRX5075174,SMARCA4,222
chr1,54406583,54406822,SRX16500060,CTCF,239
chr1,54407568,54408001,SRX5075168,SMARCA4,433
chr1,54407571,54407961,SRX5075174,SMARCA4,390
chr1,54407635,54407894,SRX5075176,SMARCA4,259
chr1,54407646,54407858,SRX5075169,SMARCA4,212
chr1,54407652,54407854,SRX5054309,FOSL2,202
chr1,54408283,54408503,SRX5075175,SMARCA4,220
chr1,54408321,54408615,SRX5054309,FOSL2,294
chr1,54408362,54408619,SRX5054308,FOSL2,257
chr1,54462321,54462508,SRX5075170,SMARCA4,187
chr1,54464729,54464986,SRX5075174,SMARCA4,257
chr1,54464742,54464950,SRX5075168,SMARCA4,208
chr1,54465392,54465564,SRX5075170,SMARCA4,172
chr1,54466241,54466282,SRX1424893,POU3F2,41
chr1,54466242,54466282,SRX1424894,POU3F2,40
chr1,54474665,54475073,SRX5075174,SMARCA4,408
chr1,54474734,54475045,SRX20140895,INTS13,311
chr1,54474738,54475052,SRX5075168,SMARCA4,314
chr1,54474780,54475083,SRX5075176,SMARCA4,303
chr1,54474811,54475015,SRX5716463,SMARCA4,204
chr1,54474816,54475091,SRX5075170,SMARCA4,275
chr1,54480468,54480790,SRX5075175,SMARCA4,322
chr1,54480473,54480785,SRX5075176,SMARCA4,312
chr1,54480482,54480828,SRX5075170,SMARCA4,346
chr1,54480507,54480772,SRX5716469,SMARCA4,265
chr1,54480524,54480756,SRX5716470,SMARCA4,232
chr1,54480542,54480762,SRX5716467,SMARCA2,220
chr1,54480548,54480813,SRX5075169,SMARCA4,265
chr1,54488100,54488781,SRX20140895,INTS13,681
chr1,54488146,54488678,SRX5075174,SMARCA4,532
chr1,54488162,54488749,SRX5716469,SMARCA4,587
chr1,54488164,54488648,SRX5075170,SMARCA4,484
chr1,54488168,54488689,SRX5075168,SMARCA4,521
chr1,54488183,54488601,SRX5075169,SMARCA4,418
chr1,54488187,54488627,SRX5075176,SMARCA4,440
chr1,54488191,54488664,SRX5716470,SMARCA4,473
chr1,54488223,54488651,SRX5075175,SMARCA4,428
chr1,54488259,54488559,SRX5716451,SOX2,300
chr1,54488271,54488595,SRX20140867,INTS10,324
chr1,54488271,54488672,SRX5716463,SMARCA4,401
chr1,54488286,54488693,SRX5716464,SMARCA4,407
chr1,54488290,54488582,SRX5716467,SMARCA2,292
chr1,54488342,54488615,SRX20140881,CPSF3L,273
chr1,54488356,54488595,SRX5716453,SOX2,239
chr1,54489252,54489588,SRX20140895,INTS13,336
chr1,54489288,54489590,SRX5716470,SMARCA4,302
chr1,54489292,54489655,SRX5075174,SMARCA4,363
chr1,54489293,54489704,SRX5075168,SMARCA4,411
chr1,54489302,54489642,SRX5075169,SMARCA4,340
chr1,54489313,54489829,SRX16500059,CTCF,516
chr1,54489319,54489661,SRX5075176,SMARCA4,342
chr1,54489329,54489860,SRX16500060,CTCF,531
chr1,54489332,54489549,SRX5716469,SMARCA4,217
chr1,54489332,54489796,SRX4174629,CTCF,464
chr1,54489334,54489802,SRX16500061,CTCF,468
chr1,54489337,54489597,SRX20140867,INTS10,260
chr1,54489342,54489655,SRX5075170,SMARCA4,313
chr1,54489346,54489801,SRX16500062,CTCF,455
chr1,54489381,54489676,SRX5075175,SMARCA4,295
chr1,54489396,54489609,SRX5716464,SMARCA4,213
chr1,54499416,54499673,SRX5075175,SMARCA4,257
chr1,54499420,54499766,SRX5716470,SMARCA4,346
chr1,54499425,54499734,SRX5075174,SMARCA4,309
chr1,54499430,54499748,SRX5075168,SMARCA4,318
chr1,54499455,54499788,SRX5075176,SMARCA4,333
chr1,54499470,54499694,SRX5075170,SMARCA4,224
chr1,54499474,54499693,SRX16500061,CTCF,219
chr1,54499484,54499778,SRX16500062,CTCF,294
chr1,54499499,54499808,SRX5075169,SMARCA4,309
chr1,54499521,54499790,SRX5020211,SMARCA2,269
chr1,54499534,54499787,SRX5716467,SMARCA2,253
chr1,54499595,54499833,SRX16500059,CTCF,238
chr1,54519815,54520025,SRX16500062,CTCF,210
chr1,54542044,54542510,SRX5075169,SMARCA4,466
chr1,54542062,54542518,SRX5075174,SMARCA4,456
chr1,54542064,54542970,SRX5075176,SMARCA4,906
chr1,54542075,54542506,SRX20140895,INTS13,431
chr1,54542076,54542287,SRX5716470,SMARCA4,211
chr1,54542089,54542474,SRX5075170,SMARCA4,385
chr1,54542097,54542382,SRX5075175,SMARCA4,285
chr1,54542097,54542404,SRX5075168,SMARCA4,307
chr1,54542491,54542907,SRX5054308,FOSL2,416
chr1,54542602,54542963,SRX5075170,SMARCA4,361
chr1,54542605,54542887,SRX5054309,FOSL2,282
chr1,54542692,54542909,SRX5075169,SMARCA4,217
chr1,54569452,54569730,SRX5075175,SMARCA4,278
chr1,54569474,54569733,SRX5075176,SMARCA4,259
chr1,54569497,54569722,SRX5075169,SMARCA4,225
chr1,54569553,54569757,SRX5075170,SMARCA4,204
chr1,54569555,54569773,SRX5716469,SMARCA4,218
chr1,54570859,54571133,SRX5054308,FOSL2,274
chr1,54570889,54571144,SRX5054309,FOSL2,255
chr1,54571798,54572167,SRX5075176,SMARCA4,369
chr1,54571832,54572075,SRX5075170,SMARCA4,243
chr1,54577660,54577840,SRX5075169,SMARCA4,180
chr1,54577691,54577867,SRX5075170,SMARCA4,176
chr1,54610863,54611105,SRX5075169,SMARCA4,242
chr1,54612906,54613091,SRX5054309,FOSL2,185
chr1,54671925,54672413,SRX16500059,CTCF,488
chr1,54671976,54672435,SRX16500060,CTCF,459
chr1,54671990,54672445,SRX16500062,CTCF,455
chr1,54672005,54672396,SRX16500061,CTCF,391
chr1,54672009,54672368,SRX4174629,CTCF,359
chr1,54672081,54672346,SRX5075174,SMARCA4,265
chr1,54672087,54672378,SRX5075168,SMARCA4,291
chr1,54672091,54672342,SRX5716464,SMARCA4,251
chr1,54672103,54672302,SRX5075175,SMARCA4,199
chr1,54672146,54672338,SRX5075176,SMARCA4,192
chr1,54681320,54681617,SRX5716463,SMARCA4,297
chr1,54681371,54681659,SRX5716464,SMARCA4,288
chr1,54681376,54681715,SRX5075168,SMARCA4,339
chr1,54681392,54681770,SRX5075174,SMARCA4,378
chr1,54681463,54681645,SRX5075176,SMARCA4,182
chr1,54715570,54715751,SRX5075169,SMARCA4,181
chr1,54715576,54715984,SRX5075168,SMARCA4,408
chr1,54715577,54715994,SRX5075170,SMARCA4,417
chr1,54715587,54716096,SRX20140895,INTS13,509
chr1,54715608,54716058,SRX5075174,SMARCA4,450
chr1,54715617,54715825,SRX5716463,SMARCA4,208
chr1,54715649,54715940,SRX5075176,SMARCA4,291
chr1,54715672,54715910,SRX5716470,SMARCA4,238
chr1,54715765,54716014,SRX5716464,SMARCA4,249
chr1,54716289,54716537,SRX5075176,SMARCA4,248
chr1,54716399,54716579,SRX5054308,FOSL2,180
chr1,54716424,54716642,SRX5054309,FOSL2,218
chr1,54764173,54764447,SRX20140897,INTS13,274
chr1,54764174,54764526,SRX20140869,INTS10,352
chr1,54764183,54764702,SRX20140895,INTS13,519
chr1,54764183,54764968,SRX5075176,SMARCA4,785
chr1,54764185,54764457,SRX5075169,SMARCA4,272
chr1,54764246,54764521,SRX5075170,SMARCA4,275
chr1,54764279,54765034,SRX5075174,SMARCA4,755
chr1,54764335,54765087,SRX5075168,SMARCA4,752
chr1,54764389,54765013,SRX5716470,SMARCA4,624
chr1,54764475,54764801,SRX5054308,FOSL2,326
chr1,54764494,54764816,SRX5054307,FOSL2,322
chr1,54764552,54764780,SRX5054309,FOSL2,228
chr1,54764555,54765039,SRX5716463,SMARCA4,484
chr1,54764563,54764879,SRX5716451,SOX2,316
chr1,54764634,54764995,SRX5075170,SMARCA4,361
chr1,54764696,54764940,SRX5716464,SMARCA4,244
chr1,54764753,54765012,SRX20140895,INTS13,259
chr1,54764810,54765118,SRX5075175,SMARCA4,308
chr1,54764831,54765062,SRX5075169,SMARCA4,231
chr1,54791894,54792324,SRX16500059,CTCF,430
chr1,54791900,54792313,SRX16500060,CTCF,413
chr1,54791901,54792297,SRX16500062,CTCF,396
chr1,54791907,54792286,SRX16500061,CTCF,379
chr1,54792737,54792920,SRX5075168,SMARCA4,183
chr1,54810388,54810870,SRX16500059,CTCF,482
chr1,54810411,54810855,SRX16500062,CTCF,444
chr1,54810429,54810778,SRX4174629,CTCF,349
chr1,54810435,54810749,SRX5075169,SMARCA4,314
chr1,54810436,54810842,SRX16500061,CTCF,406
chr1,54810437,54810893,SRX16500060,CTCF,456
chr1,54810496,54810706,SRX5075170,SMARCA4,210
chr1,54810575,54810767,SRX5075168,SMARCA4,192
chr1,54856428,54856890,SRX5075170,SMARCA4,462
chr1,54856442,54856809,SRX5075175,SMARCA4,367
chr1,54856443,54856764,SRX5054308,FOSL2,321
chr1,54856460,54856813,SRX5075176,SMARCA4,353
chr1,54856461,54856757,SRX5075169,SMARCA4,296
chr1,54856465,54856676,SRX5716470,SMARCA4,211
chr1,54856465,54856751,SRX5054309,FOSL2,286
chr1,54856505,54856775,SRX5716469,SMARCA4,270
chr1,54884189,54884384,SRX5075170,SMARCA4,195
chr1,54886935,54887708,SRX20140895,INTS13,773
chr1,54886996,54887242,SRX20140867,INTS10,246
chr1,54887060,54887773,SRX5075174,SMARCA4,713
chr1,54887071,54887332,SRX5075168,SMARCA4,261
chr1,54887138,54887649,SRX20140868,INTS10,511
chr1,54887196,54887378,SRX5054307,FOSL2,182
chr1,54887299,54887596,SRX5075175,SMARCA4,297
chr1,54887441,54887699,SRX5075169,SMARCA4,258
chr1,54904573,54905019,SRX5075168,SMARCA4,446
chr1,54904610,54904905,SRX5716470,SMARCA4,295
chr1,54904612,54904884,SRX5075169,SMARCA4,272
chr1,54904624,54905008,SRX5075174,SMARCA4,384
chr1,54904628,54904803,SRX5075176,SMARCA4,175
chr1,54904629,54904947,SRX5075170,SMARCA4,318
chr1,54904637,54904959,SRX5075175,SMARCA4,322
chr1,54905456,54905662,SRX5075170,SMARCA4,206
chr1,54927285,54927661,SRX5075170,SMARCA4,376
chr1,54927369,54927661,SRX5716470,SMARCA4,292
chr1,54927407,54927713,SRX5075176,SMARCA4,306
chr1,54934784,54935274,SRX5075170,SMARCA4,490
chr1,54934807,54935247,SRX5075169,SMARCA4,440
chr1,54934826,54935303,SRX5075176,SMARCA4,477
chr1,54934846,54935173,SRX5716467,SMARCA2,327
chr1,54934856,54935242,SRX5075175,SMARCA4,386
chr1,54934859,54935243,SRX5716470,SMARCA4,384
chr1,54934872,54935293,SRX5716469,SMARCA4,421
chr1,54934878,54935225,SRX5054309,FOSL2,347
chr1,54934894,54935192,SRX5020214,SMARCA2,298
chr1,54934896,54935083,SRX5075174,SMARCA4,187
chr1,54934914,54935150,SRX5075181,SMARCA2,236
chr1,54934920,54935165,SRX5020211,SMARCA2,245
chr1,54934922,54935190,SRX5716468,SMARCA2,268
chr1,54934937,54935187,SRX5054308,FOSL2,250
chr1,54937674,54938068,SRX20140881,CPSF3L,394
chr1,54940093,54940403,SRX5075168,SMARCA4,310
chr1,54944920,54945503,SRX16500059,CTCF,583
chr1,54944994,54945487,SRX16500062,CTCF,493
chr1,54945043,54945540,SRX16500060,CTCF,497
chr1,54945061,54945497,SRX16500061,CTCF,436
chr1,54945074,54945384,SRX4174629,CTCF,310
chr1,54945142,54945378,SRX5075170,SMARCA4,236
chr1,54945164,54945419,SRX5075174,SMARCA4,255
chr1,54945164,54945446,SRX5075168,SMARCA4,282
chr1,54945226,54945418,SRX5075176,SMARCA4,192
chr1,54950521,54951229,SRX16500059,CTCF,708
chr1,54950562,54951079,SRX16500062,CTCF,517
chr1,54950597,54951077,SRX16500061,CTCF,480
chr1,54950599,54951116,SRX16500060,CTCF,517
chr1,54950657,54951013,SRX5075174,SMARCA4,356
chr1,54950673,54950883,SRX4174629,CTCF,210
chr1,54950718,54950995,SRX5075176,SMARCA4,277
chr1,54950728,54951034,SRX5075168,SMARCA4,306
chr1,54950738,54950942,SRX5716463,SMARCA4,204
chr1,54950771,54951030,SRX5075170,SMARCA4,259
chr1,54950794,54951044,SRX5716470,SMARCA4,250
chr1,54955327,54955794,SRX5075176,SMARCA4,467
chr1,54955339,54955930,SRX5075175,SMARCA4,591
chr1,54955365,54955865,SRX5075169,SMARCA4,500
chr1,54955389,54955948,SRX5075170,SMARCA4,559
chr1,54955434,54955774,SRX5054309,FOSL2,340
chr1,54955448,54955667,SRX5054308,FOSL2,219
chr1,54955452,54955854,SRX5716469,SMARCA4,402
chr1,54955468,54955731,SRX5716467,SMARCA2,263
chr1,54955494,54955806,SRX5716470,SMARCA4,312
chr1,54955571,54955778,SRX5020211,SMARCA2,207
chr1,54971524,54971733,SRX5054309,FOSL2,209
chr1,54973061,54973490,SRX16500059,CTCF,429
chr1,54973108,54973465,SRX16500061,CTCF,357
chr1,54973150,54973513,SRX16500060,CTCF,363
chr1,54973207,54973446,SRX16500062,CTCF,239
chr1,54973208,54973503,SRX5075168,SMARCA4,295
chr1,54973233,54973506,SRX5075174,SMARCA4,273
chr1,54987955,54988306,SRX5075175,SMARCA4,351
chr1,54996311,54996892,SRX16500059,CTCF,581
chr1,54996330,54996821,SRX16500061,CTCF,491
chr1,54996340,54996903,SRX16500060,CTCF,563
chr1,54996377,54996783,SRX16500062,CTCF,406
chr1,54996527,54996751,SRX4174629,CTCF,224
chr1,55021924,55022484,SRX16500062,CTCF,560
chr1,55021959,55022504,SRX16500060,CTCF,545
chr1,55021967,55022513,SRX16500059,CTCF,546
chr1,55021969,55022507,SRX16500061,CTCF,538
chr1,55022027,55022409,SRX4174629,CTCF,382
chr1,55022043,55022396,SRX5075170,SMARCA4,353
chr1,55022044,55022359,SRX5716470,SMARCA4,315
chr1,55022050,55022451,SRX5075174,SMARCA4,401
chr1,55022057,55022439,SRX5075176,SMARCA4,382
chr1,55022063,55022428,SRX5075168,SMARCA4,365
chr1,55022072,55022334,SRX5075169,SMARCA4,262
chr1,55022122,55022377,SRX5716463,SMARCA4,255
chr1,55022155,55022386,SRX5075175,SMARCA4,231
chr1,55034739,55035006,SRX5075176,SMARCA4,267
chr1,55034892,55035083,SRX5075170,SMARCA4,191
chr1,55039535,55039772,SRX5075170,SMARCA4,237
chr1,55039641,55039876,SRX5075168,SMARCA4,235
chr1,55044685,55044907,SRX20140867,INTS10,222
chr1,55050453,55050700,SRX5075169,SMARCA4,247
chr1,55050491,55050709,SRX5075175,SMARCA4,218
chr1,55050504,55050696,SRX5075170,SMARCA4,192
chr1,55064097,55064332,SRX16500059,CTCF,235
chr1,55071351,55071827,SRX16500059,CTCF,476
chr1,55071423,55071860,SRX16500060,CTCF,437
chr1,55071474,55071697,SRX4174629,CTCF,223
chr1,55071517,55071841,SRX5075174,SMARCA4,324
chr1,55071546,55071805,SRX5716470,SMARCA4,259
chr1,55071558,55071770,SRX5716469,SMARCA4,212
chr1,55071576,55071802,SRX5075170,SMARCA4,226
chr1,55071581,55071838,SRX5075168,SMARCA4,257
chr1,55071584,55071801,SRX5075176,SMARCA4,217
chr1,55071616,55071826,SRX16500062,CTCF,210
chr1,55081075,55081529,SRX5075170,SMARCA4,454
chr1,55081170,55081494,SRX5075169,SMARCA4,324
chr1,55081174,55081446,SRX5716469,SMARCA4,272
chr1,55081189,55081522,SRX5054309,FOSL2,333
chr1,55081190,55081578,SRX5075174,SMARCA4,388
chr1,55081197,55081597,SRX5075168,SMARCA4,400
chr1,55081218,55081514,SRX5054308,FOSL2,296
chr1,55081226,55081463,SRX5020211,SMARCA2,237
chr1,55081228,55081479,SRX5075176,SMARCA4,251
chr1,55081242,55081520,SRX5075175,SMARCA4,278
chr1,55081257,55081537,SRX5716470,SMARCA4,280
chr1,55081260,55081439,SRX5054307,FOSL2,179
chr1,55140353,55140925,SRX16500060,CTCF,572
chr1,55140443,55140951,SRX16500059,CTCF,508
chr1,55140477,55140954,SRX16500061,CTCF,477
chr1,55140490,55140927,SRX16500062,CTCF,437
chr1,55140531,55140882,SRX5075176,SMARCA4,351
chr1,55140583,55140885,SRX5075168,SMARCA4,302
chr1,55140588,55140888,SRX5075174,SMARCA4,300
chr1,55140592,55140920,SRX5075169,SMARCA4,328
chr1,55140626,55140878,SRX5075175,SMARCA4,252
chr1,55140629,55140923,SRX5054309,FOSL2,294
chr1,55140633,55140921,SRX4174629,CTCF,288
chr1,55140638,55140919,SRX5075170,SMARCA4,281
chr1,55140660,55140898,SRX5716469,SMARCA4,238
chr1,55140662,55140866,SRX5716463,SMARCA4,204
chr1,55140665,55140886,SRX5716470,SMARCA4,221
chr1,55214779,55215773,SRX20140895,INTS13,994
chr1,55214903,55215564,SRX20140867,INTS10,661
chr1,55215002,55215630,SRX20140897,INTS13,628
chr1,55215009,55215611,SRX20140868,INTS10,602
chr1,55215061,55215400,SRX20140896,INTS13,339
chr1,55215080,55215619,SRX20140869,INTS10,539
chr1,55215223,55215536,SRX5075174,SMARCA4,313
chr1,55215289,55215585,SRX20140879,CPSF3L,296
chr1,55215336,55215583,SRX20140894,INTS13,247
chr1,55262942,55263150,SRX5054308,FOSL2,208
chr1,55277352,55277567,SRX5054308,FOSL2,215
chr1,55277523,55277867,SRX4174629,CTCF,344
chr1,55277536,55278026,SRX16500061,CTCF,490
chr1,55277541,55277997,SRX16500062,CTCF,456
chr1,55277561,55277978,SRX16500060,CTCF,417
chr1,55277565,55278022,SRX16500059,CTCF,457
chr1,55277573,55277832,SRX5075174,SMARCA4,259
chr1,55277573,55277845,SRX5075176,SMARCA4,272
chr1,55277593,55277862,SRX5075168,SMARCA4,269
chr1,55277602,55277863,SRX5075170,SMARCA4,261
chr1,55277615,55277820,SRX5716464,SMARCA4,205
chr1,55284749,55285207,SRX16500060,CTCF,458
chr1,55284771,55285174,SRX16500059,CTCF,403
chr1,55284781,55285160,SRX16500062,CTCF,379
chr1,55284793,55285153,SRX16500061,CTCF,360
chr1,55284901,55285169,SRX5075170,SMARCA4,268
chr1,55284933,55285182,SRX4174629,CTCF,249
chr1,55284946,55285200,SRX5075176,SMARCA4,254
chr1,55304198,55304751,SRX5075170,SMARCA4,553
chr1,55304236,55304832,SRX5075176,SMARCA4,596
chr1,55304294,55304683,SRX5716467,SMARCA2,389
chr1,55304296,55304624,SRX5716470,SMARCA4,328
chr1,55304311,55304681,SRX5075169,SMARCA4,370
chr1,55304317,55304602,SRX5716468,SMARCA2,285
chr1,55304347,55304589,SRX5075175,SMARCA4,242
chr1,55304364,55304586,SRX5020211,SMARCA2,222
chr1,55304410,55304649,SRX5716469,SMARCA4,239
chr1,55310571,55311049,SRX5075169,SMARCA4,478
chr1,55310585,55310939,SRX5054308,FOSL2,354
chr1,55310587,55311069,SRX5716469,SMARCA4,482
chr1,55310589,55311080,SRX5075170,SMARCA4,491
chr1,55310597,55311013,SRX5075176,SMARCA4,416
chr1,55310602,55310900,SRX5716467,SMARCA2,298
chr1,55310621,55310994,SRX5075175,SMARCA4,373
chr1,55310624,55310889,SRX5075182,SMARCA2,265
chr1,55310624,55310994,SRX5054309,FOSL2,370
chr1,55310626,55310919,SRX5020214,SMARCA2,293
chr1,55310678,55310991,SRX5716470,SMARCA4,313
chr1,55321845,55322217,SRX5075170,SMARCA4,372
chr1,55321899,55322229,SRX5075176,SMARCA4,330
chr1,55321968,55322187,SRX5075169,SMARCA4,219
chr1,55321969,55322218,SRX5075175,SMARCA4,249
chr1,55322833,55323294,SRX5075170,SMARCA4,461
chr1,55322855,55323214,SRX5075176,SMARCA4,359
chr1,55322872,55323144,SRX5716469,SMARCA4,272
chr1,55322919,55323130,SRX5716468,SMARCA2,211
chr1,55322959,55323146,SRX5075175,SMARCA4,187
chr1,55323007,55323225,SRX5716470,SMARCA4,218
chr1,55329054,55329407,SRX5075170,SMARCA4,353
chr1,55329105,55329321,SRX5716470,SMARCA4,216
chr1,55329135,55329337,SRX5075176,SMARCA4,202
chr1,55331256,55331718,SRX5075170,SMARCA4,462
chr1,55331257,55331745,SRX5075176,SMARCA4,488
chr1,55331304,55331670,SRX5075175,SMARCA4,366
chr1,55331310,55331734,SRX5075169,SMARCA4,424
chr1,55331342,55331616,SRX5054309,FOSL2,274
chr1,55331395,55331610,SRX5054308,FOSL2,215
chr1,55331403,55331649,SRX5716467,SMARCA2,246
chr1,55331422,55331673,SRX5716469,SMARCA4,251
chr1,55331423,55331634,SRX5716468,SMARCA2,211
chr1,55331431,55331685,SRX5020211,SMARCA2,254
chr1,55338129,55338440,SRX16500061,CTCF,311
chr1,55338133,55338434,SRX16500060,CTCF,301
chr1,55338136,55338387,SRX16500059,CTCF,251
chr1,55338196,55338417,SRX16500062,CTCF,221
chr1,55338206,55338404,SRX5075168,SMARCA4,198
chr1,55347817,55348642,SRX5075170,SMARCA4,825
chr1,55347901,55348741,SRX5075176,SMARCA4,840
chr1,55347960,55348225,SRX5075175,SMARCA4,265
chr1,55347969,55348220,SRX5716468,SMARCA2,251
chr1,55347978,55348241,SRX5075169,SMARCA4,263
chr1,55348024,55348314,SRX5716470,SMARCA4,290
chr1,55353799,55354025,SRX5075170,SMARCA4,226
chr1,55362601,55362862,SRX5054308,FOSL2,261
chr1,55362629,55362828,SRX5075169,SMARCA4,199
chr1,55363467,55363642,SRX5075176,SMARCA4,175
chr1,55374801,55375112,SRX5075176,SMARCA4,311
chr1,55375610,55376088,SRX16500062,CTCF,478
chr1,55375613,55376069,SRX16500060,CTCF,456
chr1,55375623,55376098,SRX16500059,CTCF,475
chr1,55375629,55376045,SRX16500061,CTCF,416
chr1,55375695,55376049,SRX5075174,SMARCA4,354
chr1,55375699,55376009,SRX5716464,SMARCA4,310
chr1,55375699,55376040,SRX5075168,SMARCA4,341
chr1,55375707,55375997,SRX5075169,SMARCA4,290
chr1,55375748,55375988,SRX5716470,SMARCA4,240
chr1,55375750,55375995,SRX5075176,SMARCA4,245
chr1,55375769,55376077,SRX5716463,SMARCA4,308
chr1,55375778,55376032,SRX5075170,SMARCA4,254
chr1,55375782,55375999,SRX5075175,SMARCA4,217
chr1,55378553,55378796,SRX16500062,CTCF,243
chr1,55378557,55378818,SRX16500061,CTCF,261
chr1,55378579,55378845,SRX16500059,CTCF,266
chr1,55378591,55378873,SRX16500060,CTCF,282
chr1,55382808,55383173,SRX5075170,SMARCA4,365
chr1,55382830,55383182,SRX5075176,SMARCA4,352
chr1,55399363,55399745,SRX5075176,SMARCA4,382
chr1,55399390,55399714,SRX5075170,SMARCA4,324
chr1,55400309,55400891,SRX5075176,SMARCA4,582
chr1,55400369,55400860,SRX5075170,SMARCA4,491
chr1,55400494,55400674,SRX5075169,SMARCA4,180
chr1,55400562,55400750,SRX5075175,SMARCA4,188
chr1,55402144,55402471,SRX5054308,FOSL2,327
chr1,55402144,55402473,SRX5054309,FOSL2,329
chr1,55402202,55402465,SRX5075170,SMARCA4,263
chr1,55402236,55402533,SRX5075176,SMARCA4,297
chr1,55413198,55413585,SRX5075176,SMARCA4,387
chr1,55413218,55413541,SRX5075170,SMARCA4,323
chr1,55420045,55420450,SRX5075170,SMARCA4,405
chr1,55420162,55420467,SRX5075176,SMARCA4,305
chr1,55428981,55429380,SRX5716470,SMARCA4,399
chr1,55428988,55429655,SRX5075175,SMARCA4,667
chr1,55429002,55429700,SRX5054309,FOSL2,698
chr1,55429013,55429649,SRX5075170,SMARCA4,636
chr1,55429014,55429613,SRX5716469,SMARCA4,599
chr1,55429018,55429678,SRX5075169,SMARCA4,660
chr1,55429020,55429599,SRX5054308,FOSL2,579
chr1,55429031,55429650,SRX5075176,SMARCA4,619
chr1,55429063,55429373,SRX5020214,SMARCA2,310
chr1,55429125,55429346,SRX5075182,SMARCA2,221
chr1,55429130,55429469,SRX5716467,SMARCA2,339
chr1,55429144,55429372,SRX5075168,SMARCA4,228
chr1,55443278,55443956,SRX5075170,SMARCA4,678
chr1,55443314,55443900,SRX5075176,SMARCA4,586
chr1,55443468,55443845,SRX5075169,SMARCA4,377
chr1,55443473,55443840,SRX5716467,SMARCA2,367
chr1,55443512,55443830,SRX5716470,SMARCA4,318
chr1,55443546,55443873,SRX5075175,SMARCA4,327
chr1,55443575,55443782,SRX5054309,FOSL2,207
chr1,55443590,55443835,SRX5054308,FOSL2,245
chr1,55466463,55466639,SRX5075170,SMARCA4,176
chr1,55466508,55466777,SRX5075176,SMARCA4,269
chr1,55468398,55468865,SRX5075176,SMARCA4,467
chr1,55468399,55468926,SRX5075170,SMARCA4,527
chr1,55472816,55473062,SRX5075170,SMARCA4,246
chr1,55472827,55473112,SRX5054308,FOSL2,285
chr1,55472831,55473101,SRX5054309,FOSL2,270
chr1,55472870,55473048,SRX5075176,SMARCA4,178
chr1,55474241,55474426,SRX5075170,SMARCA4,185
chr1,55476757,55477008,SRX5075176,SMARCA4,251
chr1,55478738,55479113,SRX16500059,CTCF,375
chr1,55478746,55479131,SRX16500060,CTCF,385
chr1,55478829,55479071,SRX16500062,CTCF,242
chr1,55503787,55503967,SRX5054308,FOSL2,180
chr1,55506924,55507317,SRX5075169,SMARCA4,393
chr1,55507000,55507218,SRX5075176,SMARCA4,218
chr1,55507005,55507237,SRX5075170,SMARCA4,232
chr1,55507042,55507262,SRX5054309,FOSL2,220
chr1,55542863,55543505,SRX5075175,SMARCA4,642
chr1,55542884,55543535,SRX5075169,SMARCA4,651
chr1,55542886,55543451,SRX5075170,SMARCA4,565
chr1,55542925,55543420,SRX5075176,SMARCA4,495
chr1,55542939,55543472,SRX5054309,FOSL2,533
chr1,55542979,55543285,SRX5716470,SMARCA4,306
chr1,55542981,55543415,SRX5054308,FOSL2,434
chr1,55542983,55543471,SRX5716469,SMARCA4,488
chr1,55542985,55543397,SRX5716467,SMARCA2,412
chr1,55560265,55560628,SRX5075170,SMARCA4,363
chr1,55560381,55560689,SRX5075176,SMARCA4,308
chr1,55560420,55560630,SRX5075169,SMARCA4,210
chr1,55572935,55573440,SRX5075168,SMARCA4,505
chr1,55572963,55573405,SRX5075174,SMARCA4,442
chr1,55572971,55573405,SRX5075175,SMARCA4,434
chr1,55573163,55573444,SRX5054309,FOSL2,281
chr1,55573194,55573393,SRX5075170,SMARCA4,199
chr1,55573245,55573437,SRX5054308,FOSL2,192
chr1,55580884,55581251,SRX5075176,SMARCA4,367
chr1,55580907,55581275,SRX5075175,SMARCA4,368
chr1,55580907,55581295,SRX5075169,SMARCA4,388
chr1,55580919,55581282,SRX5075170,SMARCA4,363
chr1,55580963,55581143,SRX5054308,FOSL2,180
chr1,55581016,55581277,SRX5054309,FOSL2,261
chr1,55584585,55584838,SRX16500059,CTCF,253
chr1,55584922,55585448,SRX5075176,SMARCA4,526
chr1,55584944,55585212,SRX5716467,SMARCA2,268
chr1,55584957,55585326,SRX5716468,SMARCA2,369
chr1,55584964,55585218,SRX5716470,SMARCA4,254
chr1,55584970,55585377,SRX5075170,SMARCA4,407
chr1,55585019,55585359,SRX5075175,SMARCA4,340
chr1,55585037,55585429,SRX5075169,SMARCA4,392
chr1,55585227,55585444,SRX5054309,FOSL2,217
chr1,55600359,55600601,SRX5075176,SMARCA4,242
chr1,55617087,55617563,SRX5075176,SMARCA4,476
chr1,55617263,55617671,SRX5075170,SMARCA4,408
chr1,55631517,55631757,SRX5054309,FOSL2,240
chr1,55632087,55632338,SRX5054308,FOSL2,251
chr1,55632146,55632350,SRX5054309,FOSL2,204
chr1,55635950,55636234,SRX5075175,SMARCA4,284
chr1,55635965,55636283,SRX5075169,SMARCA4,318
chr1,55635968,55636249,SRX5075170,SMARCA4,281
chr1,55635982,55636290,SRX5716467,SMARCA2,308
chr1,55635987,55636313,SRX5075176,SMARCA4,326
chr1,55635988,55636222,SRX5716470,SMARCA4,234
chr1,55650439,55650799,SRX5075170,SMARCA4,360
chr1,55650472,55650758,SRX5075176,SMARCA4,286
chr1,55650498,55650709,SRX5716470,SMARCA4,211
chr1,55670772,55671042,SRX5716470,SMARCA4,270
chr1,55670773,55671012,SRX5075176,SMARCA4,239
chr1,55679975,55680233,SRX5716470,SMARCA4,258
chr1,55680043,55680272,SRX5075175,SMARCA4,229
chr1,55680075,55680280,SRX5075170,SMARCA4,205
chr1,55696085,55696561,SRX5054308,FOSL2,476
chr1,55696106,55696845,SRX5075176,SMARCA4,739
chr1,55696132,55696557,SRX5075175,SMARCA4,425
chr1,55696137,55696631,SRX5075170,SMARCA4,494
chr1,55696170,55696604,SRX5075169,SMARCA4,434
chr1,55696233,55696549,SRX5054309,FOSL2,316
chr1,55702045,55702475,SRX16500059,CTCF,430
chr1,55702061,55702451,SRX16500060,CTCF,390
chr1,55702082,55702481,SRX16500061,CTCF,399
chr1,55702102,55702470,SRX16500062,CTCF,368
chr1,55702162,55702393,SRX5075174,SMARCA4,231
chr1,55708770,55709131,SRX5075174,SMARCA4,361
chr1,55708940,55709125,SRX5075168,SMARCA4,185
chr1,55718679,55719396,SRX5075170,SMARCA4,717
chr1,55718712,55719271,SRX5716470,SMARCA4,559
chr1,55718713,55719386,SRX5075176,SMARCA4,673
chr1,55718717,55719316,SRX5075175,SMARCA4,599
chr1,55718754,55719228,SRX5054309,FOSL2,474
chr1,55718758,55719323,SRX5075169,SMARCA4,565
chr1,55718778,55719253,SRX5054308,FOSL2,475
chr1,55718785,55719276,SRX5716467,SMARCA2,491
chr1,55718802,55719115,SRX5020211,SMARCA2,313
chr1,55718812,55719181,SRX5716468,SMARCA2,369
chr1,55718812,55719183,SRX5020214,SMARCA2,371
chr1,55718839,55719290,SRX5716469,SMARCA4,451
chr1,55718840,55719319,SRX5075181,SMARCA2,479
chr1,55718857,55719117,SRX5075182,SMARCA2,260
chr1,55726989,55727393,SRX5075175,SMARCA4,404
chr1,55726998,55727344,SRX5075170,SMARCA4,346
chr1,55727001,55727457,SRX5075176,SMARCA4,456
chr1,55727017,55727352,SRX5716467,SMARCA2,335
chr1,55727020,55727404,SRX5020211,SMARCA2,384
chr1,55727023,55727351,SRX5716470,SMARCA4,328
chr1,55727026,55727386,SRX5716469,SMARCA4,360
chr1,55727041,55727291,SRX5716468,SMARCA2,250
chr1,55727048,55727391,SRX5075169,SMARCA4,343
chr1,55727105,55727356,SRX5075181,SMARCA2,251
chr1,55734930,55735423,SRX5075170,SMARCA4,493
chr1,55734961,55735334,SRX5075176,SMARCA4,373
chr1,55735005,55735462,SRX5075169,SMARCA4,457
chr1,55735193,55735418,SRX5075175,SMARCA4,225
chr1,55741401,55741997,SRX5075170,SMARCA4,596
chr1,55741439,55742029,SRX5075176,SMARCA4,590
chr1,55741471,55741803,SRX5716470,SMARCA4,332
chr1,55741491,55741852,SRX5716469,SMARCA4,361
chr1,55741499,55741836,SRX5716468,SMARCA2,337
chr1,55741511,55741931,SRX5075175,SMARCA4,420
chr1,55741519,55741892,SRX5075169,SMARCA4,373
chr1,55741535,55741914,SRX5716467,SMARCA2,379
chr1,55741570,55741847,SRX5020211,SMARCA2,277
chr1,55741613,55741793,SRX5054308,FOSL2,180
chr1,55768371,55768558,SRX5075176,SMARCA4,187
chr1,55768504,55768852,SRX5075170,SMARCA4,348
chr1,55768618,55768863,SRX5075176,SMARCA4,245
chr1,55774861,55775361,SRX5075176,SMARCA4,500
chr1,55774910,55775310,SRX5075170,SMARCA4,400
chr1,55781866,55782197,SRX5075169,SMARCA4,331
chr1,55781890,55782517,SRX5075176,SMARCA4,627
chr1,55781891,55782340,SRX5054309,FOSL2,449
chr1,55781914,55782562,SRX5075170,SMARCA4,648
chr1,55781915,55782200,SRX5075175,SMARCA4,285
chr1,55781949,55782233,SRX5054308,FOSL2,284
chr1,55781968,55782324,SRX5716469,SMARCA4,356
chr1,55781969,55782215,SRX5716470,SMARCA4,246
chr1,55786508,55786690,SRX5075168,SMARCA4,182
chr1,55786512,55786708,SRX5075174,SMARCA4,196
chr1,55823611,55823901,SRX5075174,SMARCA4,290
chr1,55823650,55823922,SRX5075168,SMARCA4,272
chr1,55827391,55827751,SRX5054309,FOSL2,360
chr1,55827422,55827609,SRX5075175,SMARCA4,187
chr1,55827424,55827676,SRX5054308,FOSL2,252
chr1,55833390,55834149,SRX5075176,SMARCA4,759
chr1,55833447,55833630,SRX5075170,SMARCA4,183
chr1,55833620,55833800,SRX5075169,SMARCA4,180
chr1,55833785,55834055,SRX5716469,SMARCA4,270
chr1,55869019,55869435,SRX5075174,SMARCA4,416
chr1,55869048,55869286,SRX5716463,SMARCA4,238
chr1,55869057,55869482,SRX5075168,SMARCA4,425
chr1,55869132,55869387,SRX5716464,SMARCA4,255
chr1,55870138,55870497,SRX5075175,SMARCA4,359
chr1,55870147,55870533,SRX5075176,SMARCA4,386
chr1,55870162,55870489,SRX5054308,FOSL2,327
chr1,55870166,55870504,SRX5075169,SMARCA4,338
chr1,55870168,55870535,SRX5054309,FOSL2,367
chr1,55870171,55870538,SRX5075181,SMARCA2,367
chr1,55870172,55870467,SRX5020211,SMARCA2,295
chr1,55870229,55870588,SRX5075170,SMARCA4,359
chr1,55886818,55887047,SRX5075176,SMARCA4,229
chr1,55886964,55887354,SRX5075170,SMARCA4,390
chr1,55893215,55893450,SRX16500059,CTCF,235
chr1,55893225,55893471,SRX16500061,CTCF,246
chr1,55893236,55893526,SRX16500060,CTCF,290
chr1,55916519,55916753,SRX5075176,SMARCA4,234
chr1,55916531,55916798,SRX5075170,SMARCA4,267
chr1,55931393,55931784,SRX5075170,SMARCA4,391
chr1,55931397,55931783,SRX5075176,SMARCA4,386
chr1,55937963,55938269,SRX5075176,SMARCA4,306
chr1,55938015,55938444,SRX5075170,SMARCA4,429
chr1,55951436,55951655,SRX5075170,SMARCA4,219
chr1,55951483,55951683,SRX5054308,FOSL2,200
chr1,55951488,55951691,SRX5054309,FOSL2,203
chr1,55954501,55954744,SRX5075176,SMARCA4,243
chr1,55954527,55954740,SRX5075170,SMARCA4,213
chr1,55959372,55959591,SRX5075176,SMARCA4,219
chr1,55966099,55966481,SRX5020211,SMARCA2,382
chr1,55966101,55966437,SRX5075175,SMARCA4,336
chr1,55966135,55966426,SRX5054308,FOSL2,291
chr1,55966146,55966429,SRX5054309,FOSL2,283
chr1,55966167,55966426,SRX5716459,Epitope tags,259
chr1,55966180,55966386,SRX5075176,SMARCA4,206
chr1,55966191,55966444,SRX5075181,SMARCA2,253
chr1,55966213,55966454,SRX5075169,SMARCA4,241
chr1,55966221,55966403,SRX5075170,SMARCA4,182
chr1,55966225,55966435,SRX5020214,SMARCA2,210
chr1,55974901,55975500,SRX5075176,SMARCA4,599
chr1,55974986,55975389,SRX5716469,SMARCA4,403
chr1,55974990,55975407,SRX5075175,SMARCA4,417
chr1,55974992,55975268,SRX5020211,SMARCA2,276
chr1,55975006,55975398,SRX5075169,SMARCA4,392
chr1,55975014,55975347,SRX5716467,SMARCA2,333
chr1,55975055,55975338,SRX5075170,SMARCA4,283
chr1,55975056,55975360,SRX5054309,FOSL2,304
chr1,55975062,55975389,SRX5716470,SMARCA4,327
chr1,55975115,55975365,SRX5054308,FOSL2,250
chr1,56017362,56017691,SRX5075170,SMARCA4,329
chr1,56017427,56017661,SRX5054308,FOSL2,234
chr1,56017448,56017623,SRX5075176,SMARCA4,175
chr1,56034272,56034531,SRX5075175,SMARCA4,259
chr1,56034275,56034577,SRX5075169,SMARCA4,302
chr1,56034302,56034492,SRX5054309,FOSL2,190
chr1,56034327,56034496,SRX5075170,SMARCA4,169
chr1,56034364,56034544,SRX5075176,SMARCA4,180
chr1,56039812,56039995,SRX5054309,FOSL2,183
chr1,56051966,56052536,SRX5075168,SMARCA4,570
chr1,56052001,56052568,SRX5075174,SMARCA4,567
chr1,56052024,56052549,SRX5075176,SMARCA4,525
chr1,56052074,56052405,SRX5716463,SMARCA4,331
chr1,56052085,56052425,SRX5716470,SMARCA4,340
chr1,56052092,56052417,SRX5716464,SMARCA4,325
chr1,56052102,56052606,SRX5075170,SMARCA4,504
chr1,56058122,56058329,SRX5075176,SMARCA4,207
chr1,56065831,56066028,SRX5054309,FOSL2,197
chr1,56065836,56066032,SRX5054308,FOSL2,196
chr1,56070670,56071004,SRX5075176,SMARCA4,334
chr1,56070695,56070971,SRX5075170,SMARCA4,276
chr1,56070739,56070997,SRX5075169,SMARCA4,258
chr1,56073947,56074275,SRX5075169,SMARCA4,328
chr1,56073973,56074381,SRX5075176,SMARCA4,408
chr1,56073976,56074339,SRX5716470,SMARCA4,363
chr1,56073978,56074258,SRX5716468,SMARCA2,280
chr1,56073994,56074408,SRX5716469,SMARCA4,414
chr1,56074006,56074327,SRX5716467,SMARCA2,321
chr1,56074046,56074363,SRX5075175,SMARCA4,317
chr1,56074057,56074359,SRX5075170,SMARCA4,302
chr1,56081250,56081694,SRX5075176,SMARCA4,444
chr1,56096283,56096564,SRX5054309,FOSL2,281
chr1,56096297,56096588,SRX5020211,SMARCA2,291
chr1,56096334,56096565,SRX5075176,SMARCA4,231
chr1,56096340,56096520,SRX5054308,FOSL2,180
chr1,56096358,56096564,SRX5075169,SMARCA4,206
chr1,56096376,56096571,SRX5075170,SMARCA4,195
chr1,56098764,56098953,SRX5075169,SMARCA4,189
chr1,56098883,56099116,SRX5020214,SMARCA2,233
chr1,56098941,56099160,SRX5075175,SMARCA4,219
chr1,56099007,56099271,SRX5075169,SMARCA4,264
chr1,56099009,56099283,SRX5054309,FOSL2,274
chr1,56099024,56099316,SRX5075176,SMARCA4,292
chr1,56099031,56099282,SRX5075170,SMARCA4,251
chr1,56099069,56099278,SRX5054308,FOSL2,209
chr1,56137829,56138086,SRX5075176,SMARCA4,257
chr1,56137874,56138231,SRX5075170,SMARCA4,357
chr1,56137919,56138339,SRX5054308,FOSL2,420
chr1,56137976,56138159,SRX5054309,FOSL2,183
chr1,56139708,56140025,SRX5054308,FOSL2,317
chr1,56146507,56146838,SRX5075175,SMARCA4,331
chr1,56146528,56146761,SRX5075170,SMARCA4,233
chr1,56146541,56146765,SRX5075176,SMARCA4,224
chr1,56180940,56181119,SRX5075170,SMARCA4,179
chr1,56185553,56185866,SRX5075176,SMARCA4,313
chr1,56185570,56185883,SRX5075170,SMARCA4,313
chr1,56185593,56185814,SRX5075169,SMARCA4,221
chr1,56189808,56190258,SRX16500060,CTCF,450
chr1,56189837,56190285,SRX16500061,CTCF,448
chr1,56189837,56190286,SRX16500059,CTCF,449
chr1,56189879,56190206,SRX5075174,SMARCA4,327
chr1,56189924,56190310,SRX16500062,CTCF,386
chr1,56191057,56191274,SRX5054309,FOSL2,217
chr1,56194775,56195203,SRX5075170,SMARCA4,428
chr1,56194841,56195159,SRX5075176,SMARCA4,318
chr1,56200556,56200967,SRX5075170,SMARCA4,411
chr1,56200652,56200920,SRX5075176,SMARCA4,268
chr1,56200676,56200881,SRX5054309,FOSL2,205
chr1,56229142,56229813,SRX5075174,SMARCA4,671
chr1,56229177,56229746,SRX5075168,SMARCA4,569
chr1,56229200,56229649,SRX20140895,INTS13,449
chr1,56229213,56229629,SRX5716463,SMARCA4,416
chr1,56229291,56229640,SRX5716451,SOX2,349
chr1,56229302,56229661,SRX20140868,INTS10,359
chr1,56229346,56229583,SRX5716464,SMARCA4,237
chr1,56229396,56229651,SRX5716454,SOX3,255
chr1,56247160,56247497,SRX5075168,SMARCA4,337
chr1,56247174,56247530,SRX5075174,SMARCA4,356
chr1,56284894,56285265,SRX5075176,SMARCA4,371
chr1,56284905,56285238,SRX5716470,SMARCA4,333
chr1,56284925,56285230,SRX5075170,SMARCA4,305
chr1,56285015,56285201,SRX5075169,SMARCA4,186
chr1,56285046,56285272,SRX5075175,SMARCA4,226
chr1,56291433,56291661,SRX5075168,SMARCA4,228
chr1,56291472,56291816,SRX5075174,SMARCA4,344
chr1,56295983,56296268,SRX5075170,SMARCA4,285
chr1,56301808,56302166,SRX5054309,FOSL2,358
chr1,56301818,56302207,SRX5075169,SMARCA4,389
chr1,56301833,56302162,SRX5075175,SMARCA4,329
chr1,56320729,56321284,SRX5075176,SMARCA4,555
chr1,56320749,56321297,SRX5075170,SMARCA4,548
chr1,56320776,56321213,SRX5075169,SMARCA4,437
chr1,56320797,56321195,SRX5716470,SMARCA4,398
chr1,56320810,56321222,SRX5075175,SMARCA4,412
chr1,56320813,56321098,SRX5716469,SMARCA4,285
chr1,56320856,56321237,SRX5716468,SMARCA2,381
chr1,56320861,56321192,SRX5716467,SMARCA2,331
chr1,56326091,56326434,SRX5075175,SMARCA4,343
chr1,56326097,56326400,SRX5054309,FOSL2,303
chr1,56326101,56326372,SRX5075170,SMARCA4,271
chr1,56326118,56326426,SRX5054308,FOSL2,308
chr1,56326127,56326462,SRX5716469,SMARCA4,335
chr1,56326134,56326361,SRX5075176,SMARCA4,227
chr1,56326141,56326432,SRX5020211,SMARCA2,291
chr1,56326142,56326427,SRX5716470,SMARCA4,285
chr1,56326142,56326501,SRX5075169,SMARCA4,359
chr1,56326165,56326466,SRX5716468,SMARCA2,301
chr1,56326177,56326451,SRX5716467,SMARCA2,274
chr1,56329015,56329243,SRX5054309,FOSL2,228
chr1,56330482,56330735,SRX5054308,FOSL2,253
chr1,56330509,56330741,SRX5054309,FOSL2,232
chr1,56330519,56330716,SRX5075176,SMARCA4,197
chr1,56330521,56330716,SRX5075169,SMARCA4,195
chr1,56332238,56332430,SRX5075168,SMARCA4,192
chr1,56335253,56335474,SRX5075176,SMARCA4,221
chr1,56374534,56374746,SRX5075176,SMARCA4,212
chr1,56390420,56390617,SRX5075168,SMARCA4,197
chr1,56425312,56425569,SRX5075170,SMARCA4,257
chr1,56425329,56425520,SRX5075175,SMARCA4,191
chr1,56425333,56425589,SRX5054309,FOSL2,256
chr1,56425358,56425637,SRX5075169,SMARCA4,279
chr1,56434648,56435043,SRX16500059,CTCF,395
chr1,56434676,56434895,SRX16500061,CTCF,219
chr1,56434686,56434987,SRX16500060,CTCF,301
chr1,56435815,56436254,SRX5075176,SMARCA4,439
chr1,56435866,56436179,SRX5075174,SMARCA4,313
chr1,56435918,56436379,SRX20140895,INTS13,461
chr1,56435924,56436183,SRX5075170,SMARCA4,259
chr1,56436701,56437378,SRX20140895,INTS13,677
chr1,56436857,56437425,SRX5075168,SMARCA4,568
chr1,56436863,56437383,SRX5075174,SMARCA4,520
chr1,56436950,56437198,SRX5716464,SMARCA4,248
chr1,56436972,56437263,SRX5716463,SMARCA4,291
chr1,56437026,56437242,SRX20140867,INTS10,216
chr1,56446723,56446925,SRX5075176,SMARCA4,202
chr1,56446800,56446985,SRX5075170,SMARCA4,185
chr1,56452248,56452656,SRX5075176,SMARCA4,408
chr1,56452289,56452610,SRX5716467,SMARCA2,321
chr1,56452304,56452589,SRX5716468,SMARCA2,285
chr1,56452313,56452612,SRX5716470,SMARCA4,299
chr1,56452326,56452615,SRX5020211,SMARCA2,289
chr1,56452328,56452618,SRX5075170,SMARCA4,290
chr1,56452340,56452623,SRX5075175,SMARCA4,283
chr1,56452351,56452587,SRX5054308,FOSL2,236
chr1,56452383,56452650,SRX5716469,SMARCA4,267
chr1,56452393,56452591,SRX5075169,SMARCA4,198
chr1,56453326,56453661,SRX5075168,SMARCA4,335
chr1,56453439,56453614,SRX5075174,SMARCA4,175
chr1,56456467,56456973,SRX5054309,FOSL2,506
chr1,56464389,56464747,SRX5075170,SMARCA4,358
chr1,56464451,56464671,SRX5054309,FOSL2,220
chr1,56464461,56464666,SRX5075176,SMARCA4,205
chr1,56469934,56470297,SRX5075176,SMARCA4,363
chr1,56470000,56470312,SRX5075170,SMARCA4,312
chr1,56470064,56470255,SRX5054309,FOSL2,191
chr1,56470080,56470273,SRX5075169,SMARCA4,193
chr1,56477241,56478001,SRX5075174,SMARCA4,760
chr1,56477311,56478057,SRX20140895,INTS13,746
chr1,56477326,56478040,SRX5075168,SMARCA4,714
chr1,56477421,56478049,SRX5075170,SMARCA4,628
chr1,56477429,56477772,SRX5716451,SOX2,343
chr1,56477449,56477930,SRX20140868,INTS10,481
chr1,56477496,56477830,SRX5716454,SOX3,334
chr1,56477533,56477776,SRX5716464,SMARCA4,243
chr1,56477555,56477817,SRX5716463,SMARCA4,262
chr1,56477579,56477940,SRX5075169,SMARCA4,361
chr1,56477621,56478056,SRX5716470,SMARCA4,435
chr1,56477623,56477948,SRX5716469,SMARCA4,325
chr1,56477635,56477995,SRX5075176,SMARCA4,360
chr1,56491433,56491676,SRX5075176,SMARCA4,243
chr1,56491524,56491741,SRX5075170,SMARCA4,217
chr1,56520213,56520398,SRX5075176,SMARCA4,185
chr1,56520291,56520474,SRX5075170,SMARCA4,183
chr1,56527517,56527836,SRX5075170,SMARCA4,319
chr1,56527517,56527914,SRX5716470,SMARCA4,397
chr1,56527537,56527870,SRX5075176,SMARCA4,333
chr1,56527564,56527805,SRX5075175,SMARCA4,241
chr1,56527635,56527856,SRX5075169,SMARCA4,221
chr1,56527938,56528120,SRX5075168,SMARCA4,182
chr1,56532388,56532566,SRX5075170,SMARCA4,178
chr1,56535291,56535753,SRX5075168,SMARCA4,462
chr1,56535323,56535791,SRX5075174,SMARCA4,468
chr1,56550422,56551155,SRX5075168,SMARCA4,733
chr1,56550427,56551185,SRX5075174,SMARCA4,758
chr1,56550437,56551043,SRX5716463,SMARCA4,606
chr1,56550565,56551002,SRX5716464,SMARCA4,437
chr1,56550615,56551002,SRX5716454,SOX3,387
chr1,56550742,56551115,SRX5716451,SOX2,373
chr1,56566985,56567296,SRX5075174,SMARCA4,311
chr1,56567004,56567319,SRX5075168,SMARCA4,315
chr1,56579086,56579712,SRX20140895,INTS13,626
chr1,56579200,56579576,SRX20140867,INTS10,376
chr1,56579228,56579842,SRX5075174,SMARCA4,614
chr1,56579271,56579743,SRX20140868,INTS10,472
chr1,56579281,56579715,SRX5075168,SMARCA4,434
chr1,56579305,56579626,SRX20140879,CPSF3L,321
chr1,56579383,56579667,SRX20140897,INTS13,284
chr1,56579404,56580005,SRX16500059,CTCF,601
chr1,56579449,56579817,SRX5075169,SMARCA4,368
chr1,56579457,56579905,SRX5075170,SMARCA4,448
chr1,56579481,56579809,SRX5075175,SMARCA4,328
chr1,56579495,56579704,SRX5716463,SMARCA4,209
chr1,56579500,56579712,SRX5716469,SMARCA4,212
chr1,56579510,56579850,SRX5075176,SMARCA4,340
chr1,56579555,56580000,SRX16500062,CTCF,445
chr1,56579559,56579846,SRX5716470,SMARCA4,287
chr1,56579598,56580006,SRX16500060,CTCF,408
chr1,56579628,56579951,SRX16500061,CTCF,323
chr1,56584843,56585333,SRX16500061,CTCF,490
chr1,56584849,56585333,SRX16500060,CTCF,484
chr1,56584855,56585323,SRX16500059,CTCF,468
chr1,56584881,56585335,SRX16500062,CTCF,454
chr1,56584895,56585248,SRX5075176,SMARCA4,353
chr1,56584925,56585199,SRX5075168,SMARCA4,274
chr1,56584930,56585225,SRX5075170,SMARCA4,295
chr1,56584950,56585199,SRX5716470,SMARCA4,249
chr1,56584960,56585201,SRX5075175,SMARCA4,241
chr1,56584979,56585196,SRX5075169,SMARCA4,217
chr1,56584983,56585243,SRX5075174,SMARCA4,260
chr1,56585044,56585271,SRX5716469,SMARCA4,227
chr1,56617023,56617375,SRX5054309,FOSL2,352
chr1,56617031,56617492,SRX5075176,SMARCA4,461
chr1,56617041,56617399,SRX5075170,SMARCA4,358
chr1,56617043,56617370,SRX5054308,FOSL2,327
chr1,56617064,56617353,SRX5716469,SMARCA4,289
chr1,56617069,56617365,SRX5075169,SMARCA4,296
chr1,56617070,56617418,SRX5075175,SMARCA4,348
chr1,56617286,56617585,SRX5075174,SMARCA4,299
chr1,56626020,56626354,SRX5075176,SMARCA4,334
chr1,56626032,56626537,SRX5075170,SMARCA4,505
chr1,56626088,56627007,SRX5075175,SMARCA4,919
chr1,56626138,56627137,SRX5075169,SMARCA4,999
chr1,56626149,56626364,SRX5716467,SMARCA2,215
chr1,56626518,56627085,SRX5075176,SMARCA4,567
chr1,56626574,56626929,SRX5716469,SMARCA4,355
chr1,56626591,56626946,SRX5716470,SMARCA4,355
chr1,56626595,56626893,SRX5054308,FOSL2,298
chr1,56626643,56626993,SRX5075170,SMARCA4,350
chr1,56626701,56626916,SRX5716467,SMARCA2,215
chr1,56626990,56627272,SRX5054309,FOSL2,282
chr1,56639196,56639631,SRX5075176,SMARCA4,435
chr1,56639338,56639663,SRX5075169,SMARCA4,325
chr1,56639409,56639633,SRX5075170,SMARCA4,224
chr1,56639457,56639655,SRX5075175,SMARCA4,198
chr1,56639464,56639700,SRX5054308,FOSL2,236
chr1,56639475,56639699,SRX5716467,SMARCA2,224
chr1,56645040,56645453,SRX5075168,SMARCA4,413
chr1,56645043,56645480,SRX5075174,SMARCA4,437
chr1,56645052,56645545,SRX5075175,SMARCA4,493
chr1,56645058,56645560,SRX20140868,INTS10,502
chr1,56645061,56645699,SRX20140895,INTS13,638
chr1,56645093,56645354,SRX5716469,SMARCA4,261
chr1,56645110,56645400,SRX5075176,SMARCA4,290
chr1,56645118,56645452,SRX5075169,SMARCA4,334
chr1,56645175,56645492,SRX5716470,SMARCA4,317
chr1,56645263,56645551,SRX5075170,SMARCA4,288
chr1,56646064,56646322,SRX5075174,SMARCA4,258
chr1,56646070,56646278,SRX5075168,SMARCA4,208
chr1,56669544,56669800,SRX5075170,SMARCA4,256
chr1,56676689,56677019,SRX5075170,SMARCA4,330
chr1,56676708,56677024,SRX5075169,SMARCA4,316
chr1,56676726,56676965,SRX5075176,SMARCA4,239
chr1,56676753,56676978,SRX5054309,FOSL2,225
chr1,56688430,56688800,SRX5075168,SMARCA4,370
chr1,56688459,56688751,SRX5716469,SMARCA4,292
chr1,56688463,56688824,SRX5075174,SMARCA4,361
chr1,56688476,56688816,SRX5054309,FOSL2,340
chr1,56688480,56688788,SRX5075170,SMARCA4,308
chr1,56688483,56688829,SRX5075176,SMARCA4,346
chr1,56688486,56688780,SRX5075175,SMARCA4,294
chr1,56688487,56688804,SRX5075169,SMARCA4,317
chr1,56688498,56688785,SRX5054308,FOSL2,287
chr1,56709232,56709726,SRX16500059,CTCF,494
chr1,56709233,56709717,SRX16500062,CTCF,484
chr1,56709234,56709742,SRX16500061,CTCF,508
chr1,56709246,56709732,SRX16500060,CTCF,486
chr1,56709321,56709510,SRX5075170,SMARCA4,189
chr1,56709336,56709629,SRX5075174,SMARCA4,293
chr1,56709362,56709541,SRX5075168,SMARCA4,179
chr1,56710633,56711007,SRX5075169,SMARCA4,374
chr1,56710654,56710997,SRX5075175,SMARCA4,343
chr1,56710669,56711025,SRX5075170,SMARCA4,356
chr1,56710691,56710987,SRX5054308,FOSL2,296
chr1,56710694,56710944,SRX5716469,SMARCA4,250
chr1,56710697,56710996,SRX5054309,FOSL2,299
chr1,56710703,56710950,SRX5020214,SMARCA2,247
chr1,56710704,56711095,SRX5075176,SMARCA4,391
chr1,56710715,56710930,SRX5716467,SMARCA2,215
chr1,56710722,56710981,SRX5716470,SMARCA4,259
chr1,56710730,56710978,SRX5075168,SMARCA4,248
chr1,56758261,56758515,SRX16500062,CTCF,254
chr1,56780914,56781208,SRX16500059,CTCF,294
chr1,56797996,56798411,SRX5075176,SMARCA4,415
chr1,56798000,56798268,SRX5075175,SMARCA4,268
chr1,56798146,56798349,SRX5075174,SMARCA4,203
chr1,56798187,56798453,SRX5075168,SMARCA4,266
chr1,56803477,56803889,SRX16500060,CTCF,412
chr1,56803518,56803964,SRX16500059,CTCF,446
chr1,56803588,56803936,SRX16500062,CTCF,348
chr1,56803592,56803878,SRX16500061,CTCF,286
chr1,56820944,56821432,SRX16500061,CTCF,488
chr1,56820967,56821439,SRX16500059,CTCF,472
chr1,56820979,56821569,SRX16500060,CTCF,590
chr1,56820985,56821528,SRX16500062,CTCF,543
chr1,56821048,56821273,SRX5075169,SMARCA4,225
chr1,56821075,56821368,SRX5075174,SMARCA4,293
chr1,56821079,56821316,SRX5075168,SMARCA4,237
chr1,56821080,56821358,SRX5075170,SMARCA4,278
chr1,56821089,56821388,SRX4174629,CTCF,299
chr1,56821103,56821320,SRX5716464,SMARCA4,217
chr1,56821113,56821329,SRX5075176,SMARCA4,216
chr1,56831800,56832314,SRX16500059,CTCF,514
chr1,56831835,56832369,SRX16500060,CTCF,534
chr1,56831844,56832292,SRX16500061,CTCF,448
chr1,56831850,56832291,SRX16500062,CTCF,441
chr1,56831870,56832211,SRX4174629,CTCF,341
chr1,56831917,56832198,SRX5075174,SMARCA4,281
chr1,56831939,56832313,SRX5075168,SMARCA4,374
chr1,56832008,56832224,SRX5075170,SMARCA4,216
chr1,56832013,56832227,SRX5075176,SMARCA4,214
chr1,56832037,56832228,SRX5075169,SMARCA4,191
chr1,56832187,56832491,SRX5716460,Epitope tags,304
chr1,56832260,56832698,SRX5075175,SMARCA4,438
chr1,56832287,56832680,SRX5075169,SMARCA4,393
chr1,56832292,56832666,SRX5054309,FOSL2,374
chr1,56832352,56832738,SRX5716470,SMARCA4,386
chr1,56832358,56832707,SRX5075176,SMARCA4,349
chr1,56832360,56832668,SRX5075170,SMARCA4,308
chr1,56832365,56832683,SRX5054308,FOSL2,318
chr1,56832370,56832707,SRX5716469,SMARCA4,337
chr1,56832374,56832670,SRX5020214,SMARCA2,296
chr1,56832410,56832635,SRX5716467,SMARCA2,225
chr1,56866666,56866935,SRX5075175,SMARCA4,269
chr1,56866747,56867021,SRX5075169,SMARCA4,274
chr1,56868850,56869083,SRX5075170,SMARCA4,233
chr1,56872683,56872895,SRX5054309,FOSL2,212
chr1,56872697,56872903,SRX5054308,FOSL2,206
chr1,56877999,56878222,SRX5075176,SMARCA4,223
chr1,56904757,56905085,SRX5716470,SMARCA4,328
chr1,56904765,56905012,SRX5075168,SMARCA4,247
chr1,56904787,56905039,SRX5075174,SMARCA4,252
chr1,56904907,56905126,SRX5716464,SMARCA4,219
chr1,56909004,56909246,SRX5075169,SMARCA4,242
chr1,56909008,56909321,SRX5075176,SMARCA4,313
chr1,56909010,56909311,SRX5075170,SMARCA4,301
chr1,56909044,56909260,SRX5716467,SMARCA2,216
chr1,56909047,56909252,SRX5054309,FOSL2,205
chr1,56911109,56911337,SRX5054309,FOSL2,228
chr1,56920631,56920899,SRX5075176,SMARCA4,268
chr1,56921517,56921700,SRX5075170,SMARCA4,183
chr1,56931246,56931649,SRX5075174,SMARCA4,403
chr1,56931330,56931593,SRX5075168,SMARCA4,263
chr1,56934454,56934813,SRX5075169,SMARCA4,359
chr1,56934460,56934854,SRX5054309,FOSL2,394
chr1,56934472,56934855,SRX5075175,SMARCA4,383
chr1,56934486,56934973,SRX5716470,SMARCA4,487
chr1,56934487,56934973,SRX5075176,SMARCA4,486
chr1,56934502,56934797,SRX5054308,FOSL2,295
chr1,56934514,56935007,SRX5075170,SMARCA4,493
chr1,56934550,56934927,SRX5716469,SMARCA4,377
chr1,56934624,56934841,SRX5716468,SMARCA2,217
chr1,56968180,56968618,SRX16500062,CTCF,438
chr1,56968238,56968619,SRX16500059,CTCF,381
chr1,56968254,56968669,SRX16500060,CTCF,415
chr1,56968275,56968589,SRX16500061,CTCF,314
chr1,56968515,56968762,SRX5075170,SMARCA4,247
chr1,56980045,56980647,SRX5075170,SMARCA4,602
chr1,56980164,56980409,SRX5075176,SMARCA4,245
chr1,57017117,57017660,SRX5075174,SMARCA4,543
chr1,57017143,57017668,SRX5075168,SMARCA4,525
chr1,57017195,57017593,SRX5716463,SMARCA4,398
chr1,57017226,57017447,SRX5716464,SMARCA4,221
chr1,57017228,57017539,SRX5054307,FOSL2,311
chr1,57017229,57017468,SRX5716454,SOX3,239
chr1,57017257,57017487,SRX5716451,SOX2,230
chr1,57017631,57018132,SRX16500062,CTCF,501
chr1,57017710,57018139,SRX16500060,CTCF,429
chr1,57017727,57018073,SRX16500061,CTCF,346
chr1,57017752,57018088,SRX16500059,CTCF,336
chr1,57079771,57080036,SRX16500062,CTCF,265
chr1,57079819,57080081,SRX16500061,CTCF,262
chr1,57112080,57112557,SRX5075174,SMARCA4,477
chr1,57112135,57112569,SRX5075168,SMARCA4,434
chr1,57112223,57112480,SRX20140867,INTS10,257
chr1,57112235,57112569,SRX20140881,CPSF3L,334
chr1,57112249,57112479,SRX5075170,SMARCA4,230
chr1,57112271,57112511,SRX5075176,SMARCA4,240
chr1,57124672,57125264,SRX5075168,SMARCA4,592
chr1,57124700,57125281,SRX5075174,SMARCA4,581
chr1,57124765,57125162,SRX5075170,SMARCA4,397
chr1,57124807,57125225,SRX5075175,SMARCA4,418
chr1,57124814,57125220,SRX5075176,SMARCA4,406
chr1,57124850,57125159,SRX5075169,SMARCA4,309
chr1,57132092,57132272,SRX5075169,SMARCA4,180
chr1,57133771,57133970,SRX5075169,SMARCA4,199
chr1,57133782,57134002,SRX5075170,SMARCA4,220
chr1,57133832,57134015,SRX5054309,FOSL2,183
chr1,57143043,57143349,SRX5075170,SMARCA4,306
chr1,57143089,57143319,SRX5075176,SMARCA4,230
chr1,57146165,57146409,SRX5075176,SMARCA4,244
chr1,57146173,57146359,SRX5075170,SMARCA4,186
chr1,57158617,57158994,SRX5075169,SMARCA4,377
chr1,57158643,57159066,SRX5075176,SMARCA4,423
chr1,57158650,57159022,SRX5075170,SMARCA4,372
chr1,57158714,57158975,SRX5054308,FOSL2,261
chr1,57158740,57158960,SRX5054309,FOSL2,220
chr1,57158742,57158958,SRX5075175,SMARCA4,216
chr1,57165567,57165959,SRX5075170,SMARCA4,392
chr1,57165616,57165988,SRX5075176,SMARCA4,372
chr1,57165648,57165876,SRX5054309,FOSL2,228
chr1,57165712,57165892,SRX5075169,SMARCA4,180
chr1,57188231,57188470,SRX5054309,FOSL2,239
chr1,57188300,57188469,SRX5075170,SMARCA4,169
chr1,57204871,57205340,SRX5075168,SMARCA4,469
chr1,57204880,57205433,SRX5075174,SMARCA4,553
chr1,57204905,57205382,SRX5716463,SMARCA4,477
chr1,57204962,57205251,SRX5716454,SOX3,289
chr1,57205033,57205264,SRX5716451,SOX2,231
chr1,57205257,57205650,SRX5075170,SMARCA4,393
chr1,57205407,57205660,SRX5075169,SMARCA4,253
chr1,57205429,57205612,SRX5054309,FOSL2,183
chr1,57205635,57205810,SRX5075176,SMARCA4,175
chr1,57206012,57206339,SRX5075168,SMARCA4,327
chr1,57206036,57206309,SRX5075174,SMARCA4,273
chr1,57214994,57215524,SRX5075174,SMARCA4,530
chr1,57215064,57215359,SRX5075175,SMARCA4,295
chr1,57215070,57215492,SRX5075170,SMARCA4,422
chr1,57215079,57215426,SRX5075168,SMARCA4,347
chr1,57215083,57215426,SRX5075176,SMARCA4,343
chr1,57215130,57215439,SRX5075169,SMARCA4,309
chr1,57215179,57215489,SRX5716470,SMARCA4,310
chr1,57215735,57216117,SRX5075174,SMARCA4,382
chr1,57215807,57216080,SRX5075168,SMARCA4,273
chr1,57280407,57280582,SRX5075176,SMARCA4,175
chr1,57319193,57319646,SRX5075170,SMARCA4,453
chr1,57319194,57319711,SRX5075176,SMARCA4,517
chr1,57319196,57319625,SRX5075175,SMARCA4,429
chr1,57319239,57319418,SRX5075168,SMARCA4,179
chr1,57319242,57319469,SRX5716469,SMARCA4,227
chr1,57319259,57319517,SRX5716467,SMARCA2,258
chr1,57319260,57319550,SRX5075169,SMARCA4,290
chr1,57319264,57319504,SRX5716470,SMARCA4,240
chr1,57319272,57319472,SRX5020211,SMARCA2,200
chr1,57319278,57319536,SRX5075174,SMARCA4,258
chr1,57319280,57319606,SRX5054308,FOSL2,326
chr1,57319282,57319584,SRX5054309,FOSL2,302
chr1,57353599,57354106,SRX5075170,SMARCA4,507
chr1,57353643,57354074,SRX5075169,SMARCA4,431
chr1,57353665,57353865,SRX5020211,SMARCA2,200
chr1,57353670,57354133,SRX5716470,SMARCA4,463
chr1,57353694,57354155,SRX5054309,FOSL2,461
chr1,57353697,57353963,SRX5075176,SMARCA4,266
chr1,57353711,57354125,SRX5716469,SMARCA4,414
chr1,57353728,57354083,SRX5716467,SMARCA2,355
chr1,57353737,57354088,SRX5054308,FOSL2,351
chr1,57353755,57354063,SRX5075175,SMARCA4,308
chr1,57377836,57378083,SRX16500060,CTCF,247
chr1,57377857,57378114,SRX16500059,CTCF,257
chr1,57381417,57381657,SRX5075168,SMARCA4,240
chr1,57411264,57411652,SRX5075170,SMARCA4,388
chr1,57411292,57411684,SRX5075176,SMARCA4,392
chr1,57411296,57411591,SRX5716469,SMARCA4,295
chr1,57411310,57411661,SRX5075169,SMARCA4,351
chr1,57411344,57411636,SRX5075175,SMARCA4,292
chr1,57411354,57411598,SRX5716470,SMARCA4,244
chr1,57411404,57411590,SRX5054309,FOSL2,186
chr1,57422342,57422516,SRX5075174,SMARCA4,174
chr1,57422361,57422807,SRX20140895,INTS13,446
chr1,57424377,57424887,SRX16500059,CTCF,510
chr1,57424429,57424901,SRX16500062,CTCF,472
chr1,57424437,57424877,SRX16500061,CTCF,440
chr1,57424478,57424930,SRX16500060,CTCF,452
chr1,57424571,57424849,SRX5075174,SMARCA4,278
chr1,57424644,57424815,SRX5075170,SMARCA4,171
chr1,57461377,57461779,SRX5075176,SMARCA4,402
chr1,57461419,57461803,SRX5075170,SMARCA4,384
chr1,57461441,57461713,SRX5075175,SMARCA4,272
chr1,57461518,57461715,SRX5075169,SMARCA4,197
chr1,57468683,57469052,SRX5075169,SMARCA4,369
chr1,57468686,57468891,SRX5075176,SMARCA4,205
chr1,57468690,57468947,SRX5054308,FOSL2,257
chr1,57468692,57468939,SRX5075170,SMARCA4,247
chr1,57468716,57469026,SRX5054309,FOSL2,310
chr1,57468758,57468975,SRX5716469,SMARCA4,217
chr1,57470115,57470340,SRX5075174,SMARCA4,225
chr1,57470152,57470357,SRX5075175,SMARCA4,205
chr1,57474138,57474664,SRX5054309,FOSL2,526
chr1,57474144,57474623,SRX5075169,SMARCA4,479
chr1,57474152,57474621,SRX5075175,SMARCA4,469
chr1,57474158,57474560,SRX5075170,SMARCA4,402
chr1,57474158,57474700,SRX5075176,SMARCA4,542
chr1,57474163,57474670,SRX5054308,FOSL2,507
chr1,57474177,57474660,SRX5716469,SMARCA4,483
chr1,57474345,57474656,SRX5020214,SMARCA2,311
chr1,57489279,57490087,SRX5075175,SMARCA4,808
chr1,57489357,57490068,SRX5075170,SMARCA4,711
chr1,57489382,57490055,SRX5075176,SMARCA4,673
chr1,57489405,57490121,SRX5075169,SMARCA4,716
chr1,57489440,57490083,SRX5716470,SMARCA4,643
chr1,57489500,57490064,SRX5054308,FOSL2,564
chr1,57489526,57490068,SRX5075168,SMARCA4,542
chr1,57489534,57490084,SRX5054309,FOSL2,550
chr1,57489538,57490051,SRX5716469,SMARCA4,513
chr1,57489552,57490003,SRX5716467,SMARCA2,451
chr1,57489627,57490125,SRX5075174,SMARCA4,498
chr1,57489729,57490034,SRX5020211,SMARCA2,305
chr1,57538725,57538898,SRX5075174,SMARCA4,173
chr1,57571500,57571720,SRX5075170,SMARCA4,220
chr1,57590993,57591267,SRX5075168,SMARCA4,274
chr1,57591005,57591297,SRX5075174,SMARCA4,292
chr1,57599189,57599625,SRX5075174,SMARCA4,436
chr1,57599205,57599560,SRX5716460,Epitope tags,355
chr1,57599248,57599558,SRX5716469,SMARCA4,310
chr1,57599256,57599654,SRX5716470,SMARCA4,398
chr1,57599259,57599607,SRX5075170,SMARCA4,348
chr1,57599263,57599592,SRX5075176,SMARCA4,329
chr1,57599263,57599627,SRX5075169,SMARCA4,364
chr1,57599281,57599595,SRX5716468,SMARCA2,314
chr1,57599296,57599536,SRX5020214,SMARCA2,240
chr1,57599296,57599603,SRX5075175,SMARCA4,307
chr1,57599307,57599603,SRX5716467,SMARCA2,296
chr1,57599312,57599564,SRX5054308,FOSL2,252
chr1,57599316,57599527,SRX5075181,SMARCA2,211
chr1,57599330,57599581,SRX5054309,FOSL2,251
chr1,57599333,57599562,SRX5075168,SMARCA4,229
chr1,57600419,57600838,SRX5075168,SMARCA4,419
chr1,57600437,57600782,SRX5075174,SMARCA4,345
chr1,57623033,57623245,SRX5075168,SMARCA4,212
chr1,57623068,57623278,SRX5075169,SMARCA4,210
chr1,57623068,57623352,SRX5075176,SMARCA4,284
chr1,57623088,57623394,SRX5075174,SMARCA4,306
chr1,57623091,57623326,SRX5075170,SMARCA4,235
chr1,57623107,57623294,SRX5075175,SMARCA4,187
chr1,57637139,57637468,SRX5054308,FOSL2,329
chr1,57637177,57637425,SRX5075174,SMARCA4,248
chr1,57637186,57637518,SRX5054309,FOSL2,332
chr1,57637209,57637463,SRX5075169,SMARCA4,254
chr1,57637217,57637534,SRX5716469,SMARCA4,317
chr1,57637232,57637423,SRX5075170,SMARCA4,191
chr1,57637264,57637468,SRX5075176,SMARCA4,204
chr1,57637267,57637552,SRX5075175,SMARCA4,285
chr1,57658562,57658731,SRX5075170,SMARCA4,169
chr1,57748705,57749006,SRX5075168,SMARCA4,301
chr1,57748709,57749025,SRX5075174,SMARCA4,316
chr1,57770638,57771077,SRX16500060,CTCF,439
chr1,57770738,57771156,SRX16500061,CTCF,418
chr1,57770769,57771169,SRX16500059,CTCF,400
chr1,57770835,57771079,SRX16500062,CTCF,244
chr1,57831633,57832016,SRX5075169,SMARCA4,383
chr1,57831637,57832111,SRX5075174,SMARCA4,474
chr1,57831660,57832058,SRX5075168,SMARCA4,398
chr1,57831668,57831993,SRX5075175,SMARCA4,325
chr1,57831679,57832021,SRX5054309,FOSL2,342
chr1,57831688,57831929,SRX5075170,SMARCA4,241
chr1,57831723,57831988,SRX5075176,SMARCA4,265
chr1,57831737,57831948,SRX5054308,FOSL2,211
chr1,57832496,57833026,SRX5075168,SMARCA4,530
chr1,57832515,57833027,SRX5075174,SMARCA4,512
chr1,57832569,57832865,SRX5716451,SOX2,296
chr1,57832582,57832925,SRX5716464,SMARCA4,343
chr1,57832604,57833003,SRX5716463,SMARCA4,399
chr1,57832694,57832909,SRX5716454,SOX3,215
chr1,57843838,57844096,SRX5054309,FOSL2,258
chr1,57857839,57858098,SRX5075175,SMARCA4,259
chr1,57857890,57858105,SRX5054309,FOSL2,215
chr1,57860231,57860725,SRX5075174,SMARCA4,494
chr1,57860293,57860710,SRX5075168,SMARCA4,417
chr1,57860300,57860667,SRX5716463,SMARCA4,367
chr1,57860365,57860623,SRX5716451,SOX2,258
chr1,57860367,57860589,SRX5716464,SMARCA4,222
chr1,57881840,57882061,SRX5054309,FOSL2,221
chr1,57882076,57882510,SRX5075174,SMARCA4,434
chr1,57882090,57882556,SRX5075168,SMARCA4,466
chr1,57882192,57882438,SRX5716463,SMARCA4,246
chr1,57882246,57882436,SRX5716451,SOX2,190
chr1,57894615,57894867,SRX5075168,SMARCA4,252
chr1,57967090,57967301,SRX5075170,SMARCA4,211
chr1,58006692,58007104,SRX5075168,SMARCA4,412
chr1,58006728,58007000,SRX5075174,SMARCA4,272
chr1,58035515,58035831,SRX16500061,CTCF,316
chr1,58035555,58035818,SRX16500060,CTCF,263
chr1,58035593,58035852,SRX16500062,CTCF,259
chr1,58035596,58035916,SRX16500059,CTCF,320
chr1,58035627,58035800,SRX5075174,SMARCA4,173
chr1,58047174,58047644,SRX16500060,CTCF,470
chr1,58047183,58047626,SRX16500061,CTCF,443
chr1,58047191,58047642,SRX16500062,CTCF,451
chr1,58047216,58047677,SRX16500059,CTCF,461
chr1,58047280,58047512,SRX5075174,SMARCA4,232
chr1,58047317,58047573,SRX4174629,CTCF,256
chr1,58059767,58060103,SRX5075168,SMARCA4,336
chr1,58059789,58060005,SRX5075174,SMARCA4,216
chr1,58084327,58084590,SRX5075168,SMARCA4,263
chr1,58084330,58084615,SRX5075174,SMARCA4,285
chr1,58155351,58155803,SRX16500061,CTCF,452
chr1,58155368,58155688,SRX5716463,SMARCA4,320
chr1,58155385,58155715,SRX16500060,CTCF,330
chr1,58155400,58155690,SRX5075168,SMARCA4,290
chr1,58155408,58155707,SRX16500062,CTCF,299
chr1,58155423,58155659,SRX5075174,SMARCA4,236
chr1,58155428,58155728,SRX16500059,CTCF,300
chr1,58162922,58163340,SRX5075174,SMARCA4,418
chr1,58162924,58163257,SRX4174629,CTCF,333
chr1,58162925,58163407,SRX16500059,CTCF,482
chr1,58162949,58163346,SRX5075168,SMARCA4,397
chr1,58162952,58163446,SRX16500061,CTCF,494
chr1,58162955,58163490,SRX16500060,CTCF,535
chr1,58162959,58163315,SRX5075176,SMARCA4,356
chr1,58162960,58163298,SRX5716464,SMARCA4,338
chr1,58162960,58163456,SRX16500062,CTCF,496
chr1,58162962,58163300,SRX5075170,SMARCA4,338
chr1,58162983,58163290,SRX5075175,SMARCA4,307
chr1,58162987,58163319,SRX5716463,SMARCA4,332
chr1,58162999,58163334,SRX5075169,SMARCA4,335
chr1,58163010,58163281,SRX5716470,SMARCA4,271
chr1,58163021,58163226,SRX5020214,SMARCA2,205
chr1,58163025,58163273,SRX5716469,SMARCA4,248
chr1,58190557,58190886,SRX5075168,SMARCA4,329
chr1,58190600,58190997,SRX5075174,SMARCA4,397
chr1,58204389,58204599,SRX16500062,CTCF,210
chr1,58249686,58250610,SRX20140895,INTS13,924
chr1,58249828,58250212,SRX20140868,INTS10,384
chr1,58250307,58250575,SRX5075168,SMARCA4,268
chr1,58251569,58251991,SRX16500060,CTCF,422
chr1,58251644,58251923,SRX16500059,CTCF,279
chr1,58251676,58252058,SRX16500061,CTCF,382
chr1,58251712,58252058,SRX16500062,CTCF,346
chr1,58290695,58290977,SRX5075168,SMARCA4,282
chr1,58290713,58291009,SRX5716470,SMARCA4,296
chr1,58290738,58291004,SRX5075169,SMARCA4,266
chr1,58290744,58290997,SRX5075170,SMARCA4,253
chr1,58290747,58290984,SRX5075176,SMARCA4,237
chr1,58290754,58291089,SRX5075174,SMARCA4,335
chr1,58290772,58290977,SRX5075175,SMARCA4,205
chr1,58290773,58291089,SRX5716463,SMARCA4,316
chr1,58290787,58291042,SRX5716464,SMARCA4,255
chr1,58318621,58318796,SRX5075176,SMARCA4,175
chr1,58340059,58340542,SRX5075174,SMARCA4,483
chr1,58340136,58340594,SRX5075168,SMARCA4,458
chr1,58358294,58358502,SRX5075174,SMARCA4,208
chr1,58363692,58363875,SRX5075174,SMARCA4,183
chr1,58395363,58395724,SRX5075169,SMARCA4,361
chr1,58395375,58395808,SRX5075174,SMARCA4,433
chr1,58395376,58395701,SRX5054309,FOSL2,325
chr1,58395377,58395723,SRX5075176,SMARCA4,346
chr1,58395382,58395743,SRX5054308,FOSL2,361
chr1,58395383,58395805,SRX5075170,SMARCA4,422
chr1,58395387,58395716,SRX5075175,SMARCA4,329
chr1,58395390,58395707,SRX5716469,SMARCA4,317
chr1,58395402,58395737,SRX5075168,SMARCA4,335
chr1,58395403,58395753,SRX5716470,SMARCA4,350
chr1,58395411,58395668,SRX5054307,FOSL2,257
chr1,58395412,58395672,SRX5020214,SMARCA2,260
chr1,58395415,58395664,SRX5716467,SMARCA2,249
chr1,58395432,58395720,SRX5020211,SMARCA2,288
chr1,58395439,58395684,SRX5716468,SMARCA2,245
chr1,58395554,58395847,SRX5716459,Epitope tags,293
chr1,58396134,58396708,SRX20140895,INTS13,574
chr1,58396164,58396672,SRX20140868,INTS10,508
chr1,58396178,58396646,SRX5075168,SMARCA4,468
chr1,58396228,58396583,SRX5075174,SMARCA4,355
chr1,58410109,58410314,SRX5075181,SMARCA2,205
chr1,58430625,58431121,SRX5075170,SMARCA4,496
chr1,58430879,58431075,SRX5075176,SMARCA4,196
chr1,58430913,58431294,SRX5054308,FOSL2,381
chr1,58430953,58431252,SRX5054309,FOSL2,299
chr1,58432660,58433212,SRX5075174,SMARCA4,552
chr1,58432708,58433151,SRX20140895,INTS13,443
chr1,58432733,58433206,SRX5075168,SMARCA4,473
chr1,58432769,58433241,SRX5075176,SMARCA4,472
chr1,58432793,58433119,SRX5716470,SMARCA4,326
chr1,58432803,58433248,SRX5716463,SMARCA4,445
chr1,58432818,58433319,SRX5075169,SMARCA4,501
chr1,58432853,58433208,SRX5075175,SMARCA4,355
chr1,58432865,58433161,SRX5075170,SMARCA4,296
chr1,58432905,58433156,SRX5716464,SMARCA4,251
chr1,58433406,58433599,SRX5075170,SMARCA4,193
chr1,58441667,58441949,SRX5075176,SMARCA4,282
chr1,58441720,58442388,SRX5075170,SMARCA4,668
chr1,58442142,58442447,SRX5075176,SMARCA4,305
chr1,58460552,58460780,SRX5075170,SMARCA4,228
chr1,58460556,58460741,SRX5075174,SMARCA4,185
chr1,58460578,58460791,SRX5716470,SMARCA4,213
chr1,58460601,58460800,SRX5075176,SMARCA4,199
chr1,58474513,58474848,SRX5075174,SMARCA4,335
chr1,58474655,58474839,SRX5075168,SMARCA4,184
chr1,58515598,58516204,SRX16500060,CTCF,606
chr1,58515644,58516232,SRX16500062,CTCF,588
chr1,58515680,58516224,SRX16500059,CTCF,544
chr1,58515748,58516201,SRX16500061,CTCF,453
chr1,58515843,58516170,SRX5075168,SMARCA4,327
chr1,58515852,58516123,SRX5716463,SMARCA4,271
chr1,58515870,58516152,SRX5075170,SMARCA4,282
chr1,58515880,58516201,SRX5075174,SMARCA4,321
chr1,58515890,58516197,SRX5075176,SMARCA4,307
chr1,58515891,58516168,SRX5075175,SMARCA4,277
chr1,58515940,58516205,SRX4174629,CTCF,265
chr1,58515953,58516187,SRX5075169,SMARCA4,234
chr1,58518285,58518347,SRX1424892,POU3F2,62
chr1,58545876,58546336,SRX5075169,SMARCA4,460
chr1,58545991,58546444,SRX5716469,SMARCA4,453
chr1,58546019,58546347,SRX5075174,SMARCA4,328
chr1,58546042,58546924,SRX20140895,INTS13,882
chr1,58546075,58546671,SRX20140897,INTS13,596
chr1,58546078,58546301,SRX5075170,SMARCA4,223
chr1,58546090,58546456,SRX5716470,SMARCA4,366
chr1,58546097,58546389,SRX5075176,SMARCA4,292
chr1,58546160,58546707,SRX20140868,INTS10,547
chr1,58546192,58546446,SRX5075175,SMARCA4,254
chr1,58546249,58546883,SRX20140867,INTS10,634
chr1,58546363,58546647,SRX20140881,CPSF3L,284
chr1,58546556,58547083,SRX5075175,SMARCA4,527
chr1,58546594,58547067,SRX5075174,SMARCA4,473
chr1,58546604,58547197,SRX16500059,CTCF,593
chr1,58546612,58546979,SRX5716464,SMARCA4,367
chr1,58546614,58547136,SRX16500061,CTCF,522
chr1,58546620,58547127,SRX16500060,CTCF,507
chr1,58546623,58546888,SRX5054309,FOSL2,265
chr1,58546627,58547019,SRX5716463,SMARCA4,392
chr1,58546627,58547081,SRX4174629,CTCF,454
chr1,58546628,58547079,SRX5075170,SMARCA4,451
chr1,58546635,58547078,SRX5075168,SMARCA4,443
chr1,58546642,58546877,SRX5054308,FOSL2,235
chr1,58546664,58547085,SRX16500062,CTCF,421
chr1,58546691,58547044,SRX5075176,SMARCA4,353
chr1,58546693,58547020,SRX5716469,SMARCA4,327
chr1,58546700,58547041,SRX5716470,SMARCA4,341
chr1,58546707,58547000,SRX5020211,SMARCA2,293
chr1,58546714,58547085,SRX5075169,SMARCA4,371
chr1,58551336,58551953,SRX20140895,INTS13,617
chr1,58551529,58551926,SRX20140868,INTS10,397
chr1,58573599,58574069,SRX5075168,SMARCA4,470
chr1,58573647,58574063,SRX5075174,SMARCA4,416
chr1,58584427,58584967,SRX5075176,SMARCA4,540
chr1,58584463,58584891,SRX5716459,Epitope tags,428
chr1,58584475,58584941,SRX5075170,SMARCA4,466
chr1,58584505,58584913,SRX5075175,SMARCA4,408
chr1,58584507,58584928,SRX5054309,FOSL2,421
chr1,58584508,58584905,SRX5075169,SMARCA4,397
chr1,58584544,58584832,SRX5020214,SMARCA2,288
chr1,58584544,58584937,SRX5020211,SMARCA2,393
chr1,58584558,58584867,SRX5716467,SMARCA2,309
chr1,58584571,58584887,SRX5054308,FOSL2,316
chr1,58584584,58584937,SRX5716470,SMARCA4,353
chr1,58584590,58584913,SRX5716469,SMARCA4,323
chr1,58584591,58584820,SRX5716468,SMARCA2,229
chr1,58584605,58584800,SRX5075181,SMARCA2,195
chr1,58592512,58592886,SRX5716469,SMARCA4,374
chr1,58592518,58592879,SRX5075169,SMARCA4,361
chr1,58592527,58592937,SRX5075176,SMARCA4,410
chr1,58592532,58592915,SRX5075170,SMARCA4,383
chr1,58592563,58592823,SRX5716468,SMARCA2,260
chr1,58592563,58592913,SRX5075175,SMARCA4,350
chr1,58592565,58592871,SRX5716467,SMARCA2,306
chr1,58592568,58592877,SRX5075174,SMARCA4,309
chr1,58592573,58592890,SRX5716470,SMARCA4,317
chr1,58592576,58592878,SRX5075168,SMARCA4,302
chr1,58592582,58592765,SRX5054309,FOSL2,183
chr1,58592623,58592849,SRX5716464,SMARCA4,226
chr1,58592625,58592833,SRX5075181,SMARCA2,208
chr1,58618338,58618575,SRX5075175,SMARCA4,237
chr1,58618416,58618733,SRX5075169,SMARCA4,317
chr1,58651906,58652284,SRX5075174,SMARCA4,378
chr1,58651908,58652261,SRX5716463,SMARCA4,353
chr1,58651922,58652178,SRX5075168,SMARCA4,256
chr1,58652519,58653099,SRX16500060,CTCF,580
chr1,58652529,58653053,SRX16500059,CTCF,524
chr1,58652550,58653010,SRX16500061,CTCF,460
chr1,58652589,58652957,SRX16500062,CTCF,368
chr1,58652596,58652915,SRX5075168,SMARCA4,319
chr1,58652598,58652915,SRX5075174,SMARCA4,317
chr1,58652605,58652899,SRX5075170,SMARCA4,294
chr1,58652607,58652827,SRX5716470,SMARCA4,220
chr1,58652612,58652922,SRX5075176,SMARCA4,310
chr1,58652622,58652909,SRX5075169,SMARCA4,287
chr1,58652628,58652856,SRX4174629,CTCF,228
chr1,58652644,58652889,SRX5075175,SMARCA4,245
chr1,58652670,58652908,SRX5716464,SMARCA4,238
chr1,58699783,58700070,SRX5075175,SMARCA4,287
chr1,58699801,58700298,SRX20140895,INTS13,497
chr1,58699806,58700135,SRX20140881,CPSF3L,329
chr1,58699815,58700347,SRX5075174,SMARCA4,532
chr1,58699820,58700047,SRX5716470,SMARCA4,227
chr1,58699850,58700259,SRX5075169,SMARCA4,409
chr1,58699851,58700178,SRX20140897,INTS13,327
chr1,58699854,58700097,SRX20140867,INTS10,243
chr1,58699869,58700325,SRX5075168,SMARCA4,456
chr1,58699907,58700288,SRX5075170,SMARCA4,381
chr1,58699935,58700331,SRX5716463,SMARCA4,396
chr1,58700065,58700345,SRX16500059,CTCF,280
chr1,58700100,58700336,SRX5075176,SMARCA4,236
chr1,58700118,58700452,SRX16500060,CTCF,334
chr1,58727232,58727841,SRX5075176,SMARCA4,609
chr1,58727271,58727772,SRX5075169,SMARCA4,501
chr1,58727297,58727849,SRX5075170,SMARCA4,552
chr1,58727302,58727765,SRX5075175,SMARCA4,463
chr1,58727333,58727845,SRX5075168,SMARCA4,512
chr1,58727343,58727878,SRX5075174,SMARCA4,535
chr1,58727359,58727760,SRX5054309,FOSL2,401
chr1,58727361,58727792,SRX5716469,SMARCA4,431
chr1,58727421,58727713,SRX5054308,FOSL2,292
chr1,58727427,58727675,SRX5054307,FOSL2,248
chr1,58727498,58727718,SRX5075182,SMARCA2,220
chr1,58739771,58740284,SRX16500061,CTCF,513
chr1,58739774,58740313,SRX16500060,CTCF,539
chr1,58739789,58740253,SRX16500062,CTCF,464
chr1,58739810,58740310,SRX16500059,CTCF,500
chr1,58739871,58740178,SRX5075176,SMARCA4,307
chr1,58739932,58740221,SRX5075174,SMARCA4,289
chr1,58739949,58740181,SRX5075170,SMARCA4,232
chr1,58739981,58740214,SRX5075169,SMARCA4,233
chr1,58739983,58740219,SRX5075168,SMARCA4,236
chr1,58740051,58740311,SRX4174629,CTCF,260
chr1,58745070,58745534,SRX5075176,SMARCA4,464
chr1,58745074,58745469,SRX5075170,SMARCA4,395
chr1,58745077,58745460,SRX5075169,SMARCA4,383
chr1,58745098,58745419,SRX5054308,FOSL2,321
chr1,58745128,58745470,SRX5075175,SMARCA4,342
chr1,58745141,58745359,SRX5716469,SMARCA4,218
chr1,58745154,58745394,SRX5075174,SMARCA4,240
chr1,58745194,58745407,SRX5075168,SMARCA4,213
chr1,58748832,58749047,SRX5075174,SMARCA4,215
chr1,58753277,58753569,SRX5075174,SMARCA4,292
chr1,58753311,58753585,SRX5075168,SMARCA4,274
chr1,58755333,58755943,SRX5075170,SMARCA4,610
chr1,58755378,58755949,SRX5075176,SMARCA4,571
chr1,58755386,58755958,SRX5075169,SMARCA4,572
chr1,58755403,58755797,SRX5716470,SMARCA4,394
chr1,58755418,58755876,SRX5716469,SMARCA4,458
chr1,58755435,58756010,SRX5075175,SMARCA4,575
chr1,58755447,58755954,SRX5054309,FOSL2,507
chr1,58755465,58755832,SRX5716467,SMARCA2,367
chr1,58755500,58755770,SRX5716460,Epitope tags,270
chr1,58755513,58755896,SRX5054308,FOSL2,383
chr1,58755558,58755968,SRX5075168,SMARCA4,410
chr1,58755559,58755849,SRX5075174,SMARCA4,290
chr1,58755597,58755865,SRX5020214,SMARCA2,268
chr1,58762847,58763098,SRX5075176,SMARCA4,251
chr1,58763244,58763561,SRX5075170,SMARCA4,317
chr1,58763269,58763540,SRX5075169,SMARCA4,271
chr1,58763290,58763473,SRX5054309,FOSL2,183
chr1,58763304,58763535,SRX5075175,SMARCA4,231
chr1,58763319,58763565,SRX5716470,SMARCA4,246
chr1,58764233,58764635,SRX5075170,SMARCA4,402
chr1,58764264,58764651,SRX5075176,SMARCA4,387
chr1,58764270,58764647,SRX5075175,SMARCA4,377
chr1,58764303,58764638,SRX5054309,FOSL2,335
chr1,58764338,58764598,SRX5054308,FOSL2,260
chr1,58764362,58764644,SRX5075169,SMARCA4,282
chr1,58764403,58764636,SRX5716469,SMARCA4,233
chr1,58769205,58769699,SRX16500061,CTCF,494
chr1,58769224,58769709,SRX16500059,CTCF,485
chr1,58769234,58769684,SRX16500062,CTCF,450
chr1,58769242,58769581,SRX5716470,SMARCA4,339
chr1,58769244,58769552,SRX5716463,SMARCA4,308
chr1,58769246,58769588,SRX5075168,SMARCA4,342
chr1,58769250,58769670,SRX16500060,CTCF,420
chr1,58769270,58769588,SRX5075174,SMARCA4,318
chr1,58769294,58769551,SRX5075170,SMARCA4,257
chr1,58769302,58769525,SRX5716464,SMARCA4,223
chr1,58769302,58769531,SRX5075175,SMARCA4,229
chr1,58769302,58769602,SRX4174629,CTCF,300
chr1,58769303,58769546,SRX5075176,SMARCA4,243
chr1,58769322,58769581,SRX5075169,SMARCA4,259
chr1,58770020,58770263,SRX5075176,SMARCA4,243
chr1,58773351,58773916,SRX5075176,SMARCA4,565
chr1,58773382,58773905,SRX5075170,SMARCA4,523
chr1,58773441,58773873,SRX5716469,SMARCA4,432
chr1,58773447,58773843,SRX5075175,SMARCA4,396
chr1,58773454,58773834,SRX5716470,SMARCA4,380
chr1,58773482,58773797,SRX5054308,FOSL2,315
chr1,58773498,58773872,SRX5075169,SMARCA4,374
chr1,58773503,58773800,SRX5716467,SMARCA2,297
chr1,58773536,58773776,SRX5716468,SMARCA2,240
chr1,58781771,58782049,SRX16500059,CTCF,278
chr1,58781772,58782005,SRX16500060,CTCF,233
chr1,58783350,58784445,SRX20140895,INTS13,1095
chr1,58783611,58784519,SRX20140869,INTS10,908
chr1,58783668,58784422,SRX20140868,INTS10,754
chr1,58783677,58784580,SRX20140867,INTS10,903
chr1,58783696,58784168,SRX20140880,CPSF3L,472
chr1,58783698,58784312,SRX20140881,CPSF3L,614
chr1,58783723,58784645,SRX20140897,INTS13,922
chr1,58783746,58784265,SRX20140879,CPSF3L,519
chr1,58783747,58784227,SRX20140894,INTS13,480
chr1,58783764,58784272,SRX20140896,INTS13,508
chr1,58783803,58784078,SRX20140882,CPSF3L,275
chr1,58784008,58784391,SRX5054309,FOSL2,383
chr1,58784042,58784541,SRX5075168,SMARCA4,499
chr1,58784043,58784392,SRX5075176,SMARCA4,349
chr1,58784044,58784451,SRX5075174,SMARCA4,407
chr1,58784045,58784260,SRX5716463,SMARCA4,215
chr1,58784069,58784305,SRX5054308,FOSL2,236
chr1,58784078,58784482,SRX5075170,SMARCA4,404
chr1,58784128,58784329,SRX5054307,FOSL2,201
chr1,58784172,58784418,SRX5716470,SMARCA4,246
chr1,58784217,58784407,SRX5075175,SMARCA4,190
chr1,58784231,58784443,SRX5716469,SMARCA4,212
chr1,58785118,58785373,SRX4174629,CTCF,255
chr1,58785123,58785476,SRX5075176,SMARCA4,353
chr1,58785129,58785441,SRX5075169,SMARCA4,312
chr1,58785155,58785475,SRX16500060,CTCF,320
chr1,58785165,58785473,SRX5075170,SMARCA4,308
chr1,58785188,58785434,SRX5075175,SMARCA4,246
chr1,58785188,58785437,SRX5716469,SMARCA4,249
chr1,58785218,58785486,SRX16500062,CTCF,268
chr1,58785266,58785565,SRX5716470,SMARCA4,299
chr1,58809344,58809620,SRX5716470,SMARCA4,276
chr1,58815043,58815530,SRX5075174,SMARCA4,487
chr1,58815120,58815500,SRX5075168,SMARCA4,380
chr1,58815168,58815397,SRX5716470,SMARCA4,229
chr1,58815176,58815480,SRX5075169,SMARCA4,304
chr1,58815190,58815471,SRX5075175,SMARCA4,281
chr1,58816186,58816613,SRX5075176,SMARCA4,427
chr1,58816199,58816639,SRX5075170,SMARCA4,440
chr1,58816201,58816681,SRX20140895,INTS13,480
chr1,58816231,58816419,SRX5054308,FOSL2,188
chr1,58816249,58816583,SRX5075175,SMARCA4,334
chr1,58816267,58816608,SRX5075169,SMARCA4,341
chr1,58816289,58816514,SRX5054309,FOSL2,225
chr1,58816293,58816649,SRX5075174,SMARCA4,356
chr1,58816294,58816653,SRX5716470,SMARCA4,359
chr1,58816304,58816619,SRX5075168,SMARCA4,315
chr1,58818152,58818391,SRX5075170,SMARCA4,239
chr1,58818156,58818471,SRX5054309,FOSL2,315
chr1,58818168,58818503,SRX5075169,SMARCA4,335
chr1,58818190,58818436,SRX5075176,SMARCA4,246
chr1,58818192,58818372,SRX5054308,FOSL2,180
chr1,58818218,58818429,SRX5075175,SMARCA4,211
chr1,58823429,58823877,SRX5054308,FOSL2,448
chr1,58823432,58823985,SRX5075170,SMARCA4,553
chr1,58823442,58823999,SRX5075176,SMARCA4,557
chr1,58823448,58823987,SRX5054309,FOSL2,539
chr1,58823465,58823964,SRX5075169,SMARCA4,499
chr1,58823473,58823844,SRX5075175,SMARCA4,371
chr1,58823522,58823758,SRX5716469,SMARCA4,236
chr1,58823551,58823766,SRX5716467,SMARCA2,215
chr1,58829806,58830053,SRX5075175,SMARCA4,247
chr1,58829950,58830145,SRX5075169,SMARCA4,195
chr1,58829960,58830183,SRX5075176,SMARCA4,223
chr1,58829987,58830157,SRX5075170,SMARCA4,170
chr1,58839914,58840579,SRX5075169,SMARCA4,665
chr1,58840156,58840582,SRX5075175,SMARCA4,426
chr1,58840177,58840601,SRX5075170,SMARCA4,424
chr1,58840239,58840540,SRX5075176,SMARCA4,301
chr1,58840243,58840455,SRX5054309,FOSL2,212
chr1,58840247,58840542,SRX5716470,SMARCA4,295
chr1,58841526,58841757,SRX16500062,CTCF,231
chr1,58841583,58841804,SRX16500060,CTCF,221
chr1,58848738,58849516,SRX5075176,SMARCA4,778
chr1,58848760,58849493,SRX5075169,SMARCA4,733
chr1,58848760,58849532,SRX5075170,SMARCA4,772
chr1,58848762,58849446,SRX5075175,SMARCA4,684
chr1,58848779,58849298,SRX5075168,SMARCA4,519
chr1,58848797,58849418,SRX5054309,FOSL2,621
chr1,58848807,58849373,SRX5075174,SMARCA4,566
chr1,58848809,58849332,SRX5716469,SMARCA4,523
chr1,58848823,58849310,SRX5020214,SMARCA2,487
chr1,58848827,58849403,SRX5054308,FOSL2,576
chr1,58848848,58849288,SRX5716470,SMARCA4,440
chr1,58848864,58849126,SRX5075182,SMARCA2,262
chr1,58848871,58849243,SRX5716467,SMARCA2,372
chr1,58862739,58863089,SRX5075170,SMARCA4,350
chr1,58862741,58863038,SRX5075169,SMARCA4,297
chr1,58862785,58863058,SRX5716467,SMARCA2,273
chr1,58862787,58863022,SRX5075176,SMARCA4,235
chr1,58862791,58863076,SRX5716469,SMARCA4,285
chr1,58862829,58863018,SRX5075175,SMARCA4,189
chr1,58862884,58863255,SRX5075168,SMARCA4,371
chr1,58862906,58863337,SRX5075174,SMARCA4,431
chr1,58870360,58870831,SRX5075176,SMARCA4,471
chr1,58870401,58870615,SRX5075175,SMARCA4,214
chr1,58870401,58870809,SRX5075170,SMARCA4,408
chr1,58870417,58870788,SRX5075169,SMARCA4,371
chr1,58874628,58875281,SRX5075174,SMARCA4,653
chr1,58874714,58875161,SRX5716463,SMARCA4,447
chr1,58874725,58875119,SRX5075176,SMARCA4,394
chr1,58874737,58875245,SRX5075168,SMARCA4,508
chr1,58874832,58875248,SRX5075170,SMARCA4,416
chr1,58874855,58875072,SRX5716464,SMARCA4,217
chr1,58874864,58875112,SRX5716470,SMARCA4,248
chr1,58874873,58875175,SRX5716460,Epitope tags,302
chr1,58874913,58875127,SRX5716469,SMARCA4,214
chr1,58874927,58875166,SRX5716451,SOX2,239
chr1,58874983,58875163,SRX5075169,SMARCA4,180
chr1,58883217,58883613,SRX5075176,SMARCA4,396
chr1,58883244,58883636,SRX5075169,SMARCA4,392
chr1,58883249,58883540,SRX5716470,SMARCA4,291
chr1,58883251,58883532,SRX5020211,SMARCA2,281
chr1,58883252,58883602,SRX5075170,SMARCA4,350
chr1,58883254,58883610,SRX5054309,FOSL2,356
chr1,58883262,58883593,SRX5020214,SMARCA2,331
chr1,58883299,58883646,SRX5075175,SMARCA4,347
chr1,58883302,58883623,SRX5054308,FOSL2,321
chr1,58883360,58883601,SRX5716469,SMARCA4,241
chr1,58883388,58883632,SRX5075168,SMARCA4,244
chr1,58883394,58883615,SRX5075174,SMARCA4,221
chr1,58886040,58886302,SRX5716469,SMARCA4,262
chr1,58886053,58886323,SRX5075170,SMARCA4,270
chr1,58886097,58886361,SRX5075176,SMARCA4,264
chr1,58903644,58904268,SRX20140895,INTS13,624
chr1,58903674,58903983,SRX5075168,SMARCA4,309
chr1,58903679,58903904,SRX5075169,SMARCA4,225
chr1,58903717,58904143,SRX5075170,SMARCA4,426
chr1,58903730,58904236,SRX20140867,INTS10,506
chr1,58903747,58904046,SRX5716470,SMARCA4,299
chr1,58903765,58904164,SRX20140868,INTS10,399
chr1,58903777,58904138,SRX5075176,SMARCA4,361
chr1,58903846,58904176,SRX20140897,INTS13,330
chr1,58909194,58909580,SRX5075170,SMARCA4,386
chr1,58909204,58909536,SRX5075169,SMARCA4,332
chr1,58909238,58909581,SRX5075176,SMARCA4,343
chr1,58909277,58909542,SRX5020214,SMARCA2,265
chr1,58909277,58909558,SRX5054309,FOSL2,281
chr1,58909286,58909480,SRX5054308,FOSL2,194
chr1,58909290,58909543,SRX5075175,SMARCA4,253
chr1,58912036,58912474,SRX5075174,SMARCA4,438
chr1,58912080,58912419,SRX5075168,SMARCA4,339
chr1,58912089,58912303,SRX20140867,INTS10,214
chr1,58922278,58922512,SRX5075170,SMARCA4,234
chr1,58932828,58933038,SRX5075175,SMARCA4,210
chr1,58932864,58933101,SRX5075169,SMARCA4,237
chr1,58934911,58935107,SRX5075170,SMARCA4,196
chr1,58968568,58969006,SRX5716470,SMARCA4,438
chr1,58968605,58969008,SRX5075176,SMARCA4,403
chr1,58968608,58969031,SRX5075170,SMARCA4,423
chr1,58968700,58969008,SRX5075175,SMARCA4,308
chr1,58968735,58969042,SRX5716467,SMARCA2,307
chr1,58968757,58968981,SRX5716468,SMARCA2,224
chr1,58968757,58968988,SRX5075169,SMARCA4,231
chr1,58982604,58982856,SRX5075176,SMARCA4,252
chr1,58982658,58982865,SRX5075170,SMARCA4,207
chr1,59007865,59008395,SRX5716469,SMARCA4,530
chr1,59007897,59008469,SRX5075176,SMARCA4,572
chr1,59007914,59008437,SRX5716470,SMARCA4,523
chr1,59007925,59008441,SRX5075169,SMARCA4,516
chr1,59007940,59008430,SRX5075175,SMARCA4,490
chr1,59007941,59008403,SRX5716467,SMARCA2,462
chr1,59007947,59008458,SRX5054309,FOSL2,511
chr1,59007958,59008416,SRX5075170,SMARCA4,458
chr1,59007968,59008234,SRX5716468,SMARCA2,266
chr1,59007970,59008455,SRX5054308,FOSL2,485
chr1,59007975,59008258,SRX5075181,SMARCA2,283
chr1,59007985,59008324,SRX5020211,SMARCA2,339
chr1,59008172,59008476,SRX5075174,SMARCA4,304
chr1,59008208,59008449,SRX5075168,SMARCA4,241
chr1,59013471,59013863,SRX5075174,SMARCA4,392
chr1,59013490,59014012,SRX5075168,SMARCA4,522
chr1,59013652,59013859,SRX5075176,SMARCA4,207
chr1,59013681,59013960,SRX5716463,SMARCA4,279
chr1,59015864,59016047,SRX5054309,FOSL2,183
chr1,59015867,59016068,SRX5075169,SMARCA4,201
chr1,59017619,59017814,SRX5054309,FOSL2,195
chr1,59020174,59020596,SRX5075176,SMARCA4,422
chr1,59020179,59020606,SRX5075170,SMARCA4,427
chr1,59020210,59020518,SRX5716469,SMARCA4,308
chr1,59020235,59020535,SRX5054308,FOSL2,300
chr1,59020241,59020556,SRX5075175,SMARCA4,315
chr1,59020242,59020543,SRX5075169,SMARCA4,301
chr1,59020286,59020496,SRX5054309,FOSL2,210
chr1,59025263,59025608,SRX5054309,FOSL2,345
chr1,59025278,59025534,SRX5075169,SMARCA4,256
chr1,59025291,59025489,SRX5075175,SMARCA4,198
chr1,59025294,59025622,SRX5075174,SMARCA4,328
chr1,59025298,59025501,SRX5075170,SMARCA4,203
chr1,59025301,59025576,SRX5075168,SMARCA4,275
chr1,59025312,59025522,SRX5075176,SMARCA4,210
chr1,59025902,59026168,SRX5075170,SMARCA4,266
chr1,59026554,59026723,SRX5075170,SMARCA4,169
chr1,59026639,59026929,SRX5054309,FOSL2,290
chr1,59026700,59026889,SRX5075176,SMARCA4,189
chr1,59043859,59044125,SRX5716470,SMARCA4,266
chr1,59043863,59044055,SRX5075176,SMARCA4,192
chr1,59043936,59044163,SRX5075170,SMARCA4,227
chr1,59046206,59046389,SRX5054309,FOSL2,183
chr1,59057104,59057713,SRX5075170,SMARCA4,609
chr1,59057112,59057657,SRX5075169,SMARCA4,545
chr1,59057114,59057664,SRX5716469,SMARCA4,550
chr1,59057116,59057709,SRX5075176,SMARCA4,593
chr1,59057143,59057624,SRX5075175,SMARCA4,481
chr1,59057153,59057715,SRX5716470,SMARCA4,562
chr1,59057179,59057457,SRX5075174,SMARCA4,278
chr1,59057196,59057649,SRX5716467,SMARCA2,453
chr1,59057199,59057669,SRX5716468,SMARCA2,470
chr1,59057201,59057466,SRX5020214,SMARCA2,265
chr1,59057234,59057443,SRX5054308,FOSL2,209
chr1,59057234,59057602,SRX5075181,SMARCA2,368
chr1,59057258,59057575,SRX5020211,SMARCA2,317
chr1,59057300,59057539,SRX5054309,FOSL2,239
chr1,59061979,59062206,SRX5075176,SMARCA4,227
chr1,59063589,59063876,SRX5075168,SMARCA4,287
chr1,59063695,59064032,SRX5075174,SMARCA4,337
chr1,59072277,59072538,SRX5075170,SMARCA4,261
chr1,59072289,59072587,SRX5054309,FOSL2,298
chr1,59072339,59072519,SRX5054308,FOSL2,180
chr1,59072365,59072791,SRX5075176,SMARCA4,426
chr1,59079460,59079675,SRX5054309,FOSL2,215
chr1,59079813,59080060,SRX5075176,SMARCA4,247
chr1,59083954,59084651,SRX5075168,SMARCA4,697
chr1,59083984,59084649,SRX5075170,SMARCA4,665
chr1,59084026,59084655,SRX5075176,SMARCA4,629
chr1,59084142,59084640,SRX5075174,SMARCA4,498
chr1,59084159,59084543,SRX5716470,SMARCA4,384
chr1,59084185,59084566,SRX5075169,SMARCA4,381
chr1,59084259,59084493,SRX5075175,SMARCA4,234
chr1,59113016,59113340,SRX5054308,FOSL2,324
chr1,59113039,59113354,SRX5054309,FOSL2,315
chr1,59113074,59113371,SRX5075170,SMARCA4,297
chr1,59113080,59113351,SRX5075169,SMARCA4,271
chr1,59113106,59113366,SRX5075175,SMARCA4,260
chr1,59113115,59113339,SRX5075176,SMARCA4,224
chr1,59116790,59117342,SRX5075174,SMARCA4,552
chr1,59116816,59117430,SRX5075168,SMARCA4,614
chr1,59116884,59117318,SRX5075170,SMARCA4,434
chr1,59116913,59117316,SRX5075176,SMARCA4,403
chr1,59116967,59117282,SRX5075169,SMARCA4,315
chr1,59116979,59117262,SRX5054309,FOSL2,283
chr1,59116983,59117299,SRX5075175,SMARCA4,316
chr1,59116987,59117212,SRX5054307,FOSL2,225
chr1,59117001,59117304,SRX5716463,SMARCA4,303
chr1,59117005,59117195,SRX5716451,SOX2,190
chr1,59117028,59117246,SRX5054308,FOSL2,218
chr1,59128320,59128756,SRX5054308,FOSL2,436
chr1,59128332,59128783,SRX5054309,FOSL2,451
chr1,59128346,59128672,SRX5075175,SMARCA4,326
chr1,59128409,59128607,SRX5075176,SMARCA4,198
chr1,59128423,59129106,SRX5075169,SMARCA4,683
chr1,59128681,59129129,SRX5716469,SMARCA4,448
chr1,59128687,59129268,SRX5075168,SMARCA4,581
chr1,59128689,59129305,SRX5075174,SMARCA4,616
chr1,59128695,59129135,SRX5716470,SMARCA4,440
chr1,59128744,59129208,SRX5716463,SMARCA4,464
chr1,59128761,59129082,SRX5075170,SMARCA4,321
chr1,59128771,59129046,SRX5075176,SMARCA4,275
chr1,59128793,59129078,SRX5716467,SMARCA2,285
chr1,59128822,59129147,SRX5716464,SMARCA4,325
chr1,59128824,59129108,SRX5716451,SOX2,284
chr1,59128828,59129015,SRX5075175,SMARCA4,187
chr1,59128854,59129087,SRX5020214,SMARCA2,233
chr1,59128875,59129119,SRX5716454,SOX3,244
chr1,59143064,59143523,SRX5075169,SMARCA4,459
chr1,59143070,59143497,SRX5075170,SMARCA4,427
chr1,59143082,59143523,SRX5054309,FOSL2,441
chr1,59143085,59143484,SRX5054308,FOSL2,399
chr1,59143109,59143505,SRX5075168,SMARCA4,396
chr1,59143131,59143482,SRX5075176,SMARCA4,351
chr1,59143131,59143523,SRX5716470,SMARCA4,392
chr1,59143135,59143545,SRX5075174,SMARCA4,410
chr1,59143140,59143489,SRX5075175,SMARCA4,349
chr1,59143189,59143471,SRX5716469,SMARCA4,282
chr1,59143932,59144178,SRX5075176,SMARCA4,246
chr1,59143963,59144168,SRX5075170,SMARCA4,205
chr1,59143992,59144172,SRX5075169,SMARCA4,180
chr1,59150709,59151418,SRX5075175,SMARCA4,709
chr1,59150740,59151473,SRX5075176,SMARCA4,733
chr1,59150843,59151443,SRX5716469,SMARCA4,600
chr1,59150877,59151483,SRX5075170,SMARCA4,606
chr1,59150925,59151487,SRX5075169,SMARCA4,562
chr1,59150928,59151450,SRX5054309,FOSL2,522
chr1,59150942,59151424,SRX5716470,SMARCA4,482
chr1,59150949,59151339,SRX5020211,SMARCA2,390
chr1,59150979,59151377,SRX5020214,SMARCA2,398
chr1,59150998,59151415,SRX5075174,SMARCA4,417
chr1,59150998,59151427,SRX5054308,FOSL2,429
chr1,59150999,59151389,SRX5075168,SMARCA4,390
chr1,59151055,59151391,SRX5716467,SMARCA2,336
chr1,59151069,59151300,SRX5075181,SMARCA2,231
chr1,59151096,59151391,SRX5716468,SMARCA2,295
chr1,59151103,59151346,SRX5075182,SMARCA2,243
chr1,59156721,59157185,SRX5075176,SMARCA4,464
chr1,59156783,59157207,SRX5054308,FOSL2,424
chr1,59156791,59157096,SRX5716467,SMARCA2,305
chr1,59156804,59157168,SRX5054309,FOSL2,364
chr1,59156813,59157227,SRX5075170,SMARCA4,414
chr1,59156821,59157146,SRX5716469,SMARCA4,325
chr1,59156821,59157204,SRX5075169,SMARCA4,383
chr1,59156836,59157186,SRX5075168,SMARCA4,350
chr1,59156836,59157275,SRX5075174,SMARCA4,439
chr1,59156839,59157148,SRX5075175,SMARCA4,309
chr1,59156861,59157086,SRX5020214,SMARCA2,225
chr1,59156866,59157163,SRX5075182,SMARCA2,297
chr1,59156874,59157185,SRX5716470,SMARCA4,311
chr1,59156885,59157167,SRX5020211,SMARCA2,282
chr1,59163601,59164176,SRX5075168,SMARCA4,575
chr1,59163616,59164208,SRX5075170,SMARCA4,592
chr1,59163621,59164169,SRX5716469,SMARCA4,548
chr1,59163641,59164185,SRX5075175,SMARCA4,544
chr1,59163659,59164132,SRX5075169,SMARCA4,473
chr1,59163665,59164147,SRX5075174,SMARCA4,482
chr1,59163667,59164181,SRX5075176,SMARCA4,514
chr1,59163725,59164104,SRX5054309,FOSL2,379
chr1,59163732,59164143,SRX5020211,SMARCA2,411
chr1,59163767,59164087,SRX5716468,SMARCA2,320
chr1,59163790,59164089,SRX5054308,FOSL2,299
chr1,59163801,59164156,SRX5716470,SMARCA4,355
chr1,59163804,59164047,SRX5020214,SMARCA2,243
chr1,59163805,59164032,SRX5075181,SMARCA2,227
chr1,59163831,59164208,SRX5716467,SMARCA2,377
chr1,59173774,59174059,SRX5075176,SMARCA4,285
chr1,59173782,59174021,SRX5054308,FOSL2,239
chr1,59173786,59174048,SRX5054309,FOSL2,262
chr1,59173796,59174069,SRX5075170,SMARCA4,273
chr1,59173813,59174065,SRX5075175,SMARCA4,252
chr1,59178364,59178803,SRX5716469,SMARCA4,439
chr1,59178391,59178701,SRX5054308,FOSL2,310
chr1,59178422,59178659,SRX5020211,SMARCA2,237
chr1,59178428,59178753,SRX5054309,FOSL2,325
chr1,59178438,59178697,SRX5075169,SMARCA4,259
chr1,59178438,59179064,SRX5075176,SMARCA4,626
chr1,59178442,59179079,SRX5075170,SMARCA4,637
chr1,59178450,59178878,SRX5716467,SMARCA2,428
chr1,59178458,59178936,SRX5716470,SMARCA4,478
chr1,59178469,59178810,SRX5716468,SMARCA2,341
chr1,59186619,59187054,SRX5075175,SMARCA4,435
chr1,59186626,59186894,SRX5075170,SMARCA4,268
chr1,59186656,59187000,SRX5075169,SMARCA4,344
chr1,59186705,59186927,SRX5054308,FOSL2,222
chr1,59186707,59186919,SRX5075176,SMARCA4,212
chr1,59198744,59198933,SRX5075169,SMARCA4,189
chr1,59202409,59202797,SRX5075176,SMARCA4,388
chr1,59202537,59202764,SRX5075170,SMARCA4,227
chr1,59202560,59202822,SRX5075169,SMARCA4,262
chr1,59202640,59202866,SRX5075175,SMARCA4,226
chr1,59214698,59215254,SRX5075169,SMARCA4,556
chr1,59214717,59215191,SRX5716470,SMARCA4,474
chr1,59214736,59215189,SRX5075175,SMARCA4,453
chr1,59214786,59215201,SRX5716467,SMARCA2,415
chr1,59214803,59215190,SRX5075176,SMARCA4,387
chr1,59214809,59215129,SRX5075170,SMARCA4,320
chr1,59214813,59215100,SRX5716469,SMARCA4,287
chr1,59214827,59215130,SRX5716468,SMARCA2,303
chr1,59214918,59215109,SRX5054308,FOSL2,191
chr1,59218489,59218735,SRX5075174,SMARCA4,246
chr1,59220495,59220685,SRX5075176,SMARCA4,190
chr1,59238403,59238979,SRX5075176,SMARCA4,576
chr1,59238449,59238902,SRX5075170,SMARCA4,453
chr1,59238494,59238893,SRX5075169,SMARCA4,399
chr1,59238504,59238946,SRX5716470,SMARCA4,442
chr1,59238547,59238880,SRX5716469,SMARCA4,333
chr1,59238548,59238861,SRX5075175,SMARCA4,313
chr1,59238586,59238977,SRX5054309,FOSL2,391
chr1,59238592,59238833,SRX5054308,FOSL2,241
chr1,59249786,59250129,SRX5075168,SMARCA4,343
chr1,59249846,59250025,SRX5075174,SMARCA4,179
chr1,59266462,59266748,SRX5075170,SMARCA4,286
chr1,59272523,59272903,SRX5075169,SMARCA4,380
chr1,59272543,59272780,SRX5075175,SMARCA4,237
chr1,59272624,59272852,SRX5054309,FOSL2,228
chr1,59272636,59272865,SRX5075170,SMARCA4,229
chr1,59272642,59272834,SRX5075176,SMARCA4,192
chr1,59276550,59276790,SRX5075176,SMARCA4,240
chr1,59290168,59290573,SRX16500060,CTCF,405
chr1,59290175,59290540,SRX16500059,CTCF,365
chr1,59290182,59290464,SRX16500061,CTCF,282
chr1,59290197,59290492,SRX16500062,CTCF,295
chr1,59291543,59291718,SRX5075176,SMARCA4,175
chr1,59296337,59297285,SRX20140895,INTS13,948
chr1,59296345,59297118,SRX5075174,SMARCA4,773
chr1,59296353,59297253,SRX5075168,SMARCA4,900
chr1,59296374,59296847,SRX5075175,SMARCA4,473
chr1,59296387,59296886,SRX5716470,SMARCA4,499
chr1,59296408,59296619,SRX5075176,SMARCA4,211
chr1,59296439,59297203,SRX5075170,SMARCA4,764
chr1,59296477,59296913,SRX20140880,CPSF3L,436
chr1,59296483,59297103,SRX20140868,INTS10,620
chr1,59296547,59296737,SRX5716451,SOX2,190
chr1,59296708,59297196,SRX5075176,SMARCA4,488
chr1,59296807,59297017,SRX5716464,SMARCA4,210
chr1,59298103,59298522,SRX5075176,SMARCA4,419
chr1,59298129,59298345,SRX5075170,SMARCA4,216
chr1,59316568,59317030,SRX5075175,SMARCA4,462
chr1,59316604,59317137,SRX5716470,SMARCA4,533
chr1,59316625,59317082,SRX5075176,SMARCA4,457
chr1,59316666,59317042,SRX5075169,SMARCA4,376
chr1,59316727,59317116,SRX5075170,SMARCA4,389
chr1,59316734,59317036,SRX5716467,SMARCA2,302
chr1,59316761,59317059,SRX5716469,SMARCA4,298
chr1,59317840,59318100,SRX5075176,SMARCA4,260
chr1,59317846,59318123,SRX5075175,SMARCA4,277
chr1,59317856,59318134,SRX5075169,SMARCA4,278
chr1,59317877,59318156,SRX5075170,SMARCA4,279
chr1,59322819,59323070,SRX5075168,SMARCA4,251
chr1,59322871,59323068,SRX5075174,SMARCA4,197
chr1,59327717,59328095,SRX5075168,SMARCA4,378
chr1,59327775,59328176,SRX5075174,SMARCA4,401
chr1,59333046,59333236,SRX5075169,SMARCA4,190
chr1,59359392,59359685,SRX5075168,SMARCA4,293
chr1,59359410,59359674,SRX5075174,SMARCA4,264
chr1,59360305,59360498,SRX5054309,FOSL2,193
chr1,59367622,59368085,SRX5716467,SMARCA2,463
chr1,59367640,59368123,SRX5716470,SMARCA4,483
chr1,59367668,59368128,SRX5075169,SMARCA4,460
chr1,59367687,59368152,SRX5075176,SMARCA4,465
chr1,59367697,59368125,SRX5075170,SMARCA4,428
chr1,59367708,59368163,SRX5075175,SMARCA4,455
chr1,59367738,59368086,SRX5716469,SMARCA4,348
chr1,59367780,59368056,SRX5020211,SMARCA2,276
chr1,59367786,59368079,SRX5054309,FOSL2,293
chr1,59367815,59368096,SRX5716468,SMARCA2,281
chr1,59367854,59368094,SRX5054308,FOSL2,240
chr1,59375226,59375768,SRX5075170,SMARCA4,542
chr1,59375251,59375703,SRX5075176,SMARCA4,452
chr1,59375267,59375580,SRX5020211,SMARCA2,313
chr1,59375282,59375800,SRX5075169,SMARCA4,518
chr1,59375285,59375854,SRX5716470,SMARCA4,569
chr1,59375286,59375754,SRX5716469,SMARCA4,468
chr1,59375300,59375581,SRX5020214,SMARCA2,281
chr1,59375321,59375688,SRX5054308,FOSL2,367
chr1,59375321,59375735,SRX5054309,FOSL2,414
chr1,59375335,59375776,SRX5075175,SMARCA4,441
chr1,59375355,59375770,SRX5716467,SMARCA2,415
chr1,59392898,59393503,SRX5075174,SMARCA4,605
chr1,59393054,59393387,SRX5075168,SMARCA4,333
chr1,59393060,59393754,SRX5075170,SMARCA4,694
chr1,59393125,59393782,SRX5075169,SMARCA4,657
chr1,59393139,59393863,SRX5075176,SMARCA4,724
chr1,59393198,59393754,SRX5716467,SMARCA2,556
chr1,59393238,59393477,SRX5020211,SMARCA2,239
chr1,59393261,59393869,SRX5075175,SMARCA4,608
chr1,59393310,59393967,SRX5716470,SMARCA4,657
chr1,59393379,59393857,SRX5716469,SMARCA4,478
chr1,59393398,59393625,SRX5054309,FOSL2,227
chr1,59393465,59393676,SRX5075168,SMARCA4,211
chr1,59393942,59394206,SRX5075174,SMARCA4,264
chr1,59393950,59394182,SRX5075168,SMARCA4,232
chr1,59408659,59408834,SRX5075176,SMARCA4,175
chr1,59431997,59432216,SRX5054309,FOSL2,219
chr1,59432000,59432209,SRX5054308,FOSL2,209
chr1,59433464,59433699,SRX5075170,SMARCA4,235
chr1,59433642,59433817,SRX5075176,SMARCA4,175
chr1,59446520,59446710,SRX5075175,SMARCA4,190
chr1,59446557,59446789,SRX5075169,SMARCA4,232
chr1,59446575,59446935,SRX5075176,SMARCA4,360
chr1,59446580,59447055,SRX5075168,SMARCA4,475
chr1,59446820,59446996,SRX5075174,SMARCA4,176
chr1,59455154,59455421,SRX5075176,SMARCA4,267
chr1,59455182,59455532,SRX5075174,SMARCA4,350
chr1,59455190,59455399,SRX5075168,SMARCA4,209
chr1,59455192,59455464,SRX5075169,SMARCA4,272
chr1,59455218,59455449,SRX5075170,SMARCA4,231
chr1,59455225,59455436,SRX5054309,FOSL2,211
chr1,59455241,59455443,SRX5075175,SMARCA4,202
chr1,59477331,59477668,SRX5075169,SMARCA4,337
chr1,59477398,59477644,SRX5075175,SMARCA4,246
chr1,59477445,59477660,SRX5054308,FOSL2,215
chr1,59482041,59482381,SRX5716469,SMARCA4,340
chr1,59482043,59482268,SRX5075170,SMARCA4,225
chr1,59482070,59482329,SRX5075175,SMARCA4,259
chr1,59482072,59482469,SRX5075176,SMARCA4,397
chr1,59482105,59482449,SRX5075169,SMARCA4,344
chr1,59482266,59482460,SRX5054309,FOSL2,194
chr1,59484026,59484444,SRX5075175,SMARCA4,418
chr1,59484049,59484462,SRX5075169,SMARCA4,413
chr1,59484051,59484472,SRX5075176,SMARCA4,421
chr1,59484060,59484479,SRX5075170,SMARCA4,419
chr1,59484081,59484491,SRX5054309,FOSL2,410
chr1,59484112,59484502,SRX5054308,FOSL2,390
chr1,59484116,59484421,SRX5075174,SMARCA4,305
chr1,59484147,59484424,SRX5020214,SMARCA2,277
chr1,59484159,59484383,SRX5716469,SMARCA4,224
chr1,59484159,59484452,SRX5075168,SMARCA4,293
chr1,59484169,59484370,SRX5075182,SMARCA2,201
chr1,59484207,59484488,SRX5020211,SMARCA2,281
chr1,59498752,59498997,SRX5075169,SMARCA4,245
chr1,59499898,59500079,SRX5075174,SMARCA4,181
chr1,59499967,59500208,SRX5075168,SMARCA4,241
chr1,59502342,59502670,SRX5075170,SMARCA4,328
chr1,59505557,59505984,SRX5075169,SMARCA4,427
chr1,59505585,59506036,SRX5075176,SMARCA4,451
chr1,59505599,59506049,SRX5075170,SMARCA4,450
chr1,59505669,59505927,SRX5075175,SMARCA4,258
chr1,59505669,59505972,SRX5716470,SMARCA4,303
chr1,59505670,59505961,SRX5054308,FOSL2,291
chr1,59505689,59505975,SRX5716469,SMARCA4,286
chr1,59505691,59506002,SRX5054309,FOSL2,311
chr1,59505695,59505974,SRX5020214,SMARCA2,279
chr1,59505703,59505984,SRX5020211,SMARCA2,281
chr1,59520228,59520533,SRX5075176,SMARCA4,305
chr1,59520256,59520584,SRX5075170,SMARCA4,328
chr1,59595833,59596145,SRX5075170,SMARCA4,312
chr1,59595873,59596146,SRX5716470,SMARCA4,273
chr1,59595878,59596138,SRX5075176,SMARCA4,260
chr1,59595884,59596094,SRX5075175,SMARCA4,210
chr1,59595920,59596134,SRX5075169,SMARCA4,214
chr1,59596346,59596793,SRX5075169,SMARCA4,447
chr1,59596448,59596689,SRX5075176,SMARCA4,241
chr1,59596448,59596717,SRX5054309,FOSL2,269
chr1,59596475,59596726,SRX5075174,SMARCA4,251
chr1,59596535,59596734,SRX5075175,SMARCA4,199
chr1,59604189,59604437,SRX5075174,SMARCA4,248
chr1,59635114,59635496,SRX5075170,SMARCA4,382
chr1,59635124,59635514,SRX5075176,SMARCA4,390
chr1,59635197,59635461,SRX5716470,SMARCA4,264
chr1,59638069,59638929,SRX5075176,SMARCA4,860
chr1,59638109,59638871,SRX5075170,SMARCA4,762
chr1,59638133,59638892,SRX5716470,SMARCA4,759
chr1,59638148,59638548,SRX5716467,SMARCA2,400
chr1,59638158,59638561,SRX5075168,SMARCA4,403
chr1,59638174,59638610,SRX5075174,SMARCA4,436
chr1,59638196,59638493,SRX5075181,SMARCA2,297
chr1,59638197,59638780,SRX5075169,SMARCA4,583
chr1,59638212,59638813,SRX5716469,SMARCA4,601
chr1,59638246,59638815,SRX5075175,SMARCA4,569
chr1,59638279,59638536,SRX5020211,SMARCA2,257
chr1,59645852,59646293,SRX5075176,SMARCA4,441
chr1,59645885,59646265,SRX5075175,SMARCA4,380
chr1,59645913,59646269,SRX5075169,SMARCA4,356
chr1,59645943,59646271,SRX5716470,SMARCA4,328
chr1,59645963,59646285,SRX5075170,SMARCA4,322
chr1,59658096,59658371,SRX5075176,SMARCA4,275
chr1,59669707,59670300,SRX5075175,SMARCA4,593
chr1,59669709,59670496,SRX5075174,SMARCA4,787
chr1,59669716,59670499,SRX5075168,SMARCA4,783
chr1,59669729,59670293,SRX5716469,SMARCA4,564
chr1,59669732,59670347,SRX5075176,SMARCA4,615
chr1,59669733,59670260,SRX20140867,INTS10,527
chr1,59669740,59670277,SRX5075170,SMARCA4,537
chr1,59669750,59670377,SRX5075169,SMARCA4,627
chr1,59669772,59670090,SRX5054309,FOSL2,318
chr1,59669780,59670052,SRX5054308,FOSL2,272
chr1,59669794,59670226,SRX5716470,SMARCA4,432
chr1,59669809,59670366,SRX5716463,SMARCA4,557
chr1,59669825,59670360,SRX20140895,INTS13,535
chr1,59669838,59670393,SRX5716464,SMARCA4,555
chr1,59669865,59670204,SRX5054307,FOSL2,339
chr1,59669870,59670239,SRX20140860,SOX2,369
chr1,59669895,59670188,SRX20140881,CPSF3L,293
chr1,59669909,59670334,SRX5716451,SOX2,425
chr1,59669913,59670288,SRX5716454,SOX3,375
chr1,59669963,59670212,SRX20140879,CPSF3L,249
chr1,59672905,59673160,SRX5054309,FOSL2,255
chr1,59677919,59678409,SRX5075174,SMARCA4,490
chr1,59678058,59678494,SRX5716463,SMARCA4,436
chr1,59678067,59678400,SRX5075168,SMARCA4,333
chr1,59678640,59679293,SRX5075175,SMARCA4,653
chr1,59678722,59679261,SRX5075169,SMARCA4,539
chr1,59678757,59679243,SRX5075174,SMARCA4,486
chr1,59678769,59679255,SRX5075176,SMARCA4,486
chr1,59678789,59679185,SRX5716470,SMARCA4,396
chr1,59678799,59679238,SRX5075170,SMARCA4,439
chr1,59678804,59679208,SRX5054309,FOSL2,404
chr1,59678821,59679175,SRX5716469,SMARCA4,354
chr1,59678829,59679175,SRX5716460,Epitope tags,346
chr1,59678846,59679224,SRX5075168,SMARCA4,378
chr1,59678945,59679173,SRX5054308,FOSL2,228
chr1,59691352,59691634,SRX5075170,SMARCA4,282
chr1,59691413,59691626,SRX5075176,SMARCA4,213
chr1,59692624,59692962,SRX5075169,SMARCA4,338
chr1,59692644,59692876,SRX5716467,SMARCA2,232
chr1,59692654,59692974,SRX5075176,SMARCA4,320
chr1,59692657,59692910,SRX5716470,SMARCA4,253
chr1,59692676,59692973,SRX5075175,SMARCA4,297
chr1,59692677,59692988,SRX5075170,SMARCA4,311
chr1,59698370,59698813,SRX5075168,SMARCA4,443
chr1,59698386,59698787,SRX5075174,SMARCA4,401
chr1,59698523,59698769,SRX5075170,SMARCA4,246
chr1,59699135,59699676,SRX16500059,CTCF,541
chr1,59699141,59699648,SRX16500062,CTCF,507
chr1,59699173,59699649,SRX16500060,CTCF,476
chr1,59699190,59699492,SRX5716470,SMARCA4,302
chr1,59699198,59699652,SRX16500061,CTCF,454
chr1,59699227,59699457,SRX5716469,SMARCA4,230
chr1,59699244,59699521,SRX5075176,SMARCA4,277
chr1,59699269,59699508,SRX5075168,SMARCA4,239
chr1,59699275,59699581,SRX5075174,SMARCA4,306
chr1,59699277,59699518,SRX5075175,SMARCA4,241
chr1,59699280,59699546,SRX5075169,SMARCA4,266
chr1,59699293,59699534,SRX5075170,SMARCA4,241
chr1,59699397,59699650,SRX4174629,CTCF,253
chr1,59707072,59707585,SRX5075176,SMARCA4,513
chr1,59707099,59707557,SRX5716469,SMARCA4,458
chr1,59707105,59707578,SRX5075170,SMARCA4,473
chr1,59707117,59707542,SRX5075169,SMARCA4,425
chr1,59707138,59707595,SRX5075175,SMARCA4,457
chr1,59707141,59707511,SRX5075168,SMARCA4,370
chr1,59707147,59707552,SRX5054309,FOSL2,405
chr1,59707194,59707500,SRX5020211,SMARCA2,306
chr1,59707194,59707557,SRX5075174,SMARCA4,363
chr1,59707200,59707559,SRX5054308,FOSL2,359
chr1,59707209,59707472,SRX5716467,SMARCA2,263
chr1,59707232,59707530,SRX5716470,SMARCA4,298
chr1,59707237,59707546,SRX5020214,SMARCA2,309
chr1,59718032,59718464,SRX16500060,CTCF,432
chr1,59718063,59718410,SRX16500059,CTCF,347
chr1,59718078,59718440,SRX16500061,CTCF,362
chr1,59718087,59718396,SRX16500062,CTCF,309
chr1,59725803,59726023,SRX5075174,SMARCA4,220
chr1,59725832,59726032,SRX5075168,SMARCA4,200
chr1,59730235,59730509,SRX5075169,SMARCA4,274
chr1,59730273,59730505,SRX5054308,FOSL2,232
chr1,59730273,59730535,SRX5054309,FOSL2,262
chr1,59730345,59730545,SRX5075170,SMARCA4,200
chr1,59730895,59731317,SRX5075168,SMARCA4,422
chr1,59730905,59731381,SRX5075169,SMARCA4,476
chr1,59730914,59731737,SRX5075170,SMARCA4,823
chr1,59730927,59731483,SRX5075175,SMARCA4,556
chr1,59730937,59731529,SRX5075176,SMARCA4,592
chr1,59731008,59731463,SRX5054309,FOSL2,455
chr1,59731017,59731500,SRX5054308,FOSL2,483
chr1,59731120,59731363,SRX5020211,SMARCA2,243
chr1,59731123,59731420,SRX5716469,SMARCA4,297
chr1,59731124,59731398,SRX5020214,SMARCA2,274
chr1,59731149,59731518,SRX5716470,SMARCA4,369
chr1,59738015,59738915,SRX5075169,SMARCA4,900
chr1,59738050,59738871,SRX5075170,SMARCA4,821
chr1,59738078,59738493,SRX5716467,SMARCA2,415
chr1,59738092,59738623,SRX5075176,SMARCA4,531
chr1,59738096,59738551,SRX5075175,SMARCA4,455
chr1,59738099,59738352,SRX5716468,SMARCA2,253
chr1,59738114,59739049,SRX5716469,SMARCA4,935
chr1,59738157,59738445,SRX5020211,SMARCA2,288
chr1,59738210,59738514,SRX5054308,FOSL2,304
chr1,59738301,59738523,SRX5716470,SMARCA4,222
chr1,59738354,59738537,SRX5054309,FOSL2,183
chr1,59738690,59738979,SRX5716470,SMARCA4,289
chr1,59738693,59738904,SRX5075176,SMARCA4,211
chr1,59750492,59751051,SRX5075170,SMARCA4,559
chr1,59750505,59751057,SRX5075176,SMARCA4,552
chr1,59750546,59751021,SRX5075175,SMARCA4,475
chr1,59750586,59751014,SRX5075169,SMARCA4,428
chr1,59750602,59750951,SRX5020211,SMARCA2,349
chr1,59750603,59750974,SRX5716469,SMARCA4,371
chr1,59750646,59751029,SRX5054309,FOSL2,383
chr1,59750664,59751048,SRX5054308,FOSL2,384
chr1,59750668,59750958,SRX5075174,SMARCA4,290
chr1,59750676,59750897,SRX5716467,SMARCA2,221
chr1,59750677,59751005,SRX5075168,SMARCA4,328
chr1,59750700,59750929,SRX5716470,SMARCA4,229
chr1,59759359,59759884,SRX16500060,CTCF,525
chr1,59759375,59759700,SRX20140895,INTS13,325
chr1,59759385,59759772,SRX5075169,SMARCA4,387
chr1,59759390,59759882,SRX16500061,CTCF,492
chr1,59759393,59759715,SRX5075176,SMARCA4,322
chr1,59759395,59759867,SRX16500059,CTCF,472
chr1,59759415,59759733,SRX5075170,SMARCA4,318
chr1,59759416,59759799,SRX5075168,SMARCA4,383
chr1,59759427,59759757,SRX4174629,CTCF,330
chr1,59759427,59759846,SRX16500062,CTCF,419
chr1,59759430,59759697,SRX5716469,SMARCA4,267
chr1,59759464,59759784,SRX5075174,SMARCA4,320
chr1,59759472,59759705,SRX5716463,SMARCA4,233
chr1,59759512,59759721,SRX5075175,SMARCA4,209
chr1,59767112,59767445,SRX5075170,SMARCA4,333
chr1,59767132,59767408,SRX5075176,SMARCA4,276
chr1,59777224,59777399,SRX5075170,SMARCA4,175
chr1,59777263,59777475,SRX5716469,SMARCA4,212
chr1,59777264,59777504,SRX5075169,SMARCA4,240
chr1,59879528,59879983,SRX16500059,CTCF,455
chr1,59879574,59879963,SRX16500060,CTCF,389
chr1,59879589,59879921,SRX16500062,CTCF,332
chr1,59879610,59880010,SRX16500061,CTCF,400
chr1,59879622,59879953,SRX5075168,SMARCA4,331
chr1,59879646,59879856,SRX4174629,CTCF,210
chr1,59879653,59879867,SRX5075174,SMARCA4,214
chr1,59903135,59903570,SRX16500059,CTCF,435
chr1,59903149,59903471,SRX16500061,CTCF,322
chr1,59903169,59903606,SRX16500060,CTCF,437
chr1,59903198,59903577,SRX16500062,CTCF,379
chr1,59903262,59903441,SRX5075168,SMARCA4,179
chr1,59911041,59911227,SRX5075168,SMARCA4,186
chr1,59911101,59911312,SRX5075174,SMARCA4,211
chr1,59926572,59926917,SRX5075170,SMARCA4,345
chr1,59926668,59926857,SRX5075175,SMARCA4,189
chr1,59926668,59926971,SRX5716469,SMARCA4,303
chr1,59926801,59927027,SRX5075176,SMARCA4,226
chr1,59947200,59947726,SRX16500061,CTCF,526
chr1,59947217,59947745,SRX16500059,CTCF,528
chr1,59947223,59947740,SRX16500060,CTCF,517
chr1,59947232,59947791,SRX16500062,CTCF,559
chr1,59947287,59947650,SRX5075168,SMARCA4,363
chr1,59947310,59947642,SRX4174629,CTCF,332
chr1,59947342,59947610,SRX5075174,SMARCA4,268
chr1,59947356,59947601,SRX5075175,SMARCA4,245
chr1,59947381,59947702,SRX5075170,SMARCA4,321
chr1,59967117,59967422,SRX5075176,SMARCA4,305
chr1,59967148,59967480,SRX5075170,SMARCA4,332
chr1,59967160,59967429,SRX5054309,FOSL2,269
chr1,59967166,59967408,SRX5075169,SMARCA4,242
chr1,59967233,59967418,SRX5054308,FOSL2,185
chr1,59971301,59971819,SRX16500059,CTCF,518
chr1,59971304,59971799,SRX16500060,CTCF,495
chr1,59971319,59971748,SRX16500062,CTCF,429
chr1,59971330,59971801,SRX16500061,CTCF,471
chr1,59971372,59971715,SRX5075168,SMARCA4,343
chr1,59971374,59971835,SRX4174629,CTCF,461
chr1,59971421,59971788,SRX5075174,SMARCA4,367
chr1,59971441,59971771,SRX5075170,SMARCA4,330
chr1,59971444,59971764,SRX5716463,SMARCA4,320
chr1,59971457,59971709,SRX5716469,SMARCA4,252
chr1,59971459,59971750,SRX5075169,SMARCA4,291
chr1,59971464,59971714,SRX5075175,SMARCA4,250
chr1,59971465,59971693,SRX5716464,SMARCA4,228
chr1,59971475,59971724,SRX5075176,SMARCA4,249
chr1,59971518,59971768,SRX5716470,SMARCA4,250
chr1,59976721,59977142,SRX5075168,SMARCA4,421
chr1,59976742,59977235,SRX16500061,CTCF,493
chr1,59976756,59977249,SRX16500060,CTCF,493
chr1,59976767,59977270,SRX16500059,CTCF,503
chr1,59976785,59977230,SRX16500062,CTCF,445
chr1,59976808,59977175,SRX5075176,SMARCA4,367
chr1,59976811,59977160,SRX5075170,SMARCA4,349
chr1,59976820,59977096,SRX4174629,CTCF,276
chr1,59976861,59977158,SRX5075174,SMARCA4,297
chr1,59976890,59977179,SRX5075169,SMARCA4,289
chr1,59976908,59977120,SRX5716469,SMARCA4,212
chr1,59976922,59977136,SRX5716463,SMARCA4,214
chr1,59976941,59977152,SRX5716470,SMARCA4,211
chr1,59978049,59978328,SRX5054309,FOSL2,279
chr1,59978130,59978341,SRX5054308,FOSL2,211
chr1,59986334,59986548,SRX20140867,INTS10,214
chr1,59986441,59986968,SRX5075174,SMARCA4,527
chr1,59986466,59986937,SRX5075168,SMARCA4,471
chr1,59986595,59986845,SRX5716464,SMARCA4,250
chr1,59986688,59986963,SRX5716463,SMARCA4,275
chr1,59994242,59995300,SRX5075175,SMARCA4,1058
chr1,59994243,59995351,SRX5075170,SMARCA4,1108
chr1,59994284,59995208,SRX5075169,SMARCA4,924
chr1,59994285,59995412,SRX5716470,SMARCA4,1127
chr1,59994291,59995436,SRX5075176,SMARCA4,1145
chr1,59994301,59995170,SRX5054308,FOSL2,869
chr1,59994320,59995268,SRX5716469,SMARCA4,948
chr1,59994351,59995189,SRX5054309,FOSL2,838
chr1,59994372,59995080,SRX5716467,SMARCA2,708
chr1,59994374,59995234,SRX5716468,SMARCA2,860
chr1,59994399,59994776,SRX5020214,SMARCA2,377
chr1,59994452,59994800,SRX5075181,SMARCA2,348
chr1,59994536,59994861,SRX5075182,SMARCA2,325
chr1,59994575,59995345,SRX5020211,SMARCA2,770
chr1,59994919,59995142,SRX5020214,SMARCA2,223
chr1,59998991,59999271,SRX5075174,SMARCA4,280
chr1,59999026,59999361,SRX5716463,SMARCA4,335
chr1,59999142,59999340,SRX5075168,SMARCA4,198
chr1,60010983,60011222,SRX5075176,SMARCA4,239
chr1,60011010,60011240,SRX5075170,SMARCA4,230
chr1,60031131,60031474,SRX5075176,SMARCA4,343
chr1,60068408,60069117,SRX5075169,SMARCA4,709
chr1,60068468,60069062,SRX5054309,FOSL2,594
chr1,60068481,60069169,SRX5075170,SMARCA4,688
chr1,60068499,60068718,SRX5716469,SMARCA4,219
chr1,60068517,60069045,SRX5054308,FOSL2,528
chr1,60068517,60069131,SRX5075175,SMARCA4,614
chr1,60068542,60069189,SRX5075176,SMARCA4,647
chr1,60068556,60069099,SRX5716470,SMARCA4,543
chr1,60068619,60069119,SRX5716467,SMARCA2,500
chr1,60068639,60069045,SRX5020211,SMARCA2,406
chr1,60068660,60068985,SRX5020214,SMARCA2,325
chr1,60068793,60069054,SRX5716468,SMARCA2,261
chr1,60068807,60069071,SRX5716469,SMARCA4,264
chr1,60078164,60078611,SRX5075176,SMARCA4,447
chr1,60078184,60078675,SRX5075169,SMARCA4,491
chr1,60078205,60078591,SRX5716469,SMARCA4,386
chr1,60078212,60078614,SRX5075175,SMARCA4,402
chr1,60078248,60078501,SRX5054309,FOSL2,253
chr1,60078261,60078512,SRX5020214,SMARCA2,251
chr1,60078285,60078563,SRX5054308,FOSL2,278
chr1,60078710,60078879,SRX5075170,SMARCA4,169
chr1,60088685,60088929,SRX5075170,SMARCA4,244
chr1,60088695,60088980,SRX16500061,CTCF,285
chr1,60088713,60088923,SRX5075175,SMARCA4,210
chr1,60088728,60088906,SRX5075176,SMARCA4,178
chr1,60088802,60088982,SRX5075169,SMARCA4,180
chr1,60091371,60091591,SRX5075168,SMARCA4,220
chr1,60091381,60091589,SRX5075174,SMARCA4,208
chr1,60133045,60133273,SRX5075176,SMARCA4,228
chr1,60133059,60133330,SRX5075175,SMARCA4,271
chr1,60133934,60134162,SRX5075170,SMARCA4,228
chr1,60153987,60154322,SRX5075176,SMARCA4,335
chr1,60154049,60154331,SRX5075170,SMARCA4,282
chr1,60154090,60154391,SRX5716468,SMARCA2,301
chr1,60154119,60154350,SRX5716467,SMARCA2,231
chr1,60154198,60154394,SRX5075175,SMARCA4,196
chr1,60156926,60157217,SRX16500059,CTCF,291
chr1,60156934,60157182,SRX16500060,CTCF,248
chr1,60157026,60157239,SRX4174629,CTCF,213
chr1,60171818,60172111,SRX5716470,SMARCA4,293
chr1,60171829,60172021,SRX5054309,FOSL2,192
chr1,60171862,60172121,SRX5075169,SMARCA4,259
chr1,60228322,60228513,SRX5075176,SMARCA4,191
chr1,60255633,60255839,SRX5054309,FOSL2,206
chr1,60262684,60263061,SRX5075176,SMARCA4,377
chr1,60262758,60263108,SRX5075170,SMARCA4,350
chr1,60262842,60263063,SRX5716469,SMARCA4,221
chr1,60266199,60266462,SRX5054309,FOSL2,263
chr1,60266235,60266427,SRX5054308,FOSL2,192
chr1,60279435,60279478,SRX1424894,POU3F2,43
chr1,60279436,60279476,SRX1424891,POU3F2,40
chr1,60279438,60279479,SRX1424892,POU3F2,41
chr1,60279783,60280062,SRX5054309,FOSL2,279
chr1,60281274,60281833,SRX16500060,CTCF,559
chr1,60281275,60281803,SRX16500059,CTCF,528
chr1,60281304,60281826,SRX5075176,SMARCA4,522
chr1,60281314,60281757,SRX16500062,CTCF,443
chr1,60281332,60281721,SRX5075168,SMARCA4,389
chr1,60281337,60281786,SRX5075169,SMARCA4,449
chr1,60281339,60281908,SRX5075170,SMARCA4,569
chr1,60281340,60281801,SRX5075174,SMARCA4,461
chr1,60281343,60281786,SRX16500061,CTCF,443
chr1,60281360,60281731,SRX5716470,SMARCA4,371
chr1,60281378,60281663,SRX5716463,SMARCA4,285
chr1,60281384,60281733,SRX5075175,SMARCA4,349
chr1,60281386,60281839,SRX4174629,CTCF,453
chr1,60281480,60281738,SRX5054309,FOSL2,258
chr1,60281573,60281919,SRX5054308,FOSL2,346
chr1,60359487,60359880,SRX5075176,SMARCA4,393
chr1,60364764,60364939,SRX5075176,SMARCA4,175
chr1,60364781,60365002,SRX5075170,SMARCA4,221
chr1,60376349,60376592,SRX5054309,FOSL2,243
chr1,60386152,60386448,SRX5716467,SMARCA2,296
chr1,60386161,60386440,SRX5716470,SMARCA4,279
chr1,60386169,60386512,SRX5075176,SMARCA4,343
chr1,60386184,60386503,SRX5716469,SMARCA4,319
chr1,60386198,60386498,SRX5075169,SMARCA4,300
chr1,60386225,60386508,SRX5075170,SMARCA4,283
chr1,60386227,60386508,SRX5054309,FOSL2,281
chr1,60386229,60386519,SRX5020211,SMARCA2,290
chr1,60386230,60386441,SRX5716468,SMARCA2,211
chr1,60386268,60386552,SRX5054308,FOSL2,284
chr1,60386272,60386464,SRX5075175,SMARCA4,192
chr1,60387995,60388551,SRX5075170,SMARCA4,556
chr1,60388007,60388495,SRX5075176,SMARCA4,488
chr1,60388185,60388413,SRX5716470,SMARCA4,228
chr1,60391561,60391812,SRX5075174,SMARCA4,251
chr1,60394371,60394680,SRX5054309,FOSL2,309
chr1,60394513,60394748,SRX5075169,SMARCA4,235
chr1,60402965,60403173,SRX5075176,SMARCA4,208
chr1,60413036,60413415,SRX5075169,SMARCA4,379
chr1,60413041,60413556,SRX5075176,SMARCA4,515
chr1,60413066,60413459,SRX5716470,SMARCA4,393
chr1,60413078,60413505,SRX5075175,SMARCA4,427
chr1,60413103,60413392,SRX5716467,SMARCA2,289
chr1,60413117,60413342,SRX5716469,SMARCA4,225
chr1,60413127,60413450,SRX5075170,SMARCA4,323
chr1,60413147,60413420,SRX5716468,SMARCA2,273
chr1,60422892,60423426,SRX5075170,SMARCA4,534
chr1,60422968,60423600,SRX5075176,SMARCA4,632
chr1,60422980,60423490,SRX5716470,SMARCA4,510
chr1,60423012,60423408,SRX5075175,SMARCA4,396
chr1,60423054,60423455,SRX5716469,SMARCA4,401
chr1,60423059,60423481,SRX5075169,SMARCA4,422
chr1,60423081,60423401,SRX5716468,SMARCA2,320
chr1,60423120,60423450,SRX5054309,FOSL2,330
chr1,60423153,60423396,SRX5054308,FOSL2,243
chr1,60425560,60425884,SRX16500059,CTCF,324
chr1,60436211,60436500,SRX20140867,INTS10,289
chr1,60444621,60445093,SRX5075170,SMARCA4,472
chr1,60444675,60444900,SRX5075176,SMARCA4,225
chr1,60461809,60462093,SRX5075175,SMARCA4,284
chr1,60461832,60462107,SRX5075169,SMARCA4,275
chr1,60461874,60462165,SRX5716470,SMARCA4,291
chr1,60461901,60462351,SRX5075170,SMARCA4,450
chr1,60461917,60462219,SRX5075176,SMARCA4,302
chr1,60461930,60462173,SRX5716469,SMARCA4,243
chr1,60470268,60470505,SRX5054309,FOSL2,237
chr1,60483565,60483790,SRX5075170,SMARCA4,225
chr1,60483567,60483765,SRX5075168,SMARCA4,198
chr1,60483615,60483886,SRX5075174,SMARCA4,271
chr1,60483644,60483850,SRX5075176,SMARCA4,206
chr1,60504480,60504902,SRX5075176,SMARCA4,422
chr1,60504544,60504884,SRX5075169,SMARCA4,340
chr1,60504546,60504891,SRX5075170,SMARCA4,345
chr1,60504547,60504817,SRX5075175,SMARCA4,270
chr1,60510165,60510634,SRX5075176,SMARCA4,469
chr1,60510229,60510461,SRX5075175,SMARCA4,232
chr1,60510241,60510520,SRX5075169,SMARCA4,279
chr1,60510241,60510583,SRX5075170,SMARCA4,342
chr1,60559247,60559815,SRX5075170,SMARCA4,568
chr1,60559293,60559834,SRX5075176,SMARCA4,541
chr1,60559383,60559709,SRX5075169,SMARCA4,326
chr1,60559443,60559721,SRX5075175,SMARCA4,278
chr1,60560724,60561111,SRX5075174,SMARCA4,387
chr1,60560729,60561099,SRX5716463,SMARCA4,370
chr1,60560748,60561065,SRX5075168,SMARCA4,317
chr1,60564126,60564458,SRX5075176,SMARCA4,332
chr1,60564183,60564467,SRX5075170,SMARCA4,284
chr1,60564206,60564426,SRX5716467,SMARCA2,220
chr1,60564215,60564411,SRX5075169,SMARCA4,196
chr1,60564236,60564452,SRX5716470,SMARCA4,216
chr1,60564962,60565175,SRX5075176,SMARCA4,213
chr1,60573753,60574081,SRX5075175,SMARCA4,328
chr1,60573755,60574047,SRX5054309,FOSL2,292
chr1,60573758,60574049,SRX5075174,SMARCA4,291
chr1,60573759,60574084,SRX5054308,FOSL2,325
chr1,60573764,60574036,SRX5075169,SMARCA4,272
chr1,60573798,60574072,SRX5716470,SMARCA4,274
chr1,60573803,60574098,SRX5075168,SMARCA4,295
chr1,60573805,60574056,SRX5075176,SMARCA4,251
chr1,60573824,60574035,SRX5020214,SMARCA2,211
chr1,60573839,60574044,SRX5075170,SMARCA4,205
chr1,60573843,60574104,SRX5716469,SMARCA4,261
chr1,60573905,60574105,SRX5020211,SMARCA2,200
chr1,60587543,60587726,SRX5054309,FOSL2,183
chr1,60597174,60597425,SRX5054309,FOSL2,251
chr1,60598113,60598330,SRX5075170,SMARCA4,217
chr1,60598117,60598337,SRX5075176,SMARCA4,220
chr1,60615650,60616160,SRX5075169,SMARCA4,510
chr1,60615664,60616115,SRX5716470,SMARCA4,451
chr1,60615671,60616011,SRX5716469,SMARCA4,340
chr1,60615680,60615880,SRX5075175,SMARCA4,200
chr1,60615719,60616054,SRX5716467,SMARCA2,335
chr1,60615722,60616025,SRX5054309,FOSL2,303
chr1,60615738,60615917,SRX5075176,SMARCA4,179
chr1,60615756,60615967,SRX5716468,SMARCA2,211
chr1,60615767,60616011,SRX5020214,SMARCA2,244
chr1,60615781,60616032,SRX5020211,SMARCA2,251
chr1,60620211,60620401,SRX5075170,SMARCA4,190
chr1,60621205,60621947,SRX5075170,SMARCA4,742
chr1,60621251,60621881,SRX5075176,SMARCA4,630
chr1,60621268,60621852,SRX5716470,SMARCA4,584
chr1,60621275,60621806,SRX5075169,SMARCA4,531
chr1,60621405,60622140,SRX5075174,SMARCA4,735
chr1,60621472,60622038,SRX5075168,SMARCA4,566
chr1,60621553,60621816,SRX5075175,SMARCA4,263
chr1,60621673,60621887,SRX5716463,SMARCA4,214
chr1,60664115,60664631,SRX5075170,SMARCA4,516
chr1,60664153,60664637,SRX5075176,SMARCA4,484
chr1,60666876,60667086,SRX5054309,FOSL2,210
chr1,60679394,60679757,SRX5716463,SMARCA4,363
chr1,60679438,60680358,SRX5075174,SMARCA4,920
chr1,60679481,60679809,SRX5716451,SOX2,328
chr1,60679509,60680315,SRX5075168,SMARCA4,806
chr1,60679851,60680348,SRX5716463,SMARCA4,497
chr1,60679890,60680186,SRX5716464,SMARCA4,296
chr1,60694444,60694628,SRX5054309,FOSL2,184
chr1,60697498,60697677,SRX5075170,SMARCA4,179
chr1,60697642,60697874,SRX5075176,SMARCA4,232
chr1,60697718,60697926,SRX5054309,FOSL2,208
chr1,60697736,60697958,SRX5075170,SMARCA4,222
chr1,60699310,60699709,SRX5075170,SMARCA4,399
chr1,60699331,60699762,SRX5075176,SMARCA4,431
chr1,60699349,60699637,SRX5075169,SMARCA4,288
chr1,60699390,60699619,SRX5075175,SMARCA4,229
chr1,60699469,60699682,SRX5716470,SMARCA4,213
chr1,60762170,60762459,SRX5075176,SMARCA4,289
chr1,60762191,60762462,SRX5075170,SMARCA4,271
chr1,60762251,60762478,SRX5075169,SMARCA4,227
chr1,60765191,60765471,SRX16500060,CTCF,280
chr1,60765199,60765484,SRX16500059,CTCF,285
chr1,60765276,60765583,SRX16500062,CTCF,307
chr1,60769040,60769396,SRX5075170,SMARCA4,356
chr1,60769043,60769463,SRX5075176,SMARCA4,420
chr1,60812957,60813451,SRX5075169,SMARCA4,494
chr1,60812965,60813446,SRX5716470,SMARCA4,481
chr1,60813001,60813483,SRX5075176,SMARCA4,482
chr1,60813006,60813394,SRX5075175,SMARCA4,388
chr1,60813015,60813468,SRX5075170,SMARCA4,453
chr1,60813092,60813318,SRX5716468,SMARCA2,226
chr1,60813098,60813426,SRX5020211,SMARCA2,328
chr1,60813154,60813469,SRX5054308,FOSL2,315
chr1,60813160,60813427,SRX5054309,FOSL2,267
chr1,60813167,60813430,SRX5075181,SMARCA2,263
chr1,60833248,60833503,SRX5075168,SMARCA4,255
chr1,60848529,60849041,SRX16500060,CTCF,512
chr1,60848538,60849057,SRX16500061,CTCF,519
chr1,60848552,60849046,SRX16500059,CTCF,494
chr1,60848591,60849020,SRX16500062,CTCF,429
chr1,60848645,60848939,SRX5075170,SMARCA4,294
chr1,60848654,60848923,SRX5075168,SMARCA4,269
chr1,60848674,60848953,SRX5075174,SMARCA4,279
chr1,60848711,60848960,SRX5075176,SMARCA4,249
chr1,60848720,60848937,SRX5075169,SMARCA4,217
chr1,60858421,60858709,SRX5716470,SMARCA4,288
chr1,60858428,60858739,SRX5075176,SMARCA4,311
chr1,60858435,60858697,SRX5716467,SMARCA2,262
chr1,60858436,60858705,SRX5075175,SMARCA4,269
chr1,60858438,60858774,SRX5716469,SMARCA4,336
chr1,60858439,60858713,SRX5075170,SMARCA4,274
chr1,60858454,60858749,SRX5075169,SMARCA4,295
chr1,60867890,60868063,SRX5075174,SMARCA4,173
chr1,60874771,60874992,SRX5054308,FOSL2,221
chr1,60874780,60875012,SRX5054309,FOSL2,232
chr1,60874796,60875036,SRX5075175,SMARCA4,240
chr1,60874804,60875098,SRX5075169,SMARCA4,294
chr1,60874818,60875050,SRX5075170,SMARCA4,232
chr1,60874840,60875022,SRX5075176,SMARCA4,182
chr1,60886779,60887030,SRX5075176,SMARCA4,251
chr1,60886852,60887080,SRX5075170,SMARCA4,228
chr1,60893391,60893736,SRX5075168,SMARCA4,345
chr1,60893456,60893724,SRX5075174,SMARCA4,268
chr1,60894141,60894568,SRX5075174,SMARCA4,427
chr1,60894195,60894550,SRX5075168,SMARCA4,355
chr1,60894224,60894510,SRX5716463,SMARCA4,286
chr1,60894228,60894533,SRX5075176,SMARCA4,305
chr1,60894260,60894545,SRX5075170,SMARCA4,285
chr1,60904062,60904516,SRX5075170,SMARCA4,454
chr1,60904086,60904453,SRX5716467,SMARCA2,367
chr1,60904089,60904620,SRX5075176,SMARCA4,531
chr1,60904144,60904479,SRX5075175,SMARCA4,335
chr1,60904154,60904467,SRX5075169,SMARCA4,313
chr1,60904173,60904512,SRX5716469,SMARCA4,339
chr1,60904202,60904509,SRX5716470,SMARCA4,307
chr1,60936095,60936408,SRX5075170,SMARCA4,313
chr1,60963181,60963368,SRX5075175,SMARCA4,187
chr1,60963197,60963405,SRX5075176,SMARCA4,208
chr1,60963197,60963426,SRX5075169,SMARCA4,229
chr1,60970041,60970307,SRX5075170,SMARCA4,266
chr1,60970057,60970404,SRX16500060,CTCF,347
chr1,60970079,60970456,SRX16500059,CTCF,377
chr1,60970085,60970390,SRX5075176,SMARCA4,305
chr1,60970114,60970389,SRX16500061,CTCF,275
chr1,60970120,60970456,SRX16500062,CTCF,336
chr1,60972769,60973078,SRX5054309,FOSL2,309
chr1,60972805,60973004,SRX5075169,SMARCA4,199
chr1,60972813,60973041,SRX5054308,FOSL2,228
chr1,60974640,60974881,SRX5075174,SMARCA4,241
chr1,60974701,60974885,SRX5075168,SMARCA4,184
chr1,60983960,60984268,SRX5075170,SMARCA4,308
chr1,60984396,60984812,SRX5075176,SMARCA4,416
chr1,60984445,60984876,SRX5054308,FOSL2,431
chr1,60984458,60984788,SRX5075170,SMARCA4,330
chr1,60984572,60984854,SRX5054309,FOSL2,282
chr1,60989928,60990665,SRX5075175,SMARCA4,737
chr1,60989984,60990639,SRX5075169,SMARCA4,655
chr1,60990008,60990584,SRX5716469,SMARCA4,576
chr1,60990026,60990368,SRX5054308,FOSL2,342
chr1,60990032,60990661,SRX5075170,SMARCA4,629
chr1,60990047,60990422,SRX5054309,FOSL2,375
chr1,60990052,60991110,SRX5075176,SMARCA4,1058
chr1,60990117,60990545,SRX5716467,SMARCA2,428
chr1,60990157,60990691,SRX5716470,SMARCA4,534
chr1,60990738,60991125,SRX5075170,SMARCA4,387
chr1,60990800,60991049,SRX5075168,SMARCA4,249
chr1,60990808,60991027,SRX5075174,SMARCA4,219
chr1,61006047,61006415,SRX5075174,SMARCA4,368
chr1,61006084,61006392,SRX5075168,SMARCA4,308
chr1,61042856,61043351,SRX16500061,CTCF,495
chr1,61042888,61043391,SRX16500060,CTCF,503
chr1,61042914,61043126,SRX4174629,CTCF,212
chr1,61042916,61043358,SRX16500059,CTCF,442
chr1,61042939,61043348,SRX16500062,CTCF,409
chr1,61042960,61043214,SRX5716470,SMARCA4,254
chr1,61042967,61043235,SRX5075174,SMARCA4,268
chr1,61043001,61043249,SRX5075168,SMARCA4,248
chr1,61043002,61043214,SRX5075176,SMARCA4,212
chr1,61043025,61043224,SRX5075169,SMARCA4,199
chr1,61043026,61043270,SRX5075170,SMARCA4,244
chr1,61049788,61050350,SRX16500060,CTCF,562
chr1,61049815,61050347,SRX16500061,CTCF,532
chr1,61049834,61050357,SRX16500059,CTCF,523
chr1,61049859,61050299,SRX16500062,CTCF,440
chr1,61049878,61050302,SRX5075174,SMARCA4,424
chr1,61049895,61050351,SRX5075170,SMARCA4,456
chr1,61049934,61050226,SRX4174629,CTCF,292
chr1,61049935,61050303,SRX5075176,SMARCA4,368
chr1,61049960,61050309,SRX5075168,SMARCA4,349
chr1,61049983,61050206,SRX5716463,SMARCA4,223
chr1,61050006,61050352,SRX5075169,SMARCA4,346
chr1,61050008,61050495,SRX20140895,INTS13,487
chr1,61050056,61050243,SRX5075175,SMARCA4,187
chr1,61056790,61057187,SRX5075170,SMARCA4,397
chr1,61056837,61057048,SRX5716470,SMARCA4,211
chr1,61056850,61057281,SRX5075176,SMARCA4,431
chr1,61056952,61057125,SRX5075174,SMARCA4,173
chr1,61057210,61057421,SRX5716470,SMARCA4,211
chr1,61076796,61077073,SRX5075168,SMARCA4,277
chr1,61076882,61077325,SRX5075174,SMARCA4,443
chr1,61076957,61077229,SRX20140895,INTS13,272
chr1,61076963,61077397,SRX5075170,SMARCA4,434
chr1,61076970,61077204,SRX5716463,SMARCA4,234
chr1,61077007,61077208,SRX5075175,SMARCA4,201
chr1,61077069,61077274,SRX5075176,SMARCA4,205
chr1,61079917,61080235,SRX5075170,SMARCA4,318
chr1,61079940,61080243,SRX5075176,SMARCA4,303
chr1,61079953,61080134,SRX5075169,SMARCA4,181
chr1,61093771,61093988,SRX5054309,FOSL2,217
chr1,61093800,61094008,SRX5020214,SMARCA2,208
chr1,61093863,61094063,SRX5020211,SMARCA2,200
chr1,61109233,61109516,SRX5716470,SMARCA4,283
chr1,61111447,61111921,SRX5075168,SMARCA4,474
chr1,61111462,61112022,SRX5075174,SMARCA4,560
chr1,61120419,61120610,SRX5075174,SMARCA4,191
chr1,61131727,61132058,SRX5075176,SMARCA4,331
chr1,61131745,61132024,SRX5075170,SMARCA4,279
chr1,61132715,61133014,SRX5075176,SMARCA4,299
chr1,61132800,61133048,SRX5075174,SMARCA4,248
chr1,61133068,61133288,SRX5075176,SMARCA4,220
chr1,61139477,61139768,SRX5075169,SMARCA4,291
chr1,61139491,61139709,SRX5075170,SMARCA4,218
chr1,61139515,61139750,SRX5075176,SMARCA4,235
chr1,61141378,61141845,SRX5075170,SMARCA4,467
chr1,61141422,61142009,SRX5075175,SMARCA4,587
chr1,61141432,61141873,SRX5075169,SMARCA4,441
chr1,61141438,61141956,SRX5075176,SMARCA4,518
chr1,61141483,61141803,SRX5054309,FOSL2,320
chr1,61141491,61141737,SRX5716470,SMARCA4,246
chr1,61141521,61141875,SRX5054308,FOSL2,354
chr1,61151960,61152452,SRX5075174,SMARCA4,492
chr1,61152022,61152508,SRX5716464,SMARCA4,486
chr1,61152023,61152374,SRX20140895,INTS13,351
chr1,61152042,61152380,SRX20140868,INTS10,338
chr1,61152056,61152473,SRX5716463,SMARCA4,417
chr1,61152080,61152519,SRX5075168,SMARCA4,439
chr1,61152208,61152389,SRX5075176,SMARCA4,181
chr1,61152226,61152395,SRX5075170,SMARCA4,169
chr1,61152289,61152572,SRX5716470,SMARCA4,283
chr1,61157460,61157792,SRX5716470,SMARCA4,332
chr1,61157483,61157859,SRX5716469,SMARCA4,376
chr1,61157500,61157770,SRX5020211,SMARCA2,270
chr1,61157501,61157777,SRX5716467,SMARCA2,276
chr1,61157509,61157900,SRX5075175,SMARCA4,391
chr1,61157528,61157887,SRX5075170,SMARCA4,359
chr1,61157531,61157824,SRX5075169,SMARCA4,293
chr1,61157543,61157863,SRX5075176,SMARCA4,320
chr1,61157601,61157784,SRX5054309,FOSL2,183
chr1,61158653,61159097,SRX5075176,SMARCA4,444
chr1,61158661,61158965,SRX5075169,SMARCA4,304
chr1,61158680,61159066,SRX5075170,SMARCA4,386
chr1,61158742,61158972,SRX5716468,SMARCA2,230
chr1,61158770,61159063,SRX5020211,SMARCA2,293
chr1,61163892,61164189,SRX5075170,SMARCA4,297
chr1,61163928,61164189,SRX5075176,SMARCA4,261
chr1,61172162,61172377,SRX5054309,FOSL2,215
chr1,61172162,61172392,SRX5054308,FOSL2,230
chr1,61182047,61182420,SRX5054308,FOSL2,373
chr1,61182100,61182406,SRX5075168,SMARCA4,306
chr1,61182103,61182369,SRX5054309,FOSL2,266
chr1,61182111,61182375,SRX5075176,SMARCA4,264
chr1,61182125,61182337,SRX5075175,SMARCA4,212
chr1,61182127,61182369,SRX5075174,SMARCA4,242
chr1,61182144,61182338,SRX5075170,SMARCA4,194
chr1,61182145,61182399,SRX5075169,SMARCA4,254
chr1,61184370,61184825,SRX5075170,SMARCA4,455
chr1,61184406,61184857,SRX5075176,SMARCA4,451
chr1,61184523,61184710,SRX5075169,SMARCA4,187
chr1,61220631,61220891,SRX5054308,FOSL2,260
chr1,61244079,61244518,SRX5075170,SMARCA4,439
chr1,61244087,61244579,SRX5075176,SMARCA4,492
chr1,61244096,61244538,SRX5075169,SMARCA4,442
chr1,61244109,61244411,SRX5716467,SMARCA2,302
chr1,61244118,61244444,SRX5020211,SMARCA2,326
chr1,61244124,61244488,SRX5716459,Epitope tags,364
chr1,61244129,61244520,SRX5716469,SMARCA4,391
chr1,61244133,61244526,SRX5054309,FOSL2,393
chr1,61244156,61244478,SRX5054308,FOSL2,322
chr1,61244175,61244573,SRX5716470,SMARCA4,398
chr1,61244184,61244539,SRX5075175,SMARCA4,355
chr1,61244189,61244459,SRX5716468,SMARCA2,270
chr1,61244259,61244464,SRX5075181,SMARCA2,205
chr1,61244264,61244505,SRX5020214,SMARCA2,241
chr1,61254718,61255138,SRX5716470,SMARCA4,420
chr1,61254780,61255239,SRX5075176,SMARCA4,459
chr1,61254840,61255237,SRX5075175,SMARCA4,397
chr1,61254864,61255166,SRX5020211,SMARCA2,302
chr1,61254936,61255293,SRX5075169,SMARCA4,357
chr1,61254945,61255340,SRX5075170,SMARCA4,395
chr1,61254968,61255229,SRX5716467,SMARCA2,261
chr1,61254991,61255304,SRX5716469,SMARCA4,313
chr1,61261633,61261816,SRX5075170,SMARCA4,183
chr1,61261647,61261822,SRX5075176,SMARCA4,175
chr1,61284338,61284532,SRX5075174,SMARCA4,194
chr1,61287673,61288038,SRX5716470,SMARCA4,365
chr1,61287694,61288106,SRX5075175,SMARCA4,412
chr1,61287699,61288125,SRX5075169,SMARCA4,426
chr1,61287721,61288042,SRX5716469,SMARCA4,321
chr1,61287729,61288105,SRX5075176,SMARCA4,376
chr1,61287742,61287997,SRX5020214,SMARCA2,255
chr1,61287746,61288084,SRX5716468,SMARCA2,338
chr1,61287746,61288096,SRX5075170,SMARCA4,350
chr1,61287780,61288074,SRX5054309,FOSL2,294
chr1,61287787,61288076,SRX5716467,SMARCA2,289
chr1,61287797,61287997,SRX5020211,SMARCA2,200
chr1,61287819,61288070,SRX5075182,SMARCA2,251
chr1,61287821,61288116,SRX5054308,FOSL2,295
chr1,61301113,61301287,SRX5075174,SMARCA4,174
chr1,61302162,61302499,SRX5075169,SMARCA4,337
chr1,61302283,61302481,SRX5054309,FOSL2,198
chr1,61302290,61302541,SRX5054308,FOSL2,251
chr1,61302299,61302549,SRX5075170,SMARCA4,250
chr1,61318229,61318808,SRX5716467,SMARCA2,579
chr1,61318234,61318801,SRX5075170,SMARCA4,567
chr1,61318234,61318839,SRX5075169,SMARCA4,605
chr1,61318256,61318764,SRX5716470,SMARCA4,508
chr1,61318264,61318937,SRX5075176,SMARCA4,673
chr1,61318270,61318727,SRX5020211,SMARCA2,457
chr1,61318274,61318531,SRX5075168,SMARCA4,257
chr1,61318277,61318742,SRX5075175,SMARCA4,465
chr1,61318308,61318707,SRX5716468,SMARCA2,399
chr1,61318335,61318529,SRX5075174,SMARCA4,194
chr1,61318339,61318714,SRX5716469,SMARCA4,375
chr1,61318513,61318711,SRX5075181,SMARCA2,198
chr1,61318897,61319123,SRX5054309,FOSL2,226
chr1,61319853,61320233,SRX5075174,SMARCA4,380
chr1,61319892,61320165,SRX5716463,SMARCA4,273
chr1,61319919,61320284,SRX5075168,SMARCA4,365
chr1,61319965,61320237,SRX20140895,INTS13,272
chr1,61337825,61338509,SRX5075169,SMARCA4,684
chr1,61337846,61338562,SRX5075175,SMARCA4,716
chr1,61337852,61338566,SRX5075176,SMARCA4,714
chr1,61337912,61338447,SRX5716470,SMARCA4,535
chr1,61337916,61338531,SRX5075168,SMARCA4,615
chr1,61337922,61338474,SRX5054309,FOSL2,552
chr1,61337931,61338505,SRX5075174,SMARCA4,574
chr1,61337952,61338482,SRX5075170,SMARCA4,530
chr1,61337959,61338421,SRX5020214,SMARCA2,462
chr1,61337962,61338473,SRX5716469,SMARCA4,511
chr1,61337966,61338268,SRX5020211,SMARCA2,302
chr1,61337972,61338313,SRX5054308,FOSL2,341
chr1,61338008,61338237,SRX5075181,SMARCA2,229
chr1,61338026,61338350,SRX5075182,SMARCA2,324
chr1,61338039,61338326,SRX5716467,SMARCA2,287
chr1,61338068,61338437,SRX5716460,Epitope tags,369
chr1,61338177,61338534,SRX16500062,CTCF,357
chr1,61338208,61338583,SRX16500059,CTCF,375
chr1,61338222,61338769,SRX16500060,CTCF,547
chr1,61338259,61338589,SRX16500061,CTCF,330
chr1,61344722,61344940,SRX5054308,FOSL2,218
chr1,61344775,61344975,SRX5020211,SMARCA2,200
chr1,61388624,61388932,SRX5054308,FOSL2,308
chr1,61388681,61388915,SRX5075169,SMARCA4,234
chr1,61388683,61388912,SRX5075175,SMARCA4,229
chr1,61388697,61388968,SRX5054309,FOSL2,271
chr1,61397809,61398184,SRX5054309,FOSL2,375
chr1,61397844,61398151,SRX5054308,FOSL2,307
chr1,61402957,61403145,SRX5054309,FOSL2,188
chr1,61441800,61442147,SRX5075170,SMARCA4,347
chr1,61441840,61442151,SRX5075176,SMARCA4,311
chr1,61441853,61442133,SRX5075169,SMARCA4,280
chr1,61444216,61444684,SRX5075168,SMARCA4,468
chr1,61444250,61444660,SRX5716463,SMARCA4,410
chr1,61444267,61444676,SRX5075174,SMARCA4,409
chr1,61444386,61444627,SRX5716464,SMARCA4,241
chr1,61451246,61451527,SRX5075176,SMARCA4,281
chr1,61452866,61453523,SRX5716469,SMARCA4,657
chr1,61452876,61453623,SRX5716470,SMARCA4,747
chr1,61453051,61453637,SRX5075170,SMARCA4,586
chr1,61453092,61453652,SRX5075168,SMARCA4,560
chr1,61453128,61453624,SRX5075174,SMARCA4,496
chr1,61453148,61453574,SRX5075175,SMARCA4,426
chr1,61453152,61453433,SRX5075181,SMARCA2,281
chr1,61453183,61453615,SRX5075176,SMARCA4,432
chr1,61453205,61453574,SRX5075169,SMARCA4,369
chr1,61453235,61453513,SRX5054309,FOSL2,278
chr1,61453246,61453483,SRX5716468,SMARCA2,237
chr1,61453247,61453436,SRX5054308,FOSL2,189
chr1,61453248,61453539,SRX20140895,INTS13,291
chr1,61453253,61453553,SRX5716451,SOX2,300
chr1,61453315,61453819,SRX16500060,CTCF,504
chr1,61453333,61453767,SRX16500059,CTCF,434
chr1,61453334,61453768,SRX16500061,CTCF,434
chr1,61453340,61453864,SRX16500062,CTCF,524
chr1,61453351,61453576,SRX5716463,SMARCA4,225
chr1,61453375,61453723,SRX4174629,CTCF,348
chr1,61482426,61482687,SRX5075176,SMARCA4,261
chr1,61482466,61482706,SRX5075170,SMARCA4,240
chr1,61482531,61482711,SRX5054308,FOSL2,180
chr1,61504870,61505210,SRX5054309,FOSL2,340
chr1,61504914,61505156,SRX5054308,FOSL2,242
chr1,61524152,61524562,SRX5075170,SMARCA4,410
chr1,61524274,61524638,SRX5075176,SMARCA4,364
chr1,61579768,61580188,SRX5075170,SMARCA4,420
chr1,61579811,61580103,SRX5020211,SMARCA2,292
chr1,61579826,61580175,SRX5075176,SMARCA4,349
chr1,61579858,61580203,SRX5075175,SMARCA4,345
chr1,61579913,61580093,SRX5075169,SMARCA4,180
chr1,61585867,61586047,SRX5075170,SMARCA4,180
chr1,61585883,61586138,SRX5075176,SMARCA4,255
chr1,61588567,61589079,SRX16500059,CTCF,512
chr1,61588604,61589035,SRX16500062,CTCF,431
chr1,61588608,61589059,SRX16500061,CTCF,451
chr1,61588615,61589096,SRX16500060,CTCF,481
chr1,61588656,61588963,SRX5075174,SMARCA4,307
chr1,61588678,61588987,SRX4174629,CTCF,309
chr1,61588723,61588954,SRX5075168,SMARCA4,231
chr1,61588975,61589550,SRX20140867,INTS10,575
chr1,61588984,61589714,SRX20140881,CPSF3L,730
chr1,61589073,61589426,SRX20140897,INTS13,353
chr1,61589092,61589709,SRX20140869,INTS10,617
chr1,61589154,61589462,SRX20140896,INTS13,308
chr1,61589472,61589685,SRX5075170,SMARCA4,213
chr1,61604379,61604600,SRX5054309,FOSL2,221
chr1,61616402,61616694,SRX5054309,FOSL2,292
chr1,61638088,61638726,SRX5075170,SMARCA4,638
chr1,61638090,61638721,SRX5075176,SMARCA4,631
chr1,61638167,61638602,SRX5075169,SMARCA4,435
chr1,61638170,61638680,SRX5716469,SMARCA4,510
chr1,61638193,61638515,SRX5075175,SMARCA4,322
chr1,61638197,61638616,SRX5716467,SMARCA2,419
chr1,61638214,61638630,SRX5716468,SMARCA2,416
chr1,61638255,61638639,SRX5716470,SMARCA4,384
chr1,61638257,61638639,SRX5020211,SMARCA2,382
chr1,61638265,61638501,SRX5054309,FOSL2,236
chr1,61638280,61638459,SRX5075182,SMARCA2,179
chr1,61638308,61638543,SRX5020214,SMARCA2,235
chr1,61638344,61638559,SRX5075181,SMARCA2,215
chr1,61641687,61642195,SRX16500060,CTCF,508
chr1,61641705,61641970,SRX5075168,SMARCA4,265
chr1,61641705,61641991,SRX5716464,SMARCA4,286
chr1,61641734,61642189,SRX16500061,CTCF,455
chr1,61641746,61642168,SRX16500059,CTCF,422
chr1,61641756,61642123,SRX16500062,CTCF,367
chr1,61641757,61642055,SRX5075174,SMARCA4,298
chr1,61692482,61692761,SRX5054309,FOSL2,279
chr1,61692523,61692785,SRX5075169,SMARCA4,262
chr1,61724783,61725389,SRX20140869,INTS10,606
chr1,61724807,61725414,SRX20140895,INTS13,607
chr1,61724822,61725355,SRX20140881,CPSF3L,533
chr1,61724846,61725348,SRX20140897,INTS13,502
chr1,61724866,61725323,SRX20140879,CPSF3L,457
chr1,61724867,61725360,SRX20140896,INTS13,493
chr1,61724879,61725350,SRX20140867,INTS10,471
chr1,61724881,61725203,SRX20140880,CPSF3L,322
chr1,61724884,61725384,SRX20140868,INTS10,500
chr1,61724907,61725173,SRX5716463,SMARCA4,266
chr1,61724929,61725297,SRX5716464,SMARCA4,368
chr1,61724940,61725487,SRX5075168,SMARCA4,547
chr1,61724972,61725617,SRX5075174,SMARCA4,645
chr1,61724975,61725286,SRX20140894,INTS13,311
chr1,61725109,61725498,SRX5075176,SMARCA4,389
chr1,61725123,61725698,SRX5075175,SMARCA4,575
chr1,61725183,61725431,SRX5716469,SMARCA4,248
chr1,61725235,61725461,SRX5075169,SMARCA4,226
chr1,61725244,61725668,SRX5075170,SMARCA4,424
chr1,61725417,61725633,SRX5054309,FOSL2,216
chr1,61742390,61743081,SRX20140895,INTS13,691
chr1,61742483,61742763,SRX20140869,INTS10,280
chr1,61742582,61742846,SRX5075174,SMARCA4,264
chr1,61746819,61747032,SRX5075169,SMARCA4,213
chr1,61746857,61747152,SRX5075176,SMARCA4,295
chr1,61746919,61747114,SRX5075170,SMARCA4,195
chr1,61807767,61808043,SRX5075170,SMARCA4,276
chr1,61807782,61807973,SRX5075176,SMARCA4,191
chr1,61837724,61837966,SRX5075168,SMARCA4,242
chr1,61839687,61840108,SRX5054308,FOSL2,421
chr1,61839700,61840127,SRX5054309,FOSL2,427
chr1,61839714,61840137,SRX5075175,SMARCA4,423
chr1,61839716,61840141,SRX5075169,SMARCA4,425
chr1,61839737,61840105,SRX5075176,SMARCA4,368
chr1,61839766,61840102,SRX5716469,SMARCA4,336
chr1,61839781,61840051,SRX5020214,SMARCA2,270
chr1,61839789,61840050,SRX5075170,SMARCA4,261
chr1,61839796,61840117,SRX5020211,SMARCA2,321
chr1,61839850,61840081,SRX5075182,SMARCA2,231
chr1,61839868,61840079,SRX5716470,SMARCA4,211
chr1,61842939,61843202,SRX16500059,CTCF,263
chr1,61852060,61852563,SRX16500061,CTCF,503
chr1,61852100,61852618,SRX16500060,CTCF,518
chr1,61852107,61852567,SRX16500059,CTCF,460
chr1,61852125,61852568,SRX16500062,CTCF,443
chr1,61852177,61852374,SRX5075168,SMARCA4,197
chr1,61852203,61852405,SRX5075174,SMARCA4,202
chr1,61852209,61852402,SRX5075176,SMARCA4,193
chr1,61853572,61853929,SRX5716470,SMARCA4,357
chr1,61853576,61853898,SRX5075175,SMARCA4,322
chr1,61853599,61853913,SRX5075176,SMARCA4,314
chr1,61853603,61853914,SRX5075170,SMARCA4,311
chr1,61853612,61853946,SRX5075169,SMARCA4,334
chr1,61914822,61915101,SRX5075174,SMARCA4,279
chr1,61914841,61915144,SRX5075168,SMARCA4,303
chr1,61914936,61915251,SRX20140881,CPSF3L,315
chr1,61915165,61915410,SRX5075174,SMARCA4,245
chr1,61921453,61921804,SRX16500062,CTCF,351
chr1,61921481,61921825,SRX16500061,CTCF,344
chr1,61921497,61921822,SRX16500060,CTCF,325
chr1,61950403,61950731,SRX16500062,CTCF,328
chr1,61950417,61950808,SRX16500059,CTCF,391
chr1,61950418,61950707,SRX16500060,CTCF,289
chr1,61950456,61950749,SRX16500061,CTCF,293
chr1,61951687,61951944,SRX5075168,SMARCA4,257
chr1,61951716,61951927,SRX5716470,SMARCA4,211
chr1,61951717,61952100,SRX5075174,SMARCA4,383
chr1,61951720,61951931,SRX5075169,SMARCA4,211
chr1,61951744,61952003,SRX5075170,SMARCA4,259
chr1,61952337,61952575,SRX5716470,SMARCA4,238
chr1,61980618,61980891,SRX5075170,SMARCA4,273
chr1,61980621,61980865,SRX5075176,SMARCA4,244
chr1,61980633,61980812,SRX5075168,SMARCA4,179
chr1,61992242,61992511,SRX5054308,FOSL2,269
chr1,61992306,61992516,SRX5054309,FOSL2,210
chr1,61992366,61992555,SRX5075169,SMARCA4,189
chr1,61993305,61993929,SRX5075176,SMARCA4,624
chr1,61993328,61993953,SRX5075170,SMARCA4,625
chr1,61993353,61993664,SRX5075169,SMARCA4,311
chr1,61993364,61993644,SRX5054309,FOSL2,280
chr1,61993365,61993833,SRX5716470,SMARCA4,468
chr1,61993403,61993818,SRX5075175,SMARCA4,415
chr1,61993470,61993682,SRX5716469,SMARCA4,212
chr1,61993478,61993762,SRX5716467,SMARCA2,284
chr1,62022495,62022812,SRX5075170,SMARCA4,317
chr1,62022535,62022839,SRX5075176,SMARCA4,304
chr1,62038953,62039188,SRX16500060,CTCF,235
chr1,62038958,62039222,SRX16500062,CTCF,264
chr1,62039017,62039282,SRX16500059,CTCF,265
chr1,62039038,62039259,SRX16500061,CTCF,221
chr1,62045530,62045952,SRX5075170,SMARCA4,422
chr1,62045545,62045900,SRX5054308,FOSL2,355
chr1,62045552,62046030,SRX5075176,SMARCA4,478
chr1,62045560,62045948,SRX5054309,FOSL2,388
chr1,62045719,62045936,SRX5020211,SMARCA2,217
chr1,62064757,62065289,SRX5075168,SMARCA4,532
chr1,62064772,62065269,SRX5075174,SMARCA4,497
chr1,62070337,62070872,SRX16500059,CTCF,535
chr1,62070369,62070803,SRX16500060,CTCF,434
chr1,62070373,62070858,SRX16500062,CTCF,485
chr1,62070379,62070835,SRX16500061,CTCF,456
chr1,62070466,62070650,SRX5075176,SMARCA4,184
chr1,62070535,62070708,SRX5075174,SMARCA4,173
chr1,62076292,62076666,SRX5054309,FOSL2,374
chr1,62076294,62076701,SRX5075176,SMARCA4,407
chr1,62076309,62076686,SRX5075170,SMARCA4,377
chr1,62076323,62076678,SRX5075175,SMARCA4,355
chr1,62076341,62076659,SRX5716470,SMARCA4,318
chr1,62076354,62076712,SRX5075169,SMARCA4,358
chr1,62076366,62076658,SRX5054308,FOSL2,292
chr1,62076370,62076663,SRX5716469,SMARCA4,293
chr1,62076422,62076654,SRX5020211,SMARCA2,232
chr1,62082653,62083140,SRX16500059,CTCF,487
chr1,62082661,62083252,SRX16500060,CTCF,591
chr1,62082693,62083115,SRX16500062,CTCF,422
chr1,62082698,62083205,SRX16500061,CTCF,507
chr1,62082716,62083132,SRX4174629,CTCF,416
chr1,62082747,62083130,SRX5075174,SMARCA4,383
chr1,62082768,62083012,SRX5075168,SMARCA4,244
chr1,62082812,62083017,SRX5716464,SMARCA4,205
chr1,62082838,62083091,SRX5075170,SMARCA4,253
chr1,62111174,62111385,SRX5075176,SMARCA4,211
chr1,62117181,62117721,SRX5075176,SMARCA4,540
chr1,62117189,62117711,SRX5075170,SMARCA4,522
chr1,62122244,62122577,SRX5054309,FOSL2,333
chr1,62122261,62122594,SRX5075168,SMARCA4,333
chr1,62122264,62122578,SRX5054308,FOSL2,314
chr1,62122268,62122528,SRX5716469,SMARCA4,260
chr1,62122286,62122571,SRX5075169,SMARCA4,285
chr1,62122289,62122575,SRX5075175,SMARCA4,286
chr1,62122292,62122556,SRX5054307,FOSL2,264
chr1,62122293,62122604,SRX5075170,SMARCA4,311
chr1,62122294,62122505,SRX5716470,SMARCA4,211
chr1,62122296,62122562,SRX5075174,SMARCA4,266
chr1,62122298,62122578,SRX5075176,SMARCA4,280
chr1,62131015,62131473,SRX16500060,CTCF,458
chr1,62131027,62131503,SRX16500061,CTCF,476
chr1,62131086,62131383,SRX4174629,CTCF,297
chr1,62131096,62131574,SRX16500059,CTCF,478
chr1,62131106,62131459,SRX5075174,SMARCA4,353
chr1,62131117,62131427,SRX5075168,SMARCA4,310
chr1,62131141,62131381,SRX5716464,SMARCA4,240
chr1,62131152,62131386,SRX5075175,SMARCA4,234
chr1,62131153,62131408,SRX5075176,SMARCA4,255
chr1,62131155,62131485,SRX16500062,CTCF,330
chr1,62131157,62131369,SRX5075169,SMARCA4,212
chr1,62131163,62131425,SRX5075170,SMARCA4,262
chr1,62131182,62131393,SRX5716470,SMARCA4,211
chr1,62131191,62131409,SRX5716463,SMARCA4,218
chr1,62131201,62131413,SRX5716469,SMARCA4,212
chr1,62135709,62136136,SRX16500061,CTCF,427
chr1,62135710,62136071,SRX16500060,CTCF,361
chr1,62135716,62136144,SRX16500059,CTCF,428
chr1,62135728,62136097,SRX16500062,CTCF,369
chr1,62135797,62136055,SRX5075176,SMARCA4,258
chr1,62144138,62144626,SRX16500062,CTCF,488
chr1,62144140,62144672,SRX16500059,CTCF,532
chr1,62144154,62144697,SRX16500061,CTCF,543
chr1,62144205,62144698,SRX16500060,CTCF,493
chr1,62144234,62144582,SRX5075174,SMARCA4,348
chr1,62144270,62144532,SRX5075176,SMARCA4,262
chr1,62144283,62144541,SRX5075169,SMARCA4,258
chr1,62144288,62144556,SRX5075170,SMARCA4,268
chr1,62144307,62144626,SRX5075168,SMARCA4,319
chr1,62144350,62144555,SRX5716464,SMARCA4,205
chr1,62144379,62144589,SRX4174629,CTCF,210
chr1,62150119,62150326,SRX5054309,FOSL2,207
chr1,62175402,62175980,SRX16500061,CTCF,578
chr1,62175438,62176019,SRX16500060,CTCF,581
chr1,62175521,62176050,SRX16500059,CTCF,529
chr1,62175556,62175968,SRX16500062,CTCF,412
chr1,62175638,62175957,SRX5075174,SMARCA4,319
chr1,62175655,62175882,SRX5075168,SMARCA4,227
chr1,62175681,62175953,SRX4174629,CTCF,272
chr1,62175689,62175901,SRX5075170,SMARCA4,212
chr1,62183082,62183269,SRX5075174,SMARCA4,187
chr1,62198631,62198806,SRX5075176,SMARCA4,175
chr1,62198763,62198932,SRX5075170,SMARCA4,169
chr1,62218713,62218895,SRX5054308,FOSL2,182
chr1,62230810,62231057,SRX5054309,FOSL2,247
chr1,62230843,62231106,SRX5054308,FOSL2,263
chr1,62230922,62231108,SRX5075169,SMARCA4,186
chr1,62237806,62238419,SRX5075174,SMARCA4,613
chr1,62237879,62238393,SRX5075168,SMARCA4,514
chr1,62237900,62238388,SRX5716464,SMARCA4,488
chr1,62238018,62238409,SRX5716463,SMARCA4,391
chr1,62263313,62263757,SRX5075176,SMARCA4,444
chr1,62263411,62263909,SRX5075169,SMARCA4,498
chr1,62263419,62263849,SRX5075175,SMARCA4,430
chr1,62263427,62263837,SRX5075170,SMARCA4,410
chr1,62263458,62263651,SRX5054308,FOSL2,193
chr1,62263511,62263730,SRX5716469,SMARCA4,219
chr1,62263511,62263757,SRX5716470,SMARCA4,246
chr1,62271142,62271337,SRX5075170,SMARCA4,195
chr1,62272094,62272417,SRX5075174,SMARCA4,323
chr1,62272133,62272322,SRX5075170,SMARCA4,189
chr1,62272161,62272341,SRX5075176,SMARCA4,180
chr1,62272395,62272670,SRX16500062,CTCF,275
chr1,62282233,62282477,SRX5054308,FOSL2,244
chr1,62282322,62282510,SRX5054309,FOSL2,188
chr1,62283349,62283674,SRX5075174,SMARCA4,325
chr1,62286705,62287043,SRX5716470,SMARCA4,338
chr1,62286755,62287004,SRX5075176,SMARCA4,249
chr1,62286789,62287012,SRX5075170,SMARCA4,223
chr1,62288283,62288635,SRX5075168,SMARCA4,352
chr1,62288285,62288764,SRX5075174,SMARCA4,479
chr1,62292071,62292460,SRX20140868,INTS10,389
chr1,62292123,62292456,SRX20140895,INTS13,333
chr1,62295896,62296452,SRX5075170,SMARCA4,556
chr1,62295905,62296385,SRX5075175,SMARCA4,480
chr1,62295932,62296390,SRX5716469,SMARCA4,458
chr1,62295936,62296442,SRX5075169,SMARCA4,506
chr1,62295959,62296487,SRX5075176,SMARCA4,528
chr1,62295983,62296430,SRX5716470,SMARCA4,447
chr1,62296036,62296331,SRX5020211,SMARCA2,295
chr1,62296065,62296350,SRX5716467,SMARCA2,285
chr1,62296186,62296401,SRX5716468,SMARCA2,215
chr1,62296239,62296523,SRX5075168,SMARCA4,284
chr1,62296298,62296539,SRX5716463,SMARCA4,241
chr1,62296313,62296563,SRX5075174,SMARCA4,250
chr1,62299811,62300013,SRX5075176,SMARCA4,202
chr1,62299851,62300048,SRX5075170,SMARCA4,197
chr1,62306162,62306368,SRX5054309,FOSL2,206
chr1,62308055,62308353,SRX5716470,SMARCA4,298
chr1,62308071,62308331,SRX5075176,SMARCA4,260
chr1,62308090,62308284,SRX5054309,FOSL2,194
chr1,62308106,62308343,SRX5054308,FOSL2,237
chr1,62308109,62308372,SRX5075170,SMARCA4,263
chr1,62308126,62308348,SRX5075175,SMARCA4,222
chr1,62308127,62308325,SRX5075169,SMARCA4,198
chr1,62308150,62308364,SRX5716469,SMARCA4,214
chr1,62311620,62311918,SRX5054309,FOSL2,298
chr1,62311623,62311866,SRX5054308,FOSL2,243
chr1,62319132,62319330,SRX5075174,SMARCA4,198
chr1,62319157,62319355,SRX5075175,SMARCA4,198
chr1,62319173,62319398,SRX5075168,SMARCA4,225
chr1,62319257,62319434,SRX5075176,SMARCA4,177
chr1,62321489,62321762,SRX5054309,FOSL2,273
chr1,62321517,62321716,SRX5075169,SMARCA4,199
chr1,62321546,62321786,SRX5075176,SMARCA4,240
chr1,62321577,62321781,SRX5054308,FOSL2,204
chr1,62337994,62338673,SRX5075174,SMARCA4,679
chr1,62338074,62338628,SRX5075168,SMARCA4,554
chr1,62338083,62338315,SRX5716451,SOX2,232
chr1,62338087,62338552,SRX5716463,SMARCA4,465
chr1,62338144,62338546,SRX16500060,CTCF,402
chr1,62338272,62338499,SRX16500061,CTCF,227
chr1,62338316,62338555,SRX16500059,CTCF,239
chr1,62348972,62349146,SRX5075170,SMARCA4,174
chr1,62356462,62356806,SRX5075170,SMARCA4,344
chr1,62356468,62356787,SRX5075169,SMARCA4,319
chr1,62356471,62356797,SRX5075176,SMARCA4,326
chr1,62356476,62356742,SRX5054309,FOSL2,266
chr1,62356482,62356692,SRX5054308,FOSL2,210
chr1,62356492,62356770,SRX5075175,SMARCA4,278
chr1,62358964,62359173,SRX5075174,SMARCA4,209
chr1,62359003,62359261,SRX5075168,SMARCA4,258
chr1,62362482,62362821,SRX5075170,SMARCA4,339
chr1,62362504,62362802,SRX5075176,SMARCA4,298
chr1,62364816,62365040,SRX5054309,FOSL2,224
chr1,62364819,62365064,SRX5075169,SMARCA4,245
chr1,62370205,62370388,SRX5054309,FOSL2,183
chr1,62384681,62385038,SRX5075176,SMARCA4,357
chr1,62384720,62385044,SRX5075169,SMARCA4,324
chr1,62384733,62385052,SRX5716470,SMARCA4,319
chr1,62384734,62385030,SRX5075175,SMARCA4,296
chr1,62384741,62385044,SRX5075170,SMARCA4,303
chr1,62384793,62385047,SRX5020211,SMARCA2,254
chr1,62384842,62385073,SRX5716469,SMARCA4,231
chr1,62386725,62386983,SRX5075174,SMARCA4,258
chr1,62391343,62391776,SRX16500060,CTCF,433
chr1,62391345,62391778,SRX16500062,CTCF,433
chr1,62391346,62391758,SRX16500059,CTCF,412
chr1,62391364,62391748,SRX16500061,CTCF,384
chr1,62391482,62391693,SRX5075174,SMARCA4,211
chr1,62398392,62398685,SRX5054309,FOSL2,293
chr1,62398414,62398667,SRX5075169,SMARCA4,253
chr1,62398433,62398681,SRX5054308,FOSL2,248
chr1,62400945,62401194,SRX5075175,SMARCA4,249
chr1,62400973,62401502,SRX5075174,SMARCA4,529
chr1,62400985,62401444,SRX5716464,SMARCA4,459
chr1,62400986,62401437,SRX5075170,SMARCA4,451
chr1,62401012,62401433,SRX5075168,SMARCA4,421
chr1,62401022,62401379,SRX5075176,SMARCA4,357
chr1,62401039,62401474,SRX20140867,INTS10,435
chr1,62401093,62401273,SRX5075169,SMARCA4,180
chr1,62401148,62401604,SRX5716470,SMARCA4,456
chr1,62401162,62401401,SRX5716463,SMARCA4,239
chr1,62401192,62401441,SRX20140879,CPSF3L,249
chr1,62407291,62407924,SRX16500060,CTCF,633
chr1,62407303,62407790,SRX16500062,CTCF,487
chr1,62407337,62407857,SRX16500059,CTCF,520
chr1,62407348,62407749,SRX4174629,CTCF,401
chr1,62407349,62407846,SRX16500061,CTCF,497
chr1,62407419,62407713,SRX5075176,SMARCA4,294
chr1,62407435,62407676,SRX5075174,SMARCA4,241
chr1,62407470,62407753,SRX5075168,SMARCA4,283
chr1,62417523,62417987,SRX5075169,SMARCA4,464
chr1,62417562,62417938,SRX5054309,FOSL2,376
chr1,62417596,62417814,SRX5716469,SMARCA4,218
chr1,62417619,62418004,SRX5075170,SMARCA4,385
chr1,62417654,62417972,SRX5054308,FOSL2,318
chr1,62417663,62417964,SRX5075176,SMARCA4,301
chr1,62417772,62417981,SRX5075175,SMARCA4,209
chr1,62435913,62436532,SRX20140895,INTS13,619
chr1,62435931,62436472,SRX20140869,INTS10,541
chr1,62435939,62436472,SRX20140868,INTS10,533
chr1,62435959,62436517,SRX20140879,CPSF3L,558
chr1,62435969,62436540,SRX20140897,INTS13,571
chr1,62435988,62437073,SRX20140881,CPSF3L,1085
chr1,62435999,62436516,SRX20140867,INTS10,517
chr1,62436002,62436421,SRX20140896,INTS13,419
chr1,62436011,62436608,SRX5075168,SMARCA4,597
chr1,62436013,62436452,SRX5075174,SMARCA4,439
chr1,62436028,62436421,SRX5075176,SMARCA4,393
chr1,62436066,62436371,SRX20140894,INTS13,305
chr1,62436124,62436608,SRX5075170,SMARCA4,484
chr1,62436256,62436509,SRX5716463,SMARCA4,253
chr1,62436302,62436728,SRX5054307,FOSL2,426
chr1,62436394,62436682,SRX5716451,SOX2,288
chr1,62436464,62436679,SRX5716454,SOX3,215
chr1,62436526,62436741,SRX5054308,FOSL2,215
chr1,62436594,62437008,SRX5075174,SMARCA4,414
chr1,62436675,62437017,SRX20140879,CPSF3L,342
chr1,62436684,62436946,SRX5075168,SMARCA4,262
chr1,62436786,62437207,SRX20140867,INTS10,421
chr1,62436795,62437290,SRX20140895,INTS13,495
chr1,62436884,62437261,SRX20140868,INTS10,377
chr1,62480754,62480795,SRX1424893,POU3F2,41
chr1,62480755,62480795,SRX1424891,POU3F2,40
chr1,62493743,62493958,SRX5075169,SMARCA4,215
chr1,62493803,62493986,SRX5054309,FOSL2,183
chr1,62508166,62508538,SRX16500060,CTCF,372
chr1,62508176,62508562,SRX16500061,CTCF,386
chr1,62508181,62508538,SRX16500059,CTCF,357
chr1,62508204,62508535,SRX16500062,CTCF,331
chr1,62508227,62508399,SRX5075170,SMARCA4,172
chr1,62508256,62508437,SRX5075168,SMARCA4,181
chr1,62508325,62508512,SRX5075175,SMARCA4,187
chr1,62530490,62530888,SRX16500062,CTCF,398
chr1,62530515,62530905,SRX16500059,CTCF,390
chr1,62530539,62530927,SRX16500061,CTCF,388
chr1,62530549,62530921,SRX16500060,CTCF,372
chr1,62530601,62530951,SRX4174629,CTCF,350
chr1,62622014,62622282,SRX5075174,SMARCA4,268
chr1,62622017,62622287,SRX5054309,FOSL2,270
chr1,62622096,62622299,SRX5075169,SMARCA4,203
chr1,62676759,62677240,SRX5075170,SMARCA4,481
chr1,62676798,62677283,SRX5075169,SMARCA4,485
chr1,62676808,62677279,SRX5075175,SMARCA4,471
chr1,62676831,62677225,SRX5075176,SMARCA4,394
chr1,62676957,62677276,SRX5054309,FOSL2,319
chr1,62676963,62677219,SRX5716469,SMARCA4,256
chr1,62682589,62682783,SRX5075174,SMARCA4,194
chr1,62682656,62682906,SRX5716463,SMARCA4,250
chr1,62687522,62688734,SRX20140895,INTS13,1212
chr1,62687712,62687994,SRX20140868,INTS10,282
chr1,62688113,62688699,SRX20140868,INTS10,586
chr1,62688141,62688530,SRX5075175,SMARCA4,389
chr1,62688193,62688601,SRX20140897,INTS13,408
chr1,62688200,62688709,SRX20140869,INTS10,509
chr1,62688291,62688674,SRX20140867,INTS10,383
chr1,62688401,62688627,SRX5075174,SMARCA4,226
chr1,62688420,62688590,SRX5075170,SMARCA4,170
chr1,62688489,62688697,SRX5075168,SMARCA4,208
chr1,62689531,62689728,SRX5054309,FOSL2,197
chr1,62690290,62690646,SRX5075168,SMARCA4,356
chr1,62690322,62690686,SRX5075174,SMARCA4,364
chr1,62690372,62690643,SRX5054308,FOSL2,271
chr1,62690391,62690585,SRX5075176,SMARCA4,194
chr1,62690392,62690662,SRX5075169,SMARCA4,270
chr1,62690413,62690645,SRX5054309,FOSL2,232
chr1,62690428,62690620,SRX5075170,SMARCA4,192
chr1,62720895,62721126,SRX5075176,SMARCA4,231
chr1,62720978,62721209,SRX5075168,SMARCA4,231
chr1,62721019,62721199,SRX5075169,SMARCA4,180
chr1,62725263,62725533,SRX5075170,SMARCA4,270
chr1,62725312,62725512,SRX5075174,SMARCA4,200
chr1,62735752,62736221,SRX5075176,SMARCA4,469
chr1,62735755,62735973,SRX5716470,SMARCA4,218
chr1,62735792,62736184,SRX5075170,SMARCA4,392
chr1,62735816,62736188,SRX5054309,FOSL2,372
chr1,62735843,62736148,SRX5054308,FOSL2,305
chr1,62735852,62736199,SRX5075169,SMARCA4,347
chr1,62735861,62736073,SRX5716469,SMARCA4,212
chr1,62735868,62736238,SRX5075175,SMARCA4,370
chr1,62735915,62736142,SRX5020211,SMARCA2,227
chr1,62735921,62736100,SRX5075168,SMARCA4,179
chr1,62735964,62736145,SRX5075174,SMARCA4,181
chr1,62746475,62746916,SRX16500061,CTCF,441
chr1,62746499,62746944,SRX16500059,CTCF,445
chr1,62746509,62746741,SRX5075169,SMARCA4,232
chr1,62746514,62746999,SRX16500060,CTCF,485
chr1,62746520,62746905,SRX16500062,CTCF,385
chr1,62746524,62746728,SRX5075170,SMARCA4,204
chr1,62746592,62746791,SRX5075174,SMARCA4,199
chr1,62751182,62751455,SRX5075169,SMARCA4,273
chr1,62751197,62751437,SRX5716467,SMARCA2,240
chr1,62751220,62751470,SRX5716470,SMARCA4,250
chr1,62751232,62751409,SRX5075170,SMARCA4,177
chr1,62783788,62783967,SRX5075168,SMARCA4,179
chr1,62783794,62784024,SRX5716464,SMARCA4,230
chr1,62783807,62784004,SRX5075174,SMARCA4,197
chr1,62783831,62784406,SRX20140895,INTS13,575
chr1,62783940,62784253,SRX20140897,INTS13,313
chr1,62784071,62784320,SRX5075174,SMARCA4,249
chr1,62784136,62784399,SRX5075169,SMARCA4,263
chr1,62841386,62842041,SRX16500059,CTCF,655
chr1,62841450,62841966,SRX16500061,CTCF,516
chr1,62841502,62842023,SRX16500062,CTCF,521
chr1,62841554,62842046,SRX16500060,CTCF,492
chr1,62841637,62841949,SRX5075176,SMARCA4,312
chr1,62841646,62841942,SRX5075174,SMARCA4,296
chr1,62841648,62841905,SRX5075170,SMARCA4,257
chr1,62841697,62841893,SRX5075169,SMARCA4,196
chr1,62841716,62841916,SRX5075168,SMARCA4,200
chr1,62875792,62876147,SRX5054308,FOSL2,355
chr1,62875816,62876120,SRX5075176,SMARCA4,304
chr1,62875845,62876059,SRX5075170,SMARCA4,214
chr1,62875845,62876098,SRX5075169,SMARCA4,253
chr1,62875847,62876105,SRX5054309,FOSL2,258
chr1,62882260,62882438,SRX5075174,SMARCA4,178
chr1,62882380,62882663,SRX5075168,SMARCA4,283
chr1,62906319,62906983,SRX16500062,CTCF,664
chr1,62906331,62906755,SRX16500060,CTCF,424
chr1,62906334,62906859,SRX16500061,CTCF,525
chr1,62906383,62906839,SRX16500059,CTCF,456
chr1,62912015,62912454,SRX16500060,CTCF,439
chr1,62912015,62912477,SRX16500059,CTCF,462
chr1,62912047,62912396,SRX16500061,CTCF,349
chr1,62912067,62912412,SRX16500062,CTCF,345
chr1,62912106,62912367,SRX5075174,SMARCA4,261
chr1,62962354,62962615,SRX20140881,CPSF3L,261
chr1,62963100,62963608,SRX16500060,CTCF,508
chr1,62963154,62963590,SRX16500062,CTCF,436
chr1,62963156,62963627,SRX16500059,CTCF,471
chr1,62963185,62963613,SRX16500061,CTCF,428
chr1,62963198,62963519,SRX4174629,CTCF,321
chr1,63004923,63005291,SRX16500059,CTCF,368
chr1,63004946,63005311,SRX16500060,CTCF,365
chr1,63010886,63011358,SRX5075168,SMARCA4,472
chr1,63010898,63011369,SRX5075174,SMARCA4,471
chr1,63010954,63011321,SRX5075170,SMARCA4,367
chr1,63010965,63011298,SRX5716470,SMARCA4,333
chr1,63010972,63011310,SRX5716464,SMARCA4,338
chr1,63010994,63011280,SRX5020214,SMARCA2,286
chr1,63011005,63011430,SRX5075169,SMARCA4,425
chr1,63011013,63011334,SRX5075176,SMARCA4,321
chr1,63011017,63011252,SRX5716469,SMARCA4,235
chr1,63011024,63011374,SRX5054309,FOSL2,350
chr1,63011033,63011308,SRX5716463,SMARCA4,275
chr1,63011035,63011293,SRX5075175,SMARCA4,258
chr1,63011056,63011299,SRX5054308,FOSL2,243
chr1,63074182,63074395,SRX4174629,CTCF,213
chr1,63087884,63088357,SRX16500062,CTCF,473
chr1,63087905,63088391,SRX5075174,SMARCA4,486
chr1,63087921,63088381,SRX5716463,SMARCA4,460
chr1,63087931,63088434,SRX5075168,SMARCA4,503
chr1,63087934,63088307,SRX16500061,CTCF,373
chr1,63087935,63088382,SRX16500059,CTCF,447
chr1,63087952,63088352,SRX5716464,SMARCA4,400
chr1,63087959,63088208,SRX5716451,SOX2,249
chr1,63087963,63088463,SRX16500060,CTCF,500
chr1,63088021,63088362,SRX20140895,INTS13,341
chr1,63088118,63088423,SRX20140881,CPSF3L,305
chr1,63112107,63112415,SRX5020211,SMARCA2,308
chr1,63112132,63112529,SRX5075169,SMARCA4,397
chr1,63112138,63112435,SRX5716459,Epitope tags,297
chr1,63112144,63112508,SRX5054309,FOSL2,364
chr1,63112149,63112533,SRX5716469,SMARCA4,384
chr1,63112150,63112519,SRX5075170,SMARCA4,369
chr1,63112162,63112591,SRX5075176,SMARCA4,429
chr1,63112172,63112514,SRX5716470,SMARCA4,342
chr1,63112180,63112521,SRX5054308,FOSL2,341
chr1,63112199,63112501,SRX5075175,SMARCA4,302
chr1,63112200,63112494,SRX5075174,SMARCA4,294
chr1,63112229,63112448,SRX5020214,SMARCA2,219
chr1,63112252,63112468,SRX5716467,SMARCA2,216
chr1,63112293,63112497,SRX5075168,SMARCA4,204
chr1,63124647,63125302,SRX5075169,SMARCA4,655
chr1,63124675,63125221,SRX5075174,SMARCA4,546
chr1,63124732,63125314,SRX5075170,SMARCA4,582
chr1,63124733,63125267,SRX5075175,SMARCA4,534
chr1,63124741,63125286,SRX5075176,SMARCA4,545
chr1,63124824,63125274,SRX5054309,FOSL2,450
chr1,63124827,63125247,SRX5716469,SMARCA4,420
chr1,63124840,63125198,SRX5716470,SMARCA4,358
chr1,63124841,63125173,SRX5075168,SMARCA4,332
chr1,63124856,63125259,SRX5054308,FOSL2,403
chr1,63124879,63125170,SRX5020214,SMARCA2,291
chr1,63124900,63125215,SRX5716467,SMARCA2,315
chr1,63124936,63125198,SRX5716468,SMARCA2,262
chr1,63124948,63125221,SRX5020211,SMARCA2,273
chr1,63124982,63125186,SRX5075181,SMARCA2,204
chr1,63125007,63125186,SRX5054307,FOSL2,179
chr1,63135116,63135419,SRX20140881,CPSF3L,303
chr1,63141956,63142160,SRX5075168,SMARCA4,204
chr1,63148977,63149448,SRX16500059,CTCF,471
chr1,63148993,63149417,SRX16500062,CTCF,424
chr1,63148993,63149439,SRX16500061,CTCF,446
chr1,63149014,63149474,SRX16500060,CTCF,460
chr1,63149065,63149384,SRX4174629,CTCF,319
chr1,63149099,63149354,SRX5075174,SMARCA4,255
chr1,63189847,63190126,SRX16500060,CTCF,279
chr1,63199740,63200032,SRX5075174,SMARCA4,292
chr1,63199808,63199998,SRX5716451,SOX2,190
chr1,63199816,63199995,SRX5075168,SMARCA4,179
chr1,63316853,63317287,SRX16500059,CTCF,434
chr1,63316892,63317349,SRX16500061,CTCF,457
chr1,63316937,63317309,SRX16500062,CTCF,372
chr1,63316955,63317307,SRX16500060,CTCF,352
chr1,63322292,63322809,SRX20140895,INTS13,517
chr1,63322361,63322592,SRX5075174,SMARCA4,231
chr1,63327458,63327996,SRX16500060,CTCF,538
chr1,63327476,63327981,SRX16500062,CTCF,505
chr1,63327484,63327992,SRX16500059,CTCF,508
chr1,63327490,63327988,SRX16500061,CTCF,498
chr1,63327649,63327975,SRX4174629,CTCF,326
chr1,63327676,63327857,SRX5075174,SMARCA4,181
chr1,63367260,63367897,SRX5075168,SMARCA4,637
chr1,63367278,63367820,SRX5075170,SMARCA4,542
chr1,63367286,63367716,SRX5716470,SMARCA4,430
chr1,63367295,63367770,SRX5075176,SMARCA4,475
chr1,63367311,63367987,SRX20140895,INTS13,676
chr1,63367319,63367945,SRX5075174,SMARCA4,626
chr1,63367342,63367661,SRX5075169,SMARCA4,319
chr1,63367372,63367589,SRX5075175,SMARCA4,217
chr1,63367403,63367843,SRX5716469,SMARCA4,440
chr1,63367420,63367999,SRX20140868,INTS10,579
chr1,63367421,63367721,SRX5716464,SMARCA4,300
chr1,63367459,63367817,SRX5716463,SMARCA4,358
chr1,63367502,63367956,SRX20140867,INTS10,454
chr1,63367519,63367764,SRX20140880,CPSF3L,245
chr1,63367627,63367979,SRX20140879,CPSF3L,352
chr1,63411013,63411440,SRX5075176,SMARCA4,427
chr1,63411065,63411417,SRX5075170,SMARCA4,352
chr1,63411089,63411352,SRX5716467,SMARCA2,263
chr1,63411109,63411403,SRX5716468,SMARCA2,294
chr1,63411114,63411388,SRX5716470,SMARCA4,274
chr1,63411154,63411423,SRX5075169,SMARCA4,269
chr1,63411197,63411402,SRX5075175,SMARCA4,205
chr1,63414965,63415320,SRX5075170,SMARCA4,355
chr1,63441538,63442066,SRX16500059,CTCF,528
chr1,63441553,63442071,SRX16500061,CTCF,518
chr1,63441562,63441999,SRX16500062,CTCF,437
chr1,63441575,63442062,SRX16500060,CTCF,487
chr1,63441609,63441917,SRX5075168,SMARCA4,308
chr1,63441631,63441884,SRX5075169,SMARCA4,253
chr1,63441654,63441959,SRX5075174,SMARCA4,305
chr1,63441656,63441930,SRX5075170,SMARCA4,274
chr1,63441662,63441870,SRX5075176,SMARCA4,208
chr1,63441672,63441935,SRX5075175,SMARCA4,263
chr1,63441741,63441951,SRX4174629,CTCF,210
chr1,63448787,63449024,SRX5075169,SMARCA4,237
chr1,63448816,63449044,SRX5054309,FOSL2,228
chr1,63448821,63448996,SRX5075176,SMARCA4,175
chr1,63448843,63449043,SRX5054308,FOSL2,200
chr1,63448853,63449064,SRX5075170,SMARCA4,211
chr1,63454348,63454563,SRX5075170,SMARCA4,215
chr1,63523012,63523701,SRX5075174,SMARCA4,689
chr1,63523053,63523736,SRX5075168,SMARCA4,683
chr1,63523120,63523655,SRX20140895,INTS13,535
chr1,63523148,63523510,SRX20140869,INTS10,362
chr1,63523153,63523486,SRX20140867,INTS10,333
chr1,63523225,63523496,SRX20140868,INTS10,271
chr1,63523299,63523519,SRX5716470,SMARCA4,220
chr1,63523354,63523759,SRX5075170,SMARCA4,405
chr1,63537883,63538353,SRX16500062,CTCF,470
chr1,63537948,63538399,SRX16500060,CTCF,451
chr1,63537950,63538394,SRX16500059,CTCF,444
chr1,63537966,63538314,SRX16500061,CTCF,348
chr1,63557281,63557799,SRX16500060,CTCF,518
chr1,63557353,63557755,SRX16500059,CTCF,402
chr1,63557432,63557718,SRX16500061,CTCF,286
chr1,63557452,63557662,SRX4174629,CTCF,210
chr1,63557466,63557750,SRX16500062,CTCF,284
chr1,63557469,63557685,SRX5075176,SMARCA4,216
chr1,63557470,63557713,SRX5075170,SMARCA4,243
chr1,63557499,63557744,SRX5075168,SMARCA4,245
chr1,63557531,63557735,SRX5716463,SMARCA4,204
chr1,63575144,63575729,SRX16500060,CTCF,585
chr1,63575174,63575815,SRX16500059,CTCF,641
chr1,63575208,63575691,SRX16500062,CTCF,483
chr1,63575216,63575677,SRX16500061,CTCF,461
chr1,63593265,63593434,SRX5075170,SMARCA4,169
chr1,63593400,63593858,SRX20140868,INTS10,458
chr1,63593410,63594074,SRX20140895,INTS13,664
chr1,63593499,63593839,SRX5716470,SMARCA4,340
chr1,63593545,63593882,SRX5075174,SMARCA4,337
chr1,63593561,63593891,SRX5075176,SMARCA4,330
chr1,63593619,63593861,SRX5075169,SMARCA4,242
chr1,63593637,63593929,SRX5075168,SMARCA4,292
chr1,63593643,63593987,SRX5075170,SMARCA4,344
chr1,63593698,63593933,SRX5075175,SMARCA4,235
chr1,63611383,63611595,SRX5075168,SMARCA4,212
chr1,63615780,63616269,SRX16500060,CTCF,489
chr1,63615790,63616270,SRX16500061,CTCF,480
chr1,63615809,63616371,SRX16500059,CTCF,562
chr1,63615813,63616261,SRX16500062,CTCF,448
chr1,63615825,63616125,SRX4174629,CTCF,300
chr1,63615902,63616095,SRX5075174,SMARCA4,193
chr1,63615947,63616184,SRX5075170,SMARCA4,237
chr1,63623981,63624236,SRX5075168,SMARCA4,255
chr1,63623999,63624421,SRX20140895,INTS13,422
chr1,63624011,63624278,SRX5075174,SMARCA4,267
chr1,63624030,63624262,SRX5716451,SOX2,232
chr1,63635673,63636058,SRX5075176,SMARCA4,385
chr1,63635691,63636009,SRX5716470,SMARCA4,318
chr1,63635709,63636059,SRX5075170,SMARCA4,350
chr1,63635773,63636008,SRX5716469,SMARCA4,235
chr1,63635781,63636013,SRX5075175,SMARCA4,232
chr1,63635797,63635977,SRX5075169,SMARCA4,180
chr1,63645299,63645698,SRX5075170,SMARCA4,399
chr1,63645307,63645677,SRX5075176,SMARCA4,370
chr1,63645318,63645591,SRX5075175,SMARCA4,273
chr1,63645379,63645592,SRX5716469,SMARCA4,213
chr1,63645404,63645615,SRX5716468,SMARCA2,211
chr1,63645406,63645606,SRX5020211,SMARCA2,200
chr1,63650993,63651458,SRX5075176,SMARCA4,465
chr1,63651024,63651401,SRX5075170,SMARCA4,377
chr1,63651073,63651285,SRX5075169,SMARCA4,212
chr1,63651166,63651386,SRX5054308,FOSL2,220
chr1,63651208,63651391,SRX5054309,FOSL2,183
chr1,63661964,63662400,SRX5075175,SMARCA4,436
chr1,63661976,63662491,SRX5075169,SMARCA4,515
chr1,63662001,63662700,SRX5075176,SMARCA4,699
chr1,63662132,63662673,SRX5075170,SMARCA4,541
chr1,63662134,63662508,SRX5716470,SMARCA4,374
chr1,63662231,63662498,SRX5054309,FOSL2,267
chr1,63662260,63662535,SRX5054308,FOSL2,275
chr1,63662917,63663096,SRX5075168,SMARCA4,179
chr1,63662927,63663103,SRX5075174,SMARCA4,176
chr1,63674341,63674746,SRX5075175,SMARCA4,405
chr1,63674341,63674747,SRX5054308,FOSL2,406
chr1,63674343,63674748,SRX5020211,SMARCA2,405
chr1,63674346,63674659,SRX5075182,SMARCA2,313
chr1,63674349,63674740,SRX5054309,FOSL2,391
chr1,63674351,63674850,SRX5075170,SMARCA4,499
chr1,63674362,63674806,SRX5716470,SMARCA4,444
chr1,63674363,63674766,SRX5075169,SMARCA4,403
chr1,63674363,63674816,SRX16500060,CTCF,453
chr1,63674365,63674769,SRX5716469,SMARCA4,404
chr1,63674366,63674846,SRX16500059,CTCF,480
chr1,63674378,63674832,SRX5075176,SMARCA4,454
chr1,63674384,63674787,SRX16500061,CTCF,403
chr1,63674391,63674777,SRX5075174,SMARCA4,386
chr1,63674396,63674779,SRX16500062,CTCF,383
chr1,63674434,63674767,SRX5075168,SMARCA4,333
chr1,63674453,63674705,SRX5716463,SMARCA4,252
chr1,63674455,63674763,SRX4174629,CTCF,308
chr1,63674460,63674710,SRX5020214,SMARCA2,250
chr1,63674472,63674715,SRX5716464,SMARCA4,243
chr1,63674476,63674691,SRX5716467,SMARCA2,215
chr1,63674477,63674668,SRX5054307,FOSL2,191
chr1,63675656,63675957,SRX5075170,SMARCA4,301
chr1,63675662,63675928,SRX5075176,SMARCA4,266
chr1,63688433,63688645,SRX5054309,FOSL2,212
chr1,63691812,63692337,SRX16500060,CTCF,525
chr1,63691832,63692305,SRX16500061,CTCF,473
chr1,63691835,63692351,SRX16500059,CTCF,516
chr1,63691871,63692272,SRX4174629,CTCF,401
chr1,63691883,63692373,SRX16500062,CTCF,490
chr1,63691944,63692235,SRX5075168,SMARCA4,291
chr1,63691947,63692288,SRX5075174,SMARCA4,341
chr1,63692002,63692230,SRX5075169,SMARCA4,228
chr1,63692004,63692360,SRX5075170,SMARCA4,356
chr1,63692022,63692342,SRX5075176,SMARCA4,320
chr1,63692043,63692362,SRX5716470,SMARCA4,319
chr1,63692075,63692302,SRX5075175,SMARCA4,227
chr1,63711017,63711338,SRX5075170,SMARCA4,321
chr1,63711055,63711351,SRX5075176,SMARCA4,296
chr1,63714176,63714603,SRX5075176,SMARCA4,427
chr1,63714206,63714548,SRX5054308,FOSL2,342
chr1,63714218,63714546,SRX5075175,SMARCA4,328
chr1,63714232,63714570,SRX5075169,SMARCA4,338
chr1,63714233,63714557,SRX5054309,FOSL2,324
chr1,63714258,63714531,SRX5716469,SMARCA4,273
chr1,63714286,63714570,SRX5075170,SMARCA4,284
chr1,63721620,63721814,SRX5054309,FOSL2,194
chr1,63731502,63732043,SRX5075175,SMARCA4,541
chr1,63731543,63732032,SRX5075176,SMARCA4,489
chr1,63731552,63731964,SRX5716469,SMARCA4,412
chr1,63731560,63732048,SRX5075169,SMARCA4,488
chr1,63731575,63732027,SRX5716470,SMARCA4,452
chr1,63731577,63731927,SRX5054309,FOSL2,350
chr1,63731609,63731939,SRX5054308,FOSL2,330
chr1,63731619,63732028,SRX5075170,SMARCA4,409
chr1,63731680,63732010,SRX5020211,SMARCA2,330
chr1,63746061,63746556,SRX5075168,SMARCA4,495
chr1,63746107,63746624,SRX5716470,SMARCA4,517
chr1,63746108,63746360,SRX5716467,SMARCA2,252
chr1,63746109,63746855,SRX5075170,SMARCA4,746
chr1,63746127,63746871,SRX5075175,SMARCA4,744
chr1,63746154,63746842,SRX5075176,SMARCA4,688
chr1,63746160,63746712,SRX5054309,FOSL2,552
chr1,63746160,63746713,SRX5075174,SMARCA4,553
chr1,63746170,63746806,SRX5075169,SMARCA4,636
chr1,63746209,63746734,SRX5054308,FOSL2,525
chr1,63746225,63746675,SRX5716469,SMARCA4,450
chr1,63746241,63746586,SRX5020214,SMARCA2,345
chr1,63773719,63774154,SRX16500059,CTCF,435
chr1,63773733,63774100,SRX16500062,CTCF,367
chr1,63773735,63774028,SRX5075174,SMARCA4,293
chr1,63773738,63774142,SRX16500061,CTCF,404
chr1,63773752,63773956,SRX5716463,SMARCA4,204
chr1,63773752,63773974,SRX4174629,CTCF,222
chr1,63773754,63774257,SRX16500060,CTCF,503
chr1,63773755,63774058,SRX5075170,SMARCA4,303
chr1,63773799,63774078,SRX5075168,SMARCA4,279
chr1,63773822,63774045,SRX5075176,SMARCA4,223
chr1,63773860,63774400,SRX20140895,INTS13,540
chr1,63774985,63775162,SRX5075176,SMARCA4,177
chr1,63775066,63775319,SRX5075174,SMARCA4,253
chr1,63794914,63795345,SRX5075169,SMARCA4,431
chr1,63794962,63795348,SRX5075175,SMARCA4,386
chr1,63794983,63795433,SRX5075170,SMARCA4,450
chr1,63794989,63795387,SRX5716469,SMARCA4,398
chr1,63795003,63795378,SRX5716470,SMARCA4,375
chr1,63795004,63795349,SRX5075176,SMARCA4,345
chr1,63795016,63795331,SRX5716467,SMARCA2,315
chr1,63795027,63795343,SRX5716468,SMARCA2,316
chr1,63795028,63795310,SRX5054308,FOSL2,282
chr1,63795034,63795386,SRX5054309,FOSL2,352
chr1,63795051,63795258,SRX5020214,SMARCA2,207
chr1,63811127,63811391,SRX5075176,SMARCA4,264
chr1,63813792,63814031,SRX5054309,FOSL2,239
chr1,63813844,63814092,SRX5054308,FOSL2,248
chr1,63813883,63814214,SRX5075176,SMARCA4,331
chr1,63813900,63814094,SRX5075175,SMARCA4,194
chr1,63814046,63814225,SRX5075170,SMARCA4,179
chr1,63817057,63817277,SRX5075169,SMARCA4,220
chr1,63824520,63824731,SRX5054309,FOSL2,211
chr1,63826525,63826851,SRX5054309,FOSL2,326
chr1,63848682,63849097,SRX5020211,SMARCA2,415
chr1,63848713,63849106,SRX5075169,SMARCA4,393
chr1,63848715,63849118,SRX5075175,SMARCA4,403
chr1,63848732,63849151,SRX5716470,SMARCA4,419
chr1,63848746,63849047,SRX5075181,SMARCA2,301
chr1,63848746,63849058,SRX5075170,SMARCA4,312
chr1,63848749,63849126,SRX5075174,SMARCA4,377
chr1,63848756,63849108,SRX5054309,FOSL2,352
chr1,63848775,63849103,SRX5075176,SMARCA4,328
chr1,63848775,63849143,SRX5716468,SMARCA2,368
chr1,63848780,63849032,SRX5716469,SMARCA4,252
chr1,63848789,63849151,SRX5020214,SMARCA2,362
chr1,63848806,63849142,SRX5075168,SMARCA4,336
chr1,63848807,63849095,SRX5716467,SMARCA2,288
chr1,63848873,63849110,SRX5054308,FOSL2,237
chr1,63866065,63866436,SRX5075170,SMARCA4,371
chr1,63866119,63866466,SRX5075176,SMARCA4,347
chr1,63866223,63866434,SRX5075169,SMARCA4,211
chr1,63866273,63866495,SRX5075181,SMARCA2,222
chr1,63873807,63873993,SRX5075169,SMARCA4,186
chr1,63874327,63874615,SRX5054308,FOSL2,288
chr1,63874497,63874771,SRX5075176,SMARCA4,274
chr1,63893204,63893383,SRX5075168,SMARCA4,179
chr1,63906349,63906774,SRX5075176,SMARCA4,425
chr1,63906354,63906610,SRX5075174,SMARCA4,256
chr1,63906375,63906784,SRX5075170,SMARCA4,409
chr1,63906383,63906625,SRX20140879,CPSF3L,242
chr1,63906452,63906685,SRX5075169,SMARCA4,233
chr1,63909611,63909858,SRX5075170,SMARCA4,247
chr1,63915159,63915384,SRX16500060,CTCF,225
chr1,63920457,63920966,SRX5054309,FOSL2,509
chr1,63920477,63920931,SRX5716468,SMARCA2,454
chr1,63920505,63920922,SRX5075175,SMARCA4,417
chr1,63920508,63920952,SRX5716467,SMARCA2,444
chr1,63920511,63920808,SRX5020211,SMARCA2,297
chr1,63920522,63920922,SRX5075169,SMARCA4,400
chr1,63920523,63920951,SRX5075182,SMARCA2,428
chr1,63920532,63920965,SRX5716470,SMARCA4,433
chr1,63920537,63920889,SRX5020214,SMARCA2,352
chr1,63920544,63920978,SRX5075181,SMARCA2,434
chr1,63920571,63920850,SRX5075176,SMARCA4,279
chr1,63920586,63920977,SRX5075170,SMARCA4,391
chr1,63920607,63920950,SRX5716469,SMARCA4,343
chr1,63936341,63936611,SRX5054309,FOSL2,270
chr1,63947021,63947504,SRX5716470,SMARCA4,483
chr1,63947129,63947547,SRX5075176,SMARCA4,418
chr1,63947182,63947520,SRX5075169,SMARCA4,338
chr1,63947201,63947515,SRX5075175,SMARCA4,314
chr1,63947236,63947537,SRX5716468,SMARCA2,301
chr1,63967971,63968168,SRX5075176,SMARCA4,197
chr1,63967987,63968156,SRX5075170,SMARCA4,169
chr1,63984321,63984539,SRX5716470,SMARCA4,218
chr1,63987016,63987364,SRX5054309,FOSL2,348
chr1,63987057,63987341,SRX5054308,FOSL2,284
chr1,63987112,63987335,SRX5075175,SMARCA4,223
chr1,63987159,63987340,SRX5075169,SMARCA4,181
chr1,63999989,64000328,SRX5054309,FOSL2,339
chr1,63999995,64000436,SRX5075176,SMARCA4,441
chr1,64000010,64000214,SRX5020211,SMARCA2,204
chr1,64000037,64000412,SRX5075170,SMARCA4,375
chr1,64000052,64000281,SRX5054308,FOSL2,229
chr1,64000060,64000297,SRX5075175,SMARCA4,237
chr1,64000069,64000320,SRX5075169,SMARCA4,251
chr1,64000097,64000481,SRX5716469,SMARCA4,384
chr1,64019897,64020152,SRX5716470,SMARCA4,255
chr1,64019923,64020098,SRX5075176,SMARCA4,175
chr1,64031304,64031602,SRX5054309,FOSL2,298
chr1,64031309,64031541,SRX5075175,SMARCA4,232
chr1,64031311,64031574,SRX5075176,SMARCA4,263
chr1,64039467,64039951,SRX5075169,SMARCA4,484
chr1,64039505,64039908,SRX5075170,SMARCA4,403
chr1,64039532,64039930,SRX5075176,SMARCA4,398
chr1,64039541,64039897,SRX5075175,SMARCA4,356
chr1,64039541,64039962,SRX5054309,FOSL2,421
chr1,64039545,64039868,SRX5716467,SMARCA2,323
chr1,64039553,64039860,SRX5716470,SMARCA4,307
chr1,64039589,64039906,SRX5716469,SMARCA4,317
chr1,64039590,64039875,SRX5020214,SMARCA2,285
chr1,64039598,64039874,SRX5054308,FOSL2,276
chr1,64039603,64039848,SRX5020211,SMARCA2,245
chr1,64042599,64043013,SRX5054309,FOSL2,414
chr1,64042650,64043031,SRX5075169,SMARCA4,381
chr1,64042659,64042956,SRX5054308,FOSL2,297
chr1,64042662,64043024,SRX5075170,SMARCA4,362
chr1,64042681,64042987,SRX5075176,SMARCA4,306
chr1,64042740,64043021,SRX5075175,SMARCA4,281
chr1,64042753,64042974,SRX5716470,SMARCA4,221
chr1,64042877,64043126,SRX5075168,SMARCA4,249
chr1,64063309,64063489,SRX5075169,SMARCA4,180
chr1,64073772,64074000,SRX5075176,SMARCA4,228
chr1,64073788,64073958,SRX5075170,SMARCA4,170
chr1,64082425,64082733,SRX5075175,SMARCA4,308
chr1,64082492,64082743,SRX5075176,SMARCA4,251
chr1,64082516,64082811,SRX5075169,SMARCA4,295
chr1,64092753,64093359,SRX5075176,SMARCA4,606
chr1,64092787,64093081,SRX5075170,SMARCA4,294
chr1,64092842,64093063,SRX5075169,SMARCA4,221
chr1,64092849,64093040,SRX5075175,SMARCA4,191
chr1,64092892,64093165,SRX5716470,SMARCA4,273
chr1,64102969,64103171,SRX5075170,SMARCA4,202
chr1,64103009,64103198,SRX5075176,SMARCA4,189
chr1,64112363,64112636,SRX5054309,FOSL2,273
chr1,64112403,64112642,SRX5075175,SMARCA4,239
chr1,64112415,64112636,SRX5054308,FOSL2,221
chr1,64124641,64124998,SRX5075176,SMARCA4,357
chr1,64124862,64125031,SRX5075170,SMARCA4,169
chr1,64133073,64133340,SRX5075175,SMARCA4,267
chr1,64133082,64133437,SRX5075169,SMARCA4,355
chr1,64133161,64133357,SRX5075176,SMARCA4,196
chr1,64136921,64137403,SRX5075176,SMARCA4,482
chr1,64136957,64137392,SRX5075170,SMARCA4,435
chr1,64136962,64137531,SRX16500059,CTCF,569
chr1,64136963,64137320,SRX5075169,SMARCA4,357
chr1,64136968,64137355,SRX5075175,SMARCA4,387
chr1,64136969,64137210,SRX5020211,SMARCA2,241
chr1,64136999,64137524,SRX16500061,CTCF,525
chr1,64137033,64137322,SRX5716470,SMARCA4,289
chr1,64137037,64137554,SRX16500060,CTCF,517
chr1,64137044,64137437,SRX5075168,SMARCA4,393
chr1,64137045,64137257,SRX5716469,SMARCA4,212
chr1,64137062,64137288,SRX5054308,FOSL2,226
chr1,64137070,64137487,SRX16500062,CTCF,417
chr1,64137084,64137423,SRX5075174,SMARCA4,339
chr1,64137099,64137388,SRX5716463,SMARCA4,289
chr1,64137102,64137404,SRX5716464,SMARCA4,302
chr1,64137113,64137514,SRX4174629,CTCF,401
chr1,64154057,64154243,SRX5075176,SMARCA4,186
chr1,64154133,64154304,SRX5075170,SMARCA4,171
chr1,64163843,64164232,SRX5716467,SMARCA2,389
chr1,64163924,64164272,SRX5075176,SMARCA4,348
chr1,64163943,64164316,SRX5075170,SMARCA4,373
chr1,64164003,64164357,SRX5075169,SMARCA4,354
chr1,64164036,64164285,SRX16500059,CTCF,249
chr1,64164037,64164340,SRX16500061,CTCF,303
chr1,64164048,64164235,SRX5075175,SMARCA4,187
chr1,64164061,64164292,SRX16500060,CTCF,231
chr1,64164164,64164337,SRX5075174,SMARCA4,173
chr1,64168144,64168406,SRX5054308,FOSL2,262
chr1,64172126,64172387,SRX5054309,FOSL2,261
chr1,64172156,64172377,SRX5054308,FOSL2,221
chr1,64172496,64172956,SRX5716469,SMARCA4,460
chr1,64172548,64173068,SRX5075176,SMARCA4,520
chr1,64172610,64173090,SRX5075170,SMARCA4,480
chr1,64172623,64172979,SRX5716468,SMARCA2,356
chr1,64172714,64172945,SRX5716470,SMARCA4,231
chr1,64172728,64172990,SRX5075175,SMARCA4,262
chr1,64172753,64173064,SRX5075169,SMARCA4,311
chr1,64172780,64172984,SRX5020211,SMARCA2,204
chr1,64183392,64183755,SRX5075170,SMARCA4,363
chr1,64183400,64183839,SRX5075176,SMARCA4,439
chr1,64194955,64195310,SRX5075170,SMARCA4,355
chr1,64194969,64195404,SRX5075176,SMARCA4,435
chr1,64195019,64195231,SRX5716469,SMARCA4,212
chr1,64195103,64195286,SRX5075169,SMARCA4,183
chr1,64195103,64195433,SRX5716468,SMARCA2,330
chr1,64197729,64197919,SRX5075176,SMARCA4,190
chr1,64212072,64212370,SRX5054309,FOSL2,298
chr1,64212146,64212348,SRX5075169,SMARCA4,202
chr1,64223269,64223657,SRX5716469,SMARCA4,388
chr1,64223279,64223685,SRX5716470,SMARCA4,406
chr1,64223282,64223708,SRX5075169,SMARCA4,426
chr1,64223295,64223650,SRX5075175,SMARCA4,355
chr1,64223299,64223710,SRX5054309,FOSL2,411
chr1,64223308,64223686,SRX5054308,FOSL2,378
chr1,64223320,64223651,SRX5020211,SMARCA2,331
chr1,64223331,64223760,SRX5075170,SMARCA4,429
chr1,64223333,64223688,SRX5020214,SMARCA2,355
chr1,64223352,64223885,SRX5075176,SMARCA4,533
chr1,64223375,64223628,SRX5716459,Epitope tags,253
chr1,64223396,64223679,SRX5716467,SMARCA2,283
chr1,64223413,64223629,SRX5075181,SMARCA2,216
chr1,64230990,64231619,SRX5075170,SMARCA4,629
chr1,64231050,64231653,SRX5075176,SMARCA4,603
chr1,64231088,64231547,SRX5075174,SMARCA4,459
chr1,64231119,64231421,SRX5716467,SMARCA2,302
chr1,64231135,64231375,SRX5020211,SMARCA2,240
chr1,64231139,64231511,SRX5075168,SMARCA4,372
chr1,64231143,64231560,SRX5075169,SMARCA4,417
chr1,64231145,64231529,SRX5054308,FOSL2,384
chr1,64231169,64231573,SRX5054309,FOSL2,404
chr1,64231173,64231488,SRX5020214,SMARCA2,315
chr1,64231183,64231523,SRX5075175,SMARCA4,340
chr1,64231193,64231457,SRX5716469,SMARCA4,264
chr1,64231214,64231419,SRX5716464,SMARCA4,205
chr1,64231276,64231503,SRX5716470,SMARCA4,227
chr1,64236554,64236723,SRX5075170,SMARCA4,169
chr1,64242944,64243417,SRX16500059,CTCF,473
chr1,64242965,64243370,SRX16500060,CTCF,405
chr1,64242988,64243376,SRX16500062,CTCF,388
chr1,64243000,64243375,SRX16500061,CTCF,375
chr1,64246235,64246738,SRX16500062,CTCF,503
chr1,64246248,64246748,SRX16500059,CTCF,500
chr1,64246271,64246722,SRX16500061,CTCF,451
chr1,64246287,64246776,SRX16500060,CTCF,489
chr1,64246431,64246610,SRX5075168,SMARCA4,179
chr1,64246472,64246659,SRX5075175,SMARCA4,187
chr1,64268952,64269370,SRX4174629,CTCF,418
chr1,64268969,64269509,SRX16500059,CTCF,540
chr1,64268985,64269505,SRX16500060,CTCF,520
chr1,64269003,64269435,SRX16500062,CTCF,432
chr1,64269007,64269457,SRX16500061,CTCF,450
chr1,64269100,64269398,SRX5075168,SMARCA4,298
chr1,64269127,64269390,SRX5075170,SMARCA4,263
chr1,64269145,64269443,SRX5075174,SMARCA4,298
chr1,64269195,64269425,SRX5075176,SMARCA4,230
chr1,64282322,64282728,SRX5075176,SMARCA4,406
chr1,64282361,64282778,SRX5075170,SMARCA4,417
chr1,64282369,64282580,SRX5075174,SMARCA4,211
chr1,64282417,64282636,SRX5075168,SMARCA4,219
chr1,64282776,64282989,SRX5075174,SMARCA4,213
chr1,64295706,64295917,SRX5054308,FOSL2,211
chr1,64295727,64295918,SRX5054309,FOSL2,191
chr1,64303038,64303259,SRX5054309,FOSL2,221
chr1,64343310,64343682,SRX5075170,SMARCA4,372
chr1,64343397,64343731,SRX5075176,SMARCA4,334
chr1,64343432,64343744,SRX5075174,SMARCA4,312
chr1,64343440,64343851,SRX5075168,SMARCA4,411
chr1,64343447,64343637,SRX5075175,SMARCA4,190
chr1,64343512,64343738,SRX5054309,FOSL2,226
chr1,64392185,64392452,SRX5075174,SMARCA4,267
chr1,64469767,64470359,SRX20140895,INTS13,592
chr1,64469782,64470269,SRX5075174,SMARCA4,487
chr1,64469785,64470215,SRX20140868,INTS10,430
chr1,64469858,64470293,SRX20140867,INTS10,435
chr1,64469917,64470357,SRX5075168,SMARCA4,440
chr1,64469941,64470476,SRX5716470,SMARCA4,535
chr1,64469942,64470270,SRX5075170,SMARCA4,328
chr1,64469963,64470260,SRX5075169,SMARCA4,297
chr1,64469965,64470315,SRX5075176,SMARCA4,350
chr1,64470107,64470294,SRX5075175,SMARCA4,187
chr1,64470405,64470748,SRX5075169,SMARCA4,343
chr1,64476721,64476921,SRX5075176,SMARCA4,200
chr1,64476721,64476955,SRX5054309,FOSL2,234
chr1,64476723,64476903,SRX5054308,FOSL2,180
chr1,64484624,64485093,SRX5075170,SMARCA4,469
chr1,64484644,64485122,SRX5075176,SMARCA4,478
chr1,64484718,64484900,SRX5075169,SMARCA4,182
chr1,64484763,64484974,SRX5716470,SMARCA4,211
chr1,64493741,64494257,SRX5075174,SMARCA4,516
chr1,64493741,64494260,SRX5075168,SMARCA4,519
chr1,64493919,64494212,SRX5716463,SMARCA4,293
chr1,64497440,64497701,SRX5075170,SMARCA4,261
chr1,64497477,64497774,SRX5054309,FOSL2,297
chr1,64497484,64497724,SRX5054308,FOSL2,240
chr1,64497508,64497706,SRX5075176,SMARCA4,198
chr1,64502154,64502474,SRX5075176,SMARCA4,320
chr1,64502159,64502525,SRX5075170,SMARCA4,366
chr1,64502225,64502435,SRX5075175,SMARCA4,210
chr1,64514058,64514719,SRX5716470,SMARCA4,661
chr1,64514073,64514367,SRX5054308,FOSL2,294
chr1,64514076,64514744,SRX5075169,SMARCA4,668
chr1,64514090,64514681,SRX5075176,SMARCA4,591
chr1,64514098,64514471,SRX5075181,SMARCA2,373
chr1,64514099,64514651,SRX5075170,SMARCA4,552
chr1,64514109,64514621,SRX5716469,SMARCA4,512
chr1,64514121,64514520,SRX5020211,SMARCA2,399
chr1,64514129,64514618,SRX5075175,SMARCA4,489
chr1,64514136,64514668,SRX5075174,SMARCA4,532
chr1,64514146,64514620,SRX5716467,SMARCA2,474
chr1,64514154,64514590,SRX5054309,FOSL2,436
chr1,64514166,64514510,SRX5716468,SMARCA2,344
chr1,64514283,64514622,SRX5075168,SMARCA4,339
chr1,64514418,64514705,SRX5716463,SMARCA4,287
chr1,64515495,64515796,SRX5075170,SMARCA4,301
chr1,64515553,64515778,SRX5075176,SMARCA4,225
chr1,64517174,64517367,SRX5054309,FOSL2,193
chr1,64517258,64517490,SRX5075175,SMARCA4,232
chr1,64523779,64524083,SRX5075168,SMARCA4,304
chr1,64530961,64531290,SRX5075176,SMARCA4,329
chr1,64531010,64531352,SRX5075170,SMARCA4,342
chr1,64531037,64531304,SRX5716470,SMARCA4,267
chr1,64531099,64531283,SRX5075169,SMARCA4,184
chr1,64538041,64538232,SRX5075174,SMARCA4,191
chr1,64539740,64539976,SRX5075170,SMARCA4,236
chr1,64539811,64540060,SRX5075176,SMARCA4,249
chr1,64540269,64540499,SRX5075169,SMARCA4,230
chr1,64540316,64540803,SRX5075176,SMARCA4,487
chr1,64540408,64540803,SRX5075170,SMARCA4,395
chr1,64540518,64540828,SRX5075174,SMARCA4,310
chr1,64540575,64540815,SRX5075168,SMARCA4,240
chr1,64543865,64544066,SRX5054308,FOSL2,201
chr1,64545256,64545448,SRX5075174,SMARCA4,192
chr1,64546128,64546357,SRX5075168,SMARCA4,229
chr1,64572644,64572839,SRX5075176,SMARCA4,195
chr1,64572670,64572919,SRX5075170,SMARCA4,249
chr1,64575761,64576022,SRX5075168,SMARCA4,261
chr1,64575887,64576204,SRX5075174,SMARCA4,317
chr1,64581248,64581485,SRX5075176,SMARCA4,237
chr1,64581551,64581877,SRX5075174,SMARCA4,326
chr1,64598088,64598326,SRX5075168,SMARCA4,238
chr1,64598196,64598691,SRX5075174,SMARCA4,495
chr1,64598344,64598615,SRX5054309,FOSL2,271
chr1,64598361,64598658,SRX5716463,SMARCA4,297
chr1,64598409,64598614,SRX5075170,SMARCA4,205
chr1,64598464,64598662,SRX5075168,SMARCA4,198
chr1,64623684,64624770,SRX5075170,SMARCA4,1086
chr1,64623716,64624822,SRX5075176,SMARCA4,1106
chr1,64623720,64624767,SRX5075169,SMARCA4,1047
chr1,64623736,64624708,SRX5054309,FOSL2,972
chr1,64623745,64624304,SRX5020214,SMARCA2,559
chr1,64623750,64624795,SRX5075175,SMARCA4,1045
chr1,64623780,64624265,SRX5054308,FOSL2,485
chr1,64623781,64624364,SRX5716469,SMARCA4,583
chr1,64623808,64624550,SRX5716467,SMARCA2,742
chr1,64623809,64624017,SRX5075182,SMARCA2,208
chr1,64623813,64624066,SRX5075181,SMARCA2,253
chr1,64623845,64624751,SRX5716470,SMARCA4,906
chr1,64623868,64624751,SRX5716468,SMARCA2,883
chr1,64623892,64624447,SRX5020211,SMARCA2,555
chr1,64624365,64624693,SRX5020214,SMARCA2,328
chr1,64624439,64624799,SRX5716469,SMARCA4,360
chr1,64624486,64624728,SRX5054308,FOSL2,242
chr1,64631663,64632085,SRX5075174,SMARCA4,422
chr1,64631789,64632044,SRX5075168,SMARCA4,255
chr1,64654267,64654744,SRX5075170,SMARCA4,477
chr1,64663640,64664032,SRX5075168,SMARCA4,392
chr1,64663652,64664317,SRX20140895,INTS13,665
chr1,64663719,64664064,SRX5075174,SMARCA4,345
chr1,64663725,64664091,SRX20140868,INTS10,366
chr1,64663837,64664084,SRX5075176,SMARCA4,247
chr1,64663930,64664554,SRX5075170,SMARCA4,624
chr1,64664278,64664879,SRX5075174,SMARCA4,601
chr1,64664290,64664881,SRX5075168,SMARCA4,591
chr1,64664369,64664817,SRX5716464,SMARCA4,448
chr1,64664438,64664767,SRX5716451,SOX2,329
chr1,64664446,64664749,SRX5716454,SOX3,303
chr1,64664458,64664830,SRX5716463,SMARCA4,372
chr1,64675664,64676187,SRX16500060,CTCF,523
chr1,64675679,64676276,SRX16500059,CTCF,597
chr1,64675686,64676351,SRX16500062,CTCF,665
chr1,64675730,64676151,SRX16500061,CTCF,421
chr1,64675764,64676055,SRX5075174,SMARCA4,291
chr1,64686617,64687224,SRX16500062,CTCF,607
chr1,64686691,64687284,SRX16500061,CTCF,593
chr1,64686695,64687149,SRX16500060,CTCF,454
chr1,64686715,64687151,SRX16500059,CTCF,436
chr1,64686843,64687054,SRX5075168,SMARCA4,211
chr1,64686868,64687066,SRX5075176,SMARCA4,198
chr1,64686874,64687063,SRX5075174,SMARCA4,189
chr1,64701990,64702211,SRX5075170,SMARCA4,221
chr1,64702011,64702205,SRX5075176,SMARCA4,194
chr1,64733539,64733923,SRX5716470,SMARCA4,384
chr1,64733588,64733869,SRX5716468,SMARCA2,281
chr1,64733589,64733885,SRX5716469,SMARCA4,296
chr1,64733595,64733897,SRX5075181,SMARCA2,302
chr1,64744385,64744808,SRX16500060,CTCF,423
chr1,64744421,64744680,SRX16500061,CTCF,259
chr1,64744455,64744816,SRX16500059,CTCF,361
chr1,64744480,64744735,SRX16500062,CTCF,255
chr1,64744513,64745407,SRX20140895,INTS13,894
chr1,64744529,64745141,SRX5075176,SMARCA4,612
chr1,64744546,64744952,SRX5075169,SMARCA4,406
chr1,64744547,64745201,SRX20140868,INTS10,654
chr1,64744553,64744898,SRX5075168,SMARCA4,345
chr1,64744620,64745190,SRX20140867,INTS10,570
chr1,64744639,64744972,SRX5075175,SMARCA4,333
chr1,64744648,64745139,SRX5075170,SMARCA4,491
chr1,64744649,64744971,SRX5716469,SMARCA4,322
chr1,64744656,64745091,SRX5075174,SMARCA4,435
chr1,64824106,64824708,SRX16500059,CTCF,602
chr1,64824111,64824551,SRX16500062,CTCF,440
chr1,64824126,64824469,SRX4174629,CTCF,343
chr1,64824127,64824630,SRX16500060,CTCF,503
chr1,64824129,64824368,SRX5716470,SMARCA4,239
chr1,64824133,64824628,SRX16500061,CTCF,495
chr1,64824135,64824418,SRX5075175,SMARCA4,283
chr1,64824137,64824454,SRX5075176,SMARCA4,317
chr1,64824163,64824506,SRX5075168,SMARCA4,343
chr1,64824186,64824472,SRX5075170,SMARCA4,286
chr1,64824224,64824511,SRX5075174,SMARCA4,287
chr1,64834885,64835099,SRX5054309,FOSL2,214
chr1,64881249,64881477,SRX5054308,FOSL2,228
chr1,64881269,64881540,SRX5054309,FOSL2,271
chr1,64881327,64881514,SRX5075175,SMARCA4,187
chr1,64881348,64881572,SRX5075170,SMARCA4,224
chr1,64881351,64881567,SRX5075169,SMARCA4,216
chr1,64886892,64887351,SRX5075174,SMARCA4,459
chr1,64886965,64887328,SRX5075168,SMARCA4,363
chr1,64886995,64887222,SRX5716463,SMARCA4,227
chr1,64887012,64887220,SRX5716464,SMARCA4,208
chr1,64898002,64898682,SRX5075169,SMARCA4,680
chr1,64898009,64898460,SRX5075168,SMARCA4,451
chr1,64898031,64898492,SRX5054309,FOSL2,461
chr1,64898031,64898591,SRX5075174,SMARCA4,560
chr1,64898052,64898550,SRX5075175,SMARCA4,498
chr1,64898070,64898460,SRX5075170,SMARCA4,390
chr1,64898071,64898508,SRX5054308,FOSL2,437
chr1,64898090,64898413,SRX5075176,SMARCA4,323
chr1,64898091,64898443,SRX5716467,SMARCA2,352
chr1,64898102,64898421,SRX5020214,SMARCA2,319
chr1,64898118,64898374,SRX5716470,SMARCA4,256
chr1,64898150,64898392,SRX5054307,FOSL2,242
chr1,64898164,64898399,SRX5716469,SMARCA4,235
chr1,64898220,64898465,SRX5020211,SMARCA2,245
chr1,64898489,64898719,SRX5075176,SMARCA4,230
chr1,64917358,64917831,SRX5075175,SMARCA4,473
chr1,64917366,64917896,SRX5075169,SMARCA4,530
chr1,64917397,64917896,SRX5716470,SMARCA4,499
chr1,64917411,64917818,SRX5075182,SMARCA2,407
chr1,64917411,64917905,SRX5075170,SMARCA4,494
chr1,64917418,64917872,SRX5020214,SMARCA2,454
chr1,64917422,64917913,SRX5075176,SMARCA4,491
chr1,64917442,64917828,SRX5054309,FOSL2,386
chr1,64917472,64917905,SRX5020211,SMARCA2,433
chr1,64917487,64917827,SRX5716469,SMARCA4,340
chr1,64917514,64917852,SRX5054308,FOSL2,338
chr1,64917547,64917806,SRX5716467,SMARCA2,259
chr1,64920844,64921309,SRX5075170,SMARCA4,465
chr1,64920855,64921296,SRX5075176,SMARCA4,441
chr1,64920945,64921261,SRX5075175,SMARCA4,316
chr1,64920954,64921266,SRX5054309,FOSL2,312
chr1,64920957,64921281,SRX5075169,SMARCA4,324
chr1,64920968,64921293,SRX5054308,FOSL2,325
chr1,64920976,64921225,SRX5020211,SMARCA2,249
chr1,64934064,64934573,SRX5716470,SMARCA4,509
chr1,64934076,64934301,SRX5075170,SMARCA4,225
chr1,64934176,64934672,SRX5075169,SMARCA4,496
chr1,64934238,64934697,SRX5075175,SMARCA4,459
chr1,64934247,64934596,SRX5075176,SMARCA4,349
chr1,64934335,64934617,SRX5054309,FOSL2,282
chr1,64934367,64934580,SRX5075170,SMARCA4,213
chr1,64934368,64934575,SRX5054308,FOSL2,207
chr1,64966022,64966919,SRX20140895,INTS13,897
chr1,64966072,64966709,SRX20140867,INTS10,637
chr1,64966147,64966640,SRX20140868,INTS10,493
chr1,64966164,64966419,SRX5716469,SMARCA4,255
chr1,64966186,64966850,SRX5716470,SMARCA4,664
chr1,64966217,64966882,SRX5075174,SMARCA4,665
chr1,64966229,64966482,SRX20140897,INTS13,253
chr1,64966319,64966604,SRX20140896,INTS13,285
chr1,64966343,64966879,SRX5075169,SMARCA4,536
chr1,64966343,64966885,SRX5075170,SMARCA4,542
chr1,64966352,64966966,SRX5075168,SMARCA4,614
chr1,64966392,64966849,SRX5716463,SMARCA4,457
chr1,64966392,64966881,SRX5716464,SMARCA4,489
chr1,64966403,64966837,SRX5075176,SMARCA4,434
chr1,64966511,64966778,SRX5054309,FOSL2,267
chr1,64966594,64966781,SRX5075175,SMARCA4,187
chr1,64966622,64966893,SRX5716469,SMARCA4,271
chr1,64983171,64983442,SRX5054308,FOSL2,271
chr1,64983205,64983411,SRX5054309,FOSL2,206
chr1,64983253,64983422,SRX5075170,SMARCA4,169
chr1,65002481,65003142,SRX5716470,SMARCA4,661
chr1,65002485,65002833,SRX5054309,FOSL2,348
chr1,65002485,65002931,SRX5075168,SMARCA4,446
chr1,65002488,65003014,SRX5075174,SMARCA4,526
chr1,65002489,65002897,SRX5075170,SMARCA4,408
chr1,65002508,65003208,SRX5075176,SMARCA4,700
chr1,65002539,65002814,SRX5054308,FOSL2,275
chr1,65002551,65002987,SRX5075169,SMARCA4,436
chr1,65002585,65002931,SRX5716469,SMARCA4,346
chr1,65002585,65003101,SRX5075175,SMARCA4,516
chr1,65048240,65048903,SRX5075170,SMARCA4,663
chr1,65048270,65048939,SRX5075176,SMARCA4,669
chr1,65059830,65060328,SRX16500061,CTCF,498
chr1,65059865,65060374,SRX16500060,CTCF,509
chr1,65059896,65060292,SRX16500059,CTCF,396
chr1,65059936,65060279,SRX16500062,CTCF,343
chr1,65060011,65060308,SRX5075176,SMARCA4,297
chr1,65060024,65060213,SRX5075168,SMARCA4,189
chr1,65060082,65060263,SRX5075170,SMARCA4,181
chr1,65066833,65067381,SRX20140868,INTS10,548
chr1,65066981,65067420,SRX20140895,INTS13,439
chr1,65067575,65068137,SRX20140895,INTS13,562
chr1,65067826,65068049,SRX5075170,SMARCA4,223
chr1,65075366,65075778,SRX16500061,CTCF,412
chr1,65075381,65075754,SRX16500062,CTCF,373
chr1,65075396,65075817,SRX16500060,CTCF,421
chr1,65075426,65075891,SRX16500059,CTCF,465
chr1,65114291,65114781,SRX5075176,SMARCA4,490
chr1,65114306,65114650,SRX5716469,SMARCA4,344
chr1,65114313,65114790,SRX5075170,SMARCA4,477
chr1,65114326,65114728,SRX5075169,SMARCA4,402
chr1,65114334,65114694,SRX5075175,SMARCA4,360
chr1,65114335,65114697,SRX5716470,SMARCA4,362
chr1,65114422,65114605,SRX5054309,FOSL2,183
chr1,65115788,65115961,SRX5075174,SMARCA4,173
chr1,65141336,65141800,SRX5075176,SMARCA4,464
chr1,65141423,65141791,SRX5075170,SMARCA4,368
chr1,65141450,65141736,SRX5075169,SMARCA4,286
chr1,65141482,65141791,SRX5075175,SMARCA4,309
chr1,65141495,65141697,SRX5020211,SMARCA2,202
chr1,65141550,65141730,SRX5054308,FOSL2,180
chr1,65147317,65147534,SRX5075176,SMARCA4,217
chr1,65147327,65147647,SRX20140895,INTS13,320
chr1,65147352,65147622,SRX5075168,SMARCA4,270
chr1,65147382,65147686,SRX5075170,SMARCA4,304
chr1,65147391,65147612,SRX5075174,SMARCA4,221
chr1,65148431,65148723,SRX20140895,INTS13,292
chr1,65167544,65168065,SRX5075174,SMARCA4,521
chr1,65167601,65168199,SRX5075168,SMARCA4,598
chr1,65167692,65167901,SRX5716454,SOX3,209
chr1,65167824,65168133,SRX20140895,INTS13,309
chr1,65174497,65174877,SRX5075170,SMARCA4,380
chr1,65174513,65174874,SRX5075176,SMARCA4,361
chr1,65174523,65174938,SRX5020211,SMARCA2,415
chr1,65174536,65174918,SRX5075169,SMARCA4,382
chr1,65174567,65174834,SRX5716469,SMARCA4,267
chr1,65174573,65174847,SRX5716470,SMARCA4,274
chr1,65174586,65174855,SRX5020214,SMARCA2,269
chr1,65174593,65174899,SRX5075175,SMARCA4,306
chr1,65174639,65174858,SRX5054309,FOSL2,219
chr1,65174657,65174841,SRX5075182,SMARCA2,184
chr1,65174667,65174889,SRX5054308,FOSL2,222
chr1,65177488,65177847,SRX5054309,FOSL2,359
chr1,65177502,65177763,SRX5054308,FOSL2,261
chr1,65177546,65177779,SRX5020214,SMARCA2,233
chr1,65195731,65196491,SRX5075176,SMARCA4,760
chr1,65195831,65196441,SRX5075170,SMARCA4,610
chr1,65195842,65196253,SRX5075175,SMARCA4,411
chr1,65195950,65196352,SRX5716470,SMARCA4,402
chr1,65195955,65196455,SRX5054309,FOSL2,500
chr1,65195973,65196474,SRX5075169,SMARCA4,501
chr1,65195999,65196413,SRX5054308,FOSL2,414
chr1,65196057,65196406,SRX5716469,SMARCA4,349
chr1,65196086,65196286,SRX5020211,SMARCA2,200
chr1,65209149,65209640,SRX16500062,CTCF,491
chr1,65209207,65209702,SRX16500059,CTCF,495
chr1,65209219,65209677,SRX16500060,CTCF,458
chr1,65209241,65209738,SRX16500061,CTCF,497
chr1,65209319,65209540,SRX5075176,SMARCA4,221
chr1,65209323,65209598,SRX5075168,SMARCA4,275
chr1,65209364,65209590,SRX5075170,SMARCA4,226
chr1,65209420,65209642,SRX5075174,SMARCA4,222
chr1,65235862,65236247,SRX16500060,CTCF,385
chr1,65235902,65236292,SRX16500059,CTCF,390
chr1,65235903,65236285,SRX16500061,CTCF,382
chr1,65235943,65236265,SRX16500062,CTCF,322
chr1,65247723,65248094,SRX5716469,SMARCA4,371
chr1,65247770,65248172,SRX5075169,SMARCA4,402
chr1,65247808,65248172,SRX5075176,SMARCA4,364
chr1,65247816,65248102,SRX5075170,SMARCA4,286
chr1,65247898,65248183,SRX5716470,SMARCA4,285
chr1,65254149,65254656,SRX5075170,SMARCA4,507
chr1,65254177,65254587,SRX5075168,SMARCA4,410
chr1,65254182,65254654,SRX5075175,SMARCA4,472
chr1,65254183,65254690,SRX5716463,SMARCA4,507
chr1,65254189,65254636,SRX5075174,SMARCA4,447
chr1,65254226,65254537,SRX5716464,SMARCA4,311
chr1,65254238,65254661,SRX5075176,SMARCA4,423
chr1,65254323,65254923,SRX20140895,INTS13,600
chr1,65254442,65254699,SRX5075169,SMARCA4,257
chr1,65254484,65254713,SRX20140867,INTS10,229
chr1,65254532,65254753,SRX16500060,CTCF,221
chr1,65260927,65261219,SRX5075168,SMARCA4,292
chr1,65260928,65261166,SRX5054309,FOSL2,238
chr1,65260935,65261189,SRX5075174,SMARCA4,254
chr1,65264554,65264845,SRX5075168,SMARCA4,291
chr1,65264576,65264823,SRX5075174,SMARCA4,247
chr1,65264632,65264843,SRX5075170,SMARCA4,211
chr1,65265611,65266000,SRX16500059,CTCF,389
chr1,65265618,65265942,SRX16500062,CTCF,324
chr1,65265636,65266115,SRX20140895,INTS13,479
chr1,65265640,65266011,SRX16500060,CTCF,371
chr1,65265646,65265988,SRX16500061,CTCF,342
chr1,65265659,65265906,SRX5075168,SMARCA4,247
chr1,65265667,65265954,SRX5075174,SMARCA4,287
chr1,65309667,65310140,SRX5075174,SMARCA4,473
chr1,65309729,65310160,SRX5075176,SMARCA4,431
chr1,65309735,65310118,SRX5716469,SMARCA4,383
chr1,65309738,65310146,SRX5075168,SMARCA4,408
chr1,65309739,65310114,SRX5716464,SMARCA4,375
chr1,65309742,65309999,SRX20140895,INTS13,257
chr1,65309746,65310101,SRX5075170,SMARCA4,355
chr1,65309753,65310147,SRX5716470,SMARCA4,394
chr1,65309757,65310107,SRX5075169,SMARCA4,350
chr1,65309761,65310155,SRX5716463,SMARCA4,394
chr1,65309763,65310120,SRX5075175,SMARCA4,357
chr1,65309775,65310082,SRX5716467,SMARCA2,307
chr1,65309785,65310062,SRX5020211,SMARCA2,277
chr1,65309789,65310058,SRX5075182,SMARCA2,269
chr1,65309791,65310002,SRX5020214,SMARCA2,211
chr1,65309796,65310080,SRX5716460,Epitope tags,284
chr1,65309808,65310056,SRX5075181,SMARCA2,248
chr1,65309833,65310050,SRX5716468,SMARCA2,217
chr1,65339877,65340169,SRX5054308,FOSL2,292
chr1,65339893,65340153,SRX5054309,FOSL2,260
chr1,65419933,65420164,SRX5075170,SMARCA4,231
chr1,65420109,65420794,SRX5075174,SMARCA4,685
chr1,65420114,65420901,SRX5075168,SMARCA4,787
chr1,65420239,65420444,SRX5716464,SMARCA4,205
chr1,65420267,65420718,SRX5075170,SMARCA4,451
chr1,65420269,65420474,SRX5716463,SMARCA4,205
chr1,65420269,65420482,SRX5075176,SMARCA4,213
chr1,65420499,65421130,SRX20140897,INTS13,631
chr1,65420502,65421173,SRX20140895,INTS13,671
chr1,65420554,65420944,SRX20140867,INTS10,390
chr1,65420606,65421029,SRX20140868,INTS10,423
chr1,65420794,65421114,SRX20140869,INTS10,320
chr1,65420814,65421264,SRX5075175,SMARCA4,450
chr1,65421184,65421423,SRX5075176,SMARCA4,239
chr1,65425763,65425946,SRX5054309,FOSL2,183
chr1,65429804,65430073,SRX5075169,SMARCA4,269
chr1,65429833,65430026,SRX5054308,FOSL2,193
chr1,65429844,65430076,SRX5075170,SMARCA4,232
chr1,65429848,65430023,SRX5075176,SMARCA4,175
chr1,65429879,65430093,SRX5054309,FOSL2,214
chr1,65429881,65430090,SRX5075175,SMARCA4,209
chr1,65431037,65431524,SRX16500059,CTCF,487
chr1,65431046,65431563,SRX16500060,CTCF,517
chr1,65431094,65431517,SRX16500062,CTCF,423
chr1,65431097,65431509,SRX16500061,CTCF,412
chr1,65436114,65436417,SRX5716470,SMARCA4,303
chr1,65436119,65436322,SRX5075170,SMARCA4,203
chr1,65436130,65436350,SRX5075169,SMARCA4,220
chr1,65436133,65436330,SRX5075176,SMARCA4,197
chr1,65440965,65441145,SRX5075169,SMARCA4,180
chr1,65440999,65441242,SRX5716469,SMARCA4,243
chr1,65459403,65459717,SRX16500062,CTCF,314
chr1,65459428,65459741,SRX16500059,CTCF,313
chr1,65459576,65459795,SRX16500061,CTCF,219
chr1,65467521,65467840,SRX5075168,SMARCA4,319
chr1,65467558,65467833,SRX5075174,SMARCA4,275
chr1,65469938,65470313,SRX5075176,SMARCA4,375
chr1,65469958,65470224,SRX5075175,SMARCA4,266
chr1,65469959,65470305,SRX5075169,SMARCA4,346
chr1,65469981,65470250,SRX5716470,SMARCA4,269
chr1,65470024,65470244,SRX5716469,SMARCA4,220
chr1,65470034,65470233,SRX5075170,SMARCA4,199
chr1,65470046,65470275,SRX5716467,SMARCA2,229
chr1,65470094,65470316,SRX5075174,SMARCA4,222
chr1,65505536,65505705,SRX5075170,SMARCA4,169
chr1,65509961,65510203,SRX5075175,SMARCA4,242
chr1,65509977,65510289,SRX5054309,FOSL2,312
chr1,65509987,65510253,SRX5075169,SMARCA4,266
chr1,65509997,65510222,SRX5054308,FOSL2,225
chr1,65525405,65525578,SRX5075174,SMARCA4,173
chr1,65525751,65525924,SRX5075174,SMARCA4,173
chr1,65528081,65528501,SRX16500059,CTCF,420
chr1,65528111,65528471,SRX16500060,CTCF,360
chr1,65528127,65528530,SRX16500061,CTCF,403
chr1,65528204,65528426,SRX16500062,CTCF,222
chr1,65606562,65606795,SRX5054309,FOSL2,233
chr1,65668370,65668760,SRX5075174,SMARCA4,390
chr1,65668538,65668717,SRX5075168,SMARCA4,179
chr1,65687525,65688002,SRX4174629,CTCF,477
chr1,65687567,65688110,SRX16500060,CTCF,543
chr1,65687615,65688126,SRX16500059,CTCF,511
chr1,65687619,65688101,SRX16500061,CTCF,482
chr1,65687653,65688077,SRX16500062,CTCF,424
chr1,65687658,65688040,SRX5075170,SMARCA4,382
chr1,65687695,65688075,SRX5716470,SMARCA4,380
chr1,65687705,65687930,SRX5716463,SMARCA4,225
chr1,65687706,65688050,SRX5075169,SMARCA4,344
chr1,65687712,65688030,SRX5075175,SMARCA4,318
chr1,65687713,65688060,SRX5075176,SMARCA4,347
chr1,65687716,65687975,SRX5075168,SMARCA4,259
chr1,65687718,65688018,SRX5075174,SMARCA4,300
chr1,65687751,65688051,SRX5716469,SMARCA4,300
chr1,65756670,65756881,SRX5716470,SMARCA4,211
chr1,65756690,65756968,SRX5075170,SMARCA4,278
chr1,65756741,65757002,SRX5020211,SMARCA2,261
chr1,65756754,65756940,SRX5075176,SMARCA4,186
chr1,65792893,65793175,SRX5075168,SMARCA4,282
chr1,65792911,65793230,SRX5075174,SMARCA4,319
chr1,65792974,65793154,SRX5075169,SMARCA4,180
chr1,65811979,65812395,SRX5075169,SMARCA4,416
chr1,65811991,65812284,SRX5075176,SMARCA4,293
chr1,65812020,65812306,SRX5075175,SMARCA4,286
chr1,65812025,65812304,SRX5054308,FOSL2,279
chr1,65812047,65812349,SRX5054309,FOSL2,302
chr1,65812053,65812355,SRX5075170,SMARCA4,302
chr1,65820880,65821356,SRX5716469,SMARCA4,476
chr1,65820899,65821284,SRX5075169,SMARCA4,385
chr1,65820990,65821413,SRX5075168,SMARCA4,423
chr1,65820992,65821366,SRX5716470,SMARCA4,374
chr1,65820995,65821388,SRX5075174,SMARCA4,393
chr1,65820999,65821313,SRX5075176,SMARCA4,314
chr1,65821007,65821361,SRX5075175,SMARCA4,354
chr1,65821033,65821283,SRX5075170,SMARCA4,250
chr1,65821040,65821338,SRX5716463,SMARCA4,298
chr1,65832455,65832686,SRX5075169,SMARCA4,231
chr1,65856679,65856923,SRX5075168,SMARCA4,244
chr1,65856737,65856917,SRX5075174,SMARCA4,180
chr1,65911569,65912131,SRX5075174,SMARCA4,562
chr1,65911584,65912108,SRX5716463,SMARCA4,524
chr1,65911626,65912091,SRX5075168,SMARCA4,465
chr1,65911696,65911996,SRX5716451,SOX2,300
chr1,65911714,65912016,SRX5716464,SMARCA4,302
chr1,65952809,65953045,SRX5054309,FOSL2,236
chr1,65958591,65959082,SRX4174629,CTCF,491
chr1,65958710,65959271,SRX16500060,CTCF,561
chr1,65958729,65959307,SRX16500059,CTCF,578
chr1,65958759,65959247,SRX16500061,CTCF,488
chr1,65958763,65959256,SRX16500062,CTCF,493
chr1,65958924,65959201,SRX5075174,SMARCA4,277
chr1,65958937,65959182,SRX5075168,SMARCA4,245
chr1,65958952,65959163,SRX5716470,SMARCA4,211
chr1,65958969,65959144,SRX5075176,SMARCA4,175
chr1,65958982,65959154,SRX5075170,SMARCA4,172
chr1,65979045,65979707,SRX5075174,SMARCA4,662
chr1,65979059,65979748,SRX5075168,SMARCA4,689
chr1,65979152,65979495,SRX5075176,SMARCA4,343
chr1,65979156,65979403,SRX5054309,FOSL2,247
chr1,65979216,65979456,SRX5075169,SMARCA4,240
chr1,65979228,65979514,SRX5716463,SMARCA4,286
chr1,65979234,65979414,SRX5054308,FOSL2,180
chr1,65979255,65979505,SRX5075170,SMARCA4,250
chr1,65979257,65979468,SRX5075175,SMARCA4,211
chr1,65992376,65992751,SRX5075168,SMARCA4,375
chr1,65992397,65992815,SRX5075174,SMARCA4,418
chr1,65992470,65992828,SRX16500059,CTCF,358
chr1,65992490,65992831,SRX16500060,CTCF,341
chr1,65992519,65992798,SRX16500062,CTCF,279
chr1,65992570,65992789,SRX16500061,CTCF,219
chr1,66000348,66000560,SRX5075169,SMARCA4,212
chr1,66050263,66050493,SRX5075174,SMARCA4,230
chr1,66050737,66050959,SRX5075174,SMARCA4,222
chr1,66050746,66050931,SRX5075168,SMARCA4,185
chr1,66070536,66070709,SRX5075174,SMARCA4,173
chr1,66070555,66070797,SRX5075168,SMARCA4,242
chr1,66082889,66083315,SRX5075168,SMARCA4,426
chr1,66082942,66083348,SRX5075174,SMARCA4,406
chr1,66090932,66091524,SRX5075174,SMARCA4,592
chr1,66090949,66091512,SRX5075168,SMARCA4,563
chr1,66091038,66091449,SRX5716464,SMARCA4,411
chr1,66091051,66091449,SRX5716463,SMARCA4,398
chr1,66091168,66091362,SRX5716451,SOX2,194
chr1,66168808,66169576,SRX5075168,SMARCA4,768
chr1,66168922,66169730,SRX5075174,SMARCA4,808
chr1,66169007,66169221,SRX5054307,FOSL2,214
chr1,66169102,66169379,SRX5716463,SMARCA4,277
chr1,66176016,66176370,SRX5075168,SMARCA4,354
chr1,66176038,66176422,SRX5075174,SMARCA4,384
chr1,66182587,66183140,SRX5075168,SMARCA4,553
chr1,66182600,66182976,SRX5054308,FOSL2,376
chr1,66182615,66182955,SRX5716470,SMARCA4,340
chr1,66182616,66182977,SRX5716469,SMARCA4,361
chr1,66182642,66182824,SRX5075169,SMARCA4,182
chr1,66182678,66183000,SRX5054309,FOSL2,322
chr1,66207518,66207788,SRX5716467,SMARCA2,270
chr1,66207547,66207773,SRX5075169,SMARCA4,226
chr1,66207553,66207842,SRX5075170,SMARCA4,289
chr1,66207558,66207886,SRX5054308,FOSL2,328
chr1,66207558,66207943,SRX5716469,SMARCA4,385
chr1,66207559,66207801,SRX5075176,SMARCA4,242
chr1,66207566,66207855,SRX5054309,FOSL2,289
chr1,66207595,66207810,SRX5075175,SMARCA4,215
chr1,66207600,66207830,SRX5716470,SMARCA4,230
chr1,66217152,66217335,SRX5054309,FOSL2,183
chr1,66231155,66231368,SRX5075170,SMARCA4,213
chr1,66231195,66231391,SRX5075169,SMARCA4,196
chr1,66231257,66231475,SRX5075175,SMARCA4,218
chr1,66242399,66243129,SRX4174629,CTCF,730
chr1,66242583,66243102,SRX16500059,CTCF,519
chr1,66242613,66243087,SRX16500061,CTCF,474
chr1,66242623,66243113,SRX16500062,CTCF,490
chr1,66242627,66242982,SRX5075168,SMARCA4,355
chr1,66242629,66242891,SRX5054308,FOSL2,262
chr1,66242637,66243138,SRX16500060,CTCF,501
chr1,66242694,66243000,SRX5075174,SMARCA4,306
chr1,66242694,66243002,SRX5075170,SMARCA4,308
chr1,66242697,66242971,SRX5075176,SMARCA4,274
chr1,66242703,66242949,SRX5716470,SMARCA4,246
chr1,66242704,66242954,SRX5075175,SMARCA4,250
chr1,66242717,66242912,SRX5054309,FOSL2,195
chr1,66242718,66242919,SRX5075169,SMARCA4,201
chr1,66253256,66253565,SRX5054309,FOSL2,309
chr1,66253270,66253736,SRX16500062,CTCF,466
chr1,66253296,66253797,SRX16500060,CTCF,501
chr1,66253306,66253728,SRX16500059,CTCF,422
chr1,66253307,66253728,SRX16500061,CTCF,421
chr1,66253362,66253632,SRX5716469,SMARCA4,270
chr1,66253369,66253618,SRX5075174,SMARCA4,249
chr1,66253416,66253626,SRX5075168,SMARCA4,210
chr1,66253420,66253605,SRX5075170,SMARCA4,185
chr1,66253430,66253652,SRX5075176,SMARCA4,222
chr1,66258476,66258749,SRX5075174,SMARCA4,273
chr1,66258482,66258662,SRX5075168,SMARCA4,180
chr1,66262311,66262572,SRX5054309,FOSL2,261
chr1,66271199,66271570,SRX5075168,SMARCA4,371
chr1,66271232,66271572,SRX5020211,SMARCA2,340
chr1,66271233,66271704,SRX5075176,SMARCA4,471
chr1,66271243,66271659,SRX5075174,SMARCA4,416
chr1,66271260,66271607,SRX5716467,SMARCA2,347
chr1,66271261,66271562,SRX5054309,FOSL2,301
chr1,66271264,66271617,SRX5075169,SMARCA4,353
chr1,66271266,66271599,SRX5075170,SMARCA4,333
chr1,66271272,66271636,SRX5075175,SMARCA4,364
chr1,66271282,66271673,SRX5716470,SMARCA4,391
chr1,66271284,66271491,SRX5716463,SMARCA4,207
chr1,66271289,66271565,SRX5075181,SMARCA2,276
chr1,66271309,66271581,SRX5054308,FOSL2,272
chr1,66271321,66271638,SRX5716469,SMARCA4,317
chr1,66271339,66271621,SRX5716468,SMARCA2,282
chr1,66271365,66271590,SRX5020214,SMARCA2,225
chr1,66282291,66282482,SRX5075176,SMARCA4,191
chr1,66283784,66283958,SRX5075170,SMARCA4,174
chr1,66283813,66284067,SRX5075176,SMARCA4,254
chr1,66294712,66295079,SRX5075170,SMARCA4,367
chr1,66294744,66295119,SRX5054309,FOSL2,375
chr1,66294749,66295125,SRX5716469,SMARCA4,376
chr1,66294764,66295047,SRX5075169,SMARCA4,283
chr1,66294767,66295084,SRX5054308,FOSL2,317
chr1,66294779,66295080,SRX5075176,SMARCA4,301
chr1,66294836,66295058,SRX5075175,SMARCA4,222
chr1,66301177,66301412,SRX5054308,FOSL2,235
chr1,66301208,66301397,SRX5075169,SMARCA4,189
chr1,66301214,66301389,SRX5075176,SMARCA4,175
chr1,66301215,66301427,SRX5716469,SMARCA4,212
chr1,66301224,66301456,SRX5075170,SMARCA4,232
chr1,66313380,66313782,SRX5075170,SMARCA4,402
chr1,66313419,66313792,SRX5075176,SMARCA4,373
chr1,66313492,66313706,SRX5075169,SMARCA4,214
chr1,66313534,66313783,SRX5075175,SMARCA4,249
chr1,66324063,66324533,SRX5054309,FOSL2,470
chr1,66324256,66324607,SRX5075169,SMARCA4,351
chr1,66324321,66324626,SRX5716469,SMARCA4,305
chr1,66324372,66324546,SRX5075170,SMARCA4,174
chr1,66324379,66324687,SRX5075176,SMARCA4,308
chr1,66324386,66324650,SRX5716468,SMARCA2,264
chr1,66324504,66324768,SRX5716470,SMARCA4,264
chr1,66331729,66331918,SRX5075170,SMARCA4,189
chr1,66332081,66332288,SRX5054308,FOSL2,207
chr1,66332087,66332445,SRX5075175,SMARCA4,358
chr1,66332111,66332399,SRX5054309,FOSL2,288
chr1,66332117,66332346,SRX16500062,CTCF,229
chr1,66332146,66332571,SRX5075170,SMARCA4,425
chr1,66332166,66332441,SRX16500061,CTCF,275
chr1,66332176,66332416,SRX5716469,SMARCA4,240
chr1,66332184,66332494,SRX5075169,SMARCA4,310
chr1,66332197,66332544,SRX5075176,SMARCA4,347
chr1,66332201,66332458,SRX5716470,SMARCA4,257
chr1,66334418,66334630,SRX5075168,SMARCA4,212
chr1,66336058,66336290,SRX5075168,SMARCA4,232
chr1,66336113,66336361,SRX5075174,SMARCA4,248
chr1,66340095,66340363,SRX5075170,SMARCA4,268
chr1,66341556,66341783,SRX5716470,SMARCA4,227
chr1,66353232,66353685,SRX5075168,SMARCA4,453
chr1,66353236,66353550,SRX5716451,SOX2,314
chr1,66353256,66353530,SRX5716463,SMARCA4,274
chr1,66353261,66353680,SRX5075174,SMARCA4,419
chr1,66353265,66353604,SRX20140895,INTS13,339
chr1,66353317,66353550,SRX5716454,SOX3,233
chr1,66354464,66354648,SRX5075176,SMARCA4,184
chr1,66354481,66354683,SRX5075170,SMARCA4,202
chr1,66354547,66354749,SRX5075169,SMARCA4,202
chr1,66360433,66360741,SRX16500062,CTCF,308
chr1,66360453,66360809,SRX16500060,CTCF,356
chr1,66360477,66360882,SRX16500061,CTCF,405
chr1,66360550,66360785,SRX16500059,CTCF,235
chr1,66374726,66375084,SRX5075169,SMARCA4,358
chr1,66374794,66375104,SRX5054309,FOSL2,310
chr1,66374813,66375105,SRX5054308,FOSL2,292
chr1,66374849,66375090,SRX5075175,SMARCA4,241
chr1,66374887,66375104,SRX5075176,SMARCA4,217
chr1,66374954,66375185,SRX5075170,SMARCA4,231
chr1,66380500,66380760,SRX5075176,SMARCA4,260
chr1,66380560,66380763,SRX5075169,SMARCA4,203
chr1,66400840,66400883,SRX1424892,POU3F2,43
chr1,66402196,66402399,SRX5054308,FOSL2,203
chr1,66402225,66402550,SRX5075170,SMARCA4,325
chr1,66402225,66402590,SRX5075176,SMARCA4,365
chr1,66436482,66436737,SRX5075170,SMARCA4,255
chr1,66436596,66436819,SRX5054309,FOSL2,223
chr1,66446247,66446808,SRX16500059,CTCF,561
chr1,66446299,66446827,SRX16500061,CTCF,528
chr1,66446318,66446835,SRX16500060,CTCF,517
chr1,66446323,66446689,SRX4174629,CTCF,366
chr1,66446328,66446828,SRX16500062,CTCF,500
chr1,66446360,66446631,SRX5075176,SMARCA4,271
chr1,66446390,66446677,SRX5075170,SMARCA4,287
chr1,66464857,66465120,SRX5054309,FOSL2,263
chr1,66466654,66467029,SRX5075170,SMARCA4,375
chr1,66466657,66466980,SRX5716469,SMARCA4,323
chr1,66466693,66466977,SRX5716470,SMARCA4,284
chr1,66466703,66466997,SRX5054309,FOSL2,294
chr1,66466714,66467002,SRX5054308,FOSL2,288
chr1,66466715,66466930,SRX5716467,SMARCA2,215
chr1,66466716,66467002,SRX5075175,SMARCA4,286
chr1,66466738,66467054,SRX5075176,SMARCA4,316
chr1,66466745,66467006,SRX5075169,SMARCA4,261
chr1,66478217,66478483,SRX5075169,SMARCA4,266
chr1,66478231,66478477,SRX5075175,SMARCA4,246
chr1,66478266,66478501,SRX5054309,FOSL2,235
chr1,66503778,66504225,SRX16500062,CTCF,447
chr1,66503781,66504215,SRX16500060,CTCF,434
chr1,66503783,66504265,SRX16500059,CTCF,482
chr1,66503836,66504260,SRX16500061,CTCF,424
chr1,66503866,66504218,SRX5075174,SMARCA4,352
chr1,66503912,66504202,SRX5075168,SMARCA4,290
chr1,66505667,66506523,SRX5075170,SMARCA4,856
chr1,66505710,66506586,SRX5075169,SMARCA4,876
chr1,66505761,66506524,SRX5075176,SMARCA4,763
chr1,66505778,66506474,SRX5054309,FOSL2,696
chr1,66505794,66506139,SRX5716468,SMARCA2,345
chr1,66505813,66506510,SRX5075175,SMARCA4,697
chr1,66505880,66506333,SRX5716469,SMARCA4,453
chr1,66506126,66506441,SRX5054308,FOSL2,315
chr1,66521729,66522213,SRX5075176,SMARCA4,484
chr1,66521742,66522185,SRX5075169,SMARCA4,443
chr1,66521747,66522141,SRX5075175,SMARCA4,394
chr1,66521749,66522083,SRX5716469,SMARCA4,334
chr1,66521755,66522154,SRX5054309,FOSL2,399
chr1,66521756,66522156,SRX5075170,SMARCA4,400
chr1,66521775,66522142,SRX5054308,FOSL2,367
chr1,66521793,66522076,SRX5716467,SMARCA2,283
chr1,66521827,66522038,SRX5716470,SMARCA4,211
chr1,66521830,66522043,SRX5020214,SMARCA2,213
chr1,66521861,66522091,SRX5020211,SMARCA2,230
chr1,66527709,66528028,SRX5075169,SMARCA4,319
chr1,66527743,66527999,SRX5075170,SMARCA4,256
chr1,66527762,66527983,SRX5075175,SMARCA4,221
chr1,66533139,66533762,SRX5075176,SMARCA4,623
chr1,66533251,66533620,SRX5075170,SMARCA4,369
chr1,66533327,66533567,SRX5075169,SMARCA4,240
chr1,66533348,66533711,SRX5075175,SMARCA4,363
chr1,66533354,66533588,SRX5075174,SMARCA4,234
chr1,66533400,66533727,SRX5075168,SMARCA4,327
chr1,66540737,66540948,SRX5716470,SMARCA4,211
chr1,66540755,66540984,SRX5075174,SMARCA4,229
chr1,66540794,66541064,SRX5075168,SMARCA4,270
chr1,66543439,66543693,SRX5716467,SMARCA2,254
chr1,66543475,66543829,SRX5075170,SMARCA4,354
chr1,66543495,66543792,SRX5054308,FOSL2,297
chr1,66543502,66543776,SRX5075176,SMARCA4,274
chr1,66543515,66543735,SRX5054309,FOSL2,220
chr1,66543525,66543786,SRX5075169,SMARCA4,261
chr1,66543533,66543727,SRX5075175,SMARCA4,194
chr1,66552872,66553103,SRX5075170,SMARCA4,231
chr1,66552903,66553092,SRX5075176,SMARCA4,189
chr1,66554000,66554259,SRX5075169,SMARCA4,259
chr1,66554015,66554265,SRX5054308,FOSL2,250
chr1,66554040,66554255,SRX5716467,SMARCA2,215
chr1,66554059,66554280,SRX5716469,SMARCA4,221
chr1,66554066,66554236,SRX5075170,SMARCA4,170
chr1,66557070,66557442,SRX5075169,SMARCA4,372
chr1,66557071,66557478,SRX5054309,FOSL2,407
chr1,66557119,66557353,SRX5054308,FOSL2,234
chr1,66557161,66557420,SRX5716467,SMARCA2,259
chr1,66557190,66557466,SRX5075175,SMARCA4,276
chr1,66557229,66557512,SRX5716470,SMARCA4,283
chr1,66557233,66557421,SRX5075170,SMARCA4,188
chr1,66557253,66557479,SRX5716469,SMARCA4,226
chr1,66563346,66563784,SRX5075176,SMARCA4,438
chr1,66563436,66563815,SRX5075170,SMARCA4,379
chr1,66563453,66563782,SRX5716469,SMARCA4,329
chr1,66563474,66563798,SRX5054309,FOSL2,324
chr1,66563481,66563780,SRX5054308,FOSL2,299
chr1,66563494,66563838,SRX5075169,SMARCA4,344
chr1,66563510,66563782,SRX5075175,SMARCA4,272
chr1,66563523,66563789,SRX5716470,SMARCA4,266
chr1,66563603,66563805,SRX5020211,SMARCA2,202
chr1,66564188,66564659,SRX5054309,FOSL2,471
chr1,66564200,66564660,SRX5075175,SMARCA4,460
chr1,66564210,66564711,SRX5075169,SMARCA4,501
chr1,66564216,66564687,SRX5075176,SMARCA4,471
chr1,66564225,66564661,SRX5716469,SMARCA4,436
chr1,66564243,66564627,SRX5075170,SMARCA4,384
chr1,66564247,66564541,SRX5716470,SMARCA4,294
chr1,66564290,66564629,SRX5054308,FOSL2,339
chr1,66564321,66564678,SRX5020214,SMARCA2,357
chr1,66564348,66564580,SRX5075182,SMARCA2,232
chr1,66571745,66572097,SRX5075175,SMARCA4,352
chr1,66571780,66572145,SRX5075176,SMARCA4,365
chr1,66571803,66572164,SRX5075169,SMARCA4,361
chr1,66571806,66572095,SRX5054309,FOSL2,289
chr1,66571849,66572075,SRX5075170,SMARCA4,226
chr1,66571853,66572175,SRX5054308,FOSL2,322
chr1,66598714,66599085,SRX5075169,SMARCA4,371
chr1,66598721,66598964,SRX5716469,SMARCA4,243
chr1,66598725,66598954,SRX5716467,SMARCA2,229
chr1,66598737,66599032,SRX5075175,SMARCA4,295
chr1,66598743,66599084,SRX5716470,SMARCA4,341
chr1,66598752,66599094,SRX5075176,SMARCA4,342
chr1,66598754,66599047,SRX5054309,FOSL2,293
chr1,66598782,66599097,SRX5075170,SMARCA4,315
chr1,66598801,66599003,SRX5075174,SMARCA4,202
chr1,66598813,66598994,SRX5054308,FOSL2,181
chr1,66606526,66606746,SRX5075169,SMARCA4,220
chr1,66606586,66606773,SRX5075175,SMARCA4,187
chr1,66624434,66624788,SRX5054309,FOSL2,354
chr1,66624449,66624751,SRX5075170,SMARCA4,302
chr1,66624468,66624739,SRX5054308,FOSL2,271
chr1,66624495,66624789,SRX5075176,SMARCA4,294
chr1,66624500,66624785,SRX5075169,SMARCA4,285
chr1,66624517,66624732,SRX5075175,SMARCA4,215
chr1,66676841,66677340,SRX5075169,SMARCA4,499
chr1,66676870,66677283,SRX5716470,SMARCA4,413
chr1,66676907,66677340,SRX5054309,FOSL2,433
chr1,66676911,66677231,SRX5075175,SMARCA4,320
chr1,66676933,66677289,SRX5054308,FOSL2,356
chr1,66676971,66677191,SRX5075176,SMARCA4,220
chr1,66676971,66677252,SRX5020211,SMARCA2,281
chr1,66676975,66677275,SRX5716469,SMARCA4,300
chr1,66676981,66677271,SRX5020214,SMARCA2,290
chr1,66677022,66677249,SRX5075170,SMARCA4,227
chr1,66695132,66695460,SRX5075174,SMARCA4,328
chr1,66695180,66695391,SRX5716470,SMARCA4,211
chr1,66695198,66695493,SRX5716464,SMARCA4,295
chr1,66695267,66695438,SRX5075170,SMARCA4,171
chr1,66705072,66705817,SRX5075175,SMARCA4,745
chr1,66705074,66705779,SRX5075176,SMARCA4,705
chr1,66705150,66705749,SRX5075170,SMARCA4,599
chr1,66705152,66705615,SRX5716469,SMARCA4,463
chr1,66705169,66705571,SRX5054308,FOSL2,402
chr1,66705171,66705393,SRX5075174,SMARCA4,222
chr1,66705181,66705698,SRX5075169,SMARCA4,517
chr1,66705196,66705517,SRX5075181,SMARCA2,321
chr1,66705198,66705571,SRX5054309,FOSL2,373
chr1,66705208,66705547,SRX5716468,SMARCA2,339
chr1,66705214,66705659,SRX5716470,SMARCA4,445
chr1,66705225,66705708,SRX5716467,SMARCA2,483
chr1,66705259,66705561,SRX5020214,SMARCA2,302
chr1,66705275,66705718,SRX5020211,SMARCA2,443
chr1,66725984,66726452,SRX16500060,CTCF,468
chr1,66725991,66726485,SRX16500059,CTCF,494
chr1,66726005,66726449,SRX16500062,CTCF,444
chr1,66726016,66726358,SRX5075175,SMARCA4,342
chr1,66726017,66726402,SRX5075168,SMARCA4,385
chr1,66726028,66726496,SRX16500061,CTCF,468
chr1,66726029,66726408,SRX5075174,SMARCA4,379
chr1,66726041,66726361,SRX5075169,SMARCA4,320
chr1,66726041,66726376,SRX5716464,SMARCA4,335
chr1,66726043,66726340,SRX5716470,SMARCA4,297
chr1,66726044,66726377,SRX5075176,SMARCA4,333
chr1,66726064,66726391,SRX5075170,SMARCA4,327
chr1,66726082,66726435,SRX5716463,SMARCA4,353
chr1,66726099,66726357,SRX4174629,CTCF,258
chr1,66733689,66733890,SRX5054309,FOSL2,201
chr1,66738562,66738793,SRX5075170,SMARCA4,231
chr1,66738582,66738807,SRX5075176,SMARCA4,225
chr1,66752231,66752591,SRX5075174,SMARCA4,360
chr1,66752311,66752517,SRX5075176,SMARCA4,206
chr1,66752332,66752618,SRX5075168,SMARCA4,286
chr1,66764902,66765464,SRX16500061,CTCF,562
chr1,66764908,66765540,SRX16500059,CTCF,632
chr1,66764938,66765409,SRX16500062,CTCF,471
chr1,66764944,66765525,SRX16500060,CTCF,581
chr1,66765083,66765347,SRX5075174,SMARCA4,264
chr1,66765153,66765331,SRX5075176,SMARCA4,178
chr1,66809939,66810329,SRX5716470,SMARCA4,390
chr1,66924523,66924836,SRX5716470,SMARCA4,313
chr1,66924688,66924938,SRX5075174,SMARCA4,250
chr1,66924738,66925478,SRX5075170,SMARCA4,740
chr1,66924755,66925566,SRX20140895,INTS13,811
chr1,66924831,66925380,SRX20140868,INTS10,549
chr1,66924989,66925258,SRX20140867,INTS10,269
chr1,66924992,66925271,SRX20140897,INTS13,279
chr1,66925018,66925460,SRX5075176,SMARCA4,442
chr1,66925081,66925562,SRX5075168,SMARCA4,481
chr1,66925259,66925571,SRX5075174,SMARCA4,312
chr1,66925301,66925496,SRX5075169,SMARCA4,195
chr1,66929954,66930439,SRX5075170,SMARCA4,485
chr1,66929968,66930406,SRX5075168,SMARCA4,438
chr1,66929977,66930414,SRX5075174,SMARCA4,437
chr1,66930011,66930267,SRX5716464,SMARCA4,256
chr1,66930012,66930324,SRX5075176,SMARCA4,312
chr1,66930060,66930348,SRX5054309,FOSL2,288
chr1,66930065,66930321,SRX5075169,SMARCA4,256
chr1,66930069,66930706,SRX20140895,INTS13,637
chr1,66930080,66930289,SRX5075175,SMARCA4,209
chr1,66930085,66930321,SRX16500062,CTCF,236
chr1,66930116,66930340,SRX5716463,SMARCA4,224
chr1,66930149,66930420,SRX5716470,SMARCA4,271
chr1,66930166,66930498,SRX20140867,INTS10,332
chr1,66930262,66930577,SRX20140868,INTS10,315
chr1,66938654,66939033,SRX5054309,FOSL2,379
chr1,66938688,66938967,SRX5075169,SMARCA4,279
chr1,66938712,66938961,SRX5054308,FOSL2,249
chr1,66944573,66945003,SRX5075170,SMARCA4,430
chr1,66944585,66944998,SRX5075169,SMARCA4,413
chr1,66944603,66945022,SRX5075175,SMARCA4,419
chr1,66944613,66944914,SRX5716469,SMARCA4,301
chr1,66944640,66944997,SRX5054309,FOSL2,357
chr1,66944646,66944942,SRX5075168,SMARCA4,296
chr1,66944649,66944974,SRX5716470,SMARCA4,325
chr1,66944653,66944993,SRX5075176,SMARCA4,340
chr1,66944659,66944952,SRX5054308,FOSL2,293
chr1,66944670,66944917,SRX5075174,SMARCA4,247
chr1,66944767,66945005,SRX5020214,SMARCA2,238
chr1,66995806,66996464,SRX16500059,CTCF,658
chr1,66995994,66996451,SRX16500061,CTCF,457
chr1,66995999,66996442,SRX16500060,CTCF,443
chr1,66996029,66996456,SRX16500062,CTCF,427
chr1,66996082,66996366,SRX5075174,SMARCA4,284
chr1,66996127,66996367,SRX5075176,SMARCA4,240
chr1,66996133,66996351,SRX5075170,SMARCA4,218
chr1,67013625,67013864,SRX5054309,FOSL2,239
chr1,67019557,67020254,SRX5075169,SMARCA4,697
chr1,67019594,67020081,SRX5054309,FOSL2,487
chr1,67019650,67020229,SRX5075176,SMARCA4,579
chr1,67019667,67020160,SRX5075170,SMARCA4,493
chr1,67019668,67020159,SRX5075174,SMARCA4,491
chr1,67019680,67020026,SRX5020211,SMARCA2,346
chr1,67019686,67020131,SRX5075168,SMARCA4,445
chr1,67019709,67020174,SRX5075175,SMARCA4,465
chr1,67019711,67020035,SRX5054308,FOSL2,324
chr1,67019727,67020202,SRX5716470,SMARCA4,475
chr1,67019738,67020049,SRX5716469,SMARCA4,311
chr1,67019815,67020112,SRX5716467,SMARCA2,297
chr1,67019819,67020042,SRX5075181,SMARCA2,223
chr1,67019852,67020072,SRX5716468,SMARCA2,220
chr1,67053470,67053803,SRX5075170,SMARCA4,333
chr1,67053472,67053866,SRX5716470,SMARCA4,394
chr1,67053506,67053717,SRX5075176,SMARCA4,211
chr1,67053586,67053773,SRX5075175,SMARCA4,187
chr1,67053590,67054513,SRX20140895,INTS13,923
chr1,67053725,67054354,SRX20140868,INTS10,629
chr1,67053784,67054226,SRX20140897,INTS13,442
chr1,67053792,67054014,SRX20140867,INTS10,222
chr1,67053862,67054257,SRX20140879,CPSF3L,395
chr1,67053896,67054214,SRX20140869,INTS10,318
chr1,67054312,67054589,SRX5075174,SMARCA4,277
chr1,67054337,67054608,SRX5075168,SMARCA4,271
chr1,67058276,67058534,SRX5075168,SMARCA4,258
chr1,67058323,67058648,SRX5075174,SMARCA4,325
chr1,67058391,67058609,SRX5716463,SMARCA4,218
chr1,67060700,67061096,SRX5075176,SMARCA4,396
chr1,67060739,67061082,SRX5075175,SMARCA4,343
chr1,67060749,67061122,SRX5054309,FOSL2,373
chr1,67060763,67061142,SRX5075169,SMARCA4,379
chr1,67060774,67061071,SRX5075170,SMARCA4,297
chr1,67060784,67061093,SRX5054308,FOSL2,309
chr1,67060815,67061041,SRX5020214,SMARCA2,226
chr1,67060819,67061109,SRX5716469,SMARCA4,290
chr1,67060838,67061017,SRX5075182,SMARCA2,179
chr1,67097349,67097542,SRX5075176,SMARCA4,193
chr1,67097356,67097613,SRX5075168,SMARCA4,257
chr1,67097358,67097685,SRX5075174,SMARCA4,327
chr1,67097392,67097567,SRX5075170,SMARCA4,175
chr1,67097463,67097667,SRX5716463,SMARCA4,204
chr1,67134910,67135144,SRX5075174,SMARCA4,234
chr1,67135341,67135689,SRX5716470,SMARCA4,348
chr1,67149093,67149530,SRX4174629,CTCF,437
chr1,67149093,67149620,SRX16500059,CTCF,527
chr1,67149100,67149584,SRX16500060,CTCF,484
chr1,67149130,67149342,SRX5716469,SMARCA4,212
chr1,67149143,67149568,SRX16500061,CTCF,425
chr1,67149165,67149415,SRX5075169,SMARCA4,250
chr1,67149180,67149485,SRX5075170,SMARCA4,305
chr1,67149191,67149512,SRX16500062,CTCF,321
chr1,67149219,67149500,SRX5075174,SMARCA4,281
chr1,67149225,67149412,SRX5075175,SMARCA4,187
chr1,67149244,67149535,SRX5075176,SMARCA4,291
chr1,67149247,67149471,SRX5075168,SMARCA4,224
chr1,67172209,67172439,SRX5054309,FOSL2,230
chr1,67193922,67194611,SRX5075174,SMARCA4,689
chr1,67194085,67194425,SRX5075168,SMARCA4,340
chr1,67194134,67194568,SRX5716463,SMARCA4,434
chr1,67194181,67194522,SRX5716464,SMARCA4,341
chr1,67201974,67202157,SRX5054308,FOSL2,183
chr1,67201980,67202228,SRX5054309,FOSL2,248
chr1,67211552,67211955,SRX16500061,CTCF,403
chr1,67211581,67211979,SRX16500059,CTCF,398
chr1,67211592,67211951,SRX16500062,CTCF,359
chr1,67211597,67211999,SRX16500060,CTCF,402
chr1,67214392,67214729,SRX16500060,CTCF,337
chr1,67214432,67214707,SRX16500062,CTCF,275
chr1,67214437,67214742,SRX16500059,CTCF,305
chr1,67214460,67214717,SRX16500061,CTCF,257
chr1,67227313,67227511,SRX5054309,FOSL2,198
chr1,67233999,67234435,SRX16500059,CTCF,436
chr1,67234011,67234376,SRX16500061,CTCF,365
chr1,67234031,67234340,SRX16500060,CTCF,309
chr1,67234075,67234328,SRX16500062,CTCF,253
chr1,67290245,67290596,SRX5075174,SMARCA4,351
chr1,67290298,67290693,SRX5075168,SMARCA4,395
chr1,67307560,67307993,SRX5075168,SMARCA4,433
chr1,67307689,67307999,SRX5075174,SMARCA4,310
chr1,67307748,67307931,SRX5075169,SMARCA4,183
chr1,67339671,67339987,SRX5075175,SMARCA4,316
chr1,67339710,67340035,SRX5716469,SMARCA4,325
chr1,67339727,67340064,SRX5075169,SMARCA4,337
chr1,67339730,67339982,SRX5075176,SMARCA4,252
chr1,67339735,67340011,SRX5075170,SMARCA4,276
chr1,67339740,67340015,SRX5054309,FOSL2,275
chr1,67339750,67339973,SRX5054308,FOSL2,223
chr1,67340109,67340332,SRX5054308,FOSL2,223
chr1,67340118,67340313,SRX5075176,SMARCA4,195
chr1,67347574,67348056,SRX16500060,CTCF,482
chr1,67347650,67348150,SRX16500059,CTCF,500
chr1,67347683,67348170,SRX16500062,CTCF,487
chr1,67347707,67348127,SRX16500061,CTCF,420
chr1,67347708,67348151,SRX4174629,CTCF,443
chr1,67347793,67348292,SRX5075175,SMARCA4,499
chr1,67347911,67348343,SRX5716469,SMARCA4,432
chr1,67347922,67348284,SRX5054309,FOSL2,362
chr1,67347928,67348377,SRX5075170,SMARCA4,449
chr1,67347959,67348264,SRX5054308,FOSL2,305
chr1,67347981,67348373,SRX5075169,SMARCA4,392
chr1,67348077,67348311,SRX5075176,SMARCA4,234
chr1,67355837,67356033,SRX5054309,FOSL2,196
chr1,67390013,67390727,SRX5075169,SMARCA4,714
chr1,67390055,67390492,SRX5075176,SMARCA4,437
chr1,67390061,67390336,SRX5020214,SMARCA2,275
chr1,67390079,67390658,SRX5054309,FOSL2,579
chr1,67390101,67390544,SRX5716470,SMARCA4,443
chr1,67390103,67390431,SRX5716469,SMARCA4,328
chr1,67390117,67390442,SRX5075175,SMARCA4,325
chr1,67390125,67390433,SRX5054308,FOSL2,308
chr1,67390174,67390352,SRX5075170,SMARCA4,178
chr1,67390203,67390466,SRX5716459,Epitope tags,263
chr1,67390207,67390557,SRX5716460,Epitope tags,350
chr1,67390406,67390704,SRX5075170,SMARCA4,298
chr1,67390520,67390716,SRX5075175,SMARCA4,196
chr1,67400019,67400289,SRX5075174,SMARCA4,270
chr1,67400079,67400302,SRX5075170,SMARCA4,223
chr1,67400095,67400340,SRX5075168,SMARCA4,245
chr1,67400102,67400361,SRX5054308,FOSL2,259
chr1,67400106,67400304,SRX5054307,FOSL2,198
chr1,67400106,67400355,SRX5075176,SMARCA4,249
chr1,67400115,67400358,SRX5054309,FOSL2,243
chr1,67400138,67400352,SRX5075169,SMARCA4,214
chr1,67430118,67431165,SRX20140895,INTS13,1047
chr1,67430192,67430869,SRX20140868,INTS10,677
chr1,67430203,67430500,SRX20140897,INTS13,297
chr1,67430219,67430486,SRX20140869,INTS10,267
chr1,67430310,67430838,SRX20140867,INTS10,528
chr1,67430365,67430589,SRX5075176,SMARCA4,224
chr1,67430379,67430665,SRX5075168,SMARCA4,286
chr1,67430398,67430693,SRX5075174,SMARCA4,295
chr1,67430643,67431000,SRX20140879,CPSF3L,357
chr1,67430957,67431191,SRX5075168,SMARCA4,234
chr1,67434603,67434819,SRX5075170,SMARCA4,216
chr1,67434613,67434788,SRX5075176,SMARCA4,175
chr1,67441223,67441622,SRX5075176,SMARCA4,399
chr1,67441264,67441616,SRX5075170,SMARCA4,352
chr1,67441268,67441564,SRX5716470,SMARCA4,296
chr1,67441297,67441619,SRX5075175,SMARCA4,322
chr1,67441312,67441640,SRX5075169,SMARCA4,328
chr1,67463673,67463845,SRX5075170,SMARCA4,172
chr1,67463713,67463892,SRX5075168,SMARCA4,179
chr1,67469541,67469898,SRX5075170,SMARCA4,357
chr1,67469594,67469885,SRX5075176,SMARCA4,291
chr1,67484497,67484824,SRX5075170,SMARCA4,327
chr1,67484535,67484822,SRX5075176,SMARCA4,287
chr1,67484567,67484770,SRX5075169,SMARCA4,203
chr1,67500339,67500880,SRX16500059,CTCF,541
chr1,67500380,67500877,SRX16500060,CTCF,497
chr1,67500385,67500850,SRX16500061,CTCF,465
chr1,67500388,67500807,SRX4174629,CTCF,419
chr1,67500415,67500845,SRX16500062,CTCF,430
chr1,67500432,67500715,SRX5075170,SMARCA4,283
chr1,67500434,67500780,SRX5075174,SMARCA4,346
chr1,67500436,67500717,SRX5716469,SMARCA4,281
chr1,67500444,67500741,SRX5716470,SMARCA4,297
chr1,67500448,67500875,SRX5075176,SMARCA4,427
chr1,67500455,67500769,SRX5716464,SMARCA4,314
chr1,67500462,67500784,SRX5075168,SMARCA4,322
chr1,67500499,67500808,SRX5075169,SMARCA4,309
chr1,67500513,67500797,SRX5075175,SMARCA4,284
chr1,67500555,67500772,SRX5716463,SMARCA4,217
chr1,67521926,67522110,SRX5075170,SMARCA4,184
chr1,67532331,67532776,SRX16500061,CTCF,445
chr1,67532359,67532785,SRX16500060,CTCF,426
chr1,67532374,67532779,SRX16500062,CTCF,405
chr1,67532378,67532756,SRX16500059,CTCF,378
chr1,67532458,67532734,SRX5075174,SMARCA4,276
chr1,67532511,67532749,SRX5075176,SMARCA4,238
chr1,67532515,67532736,SRX5075168,SMARCA4,221
chr1,67532517,67532703,SRX5075170,SMARCA4,186
chr1,67532551,67532787,SRX4174629,CTCF,236
chr1,67534724,67535010,SRX5054308,FOSL2,286
chr1,67534739,67534930,SRX5054309,FOSL2,191
chr1,67534763,67534950,SRX5075176,SMARCA4,187
chr1,67534777,67534998,SRX5075170,SMARCA4,221
chr1,67534781,67534961,SRX5075169,SMARCA4,180
chr1,67535365,67535807,SRX16500059,CTCF,442
chr1,67535380,67535806,SRX16500060,CTCF,426
chr1,67535389,67535741,SRX16500062,CTCF,352
chr1,67535425,67535800,SRX16500061,CTCF,375
chr1,67535430,67535701,SRX5075168,SMARCA4,271
chr1,67535450,67535671,SRX4174629,CTCF,221
chr1,67535482,67535726,SRX5075174,SMARCA4,244
chr1,67535504,67535684,SRX5075169,SMARCA4,180
chr1,67535538,67535712,SRX5075170,SMARCA4,174
chr1,67535538,67535748,SRX5075176,SMARCA4,210
chr1,67535559,67535770,SRX5075175,SMARCA4,211
chr1,67561529,67562050,SRX16500059,CTCF,521
chr1,67561597,67562028,SRX16500060,CTCF,431
chr1,67561599,67562008,SRX16500061,CTCF,409
chr1,67561602,67562037,SRX16500062,CTCF,435
chr1,67561663,67562039,SRX5075168,SMARCA4,376
chr1,67561677,67561987,SRX5716463,SMARCA4,310
chr1,67561690,67562026,SRX5075174,SMARCA4,336
chr1,67561697,67561937,SRX5716464,SMARCA4,240
chr1,67561706,67562003,SRX5075170,SMARCA4,297
chr1,67561729,67561992,SRX5075176,SMARCA4,263
chr1,67561730,67561966,SRX5075169,SMARCA4,236
chr1,67561730,67562003,SRX5716469,SMARCA4,273
chr1,67561741,67561978,SRX4174629,CTCF,237
chr1,67561743,67562031,SRX5716470,SMARCA4,288
chr1,67561749,67561973,SRX5075175,SMARCA4,224
chr1,67570467,67570735,SRX5054309,FOSL2,268
chr1,67570569,67570835,SRX5054308,FOSL2,266
chr1,67575994,67576174,SRX5075176,SMARCA4,180
chr1,67583013,67583311,SRX5075170,SMARCA4,298
chr1,67583107,67583439,SRX5075176,SMARCA4,332
chr1,67583136,67583337,SRX5075169,SMARCA4,201
chr1,67583471,67583735,SRX5075169,SMARCA4,264
chr1,67618699,67619017,SRX5075176,SMARCA4,318
chr1,67618749,67619004,SRX5075170,SMARCA4,255
chr1,67618763,67619013,SRX5075175,SMARCA4,250
chr1,67618795,67619046,SRX5075169,SMARCA4,251
chr1,67618798,67619036,SRX5716469,SMARCA4,238
chr1,67626495,67626878,SRX5075176,SMARCA4,383
chr1,67626511,67626844,SRX5054308,FOSL2,333
chr1,67626549,67626910,SRX5075170,SMARCA4,361
chr1,67626552,67626846,SRX5075175,SMARCA4,294
chr1,67626581,67626857,SRX5054309,FOSL2,276
chr1,67626627,67626843,SRX5075169,SMARCA4,216
chr1,67629728,67630081,SRX5075170,SMARCA4,353
chr1,67629732,67630004,SRX5075176,SMARCA4,272
chr1,67642639,67643104,SRX5075174,SMARCA4,465
chr1,67642690,67643094,SRX5075168,SMARCA4,404
chr1,67642709,67643073,SRX5716463,SMARCA4,364
chr1,67646070,67646389,SRX5075176,SMARCA4,319
chr1,67646359,67646696,SRX5075174,SMARCA4,337
chr1,67646386,67646681,SRX5075168,SMARCA4,295
chr1,67674536,67674799,SRX5075176,SMARCA4,263
chr1,67674546,67674895,SRX5075170,SMARCA4,349
chr1,67682634,67682860,SRX5054309,FOSL2,226
chr1,67683412,67683595,SRX5054308,FOSL2,183
chr1,67684814,67685361,SRX5075174,SMARCA4,547
chr1,67684834,67685401,SRX5075168,SMARCA4,567
chr1,67684887,67685300,SRX5716463,SMARCA4,413
chr1,67684891,67685286,SRX5716464,SMARCA4,395
chr1,67684897,67685368,SRX5075170,SMARCA4,471
chr1,67684981,67685513,SRX20140895,INTS13,532
chr1,67684983,67685326,SRX5075176,SMARCA4,343
chr1,67685017,67685231,SRX5054307,FOSL2,214
chr1,67685021,67685290,SRX5716470,SMARCA4,269
chr1,67685046,67685318,SRX5716454,SOX3,272
chr1,67685050,67685481,SRX20140868,INTS10,431
chr1,67685068,67685291,SRX5716451,SOX2,223
chr1,67685075,67685445,SRX20140897,INTS13,370
chr1,67685079,67685448,SRX20140879,CPSF3L,369
chr1,67685100,67685543,SRX20140867,INTS10,443
chr1,67685138,67685501,SRX20140881,CPSF3L,363
chr1,67686136,67686591,SRX20140895,INTS13,455
chr1,67686698,67687021,SRX5054308,FOSL2,323
chr1,67686727,67687044,SRX5054309,FOSL2,317
chr1,67686728,67687024,SRX5075170,SMARCA4,296
chr1,67686731,67687064,SRX5075169,SMARCA4,333
chr1,67686739,67687060,SRX5075176,SMARCA4,321
chr1,67686768,67686966,SRX5075174,SMARCA4,198
chr1,67686768,67687002,SRX5075168,SMARCA4,234
chr1,67686788,67686994,SRX5075175,SMARCA4,206
chr1,67700690,67701053,SRX5075175,SMARCA4,363
chr1,67700749,67701087,SRX5075176,SMARCA4,338
chr1,67700788,67701064,SRX5054309,FOSL2,276
chr1,67700795,67701065,SRX5054308,FOSL2,270
chr1,67700799,67701077,SRX5075174,SMARCA4,278
chr1,67700806,67701097,SRX5075170,SMARCA4,291
chr1,67700821,67701071,SRX5075169,SMARCA4,250
chr1,67700847,67701095,SRX5716469,SMARCA4,248
chr1,67700869,67701087,SRX5075168,SMARCA4,218
chr1,67700899,67701134,SRX5716470,SMARCA4,235
chr1,67700930,67701222,SRX16500061,CTCF,292
chr1,67700951,67701205,SRX16500059,CTCF,254
chr1,67710362,67710588,SRX5716469,SMARCA4,226
chr1,67710379,67710780,SRX5075170,SMARCA4,401
chr1,67710386,67710793,SRX5075176,SMARCA4,407
chr1,67710390,67710845,SRX5075169,SMARCA4,455
chr1,67710471,67710704,SRX5716470,SMARCA4,233
chr1,67710471,67710800,SRX5075175,SMARCA4,329
chr1,67713384,67713742,SRX5075176,SMARCA4,358
chr1,67713391,67713743,SRX5075169,SMARCA4,352
chr1,67713406,67713776,SRX5075170,SMARCA4,370
chr1,67713407,67713734,SRX5075175,SMARCA4,327
chr1,67723751,67723948,SRX5054309,FOSL2,197
chr1,67724912,67725343,SRX5075170,SMARCA4,431
chr1,67724921,67725297,SRX5716469,SMARCA4,376
chr1,67724945,67725324,SRX5075169,SMARCA4,379
chr1,67724953,67725308,SRX5716470,SMARCA4,355
chr1,67724958,67725292,SRX5716467,SMARCA2,334
chr1,67724964,67725343,SRX5075175,SMARCA4,379
chr1,67724968,67725366,SRX5075176,SMARCA4,398
chr1,67724989,67725285,SRX5020211,SMARCA2,296
chr1,67725029,67725209,SRX5054308,FOSL2,180
chr1,67725031,67725225,SRX5075181,SMARCA2,194
chr1,67725039,67725268,SRX5716468,SMARCA2,229
chr1,67732840,67733014,SRX5075170,SMARCA4,174
chr1,67735859,67736653,SRX5075176,SMARCA4,794
chr1,67735860,67736671,SRX5075170,SMARCA4,811
chr1,67735882,67736716,SRX5075168,SMARCA4,834
chr1,67735920,67736578,SRX5716470,SMARCA4,658
chr1,67735921,67736379,SRX5054309,FOSL2,458
chr1,67735924,67736655,SRX5075175,SMARCA4,731
chr1,67735933,67736676,SRX5075169,SMARCA4,743
chr1,67735950,67736569,SRX5716469,SMARCA4,619
chr1,67735965,67736284,SRX5054308,FOSL2,319
chr1,67735987,67736290,SRX5716468,SMARCA2,303
chr1,67736009,67736379,SRX5716467,SMARCA2,370
chr1,67736194,67736671,SRX5075174,SMARCA4,477
chr1,67748708,67749003,SRX5075170,SMARCA4,295
chr1,67749775,67750671,SRX5075176,SMARCA4,896
chr1,67749816,67750118,SRX5054309,FOSL2,302
chr1,67749880,67750070,SRX5075169,SMARCA4,190
chr1,67749881,67750488,SRX5075175,SMARCA4,607
chr1,67749975,67750366,SRX5716469,SMARCA4,391
chr1,67750079,67750359,SRX5075174,SMARCA4,280
chr1,67750092,67750485,SRX5716470,SMARCA4,393
chr1,67750102,67750321,SRX5716467,SMARCA2,219
chr1,67750109,67750506,SRX5075170,SMARCA4,397
chr1,67750123,67750489,SRX5075169,SMARCA4,366
chr1,67750124,67750330,SRX5054308,FOSL2,206
chr1,67760147,67760643,SRX16500061,CTCF,496
chr1,67760150,67760426,SRX5075175,SMARCA4,276
chr1,67760161,67760665,SRX16500060,CTCF,504
chr1,67760165,67760681,SRX16500059,CTCF,516
chr1,67760168,67760675,SRX16500062,CTCF,507
chr1,67760187,67760479,SRX5075174,SMARCA4,292
chr1,67760194,67760594,SRX4174629,CTCF,400
chr1,67760266,67760496,SRX5075176,SMARCA4,230
chr1,67760270,67760463,SRX5075169,SMARCA4,193
chr1,67760283,67760505,SRX5075170,SMARCA4,222
chr1,67760350,67760561,SRX5075168,SMARCA4,211
chr1,67766148,67766567,SRX16500059,CTCF,419
chr1,67766156,67766614,SRX16500060,CTCF,458
chr1,67766158,67766503,SRX5716464,SMARCA4,345
chr1,67766161,67766656,SRX5075176,SMARCA4,495
chr1,67766161,67766798,SRX5075170,SMARCA4,637
chr1,67766164,67766546,SRX16500062,CTCF,382
chr1,67766166,67766530,SRX16500061,CTCF,364
chr1,67766172,67766756,SRX5075174,SMARCA4,584
chr1,67766190,67766588,SRX5075168,SMARCA4,398
chr1,67766202,67766537,SRX4174629,CTCF,335
chr1,67766213,67766583,SRX5075169,SMARCA4,370
chr1,67766229,67766688,SRX5716469,SMARCA4,459
chr1,67766255,67766559,SRX5075175,SMARCA4,304
chr1,67766257,67766572,SRX5716470,SMARCA4,315
chr1,67766267,67766524,SRX5716463,SMARCA4,257
chr1,67766318,67766594,SRX5054309,FOSL2,276
chr1,67766401,67766601,SRX5020211,SMARCA2,200
chr1,67766614,67766919,SRX5075175,SMARCA4,305
chr1,67771932,67772171,SRX5075181,SMARCA2,239
chr1,67773571,67773754,SRX5054309,FOSL2,183
chr1,67777543,67777760,SRX5716470,SMARCA4,217
chr1,67785834,67786208,SRX5075176,SMARCA4,374
chr1,67785893,67786339,SRX5075170,SMARCA4,446
chr1,67785983,67786173,SRX5075175,SMARCA4,190
chr1,67786015,67786212,SRX5075169,SMARCA4,197
chr1,67791667,67792121,SRX5075175,SMARCA4,454
chr1,67791712,67792028,SRX5054309,FOSL2,316
chr1,67791713,67791957,SRX5075176,SMARCA4,244
chr1,67791732,67792002,SRX5716469,SMARCA4,270
chr1,67791733,67792013,SRX5075170,SMARCA4,280
chr1,67791745,67792006,SRX5054308,FOSL2,261
chr1,67791749,67791981,SRX5075169,SMARCA4,232
chr1,67792811,67793088,SRX5075168,SMARCA4,277
chr1,67792819,67793172,SRX5075174,SMARCA4,353
chr1,67792870,67793157,SRX5716463,SMARCA4,287
chr1,67792887,67793097,SRX5716464,SMARCA4,210
chr1,67793620,67793889,SRX5716470,SMARCA4,269
chr1,67793632,67793813,SRX5075169,SMARCA4,181
chr1,67793701,67793902,SRX5075168,SMARCA4,201
chr1,67793707,67793957,SRX5054309,FOSL2,250
chr1,67793712,67793899,SRX5075175,SMARCA4,187
chr1,67793725,67793894,SRX5075170,SMARCA4,169
chr1,67793735,67793965,SRX5075176,SMARCA4,230
chr1,67793762,67793950,SRX5075174,SMARCA4,188
chr1,67823381,67823783,SRX5075176,SMARCA4,402
chr1,67831911,67832353,SRX5075170,SMARCA4,442
chr1,67831970,67832317,SRX5075174,SMARCA4,347
chr1,67832016,67832286,SRX20140869,INTS10,270
chr1,67832052,67832428,SRX20140895,INTS13,376
chr1,67832064,67832317,SRX5075176,SMARCA4,253
chr1,67833291,67833601,SRX5075174,SMARCA4,310
chr1,67833299,67833511,SRX5075176,SMARCA4,212
chr1,67833370,67833565,SRX5075175,SMARCA4,195
chr1,67833389,67833628,SRX5075168,SMARCA4,239
chr1,67840442,67840904,SRX5075175,SMARCA4,462
chr1,67840469,67840818,SRX5075170,SMARCA4,349
chr1,67840481,67840854,SRX5075176,SMARCA4,373
chr1,67840490,67840820,SRX5716469,SMARCA4,330
chr1,67840492,67840840,SRX5054309,FOSL2,348
chr1,67840496,67840914,SRX5075169,SMARCA4,418
chr1,67840500,67840805,SRX5054308,FOSL2,305
chr1,67840510,67840779,SRX5716467,SMARCA2,269
chr1,67840547,67840773,SRX5716468,SMARCA2,226
chr1,67840556,67840747,SRX5075168,SMARCA4,191
chr1,67840562,67840735,SRX5075174,SMARCA4,173
chr1,67840564,67840864,SRX5716470,SMARCA4,300
chr1,67840578,67840776,SRX5075181,SMARCA2,198
chr1,67850022,67850462,SRX16500059,CTCF,440
chr1,67850024,67850427,SRX16500060,CTCF,403
chr1,67850024,67850430,SRX16500061,CTCF,406
chr1,67850051,67850457,SRX16500062,CTCF,406
chr1,67850107,67850329,SRX5075176,SMARCA4,222
chr1,67850125,67850358,SRX5075174,SMARCA4,233
chr1,67850153,67850343,SRX5075170,SMARCA4,190
chr1,67850609,67850943,SRX5075170,SMARCA4,334
chr1,67850647,67850956,SRX5075175,SMARCA4,309
chr1,67850694,67850936,SRX5075176,SMARCA4,242
chr1,67850695,67850959,SRX5054308,FOSL2,264
chr1,67850704,67850981,SRX5075169,SMARCA4,277
chr1,67850707,67850977,SRX5054309,FOSL2,270
chr1,67853603,67854044,SRX16500059,CTCF,441
chr1,67853604,67854016,SRX16500061,CTCF,412
chr1,67853616,67854052,SRX16500060,CTCF,436
chr1,67853626,67854017,SRX16500062,CTCF,391
chr1,67853660,67854014,SRX4174629,CTCF,354
chr1,67853763,67854033,SRX5075174,SMARCA4,270
chr1,67853782,67854016,SRX5075168,SMARCA4,234
chr1,67855951,67856193,SRX5075170,SMARCA4,242
chr1,67856000,67856432,SRX5075174,SMARCA4,432
chr1,67856014,67856334,SRX5075168,SMARCA4,320
chr1,67856023,67856259,SRX5075176,SMARCA4,236
chr1,67880264,67880558,SRX5054308,FOSL2,294
chr1,67880274,67880561,SRX5075176,SMARCA4,287
chr1,67880278,67880575,SRX5054309,FOSL2,297
chr1,67880356,67880634,SRX5075170,SMARCA4,278
chr1,67880386,67880587,SRX5075169,SMARCA4,201
chr1,67883094,67883478,SRX5054309,FOSL2,384
chr1,67883104,67883496,SRX5075176,SMARCA4,392
chr1,67883120,67883527,SRX5075169,SMARCA4,407
chr1,67883129,67883496,SRX5054308,FOSL2,367
chr1,67883130,67883501,SRX5075170,SMARCA4,371
chr1,67883145,67883545,SRX5075175,SMARCA4,400
chr1,67883163,67883409,SRX5716469,SMARCA4,246
chr1,67883227,67883477,SRX5020214,SMARCA2,250
chr1,67888646,67888968,SRX5075174,SMARCA4,322
chr1,67888762,67889026,SRX5075169,SMARCA4,264
chr1,67888781,67888960,SRX5075176,SMARCA4,179
chr1,67888797,67889124,SRX5716469,SMARCA4,327
chr1,67888826,67889129,SRX5716470,SMARCA4,303
chr1,67888865,67889069,SRX5054309,FOSL2,204
chr1,67888875,67889101,SRX5075170,SMARCA4,226
chr1,67889918,67890453,SRX5075175,SMARCA4,535
chr1,67889921,67890474,SRX5075176,SMARCA4,553
chr1,67889926,67890321,SRX5054308,FOSL2,395
chr1,67889943,67890399,SRX5075169,SMARCA4,456
chr1,67889944,67890389,SRX5075168,SMARCA4,445
chr1,67889946,67890288,SRX5075174,SMARCA4,342
chr1,67889954,67890282,SRX5075170,SMARCA4,328
chr1,67889959,67890317,SRX5054309,FOSL2,358
chr1,67889986,67890368,SRX5716470,SMARCA4,382
chr1,67889989,67890191,SRX5054307,FOSL2,202
chr1,67889992,67890277,SRX5716469,SMARCA4,285
chr1,67890077,67890352,SRX5716468,SMARCA2,275
chr1,67897632,67897832,SRX5020211,SMARCA2,200
chr1,67897707,67897943,SRX5054308,FOSL2,236
chr1,67919326,67919606,SRX5075170,SMARCA4,280
chr1,67919367,67919645,SRX5075168,SMARCA4,278
chr1,67919394,67919601,SRX5075176,SMARCA4,207
chr1,67919395,67919633,SRX5075174,SMARCA4,238
chr1,67945912,67946389,SRX5075168,SMARCA4,477
chr1,67945929,67946428,SRX5075174,SMARCA4,499
chr1,67945934,67946377,SRX5716463,SMARCA4,443
chr1,67946072,67946340,SRX5716464,SMARCA4,268
chr1,67948206,67948479,SRX5075175,SMARCA4,273
chr1,67948208,67948421,SRX5075176,SMARCA4,213
chr1,67948209,67948516,SRX5054309,FOSL2,307
chr1,67948234,67948431,SRX5054308,FOSL2,197
chr1,67948261,67948484,SRX5075169,SMARCA4,223
chr1,67948298,67948540,SRX5716469,SMARCA4,242
chr1,67957046,67957485,SRX5075170,SMARCA4,439
chr1,67957097,67957624,SRX5075176,SMARCA4,527
chr1,67970031,67970482,SRX5075170,SMARCA4,451
chr1,67970042,67970536,SRX5075169,SMARCA4,494
chr1,67970050,67970514,SRX5075176,SMARCA4,464
chr1,67970073,67970489,SRX5075175,SMARCA4,416
chr1,67970076,67970409,SRX5054308,FOSL2,333
chr1,67970087,67970485,SRX5054309,FOSL2,398
chr1,67970101,67970494,SRX5716469,SMARCA4,393
chr1,67970131,67970479,SRX5716467,SMARCA2,348
chr1,67978987,67979508,SRX5054309,FOSL2,521
chr1,67979028,67979623,SRX5075175,SMARCA4,595
chr1,67979116,67979579,SRX5075169,SMARCA4,463
chr1,67979120,67979502,SRX5716469,SMARCA4,382
chr1,67979149,67979508,SRX5075176,SMARCA4,359
chr1,67979149,67979513,SRX5054308,FOSL2,364
chr1,67979287,67979510,SRX5075174,SMARCA4,223
chr1,67979289,67979645,SRX5075170,SMARCA4,356
chr1,67979331,67979537,SRX5075168,SMARCA4,206
chr1,67987239,67987809,SRX5075169,SMARCA4,570
chr1,67987242,67987741,SRX5716469,SMARCA4,499
chr1,67987278,67987617,SRX5054308,FOSL2,339
chr1,67987296,67987844,SRX5075175,SMARCA4,548
chr1,67987334,67987749,SRX5075176,SMARCA4,415
chr1,67987358,67987759,SRX5054309,FOSL2,401
chr1,67987365,67987657,SRX5716467,SMARCA2,292
chr1,67987371,67987736,SRX5716470,SMARCA4,365
chr1,67987394,67987723,SRX5020214,SMARCA2,329
chr1,67987407,67987784,SRX5075170,SMARCA4,377
chr1,67987416,67987706,SRX5020211,SMARCA2,290
chr1,67987425,67987656,SRX5716468,SMARCA2,231
chr1,68010165,68010484,SRX16500060,CTCF,319
chr1,68010170,68010498,SRX16500059,CTCF,328
chr1,68010243,68010462,SRX16500061,CTCF,219
chr1,68011862,68012233,SRX5075168,SMARCA4,371
chr1,68011965,68012248,SRX5075174,SMARCA4,283
chr1,68011974,68012203,SRX5075169,SMARCA4,229
chr1,68051596,68051894,SRX16500060,CTCF,298
chr1,68051609,68051808,SRX5075176,SMARCA4,199
chr1,68051610,68051909,SRX16500062,CTCF,299
chr1,68093795,68094023,SRX5054309,FOSL2,228
chr1,68093804,68094064,SRX5075170,SMARCA4,260
chr1,68093831,68094074,SRX5075176,SMARCA4,243
chr1,68093854,68094038,SRX5054308,FOSL2,184
chr1,68104029,68104591,SRX5075176,SMARCA4,562
chr1,68104071,68104577,SRX5075169,SMARCA4,506
chr1,68104080,68104586,SRX5075170,SMARCA4,506
chr1,68104129,68104543,SRX5075175,SMARCA4,414
chr1,68104133,68104543,SRX5716470,SMARCA4,410
chr1,68104139,68104527,SRX5020211,SMARCA2,388
chr1,68104139,68104550,SRX5054308,FOSL2,411
chr1,68104149,68104579,SRX5054309,FOSL2,430
chr1,68104157,68104513,SRX5716469,SMARCA4,356
chr1,68104185,68104466,SRX5075168,SMARCA4,281
chr1,68104241,68104543,SRX5075174,SMARCA4,302
chr1,68111745,68112132,SRX16500059,CTCF,387
chr1,68111779,68112127,SRX4174629,CTCF,348
chr1,68111830,68112108,SRX5716469,SMARCA4,278
chr1,68111837,68112237,SRX5075176,SMARCA4,400
chr1,68111839,68112056,SRX5716470,SMARCA4,217
chr1,68111840,68112180,SRX16500060,CTCF,340
chr1,68111850,68112132,SRX16500061,CTCF,282
chr1,68111875,68112066,SRX5075168,SMARCA4,191
chr1,68111877,68112251,SRX5075170,SMARCA4,374
chr1,68111893,68112186,SRX5075175,SMARCA4,293
chr1,68111896,68112120,SRX16500062,CTCF,224
chr1,68111904,68112225,SRX5075169,SMARCA4,321
chr1,68112732,68113308,SRX5075170,SMARCA4,576
chr1,68112804,68113223,SRX5075176,SMARCA4,419
chr1,68112926,68113207,SRX5716469,SMARCA4,281
chr1,68112977,68113313,SRX5075175,SMARCA4,336
chr1,68113007,68113325,SRX5054309,FOSL2,318
chr1,68113026,68113296,SRX5054308,FOSL2,270
chr1,68116615,68117059,SRX16500060,CTCF,444
chr1,68116619,68117047,SRX16500061,CTCF,428
chr1,68116624,68117063,SRX16500059,CTCF,439
chr1,68116640,68117025,SRX16500062,CTCF,385
chr1,68116722,68116899,SRX5075174,SMARCA4,177
chr1,68116781,68116960,SRX5075168,SMARCA4,179
chr1,68116835,68117117,SRX4174629,CTCF,282
chr1,68120117,68120566,SRX16500059,CTCF,449
chr1,68120122,68120622,SRX16500060,CTCF,500
chr1,68120146,68120573,SRX16500061,CTCF,427
chr1,68120180,68120550,SRX16500062,CTCF,370
chr1,68120271,68120499,SRX5075176,SMARCA4,228
chr1,68120271,68120502,SRX4174629,CTCF,231
chr1,68120271,68120625,SRX5075168,SMARCA4,354
chr1,68120304,68120484,SRX5075169,SMARCA4,180
chr1,68120308,68120612,SRX5075170,SMARCA4,304
chr1,68120410,68120638,SRX5075174,SMARCA4,228
chr1,68128326,68128548,SRX5054308,FOSL2,222
chr1,68128334,68128554,SRX5054309,FOSL2,220
chr1,68132726,68132938,SRX5716469,SMARCA4,212
chr1,68132759,68133014,SRX5020211,SMARCA2,255
chr1,68132786,68133055,SRX5075170,SMARCA4,269
chr1,68132793,68133075,SRX5075176,SMARCA4,282
chr1,68132849,68133061,SRX5054308,FOSL2,212
chr1,68140774,68141950,SRX5075168,SMARCA4,1176
chr1,68140994,68142024,SRX5075174,SMARCA4,1030
chr1,68141017,68141403,SRX5075170,SMARCA4,386
chr1,68141017,68141950,SRX5716470,SMARCA4,933
chr1,68141034,68141303,SRX5020211,SMARCA2,269
chr1,68141038,68141788,SRX5716464,SMARCA4,750
chr1,68141047,68141443,SRX5716469,SMARCA4,396
chr1,68141052,68141693,SRX20140895,INTS13,641
chr1,68141064,68141519,SRX5075175,SMARCA4,455
chr1,68141065,68141668,SRX5075176,SMARCA4,603
chr1,68141084,68141810,SRX20140881,CPSF3L,726
chr1,68141104,68141582,SRX20140894,INTS13,478
chr1,68141108,68141353,SRX5075169,SMARCA4,245
chr1,68141114,68141807,SRX5716463,SMARCA4,693
chr1,68141134,68141674,SRX20140879,CPSF3L,540
chr1,68141137,68141603,SRX20140867,INTS10,466
chr1,68141139,68141718,SRX20140868,INTS10,579
chr1,68141205,68141704,SRX20140896,INTS13,499
chr1,68141206,68141414,SRX5716454,SOX3,208
chr1,68141211,68141599,SRX20140860,SOX2,388
chr1,68141241,68141539,SRX20140869,INTS10,298
chr1,68141303,68141705,SRX20140897,INTS13,402
chr1,68141393,68141732,SRX5716451,SOX2,339
chr1,68141512,68141958,SRX5716468,SMARCA2,446
chr1,68141571,68141964,SRX5075175,SMARCA4,393
chr1,68141770,68141972,SRX5075176,SMARCA4,202
chr1,68141911,68142173,SRX5075169,SMARCA4,262
chr1,68173461,68173701,SRX5075170,SMARCA4,240
chr1,68173490,68173670,SRX5075169,SMARCA4,180
chr1,68173865,68174515,SRX5716470,SMARCA4,650
chr1,68173944,68174501,SRX5075170,SMARCA4,557
chr1,68173958,68174555,SRX5716469,SMARCA4,597
chr1,68173963,68174516,SRX5075168,SMARCA4,553
chr1,68173970,68174521,SRX5075176,SMARCA4,551
chr1,68173987,68174413,SRX5716464,SMARCA4,426
chr1,68174022,68174446,SRX5075174,SMARCA4,424
chr1,68174022,68174495,SRX5075175,SMARCA4,473
chr1,68174024,68174452,SRX20140881,CPSF3L,428
chr1,68174026,68174481,SRX5075169,SMARCA4,455
chr1,68174037,68174412,SRX5716463,SMARCA4,375
chr1,68174047,68174451,SRX5716468,SMARCA2,404
chr1,68174077,68174600,SRX5716467,SMARCA2,523
chr1,68174080,68174321,SRX5075181,SMARCA2,241
chr1,68174088,68174370,SRX20140895,INTS13,282
chr1,68174089,68174268,SRX5075182,SMARCA2,179
chr1,68174096,68174392,SRX5054308,FOSL2,296
chr1,68174102,68174380,SRX20140867,INTS10,278
chr1,68174104,68174391,SRX5054309,FOSL2,287
chr1,68174142,68174367,SRX5020214,SMARCA2,225
chr1,68174178,68174483,SRX5020211,SMARCA2,305
chr1,68178896,68179129,SRX5054308,FOSL2,233
chr1,68178903,68179458,SRX5054309,FOSL2,555
chr1,68179138,68179415,SRX5075175,SMARCA4,277
chr1,68179156,68179428,SRX5075169,SMARCA4,272
chr1,68179291,68179466,SRX5075176,SMARCA4,175
chr1,68188287,68188495,SRX5075176,SMARCA4,208
chr1,68188327,68188539,SRX5716469,SMARCA4,212
chr1,68197866,68198126,SRX5054308,FOSL2,260
chr1,68197979,68198159,SRX5075169,SMARCA4,180
chr1,68198846,68199029,SRX5054309,FOSL2,183
chr1,68202351,68202813,SRX5075170,SMARCA4,462
chr1,68202352,68202763,SRX5075169,SMARCA4,411
chr1,68202421,68202734,SRX5075175,SMARCA4,313
chr1,68202423,68202886,SRX5075176,SMARCA4,463
chr1,68202441,68202721,SRX5716469,SMARCA4,280
chr1,68206995,68207537,SRX5075170,SMARCA4,542
chr1,68207093,68207497,SRX5075176,SMARCA4,404
chr1,68207094,68207305,SRX5075169,SMARCA4,211
chr1,68207150,68207363,SRX5075175,SMARCA4,213
chr1,68211900,68212334,SRX5075174,SMARCA4,434
chr1,68212068,68212298,SRX5075168,SMARCA4,230
chr1,68213953,68214164,SRX5075176,SMARCA4,211
chr1,68214977,68215273,SRX5075169,SMARCA4,296
chr1,68215042,68215247,SRX5075176,SMARCA4,205
chr1,68217071,68217585,SRX5075174,SMARCA4,514
chr1,68217106,68217563,SRX5716463,SMARCA4,457
chr1,68217127,68217582,SRX20140868,INTS10,455
chr1,68217129,68217645,SRX20140895,INTS13,516
chr1,68217146,68217450,SRX5716451,SOX2,304
chr1,68217148,68217620,SRX5075168,SMARCA4,472
chr1,68217221,68217442,SRX5716454,SOX3,221
chr1,68217310,68217515,SRX5716464,SMARCA4,205
chr1,68218585,68218843,SRX5075168,SMARCA4,258
chr1,68218597,68218799,SRX5075170,SMARCA4,202
chr1,68218639,68218829,SRX5075174,SMARCA4,190
chr1,68221960,68222299,SRX5075169,SMARCA4,339
chr1,68221988,68222216,SRX5054308,FOSL2,228
chr1,68222013,68222222,SRX5054309,FOSL2,209
chr1,68223926,68224173,SRX5075176,SMARCA4,247
chr1,68224014,68224183,SRX5075170,SMARCA4,169
chr1,68232079,68232768,SRX20140895,INTS13,689
chr1,68232218,68232773,SRX20140879,CPSF3L,555
chr1,68232228,68232687,SRX20140881,CPSF3L,459
chr1,68232270,68232544,SRX20140894,INTS13,274
chr1,68232280,68232677,SRX20140867,INTS10,397
chr1,68232299,68232779,SRX20140897,INTS13,480
chr1,68232362,68232685,SRX20140896,INTS13,323
chr1,68232380,68232768,SRX5075174,SMARCA4,388
chr1,68232418,68232639,SRX5075168,SMARCA4,221
chr1,68232476,68232789,SRX5075170,SMARCA4,313
chr1,68232983,68233210,SRX5075176,SMARCA4,227
chr1,68233049,68233255,SRX5075170,SMARCA4,206
chr1,68269637,68269806,SRX5075170,SMARCA4,169
chr1,68293695,68294394,SRX5716470,SMARCA4,699
chr1,68293701,68294469,SRX5075168,SMARCA4,768
chr1,68293705,68294367,SRX5075176,SMARCA4,662
chr1,68293707,68294400,SRX5075170,SMARCA4,693
chr1,68293738,68294397,SRX5075174,SMARCA4,659
chr1,68293739,68294351,SRX5075169,SMARCA4,612
chr1,68293751,68294375,SRX5716469,SMARCA4,624
chr1,68293769,68294379,SRX5075175,SMARCA4,610
chr1,68293819,68294496,SRX20140881,CPSF3L,677
chr1,68293876,68294394,SRX20140867,INTS10,518
chr1,68293901,68294367,SRX5020211,SMARCA2,466
chr1,68293908,68294381,SRX5020214,SMARCA2,473
chr1,68293939,68294324,SRX5054308,FOSL2,385
chr1,68293954,68294441,SRX5716463,SMARCA4,487
chr1,68293974,68294351,SRX5716464,SMARCA4,377
chr1,68293980,68294401,SRX5075181,SMARCA2,421
chr1,68293983,68294366,SRX5054309,FOSL2,383
chr1,68293998,68294358,SRX5075182,SMARCA2,360
chr1,68294000,68294321,SRX5716468,SMARCA2,321
chr1,68294006,68294334,SRX5716467,SMARCA2,328
chr1,68294025,68294356,SRX20140895,INTS13,331
chr1,68294056,68294339,SRX20140896,INTS13,283
chr1,68294063,68294321,SRX20140879,CPSF3L,258
chr1,68294072,68294379,SRX20140868,INTS10,307
chr1,68313632,68314535,SRX5075174,SMARCA4,903
chr1,68313641,68314592,SRX5075168,SMARCA4,951
chr1,68313701,68314283,SRX20140895,INTS13,582
chr1,68313750,68314032,SRX5716451,SOX2,282
chr1,68313823,68314121,SRX5716463,SMARCA4,298
chr1,68314357,68314545,SRX5075170,SMARCA4,188
chr1,68319953,68320415,SRX20140881,CPSF3L,462
chr1,68320020,68320369,SRX5075174,SMARCA4,349
chr1,68320065,68320303,SRX5075168,SMARCA4,238
chr1,68321012,68321520,SRX16500059,CTCF,508
chr1,68321065,68321557,SRX16500060,CTCF,492
chr1,68321079,68321496,SRX16500061,CTCF,417
chr1,68321086,68321475,SRX16500062,CTCF,389
chr1,68321092,68321420,SRX5075174,SMARCA4,328
chr1,68321105,68321430,SRX5075168,SMARCA4,325
chr1,68321127,68321346,SRX5075170,SMARCA4,219
chr1,68321151,68321421,SRX4174629,CTCF,270
chr1,68323150,68323337,SRX5075175,SMARCA4,187
chr1,68323198,68323484,SRX5716469,SMARCA4,286
chr1,68323247,68323690,SRX5716470,SMARCA4,443
chr1,68323262,68323489,SRX5075170,SMARCA4,227
chr1,68323264,68323735,SRX5075169,SMARCA4,471
chr1,68323392,68323614,SRX5075175,SMARCA4,222
chr1,68331065,68331587,SRX5075176,SMARCA4,522
chr1,68331079,68331491,SRX5054309,FOSL2,412
chr1,68331084,68331664,SRX5075170,SMARCA4,580
chr1,68331109,68331483,SRX5075175,SMARCA4,374
chr1,68331123,68331411,SRX5075174,SMARCA4,288
chr1,68331127,68331514,SRX5075169,SMARCA4,387
chr1,68331129,68331484,SRX5054308,FOSL2,355
chr1,68331148,68331569,SRX5716469,SMARCA4,421
chr1,68331181,68331407,SRX5020214,SMARCA2,226
chr1,68331189,68331471,SRX5716470,SMARCA4,282
chr1,68331191,68331520,SRX5020211,SMARCA2,329
chr1,68331201,68331504,SRX5716467,SMARCA2,303
chr1,68331220,68331433,SRX5716468,SMARCA2,213
chr1,68342680,68343149,SRX16500059,CTCF,469
chr1,68342706,68343123,SRX16500060,CTCF,417
chr1,68342721,68343123,SRX16500062,CTCF,402
chr1,68342727,68343039,SRX5075176,SMARCA4,312
chr1,68342730,68343090,SRX16500061,CTCF,360
chr1,68342742,68343018,SRX5075174,SMARCA4,276
chr1,68342754,68342981,SRX5075170,SMARCA4,227
chr1,68342762,68343054,SRX4174629,CTCF,292
chr1,68342770,68342989,SRX5716470,SMARCA4,219
chr1,68342784,68343057,SRX5075169,SMARCA4,273
chr1,68342826,68343078,SRX5075175,SMARCA4,252
chr1,68342843,68343053,SRX5075168,SMARCA4,210
chr1,68346177,68346586,SRX16500060,CTCF,409
chr1,68346181,68346570,SRX16500062,CTCF,389
chr1,68346207,68346543,SRX16500061,CTCF,336
chr1,68346223,68346612,SRX16500059,CTCF,389
chr1,68359116,68359327,SRX5716470,SMARCA4,211
chr1,68365712,68366177,SRX5075174,SMARCA4,465
chr1,68365716,68366033,SRX5075168,SMARCA4,317
chr1,68384284,68385423,SRX5075169,SMARCA4,1139
chr1,68384308,68384899,SRX5075170,SMARCA4,591
chr1,68384317,68385354,SRX5075176,SMARCA4,1037
chr1,68384324,68384863,SRX5716467,SMARCA2,539
chr1,68384332,68384854,SRX5075168,SMARCA4,522
chr1,68384336,68384995,SRX5716460,Epitope tags,659
chr1,68384341,68384991,SRX5075175,SMARCA4,650
chr1,68384347,68384892,SRX5716469,SMARCA4,545
chr1,68384348,68385264,SRX5054309,FOSL2,916
chr1,68384353,68384876,SRX5054308,FOSL2,523
chr1,68384359,68384783,SRX5020211,SMARCA2,424
chr1,68384360,68385337,SRX5075174,SMARCA4,977
chr1,68384362,68384878,SRX5716470,SMARCA4,516
chr1,68384406,68384687,SRX5716459,Epitope tags,281
chr1,68384416,68384735,SRX5054307,FOSL2,319
chr1,68384444,68384926,SRX5020214,SMARCA2,482
chr1,68384456,68384699,SRX5716453,SOX2,243
chr1,68384458,68384787,SRX5716468,SMARCA2,329
chr1,68384465,68384781,SRX5075182,SMARCA2,316
chr1,68384466,68384739,SRX5075181,SMARCA2,273
chr1,68385058,68385302,SRX5075170,SMARCA4,244
chr1,68385072,68385378,SRX5075175,SMARCA4,306
chr1,68404463,68404724,SRX5075176,SMARCA4,261
chr1,68406978,68407398,SRX5075168,SMARCA4,420
chr1,68443014,68443529,SRX16500060,CTCF,515
chr1,68443041,68443428,SRX16500061,CTCF,387
chr1,68443062,68443416,SRX16500062,CTCF,354
chr1,68443099,68443439,SRX16500059,CTCF,340
chr1,68443105,68443351,SRX5716463,SMARCA4,246
chr1,68443109,68443401,SRX5075168,SMARCA4,292
chr1,68443130,68443436,SRX5075174,SMARCA4,306
chr1,68443155,68443485,SRX5075170,SMARCA4,330
chr1,68443221,68443502,SRX5054308,FOSL2,281
chr1,68443223,68443477,SRX5075176,SMARCA4,254
chr1,68443226,68443489,SRX5054309,FOSL2,263
chr1,68443259,68443451,SRX5075169,SMARCA4,192
chr1,68449738,68450313,SRX5075176,SMARCA4,575
chr1,68449798,68450237,SRX5716470,SMARCA4,439
chr1,68449874,68450271,SRX5075170,SMARCA4,397
chr1,68453333,68453670,SRX5054309,FOSL2,337
chr1,68453337,68453636,SRX5716469,SMARCA4,299
chr1,68453369,68453552,SRX5075170,SMARCA4,183
chr1,68453379,68453559,SRX5054308,FOSL2,180
chr1,68464960,68465254,SRX5075174,SMARCA4,294
chr1,68470324,68470749,SRX16500059,CTCF,425
chr1,68470348,68470708,SRX16500061,CTCF,360
chr1,68470376,68470756,SRX16500062,CTCF,380
chr1,68470390,68470744,SRX16500060,CTCF,354
chr1,68470419,68470601,SRX5075168,SMARCA4,182
chr1,68470443,68470735,SRX5075176,SMARCA4,292
chr1,68470469,68470712,SRX5075170,SMARCA4,243
chr1,68470490,68470703,SRX5075175,SMARCA4,213
chr1,68470497,68470709,SRX5075169,SMARCA4,212
chr1,68496759,68497417,SRX20140895,INTS13,658
chr1,68496779,68497396,SRX20140868,INTS10,617
chr1,68496827,68497234,SRX20140867,INTS10,407
chr1,68496918,68497315,SRX20140897,INTS13,397
chr1,68496985,68497475,SRX5075174,SMARCA4,490
chr1,68497012,68497310,SRX5716464,SMARCA4,298
chr1,68497035,68497469,SRX5075168,SMARCA4,434
chr1,68497068,68497392,SRX5716463,SMARCA4,324
chr1,68497083,68497495,SRX5075170,SMARCA4,412
chr1,68497097,68497453,SRX5075176,SMARCA4,356
chr1,68497132,68497451,SRX5075175,SMARCA4,319
chr1,68497133,68497368,SRX5716470,SMARCA4,235
chr1,68497162,68497377,SRX5716467,SMARCA2,215
chr1,68497172,68497377,SRX5020211,SMARCA2,205
chr1,68497190,68497417,SRX5716469,SMARCA4,227
chr1,68497197,68497462,SRX5075169,SMARCA4,265
chr1,68542672,68542921,SRX5075168,SMARCA4,249
chr1,68542685,68542981,SRX5075174,SMARCA4,296
chr1,68542699,68542878,SRX5054307,FOSL2,179
chr1,68542701,68542881,SRX5054308,FOSL2,180
chr1,68551564,68551833,SRX5054309,FOSL2,269
chr1,68570968,68571209,SRX5075170,SMARCA4,241
chr1,68571489,68571907,SRX5054309,FOSL2,418
chr1,68571535,68571895,SRX5054308,FOSL2,360
chr1,68571558,68572068,SRX5075170,SMARCA4,510
chr1,68571616,68572128,SRX5075176,SMARCA4,512
chr1,68571633,68571833,SRX5075175,SMARCA4,200
chr1,68571723,68572074,SRX5075169,SMARCA4,351
chr1,68571895,68572102,SRX5075181,SMARCA2,207
chr1,68571901,68572157,SRX5716470,SMARCA4,256
chr1,68600040,68600379,SRX16500060,CTCF,339
chr1,68600109,68600358,SRX16500059,CTCF,249
chr1,68600158,68600402,SRX16500061,CTCF,244
chr1,68600171,68600400,SRX16500062,CTCF,229
chr1,68624167,68624660,SRX5075174,SMARCA4,493
chr1,68624197,68624614,SRX5716464,SMARCA4,417
chr1,68624209,68624713,SRX5075168,SMARCA4,504
chr1,68624242,68624567,SRX5716470,SMARCA4,325
chr1,68624242,68624604,SRX5075169,SMARCA4,362
chr1,68624244,68624667,SRX5075176,SMARCA4,423
chr1,68624262,68624602,SRX5075175,SMARCA4,340
chr1,68624284,68624557,SRX5716459,Epitope tags,273
chr1,68624292,68624510,SRX5716469,SMARCA4,218
chr1,68624298,68624605,SRX5075170,SMARCA4,307
chr1,68624307,68624593,SRX5716463,SMARCA4,286
chr1,68624319,68624552,SRX5054309,FOSL2,233
chr1,68624337,68624562,SRX5054307,FOSL2,225
chr1,68624343,68624530,SRX5054308,FOSL2,187
chr1,68624391,68624668,SRX5716460,Epitope tags,277
chr1,68633073,68633338,SRX5075174,SMARCA4,265
chr1,68633183,68633451,SRX5075168,SMARCA4,268
chr1,68725349,68725518,SRX5075170,SMARCA4,169
chr1,68745311,68745779,SRX5075176,SMARCA4,468
chr1,68745461,68745783,SRX5075170,SMARCA4,322
chr1,68800185,68800539,SRX5075168,SMARCA4,354
chr1,68800240,68800577,SRX5075174,SMARCA4,337
chr1,68819432,68819830,SRX16500060,CTCF,398
chr1,68819456,68819784,SRX16500061,CTCF,328
chr1,68819490,68819814,SRX16500059,CTCF,324
chr1,68819515,68819780,SRX16500062,CTCF,265
chr1,68819539,68819722,SRX5075174,SMARCA4,183
chr1,68904331,68904988,SRX5075174,SMARCA4,657
chr1,68904344,68904986,SRX5075168,SMARCA4,642
chr1,68904482,68904896,SRX5716463,SMARCA4,414
chr1,68904508,68904877,SRX5716464,SMARCA4,369
chr1,68904533,68904798,SRX5054307,FOSL2,265
chr1,68904543,68904818,SRX5054309,FOSL2,275
chr1,68904548,68904770,SRX5075170,SMARCA4,222
chr1,68904614,68904789,SRX5075176,SMARCA4,175
chr1,68916389,68916809,SRX5075176,SMARCA4,420
chr1,68916456,68916697,SRX5075168,SMARCA4,241
chr1,68916495,68916829,SRX5075170,SMARCA4,334
chr1,68916502,68916774,SRX5075175,SMARCA4,272
chr1,68916512,68916842,SRX5075169,SMARCA4,330
chr1,68916547,68916730,SRX5054309,FOSL2,183
chr1,68916572,68916745,SRX5075174,SMARCA4,173
chr1,68919182,68919392,SRX5054309,FOSL2,210
chr1,68949930,68950412,SRX5075168,SMARCA4,482
chr1,68949985,68950451,SRX5075174,SMARCA4,466
chr1,68950126,68950373,SRX5716463,SMARCA4,247
chr1,68963413,68963682,SRX5054309,FOSL2,269
chr1,68973897,68974186,SRX5054309,FOSL2,289
chr1,68973911,68974125,SRX5075176,SMARCA4,214
chr1,68973912,68974115,SRX5054308,FOSL2,203
chr1,68973912,68974161,SRX5075170,SMARCA4,249
chr1,68975555,68975882,SRX5075174,SMARCA4,327
chr1,68975646,68975906,SRX5075168,SMARCA4,260
chr1,68977250,68977483,SRX5075168,SMARCA4,233
chr1,68977270,68977596,SRX5075174,SMARCA4,326
chr1,68994098,68994321,SRX5075174,SMARCA4,223
chr1,68994147,68994368,SRX5075168,SMARCA4,221
chr1,69076692,69076871,SRX5075168,SMARCA4,179
chr1,69076777,69076965,SRX5075174,SMARCA4,188
chr1,69077711,69078038,SRX5075174,SMARCA4,327
chr1,69077735,69078247,SRX5075168,SMARCA4,512
chr1,69077741,69077971,SRX5054309,FOSL2,230
chr1,69077786,69078046,SRX5075169,SMARCA4,260
chr1,69077802,69078061,SRX5075175,SMARCA4,259
chr1,69077809,69078054,SRX5075170,SMARCA4,245
chr1,69077818,69078037,SRX5716464,SMARCA4,219
chr1,69077863,69078038,SRX5075176,SMARCA4,175
chr1,69082426,69082697,SRX5075174,SMARCA4,271
chr1,69121714,69122095,SRX5054309,FOSL2,381
chr1,69121722,69121949,SRX5020211,SMARCA2,227
chr1,69121751,69122022,SRX5716470,SMARCA4,271
chr1,69121771,69122073,SRX5075176,SMARCA4,302
chr1,69121789,69122113,SRX5054308,FOSL2,324
chr1,69121793,69122044,SRX5075169,SMARCA4,251
chr1,69121797,69122048,SRX5075170,SMARCA4,251
chr1,69121830,69122067,SRX5075175,SMARCA4,237
chr1,69126817,69127069,SRX5075169,SMARCA4,252
chr1,69126832,69127095,SRX5716470,SMARCA4,263
chr1,69127913,69128329,SRX5075168,SMARCA4,416
chr1,69127949,69128303,SRX5075174,SMARCA4,354
chr1,69127982,69128352,SRX5716464,SMARCA4,370
chr1,69128048,69128279,SRX5716463,SMARCA4,231
chr1,69246640,69247009,SRX5075170,SMARCA4,369
chr1,69246686,69247019,SRX5075176,SMARCA4,333
chr1,69263794,69264392,SRX5716470,SMARCA4,598
chr1,69263898,69264609,SRX5075176,SMARCA4,711
chr1,69263911,69264529,SRX5075175,SMARCA4,618
chr1,69263913,69264563,SRX5075170,SMARCA4,650
chr1,69263939,69264538,SRX5075169,SMARCA4,599
chr1,69263993,69264503,SRX5716467,SMARCA2,510
chr1,69264011,69264547,SRX5020211,SMARCA2,536
chr1,69264022,69264456,SRX5075181,SMARCA2,434
chr1,69264031,69264774,SRX5054308,FOSL2,743
chr1,69264036,69264492,SRX5716469,SMARCA4,456
chr1,69264067,69264445,SRX5716468,SMARCA2,378
chr1,69264078,69264778,SRX5054309,FOSL2,700
chr1,69264107,69264645,SRX5020214,SMARCA2,538
chr1,69269588,69269884,SRX5075174,SMARCA4,296
chr1,69277798,69278173,SRX5075170,SMARCA4,375
chr1,69277821,69278234,SRX5075176,SMARCA4,413
chr1,69277874,69278113,SRX5054308,FOSL2,239
chr1,69277939,69278142,SRX5020211,SMARCA2,203
chr1,69277940,69278213,SRX5054309,FOSL2,273
chr1,69283647,69283924,SRX5716470,SMARCA4,277
chr1,69283668,69283862,SRX5075168,SMARCA4,194
chr1,69283671,69283868,SRX5075174,SMARCA4,197
chr1,69284532,69284851,SRX5075168,SMARCA4,319
chr1,69284537,69284851,SRX5075174,SMARCA4,314
chr1,69284628,69284872,SRX5716463,SMARCA4,244
chr1,69290366,69290550,SRX5075169,SMARCA4,184
chr1,69290374,69290557,SRX5054309,FOSL2,183
chr1,69291017,69291230,SRX5054309,FOSL2,213
chr1,69294224,69294409,SRX5075170,SMARCA4,185
chr1,69294245,69294451,SRX5075176,SMARCA4,206
chr1,69315837,69316221,SRX5075174,SMARCA4,384
chr1,69315944,69316217,SRX20140867,INTS10,273
chr1,69316032,69316211,SRX5075168,SMARCA4,179
chr1,69328138,69328447,SRX5054309,FOSL2,309
chr1,69421449,69421629,SRX5075169,SMARCA4,180
chr1,69421471,69421733,SRX5054308,FOSL2,262
chr1,69421486,69421740,SRX5054309,FOSL2,254
chr1,69467423,69467658,SRX5716467,SMARCA2,235
chr1,69467468,69467703,SRX5075176,SMARCA4,235
chr1,69494246,69494801,SRX5054308,FOSL2,555
chr1,69494252,69494788,SRX5054309,FOSL2,536
chr1,69494272,69494919,SRX5075170,SMARCA4,647
chr1,69494287,69494861,SRX5075176,SMARCA4,574
chr1,69494292,69494556,SRX5075174,SMARCA4,264
chr1,69494321,69494590,SRX5075175,SMARCA4,269
chr1,69511442,69511862,SRX5075176,SMARCA4,420
chr1,69511447,69511697,SRX5716467,SMARCA2,250
chr1,69511457,69511704,SRX5716470,SMARCA4,247
chr1,69511465,69511758,SRX5075170,SMARCA4,293
chr1,69511476,69511718,SRX5716468,SMARCA2,242
chr1,69511536,69511744,SRX5020211,SMARCA2,208
chr1,69513651,69514006,SRX5075175,SMARCA4,355
chr1,69513672,69514022,SRX5054309,FOSL2,350
chr1,69513686,69513977,SRX5716469,SMARCA4,291
chr1,69513700,69514049,SRX5054308,FOSL2,349
chr1,69513714,69514023,SRX5075169,SMARCA4,309
chr1,69513734,69514037,SRX5020214,SMARCA2,303
chr1,69513748,69513995,SRX5716467,SMARCA2,247
chr1,69513751,69513987,SRX5020211,SMARCA2,236
chr1,69513796,69513993,SRX5075182,SMARCA2,197
chr1,69513796,69514010,SRX5075170,SMARCA4,214
chr1,69513801,69513998,SRX5075176,SMARCA4,197
chr1,69522926,69523367,SRX5075176,SMARCA4,441
chr1,69523009,69523403,SRX5075175,SMARCA4,394
chr1,69523016,69523408,SRX5716470,SMARCA4,392
chr1,69523059,69523425,SRX5075169,SMARCA4,366
chr1,69523066,69523344,SRX5075170,SMARCA4,278
chr1,69523071,69523366,SRX5054308,FOSL2,295
chr1,69523073,69523396,SRX5054309,FOSL2,323
chr1,69523077,69523343,SRX5716467,SMARCA2,266
chr1,69523089,69523317,SRX5716469,SMARCA4,228
chr1,69523130,69523330,SRX5020211,SMARCA2,200
chr1,69544928,69545165,SRX5075174,SMARCA4,237
chr1,69548056,69548320,SRX5075170,SMARCA4,264
chr1,69567182,69567495,SRX5075174,SMARCA4,313
chr1,69569983,69570354,SRX20140895,INTS13,371
chr1,69645580,69645763,SRX5075168,SMARCA4,183
chr1,69648394,69648825,SRX5075176,SMARCA4,431
chr1,69648400,69648810,SRX5075170,SMARCA4,410
chr1,69648435,69648842,SRX5716470,SMARCA4,407
chr1,69648458,69648742,SRX5716469,SMARCA4,284
chr1,69648465,69648798,SRX5075175,SMARCA4,333
chr1,69648488,69648885,SRX5075169,SMARCA4,397
chr1,69648493,69648757,SRX5716468,SMARCA2,264
chr1,69648517,69648791,SRX5054309,FOSL2,274
chr1,69648535,69648783,SRX5716467,SMARCA2,248
chr1,69700900,69701147,SRX16500059,CTCF,247
chr1,69737550,69738009,SRX16500059,CTCF,459
chr1,69737583,69737959,SRX16500060,CTCF,376
chr1,69737587,69738033,SRX16500062,CTCF,446
chr1,69737608,69738003,SRX16500061,CTCF,395
chr1,69737684,69737972,SRX4174629,CTCF,288
chr1,69738609,69738895,SRX5075174,SMARCA4,286
chr1,69739060,69739499,SRX5075174,SMARCA4,439
chr1,69739199,69739584,SRX5075170,SMARCA4,385
chr1,69739225,69739577,SRX5075176,SMARCA4,352
chr1,69739237,69739587,SRX5075168,SMARCA4,350
chr1,69739243,69739561,SRX5075175,SMARCA4,318
chr1,69739247,69739511,SRX5054309,FOSL2,264
chr1,69739262,69739569,SRX5075169,SMARCA4,307
chr1,69739300,69739521,SRX5716469,SMARCA4,221
chr1,69739306,69739564,SRX5716470,SMARCA4,258
chr1,69824979,69825223,SRX5075176,SMARCA4,244
chr1,69825075,69825267,SRX5075170,SMARCA4,192
chr1,69837028,69837349,SRX5075169,SMARCA4,321
chr1,69837058,69837354,SRX5075176,SMARCA4,296
chr1,69837111,69837379,SRX5075175,SMARCA4,268
chr1,69837126,69837341,SRX5716467,SMARCA2,215
chr1,69852410,69852585,SRX5075176,SMARCA4,175
chr1,69858580,69858893,SRX5075169,SMARCA4,313
chr1,69858637,69858883,SRX5075170,SMARCA4,246
chr1,69858651,69858834,SRX5054308,FOSL2,183
chr1,69913884,69914366,SRX5716470,SMARCA4,482
chr1,69913897,69914336,SRX5075169,SMARCA4,439
chr1,69913950,69914388,SRX5020211,SMARCA2,438
chr1,69913968,69914407,SRX5075175,SMARCA4,439
chr1,69913972,69914358,SRX5716469,SMARCA4,386
chr1,69913981,69914422,SRX5075176,SMARCA4,441
chr1,69913995,69914405,SRX5716467,SMARCA2,410
chr1,69914000,69914383,SRX5054308,FOSL2,383
chr1,69914023,69914371,SRX5075170,SMARCA4,348
chr1,69914027,69914302,SRX5716468,SMARCA2,275
chr1,69914029,69914385,SRX5075181,SMARCA2,356
chr1,69914038,69914421,SRX5054309,FOSL2,383
chr1,69915282,69915716,SRX5716470,SMARCA4,434
chr1,69915355,69915791,SRX5075170,SMARCA4,436
chr1,69915373,69915735,SRX5075176,SMARCA4,362
chr1,69915432,69915684,SRX5075169,SMARCA4,252
chr1,69915436,69915651,SRX5716467,SMARCA2,215
chr1,69952684,69952933,SRX5075169,SMARCA4,249
chr1,69952692,69952907,SRX5075170,SMARCA4,215
chr1,69952715,69952975,SRX5075175,SMARCA4,260
chr1,69952775,69953013,SRX5716470,SMARCA4,238
chr1,69977025,69977227,SRX5054309,FOSL2,202
chr1,69982998,69983262,SRX5075175,SMARCA4,264
chr1,69983025,69983327,SRX5075169,SMARCA4,302
chr1,69983032,69983243,SRX5054308,FOSL2,211
chr1,69983088,69983329,SRX5054309,FOSL2,241
chr1,69983148,69983341,SRX5075170,SMARCA4,193
chr1,69993777,69994088,SRX5716470,SMARCA4,311
chr1,69993845,69994035,SRX5075169,SMARCA4,190
chr1,70003545,70003736,SRX5075169,SMARCA4,191
chr1,70003569,70003812,SRX5075176,SMARCA4,243
chr1,70007025,70007269,SRX5075174,SMARCA4,244
chr1,70017830,70018051,SRX5054308,FOSL2,221
chr1,70017882,70018093,SRX5054309,FOSL2,211
chr1,70034419,70034774,SRX5075176,SMARCA4,355
chr1,70034436,70034647,SRX5716470,SMARCA4,211
chr1,70034442,70034691,SRX5020211,SMARCA2,249
chr1,70034463,70034715,SRX5075175,SMARCA4,252
chr1,70034464,70034748,SRX5075170,SMARCA4,284
chr1,70034478,70034675,SRX5075174,SMARCA4,197
chr1,70038091,70038260,SRX5075170,SMARCA4,169
chr1,70043893,70044104,SRX5716470,SMARCA4,211
chr1,70044681,70045166,SRX5075176,SMARCA4,485
chr1,70044697,70045200,SRX5075169,SMARCA4,503
chr1,70044703,70045190,SRX5075170,SMARCA4,487
chr1,70044756,70045210,SRX5054308,FOSL2,454
chr1,70044789,70045154,SRX5716469,SMARCA4,365
chr1,70044802,70045220,SRX5054309,FOSL2,418
chr1,70044806,70045255,SRX5075175,SMARCA4,449
chr1,70044872,70045173,SRX5020211,SMARCA2,301
chr1,70044915,70045188,SRX5716467,SMARCA2,273
chr1,70044925,70045136,SRX5716468,SMARCA2,211
chr1,70061240,70061601,SRX5075174,SMARCA4,361
chr1,70061253,70061572,SRX5075168,SMARCA4,319
chr1,70061321,70061663,SRX5716463,SMARCA4,342
chr1,70072166,70072826,SRX5075174,SMARCA4,660
chr1,70072203,70072499,SRX5075169,SMARCA4,296
chr1,70072240,70072705,SRX5075168,SMARCA4,465
chr1,70075863,70076055,SRX5054309,FOSL2,192
chr1,70075883,70076092,SRX5075169,SMARCA4,209
chr1,70075966,70076178,SRX5716469,SMARCA4,212
chr1,70090814,70091136,SRX5716470,SMARCA4,322
chr1,70090865,70091310,SRX5075176,SMARCA4,445
chr1,70090868,70091234,SRX5075169,SMARCA4,366
chr1,70090877,70091292,SRX5075175,SMARCA4,415
chr1,70090885,70091278,SRX5054309,FOSL2,393
chr1,70090897,70091313,SRX5054308,FOSL2,416
chr1,70090901,70091261,SRX5075170,SMARCA4,360
chr1,70090940,70091155,SRX5716467,SMARCA2,215
chr1,70090951,70091216,SRX5716469,SMARCA4,265
chr1,70090993,70091201,SRX5020214,SMARCA2,208
chr1,70101225,70101611,SRX5075176,SMARCA4,386
chr1,70101239,70101708,SRX5075170,SMARCA4,469
chr1,70101287,70101721,SRX5716470,SMARCA4,434
chr1,70101301,70101566,SRX5716469,SMARCA4,265
chr1,70101323,70101600,SRX5716467,SMARCA2,277
chr1,70101331,70101565,SRX5054308,FOSL2,234
chr1,70101345,70101569,SRX5075169,SMARCA4,224
chr1,70132887,70133495,SRX16500059,CTCF,608
chr1,70132889,70133402,SRX16500061,CTCF,513
chr1,70132890,70133438,SRX16500060,CTCF,548
chr1,70132898,70133498,SRX16500062,CTCF,600
chr1,70132955,70133243,SRX5075174,SMARCA4,288
chr1,70132985,70133233,SRX5075176,SMARCA4,248
chr1,70133008,70133263,SRX5075170,SMARCA4,255
chr1,70133062,70133279,SRX5075169,SMARCA4,217
chr1,70133085,70133290,SRX5716463,SMARCA4,205
chr1,70140335,70140599,SRX5716467,SMARCA2,264
chr1,70140385,70140720,SRX5716470,SMARCA4,335
chr1,70140423,70140689,SRX5075170,SMARCA4,266
chr1,70140463,70140643,SRX5075169,SMARCA4,180
chr1,70143087,70143354,SRX16500059,CTCF,267
chr1,70143101,70143326,SRX5075176,SMARCA4,225
chr1,70143119,70143349,SRX5075170,SMARCA4,230
chr1,70143125,70143307,SRX5075169,SMARCA4,182
chr1,70146571,70146767,SRX5054309,FOSL2,196
chr1,70205333,70205951,SRX20140895,INTS13,618
chr1,70205415,70206054,SRX5075174,SMARCA4,639
chr1,70205421,70206138,SRX5075168,SMARCA4,717
chr1,70205459,70205834,SRX5075176,SMARCA4,375
chr1,70205460,70205949,SRX20140869,INTS10,489
chr1,70205468,70205923,SRX5075170,SMARCA4,455
chr1,70205493,70205805,SRX20140881,CPSF3L,312
chr1,70205516,70205845,SRX20140868,INTS10,329
chr1,70205520,70205922,SRX20140897,INTS13,402
chr1,70205531,70205974,SRX5716470,SMARCA4,443
chr1,70205569,70205882,SRX20140867,INTS10,313
chr1,70205620,70205867,SRX20140894,INTS13,247
chr1,70205695,70205931,SRX5716469,SMARCA4,236
chr1,70205804,70206116,SRX5075169,SMARCA4,312
chr1,70221120,70221522,SRX5075174,SMARCA4,402
chr1,70221128,70221630,SRX5075168,SMARCA4,502
chr1,70221148,70221632,SRX5075176,SMARCA4,484
chr1,70221165,70221399,SRX5716463,SMARCA4,234
chr1,70221166,70221720,SRX5716470,SMARCA4,554
chr1,70221199,70221909,SRX20140895,INTS13,710
chr1,70221220,70221599,SRX5075170,SMARCA4,379
chr1,70221339,70221689,SRX20140897,INTS13,350
chr1,70221398,70221707,SRX20140868,INTS10,309
chr1,70289835,70290081,SRX5075168,SMARCA4,246
chr1,70289851,70290093,SRX5075174,SMARCA4,242
chr1,70290177,70290617,SRX5075169,SMARCA4,440
chr1,70290206,70290499,SRX5054308,FOSL2,293
chr1,70290209,70290527,SRX5054309,FOSL2,318
chr1,70290246,70290494,SRX5716470,SMARCA4,248
chr1,70290272,70290531,SRX5075176,SMARCA4,259
chr1,70290273,70290544,SRX5075175,SMARCA4,271
chr1,70290325,70290498,SRX5075174,SMARCA4,173
chr1,70290379,70290558,SRX5075168,SMARCA4,179
chr1,70319689,70320139,SRX5075169,SMARCA4,450
chr1,70319755,70319975,SRX5054309,FOSL2,220
chr1,70319816,70320006,SRX5075175,SMARCA4,190
chr1,70354265,70355084,SRX20140895,INTS13,819
chr1,70354442,70355096,SRX20140867,INTS10,654
chr1,70354454,70355107,SRX20140868,INTS10,653
chr1,70354460,70355050,SRX20140897,INTS13,590
chr1,70354487,70354713,SRX5075169,SMARCA4,226
chr1,70354493,70355009,SRX20140881,CPSF3L,516
chr1,70354502,70355096,SRX20140869,INTS10,594
chr1,70354509,70355045,SRX5075168,SMARCA4,536
chr1,70354513,70355071,SRX5075174,SMARCA4,558
chr1,70354629,70354943,SRX5716464,SMARCA4,314
chr1,70354652,70355009,SRX20140894,INTS13,357
chr1,70354673,70355055,SRX20140896,INTS13,382
chr1,70354705,70355054,SRX20140879,CPSF3L,349
chr1,70354788,70355058,SRX5075170,SMARCA4,270
chr1,70354793,70355117,SRX5716469,SMARCA4,324
chr1,70354831,70355031,SRX5075169,SMARCA4,200
chr1,70354832,70355139,SRX5075176,SMARCA4,307
chr1,70361929,70362422,SRX5075168,SMARCA4,493
chr1,70361948,70362416,SRX5075174,SMARCA4,468
chr1,70361955,70362288,SRX5716464,SMARCA4,333
chr1,70361973,70362288,SRX5075176,SMARCA4,315
chr1,70361992,70362351,SRX5716469,SMARCA4,359
chr1,70362024,70362300,SRX5075175,SMARCA4,276
chr1,70362038,70362345,SRX5075170,SMARCA4,307
chr1,70362049,70362396,SRX5075169,SMARCA4,347
chr1,70362065,70362280,SRX5716467,SMARCA2,215
chr1,70362070,70362328,SRX5020211,SMARCA2,258
chr1,70362073,70362377,SRX5716463,SMARCA4,304
chr1,70362184,70362364,SRX5054308,FOSL2,180
chr1,70410586,70411410,SRX5075168,SMARCA4,824
chr1,70410618,70411461,SRX5075176,SMARCA4,843
chr1,70410667,70411335,SRX5716470,SMARCA4,668
chr1,70410685,70411058,SRX5075169,SMARCA4,373
chr1,70410714,70411141,SRX5075175,SMARCA4,427
chr1,70410721,70411569,SRX20140895,INTS13,848
chr1,70410731,70411524,SRX20140881,CPSF3L,793
chr1,70410746,70411384,SRX20140897,INTS13,638
chr1,70410762,70411286,SRX20140869,INTS10,524
chr1,70410784,70411530,SRX20140868,INTS10,746
chr1,70410795,70411482,SRX20140867,INTS10,687
chr1,70410806,70411043,SRX5716463,SMARCA4,237
chr1,70410820,70411392,SRX20140879,CPSF3L,572
chr1,70410822,70411759,SRX5075174,SMARCA4,937
chr1,70410828,70411120,SRX5716464,SMARCA4,292
chr1,70410830,70411077,SRX20140894,INTS13,247
chr1,70410859,70411167,SRX5716469,SMARCA4,308
chr1,70410860,70411490,SRX20140896,INTS13,630
chr1,70410931,70411539,SRX5075170,SMARCA4,608
chr1,70411047,70411273,SRX5716451,SOX2,226
chr1,70411124,70411523,SRX5075169,SMARCA4,399
chr1,70411303,70411579,SRX5716469,SMARCA4,276
chr1,70411340,70411612,SRX5075175,SMARCA4,272
chr1,70411395,70411648,SRX5716470,SMARCA4,253
chr1,70442439,70442865,SRX5075174,SMARCA4,426
chr1,70442479,70442839,SRX5075168,SMARCA4,360
chr1,70458182,70458563,SRX5075176,SMARCA4,381
chr1,70458183,70458491,SRX5075170,SMARCA4,308
chr1,70458195,70458461,SRX5075174,SMARCA4,266
chr1,70458227,70458600,SRX5075169,SMARCA4,373
chr1,70458230,70458445,SRX5716467,SMARCA2,215
chr1,70458261,70458474,SRX5075175,SMARCA4,213
chr1,70458266,70458495,SRX5075168,SMARCA4,229
chr1,70459867,70460155,SRX5054309,FOSL2,288
chr1,70486830,70487772,SRX5075176,SMARCA4,942
chr1,70487018,70487585,SRX5075170,SMARCA4,567
chr1,70487029,70487587,SRX5054308,FOSL2,558
chr1,70487064,70487511,SRX5716469,SMARCA4,447
chr1,70487073,70487537,SRX5075169,SMARCA4,464
chr1,70487074,70487652,SRX5075175,SMARCA4,578
chr1,70487154,70487595,SRX5054309,FOSL2,441
chr1,70487175,70487477,SRX5716470,SMARCA4,302
chr1,70487190,70487515,SRX5716459,Epitope tags,325
chr1,70487220,70487537,SRX5716467,SMARCA2,317
chr1,70487875,70488243,SRX16500059,CTCF,368
chr1,70487883,70488257,SRX16500060,CTCF,374
chr1,70487910,70488274,SRX16500061,CTCF,364
chr1,70487945,70488264,SRX16500062,CTCF,319
chr1,70504720,70505187,SRX5075176,SMARCA4,467
chr1,70504839,70505115,SRX5075170,SMARCA4,276
chr1,70504883,70505071,SRX5054308,FOSL2,188
chr1,70504883,70505174,SRX5054309,FOSL2,291
chr1,70509950,70510313,SRX5075176,SMARCA4,363
chr1,70509969,70510319,SRX5054309,FOSL2,350
chr1,70509979,70510287,SRX5075175,SMARCA4,308
chr1,70509981,70510267,SRX5716470,SMARCA4,286
chr1,70509993,70510515,SRX16500062,CTCF,522
chr1,70510002,70510241,SRX5716469,SMARCA4,239
chr1,70510018,70510519,SRX16500059,CTCF,501
chr1,70510019,70510327,SRX5054308,FOSL2,308
chr1,70510020,70510320,SRX5075170,SMARCA4,300
chr1,70510034,70510527,SRX16500060,CTCF,493
chr1,70510042,70510335,SRX5075174,SMARCA4,293
chr1,70510044,70510324,SRX5075169,SMARCA4,280
chr1,70510071,70510543,SRX16500061,CTCF,472
chr1,70510114,70510375,SRX5075168,SMARCA4,261
chr1,70528715,70529100,SRX16500062,CTCF,385
chr1,70528717,70529237,SRX16500059,CTCF,520
chr1,70528719,70529200,SRX16500060,CTCF,481
chr1,70528748,70529147,SRX5075168,SMARCA4,399
chr1,70528764,70529085,SRX5716464,SMARCA4,321
chr1,70528774,70529110,SRX5716463,SMARCA4,336
chr1,70528774,70529136,SRX16500061,CTCF,362
chr1,70528775,70529103,SRX5075174,SMARCA4,328
chr1,70528784,70529075,SRX5716469,SMARCA4,291
chr1,70528786,70529088,SRX5075169,SMARCA4,302
chr1,70528790,70529109,SRX5075170,SMARCA4,319
chr1,70528793,70529152,SRX5075176,SMARCA4,359
chr1,70528800,70529084,SRX5716470,SMARCA4,284
chr1,70528822,70529095,SRX5075175,SMARCA4,273
chr1,70528845,70529082,SRX4174629,CTCF,237
chr1,70667730,70667986,SRX5075168,SMARCA4,256
chr1,70684578,70684817,SRX5054309,FOSL2,239
chr1,70684601,70684781,SRX5054308,FOSL2,180
chr1,70685224,70685717,SRX16500060,CTCF,493
chr1,70685235,70685645,SRX16500061,CTCF,410
chr1,70685262,70685714,SRX16500059,CTCF,452
chr1,70685281,70685699,SRX16500062,CTCF,418
chr1,70685282,70685650,SRX4174629,CTCF,368
chr1,70685332,70685629,SRX5075174,SMARCA4,297
chr1,70685351,70685609,SRX5075168,SMARCA4,258
chr1,70685380,70685608,SRX5716463,SMARCA4,228
chr1,70745177,70745398,SRX16500060,CTCF,221
chr1,70900245,70900467,SRX5075174,SMARCA4,222
chr1,70965962,70966435,SRX16500061,CTCF,473
chr1,70966007,70966452,SRX16500060,CTCF,445
chr1,70966008,70966415,SRX16500059,CTCF,407
chr1,70966025,70966431,SRX16500062,CTCF,406
chr1,71047605,71047876,SRX5075168,SMARCA4,271
chr1,71047634,71047821,SRX5075175,SMARCA4,187
chr1,71049916,71050386,SRX16500060,CTCF,470
chr1,71049948,71050447,SRX16500059,CTCF,499
chr1,71049964,71050182,SRX4174629,CTCF,218
chr1,71049975,71050424,SRX16500061,CTCF,449
chr1,71049980,71050397,SRX16500062,CTCF,417
chr1,71050004,71050257,SRX5716463,SMARCA4,253
chr1,71050006,71050319,SRX5075174,SMARCA4,313
chr1,71050025,71050317,SRX5075168,SMARCA4,292
chr1,71050051,71050306,SRX5075170,SMARCA4,255
chr1,71050088,71050275,SRX5075175,SMARCA4,187
chr1,71050104,71050341,SRX5075176,SMARCA4,237
chr1,71080396,71081505,SRX20140895,INTS13,1109
chr1,71080839,71081413,SRX5075170,SMARCA4,574
chr1,71080846,71081347,SRX5716470,SMARCA4,501
chr1,71080868,71081444,SRX5075168,SMARCA4,576
chr1,71080919,71081433,SRX20140867,INTS10,514
chr1,71080987,71081277,SRX20140881,CPSF3L,290
chr1,71081013,71081373,SRX20140869,INTS10,360
chr1,71081035,71081270,SRX5716469,SMARCA4,235
chr1,71081059,71081465,SRX20140897,INTS13,406
chr1,71081064,71081507,SRX16500062,CTCF,443
chr1,71081066,71081542,SRX16500059,CTCF,476
chr1,71081068,71081520,SRX16500060,CTCF,452
chr1,71081094,71081473,SRX16500061,CTCF,379
chr1,71081111,71081482,SRX5075174,SMARCA4,371
chr1,71081151,71081386,SRX20140879,CPSF3L,235
chr1,71081202,71081432,SRX5716463,SMARCA4,230
chr1,71081204,71081528,SRX4174629,CTCF,324
chr1,71081225,71081454,SRX5054308,FOSL2,229
chr1,71081273,71081491,SRX5075176,SMARCA4,218
chr1,71089842,71090205,SRX5075176,SMARCA4,363
chr1,71089905,71090236,SRX5716470,SMARCA4,331
chr1,71089910,71090218,SRX5075170,SMARCA4,308
chr1,71089925,71090248,SRX5075169,SMARCA4,323
chr1,71089945,71090225,SRX5716469,SMARCA4,280
chr1,71089947,71090206,SRX5075175,SMARCA4,259
chr1,71089948,71090324,SRX5075174,SMARCA4,376
chr1,71089961,71090292,SRX5054309,FOSL2,331
chr1,71089978,71090270,SRX5054308,FOSL2,292
chr1,71089996,71090393,SRX5075168,SMARCA4,397
chr1,71093891,71094323,SRX16500059,CTCF,432
chr1,71093926,71094284,SRX16500061,CTCF,358
chr1,71093929,71094338,SRX16500060,CTCF,409
chr1,71093951,71094295,SRX16500062,CTCF,344
chr1,71128691,71128994,SRX5075170,SMARCA4,303
chr1,71128737,71129064,SRX5075176,SMARCA4,327
chr1,71128756,71128972,SRX5075169,SMARCA4,216
chr1,71128765,71129004,SRX5054309,FOSL2,239
chr1,71135701,71135881,SRX5054308,FOSL2,180
chr1,71196687,71197054,SRX16500059,CTCF,367
chr1,71196693,71197007,SRX16500060,CTCF,314
chr1,71196693,71197063,SRX16500062,CTCF,370
chr1,71196724,71197016,SRX16500061,CTCF,292
chr1,71296397,71296708,SRX5075181,SMARCA2,311
chr1,71296451,71296714,SRX5075176,SMARCA4,263
chr1,71307467,71307864,SRX5075170,SMARCA4,397
chr1,71307480,71307885,SRX5075176,SMARCA4,405
chr1,71307528,71307821,SRX5075174,SMARCA4,293
chr1,71307540,71307841,SRX5054309,FOSL2,301
chr1,71307551,71307816,SRX5075168,SMARCA4,265
chr1,71307562,71307841,SRX5054308,FOSL2,279
chr1,71365919,71366115,SRX5075170,SMARCA4,196
chr1,71365926,71366174,SRX5054309,FOSL2,248
chr1,71365943,71366214,SRX5054308,FOSL2,271
chr1,71521670,71522077,SRX16500059,CTCF,407
chr1,71521676,71522069,SRX16500061,CTCF,393
chr1,71521677,71522104,SRX16500060,CTCF,427
chr1,71521720,71522051,SRX16500062,CTCF,331
chr1,71561710,71562068,SRX5716469,SMARCA4,358
chr1,71561712,71562156,SRX5075176,SMARCA4,444
chr1,71561734,71562121,SRX5075168,SMARCA4,387
chr1,71561736,71562131,SRX5054309,FOSL2,395
chr1,71561739,71562162,SRX5075170,SMARCA4,423
chr1,71561740,71562153,SRX5075169,SMARCA4,413
chr1,71561750,71562154,SRX5054308,FOSL2,404
chr1,71561789,71562164,SRX5075175,SMARCA4,375
chr1,71561798,71562000,SRX5020211,SMARCA2,202
chr1,71561799,71562127,SRX5716467,SMARCA2,328
chr1,71561807,71562125,SRX5716470,SMARCA4,318
chr1,71561817,71562061,SRX5020214,SMARCA2,244
chr1,71561861,71562047,SRX5075174,SMARCA4,186
chr1,71587948,71588297,SRX16500062,CTCF,349
chr1,71587978,71588340,SRX16500059,CTCF,362
chr1,71588019,71588306,SRX16500060,CTCF,287
chr1,71588038,71588302,SRX16500061,CTCF,264
chr1,71621786,71622128,SRX5075176,SMARCA4,342
chr1,71621803,71622019,SRX5054308,FOSL2,216
chr1,71621833,71622183,SRX5075170,SMARCA4,350
chr1,71621845,71622055,SRX5054309,FOSL2,210
chr1,71621884,71622251,SRX5075169,SMARCA4,367
chr1,71621974,71622207,SRX5716469,SMARCA4,233
chr1,71621981,71622249,SRX5075175,SMARCA4,268
chr1,71638149,71638392,SRX5054309,FOSL2,243
chr1,71638180,71638380,SRX5075175,SMARCA4,200
chr1,71640090,71640505,SRX5075176,SMARCA4,415
chr1,71640120,71640381,SRX5075170,SMARCA4,261
chr1,71656944,71657293,SRX5075174,SMARCA4,349
chr1,71657069,71657289,SRX5075168,SMARCA4,220
chr1,71660446,71660666,SRX5716469,SMARCA4,220
chr1,71660476,71660723,SRX5054308,FOSL2,247
chr1,71660517,71660692,SRX5075176,SMARCA4,175
chr1,71770216,71770544,SRX5020211,SMARCA2,328
chr1,71785612,71785837,SRX5075170,SMARCA4,225
chr1,71857868,71858151,SRX5075170,SMARCA4,283
chr1,71857869,71858184,SRX5075169,SMARCA4,315
chr1,71857873,71858122,SRX5075176,SMARCA4,249
chr1,71857877,71858175,SRX5716470,SMARCA4,298
chr1,71857878,71858151,SRX5716469,SMARCA4,273
chr1,71857899,71858159,SRX5075175,SMARCA4,260
chr1,71861107,71861290,SRX5054309,FOSL2,183
chr1,71861125,71861349,SRX5054308,FOSL2,224
chr1,72007479,72007648,SRX5075170,SMARCA4,169
chr1,72037683,72038209,SRX16500060,CTCF,526
chr1,72037723,72038201,SRX16500059,CTCF,478
chr1,72037738,72038136,SRX16500062,CTCF,398
chr1,72037750,72038192,SRX16500061,CTCF,442
chr1,72122097,72122456,SRX5075170,SMARCA4,359
chr1,72122140,72122478,SRX5075176,SMARCA4,338
chr1,72140364,72140605,SRX5075168,SMARCA4,241
chr1,72140406,72140579,SRX5075174,SMARCA4,173
chr1,72178389,72178592,SRX5075168,SMARCA4,203
chr1,72186616,72187096,SRX16500060,CTCF,480
chr1,72186680,72187089,SRX16500061,CTCF,409
chr1,72186716,72187125,SRX16500059,CTCF,409
chr1,72186787,72187085,SRX16500062,CTCF,298
chr1,72253127,72253432,SRX5716467,SMARCA2,305
chr1,72253174,72253470,SRX5075170,SMARCA4,296
chr1,72253213,72253425,SRX5075169,SMARCA4,212
chr1,72282719,72283005,SRX5075170,SMARCA4,286
chr1,72282729,72283045,SRX5716464,SMARCA4,316
chr1,72282743,72282982,SRX5075169,SMARCA4,239
chr1,72282752,72283137,SRX5075174,SMARCA4,385
chr1,72282757,72283182,SRX5075168,SMARCA4,425
chr1,72282763,72282950,SRX5075176,SMARCA4,187
chr1,72284753,72285307,SRX5054309,FOSL2,554
chr1,72284762,72285153,SRX5054308,FOSL2,391
chr1,72284910,72285102,SRX5075175,SMARCA4,192
chr1,72442347,72442571,SRX5054309,FOSL2,224
chr1,72485857,72486159,SRX5075170,SMARCA4,302
chr1,72485858,72486167,SRX5075176,SMARCA4,309
chr1,72485904,72486139,SRX5075175,SMARCA4,235
chr1,72496574,72496804,SRX5075170,SMARCA4,230
chr1,72557563,72557866,SRX16500059,CTCF,303
chr1,72623044,72623594,SRX16500059,CTCF,550
chr1,72623111,72623580,SRX16500060,CTCF,469
chr1,72623156,72623553,SRX16500061,CTCF,397
chr1,72623247,72623527,SRX16500062,CTCF,280
chr1,72623260,72623528,SRX5716470,SMARCA4,268
chr1,72623263,72623577,SRX5075174,SMARCA4,314
chr1,72623264,72623617,SRX5075168,SMARCA4,353
chr1,72623275,72623525,SRX5075176,SMARCA4,250
chr1,72623287,72623573,SRX5075170,SMARCA4,286
chr1,72623296,72623596,SRX5075175,SMARCA4,300
chr1,72623300,72623588,SRX5075169,SMARCA4,288
chr1,72636746,72636932,SRX5075176,SMARCA4,186
chr1,72637620,72637850,SRX5075168,SMARCA4,230
chr1,72637620,72637940,SRX5075174,SMARCA4,320
chr1,72649934,72650336,SRX5054309,FOSL2,402
chr1,72650038,72650295,SRX5075170,SMARCA4,257
chr1,72650044,72650338,SRX5075176,SMARCA4,294
chr1,72650072,72650329,SRX5054308,FOSL2,257
chr1,72724904,72725219,SRX16500062,CTCF,315
chr1,72724911,72725295,SRX16500059,CTCF,384
chr1,72724926,72725273,SRX16500060,CTCF,347
chr1,72724967,72725236,SRX16500061,CTCF,269
chr1,72759571,72759827,SRX5054309,FOSL2,256
chr1,72827337,72827623,SRX5054309,FOSL2,286
chr1,72837806,72838151,SRX5075168,SMARCA4,345
chr1,72837813,72838194,SRX5075174,SMARCA4,381
chr1,72837818,72838073,SRX5716464,SMARCA4,255
chr1,72837918,72838087,SRX5075170,SMARCA4,169
chr1,72843810,72844420,SRX20140881,CPSF3L,610
chr1,72843909,72844330,SRX20140869,INTS10,421
chr1,72845419,72845705,SRX16500061,CTCF,286
chr1,72846648,72846934,SRX5075168,SMARCA4,286
chr1,72846650,72847049,SRX5075174,SMARCA4,399
chr1,72915725,72915929,SRX5075174,SMARCA4,204
chr1,72936424,72936700,SRX5054309,FOSL2,276
chr1,72936470,72936668,SRX5075175,SMARCA4,198
chr1,72947045,72947445,SRX5075168,SMARCA4,400
chr1,72947066,72947538,SRX5075174,SMARCA4,472
chr1,72947206,72947484,SRX5716463,SMARCA4,278
chr1,73009983,73010318,SRX5075174,SMARCA4,335
chr1,73034352,73034570,SRX5075174,SMARCA4,218
chr1,73065395,73066042,SRX5075174,SMARCA4,647
chr1,73065439,73065961,SRX5716463,SMARCA4,522
chr1,73065486,73066089,SRX5075168,SMARCA4,603
chr1,73065531,73065887,SRX20140895,INTS13,356
chr1,73065612,73065845,SRX5716451,SOX2,233
chr1,73065614,73065891,SRX5716464,SMARCA4,277
chr1,73161452,73161631,SRX5075168,SMARCA4,179
chr1,73419802,73420143,SRX5075174,SMARCA4,341
chr1,73419858,73420145,SRX5075168,SMARCA4,287
chr1,73419884,73420107,SRX5716463,SMARCA4,223
chr1,73454956,73455216,SRX5075168,SMARCA4,260
chr1,73454964,73455219,SRX5075174,SMARCA4,255
chr1,73454974,73455178,SRX5716463,SMARCA4,204
chr1,73510959,73511596,SRX5716463,SMARCA4,637
chr1,73510993,73511560,SRX5075174,SMARCA4,567
chr1,73511002,73511490,SRX5716464,SMARCA4,488
chr1,73511004,73511638,SRX5075168,SMARCA4,634
chr1,73511044,73511249,SRX5716454,SOX3,205
chr1,73511117,73511334,SRX5716451,SOX2,217
chr1,73543758,73544065,SRX5075168,SMARCA4,307
chr1,73576138,73576326,SRX5075168,SMARCA4,188
chr1,73576153,73576379,SRX5054309,FOSL2,226
chr1,73576161,73576367,SRX5054308,FOSL2,206
chr1,73593353,73593821,SRX5075174,SMARCA4,468
chr1,73593366,73593698,SRX5054309,FOSL2,332
chr1,73593366,73593754,SRX5075168,SMARCA4,388
chr1,73593375,73593645,SRX5716469,SMARCA4,270
chr1,73593398,73593737,SRX5075176,SMARCA4,339
chr1,73593405,73593752,SRX5075169,SMARCA4,347
chr1,73593420,73593697,SRX5054308,FOSL2,277
chr1,73593420,73593790,SRX5075170,SMARCA4,370
chr1,73593428,73593652,SRX5054307,FOSL2,224
chr1,73593439,73593647,SRX5075175,SMARCA4,208
chr1,73593464,73593714,SRX5716470,SMARCA4,250
chr1,73593921,73594150,SRX5075174,SMARCA4,229
chr1,73604624,73604930,SRX5716460,Epitope tags,306
chr1,73604648,73605066,SRX5075176,SMARCA4,418
chr1,73604676,73604968,SRX5716470,SMARCA4,292
chr1,73604691,73604989,SRX5075170,SMARCA4,298
chr1,73604703,73605073,SRX5075174,SMARCA4,370
chr1,73604715,73605050,SRX5054308,FOSL2,335
chr1,73604727,73605086,SRX5075168,SMARCA4,359
chr1,73604734,73605061,SRX5054309,FOSL2,327
chr1,73604763,73604963,SRX5020211,SMARCA2,200
chr1,73604794,73605104,SRX5075169,SMARCA4,310
chr1,73604804,73604995,SRX5075175,SMARCA4,191
chr1,73604828,73605119,SRX5716469,SMARCA4,291
chr1,73673982,73674436,SRX5075168,SMARCA4,454
chr1,73674008,73674412,SRX5075170,SMARCA4,404
chr1,73674018,73674393,SRX5075174,SMARCA4,375
chr1,73674079,73674274,SRX5075176,SMARCA4,195
chr1,73674878,73675426,SRX16500062,CTCF,548
chr1,73674886,73675356,SRX16500060,CTCF,470
chr1,73674935,73675383,SRX16500059,CTCF,448
chr1,73674979,73675176,SRX5075169,SMARCA4,197
chr1,73674984,73675497,SRX16500061,CTCF,513
chr1,73675010,73675257,SRX5075168,SMARCA4,247
chr1,73675035,73675227,SRX5075174,SMARCA4,192
chr1,73701856,73702217,SRX20140881,CPSF3L,361
chr1,73701893,73702248,SRX5075176,SMARCA4,355
chr1,73701908,73702229,SRX20140867,INTS10,321
chr1,73701935,73702241,SRX5075174,SMARCA4,306
chr1,73701949,73702209,SRX5075170,SMARCA4,260
chr1,73701950,73702259,SRX5716463,SMARCA4,309
chr1,73701957,73702333,SRX5075168,SMARCA4,376
chr1,73701991,73702230,SRX5716470,SMARCA4,239
chr1,73702024,73702248,SRX5716464,SMARCA4,224
chr1,73781291,73781573,SRX5075174,SMARCA4,282
chr1,73781337,73781555,SRX5075168,SMARCA4,218
chr1,73781374,73781579,SRX5075176,SMARCA4,205
chr1,73781396,73781595,SRX5054309,FOSL2,199
chr1,73782975,73783183,SRX5054309,FOSL2,208
chr1,73782992,73783197,SRX5075170,SMARCA4,205
chr1,73782993,73783180,SRX5075169,SMARCA4,187
chr1,73783019,73783194,SRX5075176,SMARCA4,175
chr1,73800331,73800703,SRX5054309,FOSL2,372
chr1,73800366,73800748,SRX5075169,SMARCA4,382
chr1,73800370,73800625,SRX5716469,SMARCA4,255
chr1,73800379,73800688,SRX5075175,SMARCA4,309
chr1,73800395,73800694,SRX5075176,SMARCA4,299
chr1,73800401,73800666,SRX5075170,SMARCA4,265
chr1,73800408,73800639,SRX5054308,FOSL2,231
chr1,73802107,73802280,SRX5075174,SMARCA4,173
chr1,73839954,73840233,SRX16500061,CTCF,279
chr1,73839956,73840248,SRX16500060,CTCF,292
chr1,73839962,73840216,SRX16500062,CTCF,254
chr1,73901635,73902134,SRX5075174,SMARCA4,499
chr1,73901638,73902280,SRX5075168,SMARCA4,642
chr1,73998279,73998785,SRX16500059,CTCF,506
chr1,73998321,73998813,SRX16500060,CTCF,492
chr1,73998381,73998814,SRX16500062,CTCF,433
chr1,73998387,73998805,SRX16500061,CTCF,418
chr1,73998430,73998639,SRX5075168,SMARCA4,209
chr1,73998447,73998659,SRX5075174,SMARCA4,212
chr1,74145103,74145408,SRX5075168,SMARCA4,305
chr1,74193991,74194197,SRX5054308,FOSL2,206
chr1,74197929,74198243,SRX5716467,SMARCA2,314
chr1,74197942,74198217,SRX5716470,SMARCA4,275
chr1,74197948,74198362,SRX20140895,INTS13,414
chr1,74197974,74198436,SRX5075170,SMARCA4,462
chr1,74198016,74198463,SRX5075168,SMARCA4,447
chr1,74198065,74198453,SRX5075176,SMARCA4,388
chr1,74198073,74198333,SRX5075174,SMARCA4,260
chr1,74198136,74198485,SRX5716469,SMARCA4,349
chr1,74198262,74198495,SRX5075169,SMARCA4,233
chr1,74198280,74198500,SRX5716470,SMARCA4,220
chr1,74205242,74205523,SRX5075174,SMARCA4,281
chr1,74205347,74205758,SRX5075168,SMARCA4,411
chr1,74245168,74245598,SRX20140881,CPSF3L,430
chr1,74245230,74245454,SRX5075168,SMARCA4,224
chr1,74245239,74245585,SRX20140869,INTS10,346
chr1,74245244,74245529,SRX5075174,SMARCA4,285
chr1,74245245,74245573,SRX20140867,INTS10,328
chr1,74246422,74246630,SRX5075168,SMARCA4,208
chr1,74248130,74248385,SRX9989504,GFP,255
chr1,74316296,74316472,SRX5075174,SMARCA4,176
chr1,74340633,74341038,SRX5075174,SMARCA4,405
chr1,74340710,74340998,SRX5075168,SMARCA4,288
chr1,74343398,74343577,SRX5075168,SMARCA4,179
chr1,74343401,74343606,SRX5075174,SMARCA4,205
chr1,74357931,74358110,SRX5075168,SMARCA4,179
chr1,74368362,74368633,SRX5054309,FOSL2,271
chr1,74422446,74423191,SRX5075174,SMARCA4,745
chr1,74422462,74423273,SRX5075168,SMARCA4,811
chr1,74422918,74423011,SRX1424894,POU3F2,93
chr1,74430380,74430836,SRX5075168,SMARCA4,456
chr1,74457356,74457585,SRX5075168,SMARCA4,229
chr1,74463568,74463950,SRX5075169,SMARCA4,382
chr1,74463575,74463932,SRX5054309,FOSL2,357
chr1,74463576,74464009,SRX5075175,SMARCA4,433
chr1,74463652,74463933,SRX5075176,SMARCA4,281
chr1,74463659,74463932,SRX5716469,SMARCA4,273
chr1,74463678,74463914,SRX5075170,SMARCA4,236
chr1,74463711,74463891,SRX5054308,FOSL2,180
chr1,74467856,74468061,SRX5075168,SMARCA4,205
chr1,74467888,74468177,SRX5075174,SMARCA4,289
chr1,74468923,74469409,SRX16500061,CTCF,486
chr1,74468928,74469486,SRX16500059,CTCF,558
chr1,74468951,74469460,SRX16500060,CTCF,509
chr1,74468962,74469497,SRX16500062,CTCF,535
chr1,74469031,74469278,SRX5075174,SMARCA4,247
chr1,74469063,74469279,SRX5075168,SMARCA4,216
chr1,74469109,74469286,SRX5075170,SMARCA4,177
chr1,74496242,74496461,SRX16500061,CTCF,219
chr1,74502423,74502721,SRX5716470,SMARCA4,298
chr1,74502456,74502726,SRX5075170,SMARCA4,270
chr1,74502463,74502730,SRX5075176,SMARCA4,267
chr1,74502465,74502706,SRX5716469,SMARCA4,241
chr1,74502474,74502728,SRX5075169,SMARCA4,254
chr1,74502481,74502732,SRX5075175,SMARCA4,251
chr1,74504049,74504617,SRX16500059,CTCF,568
chr1,74504074,74504590,SRX16500061,CTCF,516
chr1,74504096,74504624,SRX16500060,CTCF,528
chr1,74504122,74504553,SRX16500062,CTCF,431
chr1,74504157,74504455,SRX5075174,SMARCA4,298
chr1,74504158,74504475,SRX5075176,SMARCA4,317
chr1,74504159,74504432,SRX5075169,SMARCA4,273
chr1,74504162,74504407,SRX5716470,SMARCA4,245
chr1,74504163,74504479,SRX5075168,SMARCA4,316
chr1,74504165,74504437,SRX5075170,SMARCA4,272
chr1,74504166,74504435,SRX5716464,SMARCA4,269
chr1,74504186,74504516,SRX4174629,CTCF,330
chr1,74504189,74504393,SRX5716463,SMARCA4,204
chr1,74504193,74504457,SRX5075175,SMARCA4,264
chr1,74504232,74504450,SRX5716469,SMARCA4,218
chr1,74505188,74505492,SRX5075174,SMARCA4,304
chr1,74506290,74506771,SRX5075168,SMARCA4,481
chr1,74506369,74506815,SRX5075174,SMARCA4,446
chr1,74506437,74506672,SRX5716464,SMARCA4,235
chr1,74506473,74506784,SRX5716463,SMARCA4,311
chr1,74506475,74506713,SRX5054307,FOSL2,238
chr1,74513469,74513725,SRX5075168,SMARCA4,256
chr1,74513501,74513715,SRX5075174,SMARCA4,214
chr1,74522134,74522462,SRX5075174,SMARCA4,328
chr1,74522185,74522493,SRX5075168,SMARCA4,308
chr1,74522273,74522520,SRX5054308,FOSL2,247
chr1,74522373,74522556,SRX5054309,FOSL2,183
chr1,74534252,74534566,SRX5054309,FOSL2,314
chr1,74534289,74534519,SRX5716469,SMARCA4,230
chr1,74534294,74534499,SRX5020214,SMARCA2,205
chr1,74534325,74534502,SRX5075170,SMARCA4,177
chr1,74534348,74534586,SRX5075175,SMARCA4,238
chr1,74584093,74584298,SRX5716464,SMARCA4,205
chr1,74584118,74584432,SRX5075174,SMARCA4,314
chr1,74584256,74584543,SRX5075168,SMARCA4,287
chr1,74637343,74637556,SRX5075169,SMARCA4,213
chr1,74637348,74637566,SRX5075175,SMARCA4,218
chr1,74641973,74642243,SRX5054309,FOSL2,270
chr1,74648427,74648696,SRX5075174,SMARCA4,269
chr1,74648444,74648648,SRX5075168,SMARCA4,204
chr1,74648453,74648660,SRX5716463,SMARCA4,207
chr1,74652794,74653193,SRX5075169,SMARCA4,399
chr1,74652806,74653270,SRX5075170,SMARCA4,464
chr1,74652814,74653224,SRX5075176,SMARCA4,410
chr1,74652838,74653157,SRX5716469,SMARCA4,319
chr1,74652840,74653248,SRX5075175,SMARCA4,408
chr1,74652857,74653191,SRX5020211,SMARCA2,334
chr1,74652876,74653294,SRX5054309,FOSL2,418
chr1,74652885,74653151,SRX5716470,SMARCA4,266
chr1,74652922,74653243,SRX5054308,FOSL2,321
chr1,74661052,74661520,SRX5075168,SMARCA4,468
chr1,74661061,74661633,SRX5075174,SMARCA4,572
chr1,74661144,74661378,SRX5716463,SMARCA4,234
chr1,74679749,74680064,SRX5075174,SMARCA4,315
chr1,74679895,74680195,SRX5075168,SMARCA4,300
chr1,74689742,74690300,SRX16500059,CTCF,558
chr1,74689758,74690214,SRX16500061,CTCF,456
chr1,74689766,74690244,SRX16500062,CTCF,478
chr1,74689770,74690236,SRX16500060,CTCF,466
chr1,74689844,74690147,SRX5075174,SMARCA4,303
chr1,74689848,74690063,SRX5075170,SMARCA4,215
chr1,74689865,74690046,SRX5075168,SMARCA4,181
chr1,74693474,74693677,SRX5075168,SMARCA4,203
chr1,74693514,74693700,SRX5075174,SMARCA4,186
chr1,74733000,74733659,SRX20140895,INTS13,659
chr1,74733037,74733425,SRX20140869,INTS10,388
chr1,74733090,74733454,SRX20140881,CPSF3L,364
chr1,74733110,74733567,SRX20140897,INTS13,457
chr1,74733133,74733549,SRX20140867,INTS10,416
chr1,74733606,74734030,SRX16500061,CTCF,424
chr1,74733638,74734053,SRX16500062,CTCF,415
chr1,74733663,74734112,SRX16500059,CTCF,449
chr1,74733675,74734151,SRX16500060,CTCF,476
chr1,74753158,74753464,SRX5075168,SMARCA4,306
chr1,74753184,74753554,SRX5075174,SMARCA4,370
chr1,74771874,74772426,SRX16500060,CTCF,552
chr1,74771877,74772370,SRX16500059,CTCF,493
chr1,74771900,74772353,SRX16500061,CTCF,453
chr1,74771907,74772316,SRX16500062,CTCF,409
chr1,74771981,74772255,SRX5075174,SMARCA4,274
chr1,74771982,74772204,SRX5075168,SMARCA4,222
chr1,74773747,74773943,SRX5075175,SMARCA4,196
chr1,74773760,74773975,SRX5716467,SMARCA2,215
chr1,74773767,74773983,SRX5716470,SMARCA4,216
chr1,74773779,74773954,SRX5075176,SMARCA4,175
chr1,74773783,74773954,SRX5075170,SMARCA4,171
chr1,74780607,74780933,SRX5075168,SMARCA4,326
chr1,74780609,74780818,SRX5075174,SMARCA4,209
chr1,74790488,74790898,SRX5054309,FOSL2,410
chr1,74790497,74790806,SRX5075175,SMARCA4,309
chr1,74790510,74790937,SRX5075169,SMARCA4,427
chr1,74790514,74790821,SRX5054308,FOSL2,307
chr1,74791576,74791789,SRX5075169,SMARCA4,213
chr1,74791600,74791831,SRX5075170,SMARCA4,231
chr1,74791645,74791888,SRX5075176,SMARCA4,243
chr1,74793881,74794180,SRX5075170,SMARCA4,299
chr1,74793882,74794188,SRX5075176,SMARCA4,306
chr1,74819128,74819387,SRX5054309,FOSL2,259
chr1,74822974,74823349,SRX5075176,SMARCA4,375
chr1,74823021,74823434,SRX5075170,SMARCA4,413
chr1,74823083,74823458,SRX5075169,SMARCA4,375
chr1,74831005,74831401,SRX5075176,SMARCA4,396
chr1,74831143,74831332,SRX5075170,SMARCA4,189
chr1,74831154,74831379,SRX5075169,SMARCA4,225
chr1,74835006,74835481,SRX5075170,SMARCA4,475
chr1,74835018,74835447,SRX5075169,SMARCA4,429
chr1,74835018,74835492,SRX5054309,FOSL2,474
chr1,74835035,74835603,SRX5075176,SMARCA4,568
chr1,74835044,74835552,SRX5075175,SMARCA4,508
chr1,74835086,74835402,SRX5716470,SMARCA4,316
chr1,74847802,74847995,SRX5075176,SMARCA4,193
chr1,74937277,74937571,SRX5075170,SMARCA4,294
chr1,74937282,74937520,SRX5075176,SMARCA4,238
chr1,74937294,74937547,SRX5075175,SMARCA4,253
chr1,74937340,74937559,SRX5716470,SMARCA4,219
chr1,74964475,74965019,SRX5075169,SMARCA4,544
chr1,74964490,74964985,SRX5075176,SMARCA4,495
chr1,74964491,74964751,SRX5075170,SMARCA4,260
chr1,74964611,74964829,SRX5716469,SMARCA4,218
chr1,74964628,74964866,SRX5716470,SMARCA4,238
chr1,74964744,74964950,SRX5054309,FOSL2,206
chr1,75079977,75080185,SRX5716464,SMARCA4,208
chr1,75080014,75080187,SRX5075174,SMARCA4,173
chr1,75080017,75080249,SRX5075170,SMARCA4,232
chr1,75080055,75080233,SRX5075176,SMARCA4,178
chr1,75097620,75098118,SRX5075170,SMARCA4,498
chr1,75097663,75098097,SRX5075176,SMARCA4,434
chr1,75097692,75097957,SRX5020211,SMARCA2,265
chr1,75097694,75097991,SRX5716468,SMARCA2,297
chr1,75097708,75098091,SRX5075175,SMARCA4,383
chr1,75097710,75098107,SRX5075169,SMARCA4,397
chr1,75097720,75098044,SRX5716470,SMARCA4,324
chr1,75097734,75098002,SRX5716467,SMARCA2,268
chr1,75097758,75097997,SRX5716469,SMARCA4,239
chr1,75097862,75098055,SRX5054309,FOSL2,193
chr1,75099676,75099909,SRX5075176,SMARCA4,233
chr1,75099690,75099905,SRX5075170,SMARCA4,215
chr1,75165959,75166146,SRX5075175,SMARCA4,187
chr1,75166256,75166648,SRX5075176,SMARCA4,392
chr1,75166342,75166666,SRX5716467,SMARCA2,324
chr1,75166350,75166556,SRX5075169,SMARCA4,206
chr1,75166366,75166651,SRX5716470,SMARCA4,285
chr1,75166404,75166715,SRX5716469,SMARCA4,311
chr1,75166474,75166810,SRX5075170,SMARCA4,336
chr1,75188952,75189151,SRX5075176,SMARCA4,199
chr1,75203562,75203936,SRX4174629,CTCF,374
chr1,75203641,75204177,SRX16500059,CTCF,536
chr1,75203645,75204159,SRX16500062,CTCF,514
chr1,75203651,75204122,SRX16500061,CTCF,471
chr1,75203657,75204120,SRX16500060,CTCF,463
chr1,75203705,75203930,SRX5716470,SMARCA4,225
chr1,75203705,75203975,SRX5075176,SMARCA4,270
chr1,75203714,75203984,SRX5075168,SMARCA4,270
chr1,75203725,75203941,SRX5716463,SMARCA4,216
chr1,75203749,75203958,SRX5075175,SMARCA4,209
chr1,75203760,75203947,SRX5075170,SMARCA4,187
chr1,75203786,75204023,SRX5075174,SMARCA4,237
chr1,75209018,75209229,SRX5075168,SMARCA4,211
chr1,75233284,75233831,SRX16500061,CTCF,547
chr1,75233286,75233749,SRX16500059,CTCF,463
chr1,75233291,75233775,SRX16500060,CTCF,484
chr1,75233321,75233715,SRX16500062,CTCF,394
chr1,75233358,75233640,SRX5075168,SMARCA4,282
chr1,75233389,75233692,SRX5075174,SMARCA4,303
chr1,75233390,75233644,SRX5075170,SMARCA4,254
chr1,75233391,75233675,SRX5716470,SMARCA4,284
chr1,75233396,75233650,SRX5075176,SMARCA4,254
chr1,75233400,75233640,SRX5075175,SMARCA4,240
chr1,75233405,75233635,SRX5716464,SMARCA4,230
chr1,75233424,75233657,SRX5075169,SMARCA4,233
chr1,75265593,75266095,SRX16500059,CTCF,502
chr1,75265644,75266116,SRX16500061,CTCF,472
chr1,75265664,75266182,SRX16500060,CTCF,518
chr1,75265679,75266092,SRX16500062,CTCF,413
chr1,75265746,75266058,SRX5075168,SMARCA4,312
chr1,75265754,75266090,SRX5075174,SMARCA4,336
chr1,75276497,75276735,SRX5075169,SMARCA4,238
chr1,75276523,75276733,SRX5075176,SMARCA4,210
chr1,75310095,75310382,SRX5054309,FOSL2,287
chr1,75310122,75310422,SRX5075176,SMARCA4,300
chr1,75310144,75310418,SRX5075170,SMARCA4,274
chr1,75310147,75310384,SRX5075169,SMARCA4,237
chr1,75330695,75330885,SRX5054309,FOSL2,190
chr1,75338996,75339226,SRX5075174,SMARCA4,230
chr1,75339002,75339181,SRX5075168,SMARCA4,179
chr1,75342825,75343146,SRX5075174,SMARCA4,321
chr1,75342836,75343104,SRX5075168,SMARCA4,268
chr1,75345824,75346310,SRX5716469,SMARCA4,486
chr1,75345836,75346285,SRX5075176,SMARCA4,449
chr1,75345877,75346334,SRX5075169,SMARCA4,457
chr1,75345911,75346399,SRX5054309,FOSL2,488
chr1,75345930,75346321,SRX5075170,SMARCA4,391
chr1,75345933,75346304,SRX5075175,SMARCA4,371
chr1,75345947,75346225,SRX5020211,SMARCA2,278
chr1,75345951,75346367,SRX5716470,SMARCA4,416
chr1,75345954,75346164,SRX5075168,SMARCA4,210
chr1,75345979,75346288,SRX5075174,SMARCA4,309
chr1,75345986,75346324,SRX5716467,SMARCA2,338
chr1,75346051,75346364,SRX5054308,FOSL2,313
chr1,75346080,75346321,SRX5020214,SMARCA2,241
chr1,75375237,75375506,SRX5054309,FOSL2,269
chr1,75430568,75430771,SRX5054309,FOSL2,203
chr1,75473026,75473201,SRX5075176,SMARCA4,175
chr1,75473172,75473410,SRX5075170,SMARCA4,238
chr1,75473240,75473423,SRX5054309,FOSL2,183
chr1,75529556,75529857,SRX5054309,FOSL2,301
chr1,75539544,75539784,SRX5054309,FOSL2,240
chr1,75539551,75539831,SRX5054308,FOSL2,280
chr1,75539558,75539766,SRX5075169,SMARCA4,208
chr1,75539628,75539849,SRX5075175,SMARCA4,221
chr1,75542876,75543473,SRX5075168,SMARCA4,597
chr1,75542883,75543095,SRX5716463,SMARCA4,212
chr1,75542918,75543235,SRX5075174,SMARCA4,317
chr1,75543290,75543477,SRX5075174,SMARCA4,187
chr1,75543310,75543527,SRX5716463,SMARCA4,217
chr1,75543744,75543998,SRX5075176,SMARCA4,254
chr1,75543767,75544047,SRX5075170,SMARCA4,280
chr1,75549126,75549393,SRX5716470,SMARCA4,267
chr1,75549142,75549377,SRX5075170,SMARCA4,235
chr1,75549148,75549404,SRX5075176,SMARCA4,256
chr1,75549151,75549456,SRX5075169,SMARCA4,305
chr1,75549163,75549395,SRX5075175,SMARCA4,232
chr1,75549183,75549473,SRX5020211,SMARCA2,290
chr1,75549188,75549441,SRX5716469,SMARCA4,253
chr1,75549194,75549406,SRX5716468,SMARCA2,212
chr1,75559899,75560082,SRX5054309,FOSL2,183
chr1,75588913,75589106,SRX5075168,SMARCA4,193
chr1,75614491,75614898,SRX4174629,CTCF,407
chr1,75614578,75615151,SRX16500062,CTCF,573
chr1,75614662,75615203,SRX16500060,CTCF,541
chr1,75614668,75615076,SRX16500061,CTCF,408
chr1,75614670,75615029,SRX5075168,SMARCA4,359
chr1,75614670,75615032,SRX5075174,SMARCA4,362
chr1,75614671,75615138,SRX16500059,CTCF,467
chr1,75614850,75615193,SRX20140895,INTS13,343
chr1,75615810,75616097,SRX5075176,SMARCA4,287
chr1,75615849,75616359,SRX20140868,INTS10,510
chr1,75615865,75616034,SRX5075170,SMARCA4,169
chr1,75615927,75616553,SRX20140895,INTS13,626
chr1,75615975,75616268,SRX5075174,SMARCA4,293
chr1,75616885,75617109,SRX5075169,SMARCA4,224
chr1,75630035,75630381,SRX5075168,SMARCA4,346
chr1,75630047,75630321,SRX5075174,SMARCA4,274
chr1,75632234,75632746,SRX16500059,CTCF,512
chr1,75632279,75632813,SRX16500060,CTCF,534
chr1,75632294,75632770,SRX16500062,CTCF,476
chr1,75632303,75632802,SRX16500061,CTCF,499
chr1,75632403,75632700,SRX4174629,CTCF,297
chr1,75632409,75632636,SRX5075168,SMARCA4,227
chr1,75632419,75632635,SRX5075174,SMARCA4,216
chr1,75632430,75632634,SRX5075170,SMARCA4,204
chr1,75672865,75673058,SRX5054309,FOSL2,193
chr1,75724041,75724221,SRX5075169,SMARCA4,180
chr1,75724105,75724886,SRX5075168,SMARCA4,781
chr1,75724134,75724996,SRX20140895,INTS13,862
chr1,75724148,75724832,SRX5075174,SMARCA4,684
chr1,75724166,75724791,SRX5075176,SMARCA4,625
chr1,75724201,75724602,SRX5075170,SMARCA4,401
chr1,75724240,75724731,SRX5716470,SMARCA4,491
chr1,75724334,75724980,SRX20140868,INTS10,646
chr1,75724370,75724576,SRX5716464,SMARCA4,206
chr1,75724375,75724650,SRX5075169,SMARCA4,275
chr1,75724383,75724900,SRX20140881,CPSF3L,517
chr1,75724391,75724871,SRX5716463,SMARCA4,480
chr1,75724422,75724861,SRX20140867,INTS10,439
chr1,75724451,75724807,SRX20140897,INTS13,356
chr1,75724542,75724883,SRX20140879,CPSF3L,341
chr1,75724641,75725003,SRX5075175,SMARCA4,362
chr1,75724695,75724895,SRX5075170,SMARCA4,200
chr1,75765542,75765889,SRX5716460,Epitope tags,347
chr1,75765660,75766199,SRX5075176,SMARCA4,539
chr1,75765687,75766172,SRX5054309,FOSL2,485
chr1,75765690,75766273,SRX5075169,SMARCA4,583
chr1,75765715,75766132,SRX5075170,SMARCA4,417
chr1,75765720,75766083,SRX5054308,FOSL2,363
chr1,75765766,75766074,SRX5020214,SMARCA2,308
chr1,75765766,75766208,SRX5075175,SMARCA4,442
chr1,75765772,75766045,SRX5716467,SMARCA2,273
chr1,75765797,75766139,SRX5716469,SMARCA4,342
chr1,75765811,75766017,SRX5020211,SMARCA2,206
chr1,75785893,75786413,SRX5075174,SMARCA4,520
chr1,75785923,75786438,SRX20140869,INTS10,515
chr1,75785940,75786174,SRX5075175,SMARCA4,234
chr1,75785954,75786419,SRX5075176,SMARCA4,465
chr1,75785957,75786465,SRX5075169,SMARCA4,508
chr1,75785971,75786501,SRX20140897,INTS13,530
chr1,75785984,75786246,SRX5075170,SMARCA4,262
chr1,75785985,75786320,SRX5716464,SMARCA4,335
chr1,75785993,75786435,SRX5075168,SMARCA4,442
chr1,75786011,75786539,SRX20140895,INTS13,528
chr1,75786012,75786513,SRX20140868,INTS10,501
chr1,75786053,75786532,SRX20140879,CPSF3L,479
chr1,75786062,75786496,SRX20140867,INTS10,434
chr1,75786132,75786537,SRX20140881,CPSF3L,405
chr1,75842518,75842820,SRX16500061,CTCF,302
chr1,75842540,75842910,SRX16500060,CTCF,370
chr1,75842546,75842931,SRX16500059,CTCF,385
chr1,75842558,75842895,SRX16500062,CTCF,337
chr1,75842628,75842801,SRX5075174,SMARCA4,173
chr1,75908595,75909017,SRX16500060,CTCF,422
chr1,75908601,75909020,SRX16500059,CTCF,419
chr1,75908669,75908955,SRX16500061,CTCF,286
chr1,75908674,75908928,SRX16500062,CTCF,254
chr1,75908789,75909029,SRX5075168,SMARCA4,240
chr1,75937116,75937385,SRX5054309,FOSL2,269
chr1,75937134,75937317,SRX5075169,SMARCA4,183
chr1,75937142,75937403,SRX5054308,FOSL2,261
chr1,75949068,75949423,SRX5075174,SMARCA4,355
chr1,75949086,75949488,SRX5075168,SMARCA4,402
chr1,75949123,75949445,SRX5075176,SMARCA4,322
chr1,75949204,75949416,SRX5716470,SMARCA4,212
chr1,75949218,75949501,SRX5075170,SMARCA4,283
chr1,75949222,75949432,SRX5075175,SMARCA4,210
chr1,75949233,75949413,SRX5075169,SMARCA4,180
chr1,75964390,75964685,SRX5075175,SMARCA4,295
chr1,75964396,75964689,SRX5075169,SMARCA4,293
chr1,75964426,75964682,SRX5054309,FOSL2,256
chr1,75964436,75964648,SRX5054308,FOSL2,212
chr1,75964441,75964661,SRX5075176,SMARCA4,220
chr1,75964479,75964828,SRX5075170,SMARCA4,349
chr1,75964493,75964704,SRX5716470,SMARCA4,211
chr1,75991403,75991963,SRX16500060,CTCF,560
chr1,75991430,75991903,SRX16500062,CTCF,473
chr1,75991455,75991949,SRX16500061,CTCF,494
chr1,75991466,75991938,SRX16500059,CTCF,472
chr1,75991544,75991919,SRX5075168,SMARCA4,375
chr1,75991569,75991907,SRX4174629,CTCF,338
chr1,75991592,75991871,SRX5075174,SMARCA4,279
chr1,75991593,75991840,SRX5716464,SMARCA4,247
chr1,75991608,75991842,SRX5716470,SMARCA4,234
chr1,75991625,75991834,SRX5716463,SMARCA4,209
chr1,75991640,75991875,SRX5075170,SMARCA4,235
chr1,76006048,76006602,SRX5716470,SMARCA4,554
chr1,76006061,76006658,SRX5075176,SMARCA4,597
chr1,76006068,76006603,SRX5075170,SMARCA4,535
chr1,76006119,76006632,SRX5075175,SMARCA4,513
chr1,76006132,76006618,SRX5075169,SMARCA4,486
chr1,76006148,76006671,SRX5716469,SMARCA4,523
chr1,76006165,76006633,SRX5054309,FOSL2,468
chr1,76006187,76006591,SRX5020211,SMARCA2,404
chr1,76006189,76006592,SRX5716467,SMARCA2,403
chr1,76006208,76006555,SRX5716468,SMARCA2,347
chr1,76006221,76006544,SRX5020214,SMARCA2,323
chr1,76006226,76006607,SRX5054308,FOSL2,381
chr1,76006255,76006549,SRX5075181,SMARCA2,294
chr1,76006288,76006581,SRX5075182,SMARCA2,293
chr1,76012777,76013474,SRX5075174,SMARCA4,697
chr1,76012843,76013479,SRX5075168,SMARCA4,636
chr1,76012879,76013177,SRX5716463,SMARCA4,298
chr1,76012932,76013467,SRX5716464,SMARCA4,535
chr1,76024635,76024833,SRX5075168,SMARCA4,198
chr1,76024663,76024856,SRX5075174,SMARCA4,193
chr1,76035179,76035377,SRX5075170,SMARCA4,198
chr1,76035193,76035368,SRX5075176,SMARCA4,175
chr1,76038275,76038652,SRX5075174,SMARCA4,377
chr1,76038335,76038625,SRX5716464,SMARCA4,290
chr1,76038338,76038601,SRX5716469,SMARCA4,263
chr1,76038382,76038589,SRX5075175,SMARCA4,207
chr1,76038386,76038640,SRX5075168,SMARCA4,254
chr1,76048034,76048503,SRX5075176,SMARCA4,469
chr1,76048064,76048321,SRX5075169,SMARCA4,257
chr1,76048067,76048485,SRX5075170,SMARCA4,418
chr1,76048111,76048335,SRX5716469,SMARCA4,224
chr1,76052941,76053339,SRX5075168,SMARCA4,398
chr1,76053027,76053453,SRX5075174,SMARCA4,426
chr1,76053109,76053363,SRX5716463,SMARCA4,254
chr1,76059286,76059744,SRX5075168,SMARCA4,458
chr1,76059385,76059778,SRX5075174,SMARCA4,393
chr1,76059426,76059758,SRX5716464,SMARCA4,332
chr1,76066464,76066677,SRX5054309,FOSL2,213
chr1,76068521,76068870,SRX5054309,FOSL2,349
chr1,76068567,76068829,SRX5075174,SMARCA4,262
chr1,76068600,76068855,SRX5054308,FOSL2,255
chr1,76068608,76068874,SRX5075175,SMARCA4,266
chr1,76068616,76068910,SRX5075170,SMARCA4,294
chr1,76068619,76068798,SRX5075168,SMARCA4,179
chr1,76074324,76075037,SRX5075174,SMARCA4,713
chr1,76074324,76075085,SRX20140895,INTS13,761
chr1,76074369,76074984,SRX5075170,SMARCA4,615
chr1,76074377,76074868,SRX20140897,INTS13,491
chr1,76074387,76074920,SRX5075168,SMARCA4,533
chr1,76074396,76074743,SRX20140867,INTS10,347
chr1,76074403,76074621,SRX5075169,SMARCA4,218
chr1,76074405,76074623,SRX5075175,SMARCA4,218
chr1,76074408,76074672,SRX5716464,SMARCA4,264
chr1,76074422,76075027,SRX20140868,INTS10,605
chr1,76074449,76074988,SRX5075176,SMARCA4,539
chr1,76074531,76074821,SRX20140896,INTS13,290
chr1,76074533,76074804,SRX5054307,FOSL2,271
chr1,76074651,76074901,SRX5716470,SMARCA4,250
chr1,76074793,76074997,SRX5716463,SMARCA4,204
chr1,76074802,76075092,SRX5075175,SMARCA4,290
chr1,76076041,76076287,SRX5054308,FOSL2,246
chr1,76084304,76084577,SRX5075175,SMARCA4,273
chr1,76084307,76084654,SRX5075170,SMARCA4,347
chr1,76084310,76084648,SRX5075176,SMARCA4,338
chr1,76086216,76086472,SRX5054309,FOSL2,256
chr1,76086312,76086510,SRX5054308,FOSL2,198
chr1,76090328,76090699,SRX5075174,SMARCA4,371
chr1,76090426,76090726,SRX5075168,SMARCA4,300
chr1,76101110,76101329,SRX5075174,SMARCA4,219
chr1,76101116,76101299,SRX5075168,SMARCA4,183
chr1,76103113,76103313,SRX5020211,SMARCA2,200
chr1,76103483,76103764,SRX5075174,SMARCA4,281
chr1,76103487,76103666,SRX5075168,SMARCA4,179
chr1,76115288,76115520,SRX5054309,FOSL2,232
chr1,76143072,76143420,SRX5075170,SMARCA4,348
chr1,76154054,76154582,SRX16500059,CTCF,528
chr1,76154079,76154558,SRX16500061,CTCF,479
chr1,76154089,76154542,SRX16500060,CTCF,453
chr1,76154095,76154672,SRX16500062,CTCF,577
chr1,76154169,76154706,SRX4174629,CTCF,537
chr1,76154200,76154404,SRX5716463,SMARCA4,204
chr1,76154219,76154449,SRX5075176,SMARCA4,230
chr1,76154221,76154418,SRX5075170,SMARCA4,197
chr1,76154223,76154524,SRX5075174,SMARCA4,301
chr1,76154274,76154491,SRX5075168,SMARCA4,217
chr1,76154777,76155027,SRX16500061,CTCF,250
chr1,76186700,76187146,SRX5075170,SMARCA4,446
chr1,76186710,76186944,SRX5716467,SMARCA2,234
chr1,76186714,76186969,SRX5075176,SMARCA4,255
chr1,76186754,76186939,SRX5075169,SMARCA4,185
chr1,76186757,76187220,SRX5716469,SMARCA4,463
chr1,76186761,76186978,SRX5716470,SMARCA4,217
chr1,76186832,76187153,SRX5075174,SMARCA4,321
chr1,76187032,76187244,SRX5075176,SMARCA4,212
chr1,76206816,76207027,SRX5716470,SMARCA4,211
chr1,76206844,76207086,SRX5075169,SMARCA4,242
chr1,76238186,76238519,SRX5075170,SMARCA4,333
chr1,76238202,76238604,SRX5075174,SMARCA4,402
chr1,76238207,76238496,SRX5054309,FOSL2,289
chr1,76238208,76238500,SRX5075176,SMARCA4,292
chr1,76238220,76238599,SRX5075169,SMARCA4,379
chr1,76238234,76238515,SRX5075175,SMARCA4,281
chr1,76238379,76238566,SRX5075168,SMARCA4,187
chr1,76250263,76250520,SRX5716468,SMARCA2,257
chr1,76250268,76250653,SRX5075176,SMARCA4,385
chr1,76250296,76250522,SRX5075175,SMARCA4,226
chr1,76250300,76250629,SRX5075170,SMARCA4,329
chr1,76250308,76250536,SRX5075168,SMARCA4,228
chr1,76250329,76250643,SRX5716470,SMARCA4,314
chr1,76250380,76250612,SRX5075169,SMARCA4,232
chr1,76254198,76254523,SRX5054309,FOSL2,325
chr1,76254205,76254521,SRX5054308,FOSL2,316
chr1,76254210,76254510,SRX5075175,SMARCA4,300
chr1,76254217,76254472,SRX5075169,SMARCA4,255
chr1,76254224,76254539,SRX5075176,SMARCA4,315
chr1,76254230,76254497,SRX5075170,SMARCA4,267
chr1,76254272,76254521,SRX5716470,SMARCA4,249
chr1,76257728,76258167,SRX5075174,SMARCA4,439
chr1,76257911,76258168,SRX5075168,SMARCA4,257
chr1,76269190,76269488,SRX5716470,SMARCA4,298
chr1,76269190,76269520,SRX5075170,SMARCA4,330
chr1,76269193,76269561,SRX5075176,SMARCA4,368
chr1,76269204,76269504,SRX5075169,SMARCA4,300
chr1,76269215,76269477,SRX5054308,FOSL2,262
chr1,76269252,76269517,SRX5075175,SMARCA4,265
chr1,76269260,76269517,SRX5075168,SMARCA4,257
chr1,76269261,76269473,SRX5716469,SMARCA4,212
chr1,76269265,76269507,SRX5054309,FOSL2,242
chr1,76281337,76281515,SRX5075170,SMARCA4,178
chr1,76281519,76281700,SRX5075176,SMARCA4,181
chr1,76294598,76294811,SRX5075168,SMARCA4,213
chr1,76313907,76314086,SRX5075174,SMARCA4,179
chr1,76330968,76331428,SRX16500059,CTCF,460
chr1,76330979,76331500,SRX16500062,CTCF,521
chr1,76330980,76331510,SRX16500060,CTCF,530
chr1,76330982,76331421,SRX16500061,CTCF,439
chr1,76331038,76331289,SRX5075168,SMARCA4,251
chr1,76331072,76331316,SRX5054309,FOSL2,244
chr1,76331098,76331355,SRX5075174,SMARCA4,257
chr1,76331149,76331331,SRX5054308,FOSL2,182
chr1,76331161,76331348,SRX5075175,SMARCA4,187
chr1,76336651,76336839,SRX5075168,SMARCA4,188
chr1,76336742,76337273,SRX5075174,SMARCA4,531
chr1,76336910,76337476,SRX5075170,SMARCA4,566
chr1,76336942,76337247,SRX5075168,SMARCA4,305
chr1,76336980,76337459,SRX5075176,SMARCA4,479
chr1,76337007,76337466,SRX5075169,SMARCA4,459
chr1,76337010,76337470,SRX5716470,SMARCA4,460
chr1,76337016,76337472,SRX5075175,SMARCA4,456
chr1,76337037,76337409,SRX5716467,SMARCA2,372
chr1,76337069,76337329,SRX5020211,SMARCA2,260
chr1,76337092,76337523,SRX5716469,SMARCA4,431
chr1,76337115,76337345,SRX5020214,SMARCA2,230
chr1,76337153,76337345,SRX5054309,FOSL2,192
chr1,76337158,76337364,SRX5075181,SMARCA2,206
chr1,76337164,76337358,SRX5054308,FOSL2,194
chr1,76337166,76337451,SRX5716468,SMARCA2,285
chr1,76340060,76340240,SRX5075169,SMARCA4,180
chr1,76340075,76340252,SRX5075170,SMARCA4,177
chr1,76340087,76340282,SRX5075176,SMARCA4,195
chr1,76355570,76356013,SRX5075168,SMARCA4,443
chr1,76355578,76356084,SRX5075174,SMARCA4,506
chr1,76355623,76355997,SRX5716463,SMARCA4,374
chr1,76355647,76355974,SRX5716464,SMARCA4,327
chr1,76388285,76388610,SRX20140869,INTS10,325
chr1,76422262,76422782,SRX5075174,SMARCA4,520
chr1,76422297,76422629,SRX5716463,SMARCA4,332
chr1,76422364,76422751,SRX5075168,SMARCA4,387
chr1,76425658,76426120,SRX5075170,SMARCA4,462
chr1,76425746,76426186,SRX5075169,SMARCA4,440
chr1,76425753,76426163,SRX5075176,SMARCA4,410
chr1,76425783,76426139,SRX5054308,FOSL2,356
chr1,76425803,76426089,SRX5075175,SMARCA4,286
chr1,76425805,76426100,SRX5716469,SMARCA4,295
chr1,76425834,76426147,SRX5054309,FOSL2,313
chr1,76428073,76428278,SRX5054309,FOSL2,205
chr1,76433257,76433486,SRX5075176,SMARCA4,229
chr1,76433277,76433488,SRX5716470,SMARCA4,211
chr1,76433286,76433630,SRX5075170,SMARCA4,344
chr1,76444805,76444986,SRX5075176,SMARCA4,181
chr1,76444839,76445045,SRX5075170,SMARCA4,206
chr1,76464413,76464736,SRX5075176,SMARCA4,323
chr1,76464470,76464742,SRX5075170,SMARCA4,272
chr1,76481044,76481325,SRX5054309,FOSL2,281
chr1,76481064,76481306,SRX5054308,FOSL2,242
chr1,76481074,76481261,SRX5075175,SMARCA4,187
chr1,76501165,76501345,SRX5075169,SMARCA4,180
chr1,76501190,76501399,SRX5054309,FOSL2,209
chr1,76501237,76501948,SRX5075168,SMARCA4,711
chr1,76501258,76501471,SRX5075176,SMARCA4,213
chr1,76501293,76502177,SRX5075174,SMARCA4,884
chr1,76509005,76509188,SRX5054309,FOSL2,183
chr1,76568933,76569111,SRX5075170,SMARCA4,178
chr1,76584679,76584909,SRX5075170,SMARCA4,230
chr1,76625977,76626158,SRX5075170,SMARCA4,181
chr1,76640116,76640420,SRX5054309,FOSL2,304
chr1,76640127,76640417,SRX5054308,FOSL2,290
chr1,76640218,76640387,SRX5075170,SMARCA4,169
chr1,76659627,76659970,SRX5075170,SMARCA4,343
chr1,76659639,76660023,SRX5075169,SMARCA4,384
chr1,76659647,76659950,SRX5075176,SMARCA4,303
chr1,76659673,76659887,SRX5054309,FOSL2,214
chr1,76679953,76680138,SRX5075174,SMARCA4,185
chr1,76680593,76680935,SRX5075174,SMARCA4,342
chr1,76680621,76680806,SRX5075168,SMARCA4,185
chr1,76687422,76687868,SRX5075170,SMARCA4,446
chr1,76687560,76687898,SRX5716470,SMARCA4,338
chr1,76687562,76687797,SRX5075176,SMARCA4,235
chr1,76690814,76691084,SRX5054308,FOSL2,270
chr1,76690828,76691149,SRX5054309,FOSL2,321
chr1,76690836,76691105,SRX5075169,SMARCA4,269
chr1,76690854,76691142,SRX20140869,INTS10,288
chr1,76690857,76691046,SRX5075175,SMARCA4,189
chr1,76690871,76691075,SRX5075176,SMARCA4,204
chr1,76690882,76691051,SRX5075170,SMARCA4,169
chr1,76760100,76760275,SRX5075176,SMARCA4,175
chr1,76760108,76760321,SRX5075170,SMARCA4,213
chr1,76779467,76779823,SRX20140869,INTS10,356
chr1,76786262,76786543,SRX5075170,SMARCA4,281
chr1,76786270,76786586,SRX5716469,SMARCA4,316
chr1,76786288,76786616,SRX5075176,SMARCA4,328
chr1,76786317,76786648,SRX5054309,FOSL2,331
chr1,76786333,76786682,SRX5054308,FOSL2,349
chr1,76786335,76786612,SRX5075175,SMARCA4,277
chr1,76826065,76826444,SRX5075176,SMARCA4,379
chr1,76826079,76826446,SRX5075169,SMARCA4,367
chr1,76826088,76826476,SRX5075170,SMARCA4,388
chr1,76826097,76826496,SRX5054309,FOSL2,399
chr1,76826101,76826483,SRX5716469,SMARCA4,382
chr1,76826105,76826426,SRX5054308,FOSL2,321
chr1,76826120,76826354,SRX5716470,SMARCA4,234
chr1,76826135,76826426,SRX5075175,SMARCA4,291
chr1,76826175,76826426,SRX5020211,SMARCA2,251
chr1,76835171,76835440,SRX5716469,SMARCA4,269
chr1,76835191,76835520,SRX5716470,SMARCA4,329
chr1,76835233,76835601,SRX5054309,FOSL2,368
chr1,76835245,76835533,SRX5075169,SMARCA4,288
chr1,76835247,76835467,SRX5716467,SMARCA2,220
chr1,76835248,76835525,SRX5075175,SMARCA4,277
chr1,76835271,76835578,SRX5054308,FOSL2,307
chr1,76857240,76857546,SRX5075168,SMARCA4,306
chr1,76862457,76862809,SRX5054309,FOSL2,352
chr1,76862477,76862749,SRX5075170,SMARCA4,272
chr1,76862486,76862752,SRX5075175,SMARCA4,266
chr1,76862493,76862814,SRX5075169,SMARCA4,321
chr1,76862521,76862783,SRX5054308,FOSL2,262
chr1,76862597,76862775,SRX5075176,SMARCA4,178
chr1,76867191,76867595,SRX16500059,CTCF,404
chr1,76867212,76867614,SRX16500062,CTCF,402
chr1,76867215,76867447,SRX16500060,CTCF,232
chr1,76867299,76867500,SRX5075176,SMARCA4,201
chr1,76867322,76867605,SRX5075168,SMARCA4,283
chr1,76867420,76867898,SRX20140895,INTS13,478
chr1,76868123,76868413,SRX4174629,CTCF,290
chr1,76868139,76868740,SRX20140895,INTS13,601
chr1,76868156,76868507,SRX16500059,CTCF,351
chr1,76868206,76868416,SRX16500062,CTCF,210
chr1,76868255,76868512,SRX5075174,SMARCA4,257
chr1,76879111,76879331,SRX5054309,FOSL2,220
chr1,76901175,76901499,SRX16500059,CTCF,324
chr1,76901206,76901427,SRX16500060,CTCF,221
chr1,76901230,76901489,SRX16500062,CTCF,259
chr1,76901242,76901498,SRX16500061,CTCF,256
chr1,76901243,76901507,SRX5075174,SMARCA4,264
chr1,76901281,76901523,SRX5075168,SMARCA4,242
chr1,76901290,76901494,SRX5716463,SMARCA4,204
chr1,76939188,76939471,SRX5716470,SMARCA4,283
chr1,76939212,76939414,SRX5075175,SMARCA4,202
chr1,76939360,76939550,SRX5075176,SMARCA4,190
chr1,76945030,76945275,SRX5075168,SMARCA4,245
chr1,76945046,76945322,SRX5075174,SMARCA4,276
chr1,76955726,76955974,SRX5716470,SMARCA4,248
chr1,76955738,76955949,SRX5075169,SMARCA4,211
chr1,76955764,76955976,SRX5716469,SMARCA4,212
chr1,76998479,76999017,SRX5716469,SMARCA4,538
chr1,76998481,76999038,SRX5075175,SMARCA4,557
chr1,76998483,76998904,SRX5716459,Epitope tags,421
chr1,76998498,76998903,SRX5716470,SMARCA4,405
chr1,76998517,76998948,SRX5716467,SMARCA2,431
chr1,76998525,76999052,SRX5075170,SMARCA4,527
chr1,76998531,76998999,SRX5054309,FOSL2,468
chr1,76998537,76999120,SRX5075169,SMARCA4,583
chr1,76998546,76999074,SRX5075176,SMARCA4,528
chr1,76998551,76998896,SRX5020214,SMARCA2,345
chr1,76998559,76998926,SRX5054308,FOSL2,367
chr1,76998578,76998903,SRX5020211,SMARCA2,325
chr1,76998585,76998894,SRX5716468,SMARCA2,309
chr1,76998612,76998825,SRX5075181,SMARCA2,213
chr1,76998624,76998845,SRX5075182,SMARCA2,221
chr1,77016443,77016692,SRX5075168,SMARCA4,249
chr1,77027951,77028189,SRX5075174,SMARCA4,238
chr1,77036686,77036864,SRX5075170,SMARCA4,178
chr1,77039683,77040170,SRX5075169,SMARCA4,487
chr1,77039709,77040214,SRX5075176,SMARCA4,505
chr1,77039739,77040117,SRX5075170,SMARCA4,378
chr1,77039741,77040017,SRX5716469,SMARCA4,276
chr1,77039748,77040162,SRX5075175,SMARCA4,414
chr1,77039752,77040133,SRX5716470,SMARCA4,381
chr1,77039777,77040124,SRX5054309,FOSL2,347
chr1,77039790,77040034,SRX5716467,SMARCA2,244
chr1,77039798,77040098,SRX5054308,FOSL2,300
chr1,77044559,77044785,SRX5075168,SMARCA4,226
chr1,77064341,77064680,SRX5075168,SMARCA4,339
chr1,77064342,77064560,SRX5075174,SMARCA4,218
chr1,77089818,77090047,SRX5075168,SMARCA4,229
chr1,77089839,77090072,SRX5075174,SMARCA4,233
chr1,77100774,77101014,SRX5075174,SMARCA4,240
chr1,77121003,77121311,SRX5075168,SMARCA4,308
chr1,77121004,77121432,SRX5075174,SMARCA4,428
chr1,77126179,77126556,SRX16500062,CTCF,377
chr1,77126185,77126692,SRX16500060,CTCF,507
chr1,77126202,77126637,SRX16500059,CTCF,435
chr1,77126217,77126632,SRX4174629,CTCF,415
chr1,77126221,77126633,SRX16500061,CTCF,412
chr1,77126283,77126523,SRX5075168,SMARCA4,240
chr1,77126310,77126508,SRX5075170,SMARCA4,198
chr1,77143513,77143876,SRX16500062,CTCF,363
chr1,77143539,77143928,SRX16500061,CTCF,389
chr1,77143540,77143956,SRX16500059,CTCF,416
chr1,77143549,77143903,SRX16500060,CTCF,354
chr1,77148156,77148590,SRX16500060,CTCF,434
chr1,77148188,77148619,SRX16500061,CTCF,431
chr1,77148203,77148606,SRX16500059,CTCF,403
chr1,77148229,77148639,SRX16500062,CTCF,410
chr1,77148265,77148584,SRX5075176,SMARCA4,319
chr1,77148315,77148553,SRX5075174,SMARCA4,238
chr1,77148339,77148519,SRX5075169,SMARCA4,180
chr1,77170688,77171067,SRX5075169,SMARCA4,379
chr1,77170701,77171094,SRX5075176,SMARCA4,393
chr1,77170714,77171103,SRX5075170,SMARCA4,389
chr1,77170731,77171058,SRX5716467,SMARCA2,327
chr1,77170741,77171037,SRX5075175,SMARCA4,296
chr1,77170742,77171144,SRX5054308,FOSL2,402
chr1,77170747,77171012,SRX5716470,SMARCA4,265
chr1,77170750,77170987,SRX5020211,SMARCA2,237
chr1,77170828,77171108,SRX5054309,FOSL2,280
chr1,77202692,77203156,SRX5075170,SMARCA4,464
chr1,77202755,77203194,SRX5716470,SMARCA4,439
chr1,77202758,77203141,SRX5075175,SMARCA4,383
chr1,77202770,77203126,SRX5716467,SMARCA2,356
chr1,77202786,77203083,SRX5716468,SMARCA2,297
chr1,77202790,77203219,SRX5075176,SMARCA4,429
chr1,77202794,77203097,SRX5075169,SMARCA4,303
chr1,77202796,77203192,SRX5716469,SMARCA4,396
chr1,77202807,77203276,SRX5075181,SMARCA2,469
chr1,77202819,77203032,SRX5020214,SMARCA2,213
chr1,77202822,77203105,SRX5054309,FOSL2,283
chr1,77202835,77203095,SRX5054308,FOSL2,260
chr1,77202837,77203179,SRX5020211,SMARCA2,342
chr1,77219137,77219632,SRX20140895,INTS13,495
chr1,77219179,77219648,SRX20140881,CPSF3L,469
chr1,77219207,77219579,SRX20140897,INTS13,372
chr1,77219227,77219651,SRX5075176,SMARCA4,424
chr1,77219230,77219629,SRX5075170,SMARCA4,399
chr1,77219232,77219630,SRX20140879,CPSF3L,398
chr1,77219238,77219541,SRX20140896,INTS13,303
chr1,77219238,77219667,SRX5075168,SMARCA4,429
chr1,77219242,77219691,SRX5075174,SMARCA4,449
chr1,77219243,77219623,SRX5075169,SMARCA4,380
chr1,77219272,77219576,SRX20140867,INTS10,304
chr1,77219287,77219591,SRX5716464,SMARCA4,304
chr1,77219299,77219555,SRX5716470,SMARCA4,256
chr1,77219300,77219703,SRX20140868,INTS10,403
chr1,77219404,77219664,SRX5716469,SMARCA4,260
chr1,77271849,77272305,SRX5075176,SMARCA4,456
chr1,77271899,77272331,SRX5075169,SMARCA4,432
chr1,77271942,77272231,SRX5054308,FOSL2,289
chr1,77271963,77272331,SRX5054309,FOSL2,368
chr1,77271971,77272302,SRX5075175,SMARCA4,331
chr1,77271974,77272277,SRX5075170,SMARCA4,303
chr1,77272048,77272288,SRX5716470,SMARCA4,240
chr1,77281715,77282011,SRX5075168,SMARCA4,296
chr1,77281758,77282208,SRX5075169,SMARCA4,450
chr1,77281761,77282119,SRX5075174,SMARCA4,358
chr1,77281767,77282125,SRX5075170,SMARCA4,358
chr1,77281771,77282254,SRX5075175,SMARCA4,483
chr1,77281777,77282154,SRX5075176,SMARCA4,377
chr1,77281866,77282345,SRX20140895,INTS13,479
chr1,77281973,77282211,SRX5716469,SMARCA4,238
chr1,77283185,77283385,SRX5075174,SMARCA4,200
chr1,77313543,77313830,SRX16500062,CTCF,287
chr1,77313583,77313818,SRX16500059,CTCF,235
chr1,77322032,77322586,SRX5716469,SMARCA4,554
chr1,77322040,77322619,SRX5054309,FOSL2,579
chr1,77322082,77322626,SRX5075175,SMARCA4,544
chr1,77322084,77322603,SRX5075170,SMARCA4,519
chr1,77322088,77322603,SRX5075169,SMARCA4,515
chr1,77322125,77322580,SRX5716460,Epitope tags,455
chr1,77322125,77322624,SRX5054308,FOSL2,499
chr1,77322130,77322588,SRX5075176,SMARCA4,458
chr1,77322154,77322548,SRX5716470,SMARCA4,394
chr1,77322167,77322509,SRX5020214,SMARCA2,342
chr1,77322201,77322510,SRX5716467,SMARCA2,309
chr1,77322203,77322620,SRX5075168,SMARCA4,417
chr1,77322219,77322615,SRX5075174,SMARCA4,396
chr1,77322224,77322545,SRX5020211,SMARCA2,321
chr1,77334786,77335372,SRX5075168,SMARCA4,586
chr1,77334836,77335371,SRX5075174,SMARCA4,535
chr1,77336816,77337106,SRX5075176,SMARCA4,290
chr1,77336831,77337042,SRX5075170,SMARCA4,211
chr1,77345186,77345531,SRX5075174,SMARCA4,345
chr1,77345201,77345660,SRX5075168,SMARCA4,459
chr1,77347635,77348098,SRX5075176,SMARCA4,463
chr1,77347640,77348064,SRX5075170,SMARCA4,424
chr1,77347664,77347992,SRX5716470,SMARCA4,328
chr1,77347665,77348050,SRX5075175,SMARCA4,385
chr1,77347668,77348083,SRX5054309,FOSL2,415
chr1,77347689,77348007,SRX5075174,SMARCA4,318
chr1,77347693,77348083,SRX5075169,SMARCA4,390
chr1,77347695,77348039,SRX5054308,FOSL2,344
chr1,77347700,77347994,SRX5075168,SMARCA4,294
chr1,77347705,77347909,SRX5020211,SMARCA2,204
chr1,77347719,77348039,SRX5716467,SMARCA2,320
chr1,77347720,77347973,SRX5716469,SMARCA4,253
chr1,77347745,77347969,SRX5020214,SMARCA2,224
chr1,77370746,77371321,SRX5075175,SMARCA4,575
chr1,77370878,77371287,SRX5075169,SMARCA4,409
chr1,77370922,77371263,SRX5075170,SMARCA4,341
chr1,77370944,77371284,SRX5054309,FOSL2,340
chr1,77370950,77371227,SRX5716469,SMARCA4,277
chr1,77370999,77371255,SRX5075176,SMARCA4,256
chr1,77371026,77371246,SRX5054308,FOSL2,220
chr1,77379052,77379453,SRX5716470,SMARCA4,401
chr1,77379261,77379480,SRX5075170,SMARCA4,219
chr1,77406632,77406920,SRX5075170,SMARCA4,288
chr1,77406778,77407120,SRX5075169,SMARCA4,342
chr1,77406792,77407101,SRX5075176,SMARCA4,309
chr1,77406822,77407085,SRX5716467,SMARCA2,263
chr1,77406829,77407041,SRX5716469,SMARCA4,212
chr1,77407998,77408380,SRX5075174,SMARCA4,382
chr1,77408000,77408325,SRX5716463,SMARCA4,325
chr1,77408074,77408349,SRX5075168,SMARCA4,275
chr1,77408104,77408327,SRX5716469,SMARCA4,223
chr1,77412463,77413260,SRX5075174,SMARCA4,797
chr1,77412471,77413374,SRX5075168,SMARCA4,903
chr1,77412503,77412787,SRX5054309,FOSL2,284
chr1,77412509,77412772,SRX5075170,SMARCA4,263
chr1,77412513,77412765,SRX5054308,FOSL2,252
chr1,77412538,77412754,SRX5075176,SMARCA4,216
chr1,77412667,77413212,SRX5716463,SMARCA4,545
chr1,77412770,77413146,SRX5716464,SMARCA4,376
chr1,77412838,77413134,SRX5716451,SOX2,296
chr1,77412846,77413051,SRX5716454,SOX3,205
chr1,77417109,77417439,SRX16500059,CTCF,330
chr1,77417170,77417389,SRX16500061,CTCF,219
chr1,77438149,77438706,SRX5716470,SMARCA4,557
chr1,77438194,77438711,SRX5075169,SMARCA4,517
chr1,77438200,77438648,SRX5075170,SMARCA4,448
chr1,77438277,77438680,SRX5075176,SMARCA4,403
chr1,77438324,77438642,SRX5716468,SMARCA2,318
chr1,77438329,77438604,SRX5075175,SMARCA4,275
chr1,77438353,77438583,SRX5054309,FOSL2,230
chr1,77438356,77438620,SRX5716467,SMARCA2,264
chr1,77438360,77438670,SRX5716469,SMARCA4,310
chr1,77438366,77438580,SRX5020211,SMARCA2,214
chr1,77447152,77447549,SRX5075168,SMARCA4,397
chr1,77473720,77474130,SRX5075175,SMARCA4,410
chr1,77473752,77474076,SRX5075169,SMARCA4,324
chr1,77473768,77474009,SRX5075170,SMARCA4,241
chr1,77473781,77473972,SRX5075176,SMARCA4,191
chr1,77473787,77474005,SRX5716469,SMARCA4,218
chr1,77489719,77490400,SRX5075174,SMARCA4,681
chr1,77489744,77490377,SRX5716464,SMARCA4,633
chr1,77489747,77490410,SRX5075168,SMARCA4,663
chr1,77489872,77490317,SRX5716469,SMARCA4,445
chr1,77489926,77490348,SRX5716463,SMARCA4,422
chr1,77489927,77490298,SRX5716470,SMARCA4,371
chr1,77489943,77490123,SRX5075169,SMARCA4,180
chr1,77489958,77490241,SRX5716451,SOX2,283
chr1,77489964,77490215,SRX5075176,SMARCA4,251
chr1,77489994,77490207,SRX5075175,SMARCA4,213
chr1,77498829,77499258,SRX5075169,SMARCA4,429
chr1,77498856,77499246,SRX5075176,SMARCA4,390
chr1,77498883,77499288,SRX5075170,SMARCA4,405
chr1,77498903,77499154,SRX5716470,SMARCA4,251
chr1,77511372,77511788,SRX5054309,FOSL2,416
chr1,77511393,77511718,SRX5075169,SMARCA4,325
chr1,77511503,77511683,SRX5054308,FOSL2,180
chr1,77514189,77514928,SRX5075174,SMARCA4,739
chr1,77514219,77514915,SRX5075168,SMARCA4,696
chr1,77514362,77514902,SRX5075176,SMARCA4,540
chr1,77514380,77514938,SRX5716470,SMARCA4,558
chr1,77514381,77514881,SRX5716463,SMARCA4,500
chr1,77514388,77514863,SRX5075170,SMARCA4,475
chr1,77514391,77514823,SRX5075169,SMARCA4,432
chr1,77514398,77514800,SRX5020211,SMARCA2,402
chr1,77514399,77514785,SRX5716468,SMARCA2,386
chr1,77514417,77514949,SRX5716469,SMARCA4,532
chr1,77514423,77514838,SRX5716451,SOX2,415
chr1,77514432,77514711,SRX5054308,FOSL2,279
chr1,77514439,77514743,SRX5075181,SMARCA2,304
chr1,77514447,77514865,SRX5075175,SMARCA4,418
chr1,77514448,77514873,SRX5716467,SMARCA2,425
chr1,77514487,77514723,SRX5020214,SMARCA2,236
chr1,77514492,77514791,SRX5716464,SMARCA4,299
chr1,77514504,77514687,SRX5054309,FOSL2,183
chr1,77514546,77514741,SRX5075182,SMARCA2,195
chr1,77515046,77515310,SRX5075176,SMARCA4,264
chr1,77533622,77534136,SRX16500061,CTCF,514
chr1,77533636,77534121,SRX16500060,CTCF,485
chr1,77533647,77534125,SRX16500062,CTCF,478
chr1,77533650,77534202,SRX16500059,CTCF,552
chr1,77533687,77534266,SRX4174629,CTCF,579
chr1,77533693,77534003,SRX5075174,SMARCA4,310
chr1,77533715,77534080,SRX5075168,SMARCA4,365
chr1,77533718,77533959,SRX5716470,SMARCA4,241
chr1,77533720,77533956,SRX5075170,SMARCA4,236
chr1,77533736,77534000,SRX5716464,SMARCA4,264
chr1,77533770,77534026,SRX5075175,SMARCA4,256
chr1,77533783,77533985,SRX5075176,SMARCA4,202
chr1,77536667,77537126,SRX5075176,SMARCA4,459
chr1,77536694,77537143,SRX5075169,SMARCA4,449
chr1,77536714,77537198,SRX5054309,FOSL2,484
chr1,77536730,77537130,SRX5054308,FOSL2,400
chr1,77536734,77537165,SRX5075170,SMARCA4,431
chr1,77536774,77537146,SRX5075175,SMARCA4,372
chr1,77536841,77537089,SRX5716469,SMARCA4,248
chr1,77536862,77537096,SRX5020211,SMARCA2,234
chr1,77536898,77537181,SRX5020214,SMARCA2,283
chr1,77536920,77537141,SRX5075182,SMARCA2,221
chr1,77539172,77539554,SRX5716469,SMARCA4,382
chr1,77539194,77539511,SRX5075169,SMARCA4,317
chr1,77539214,77539505,SRX5075176,SMARCA4,291
chr1,77539220,77539403,SRX5054308,FOSL2,183
chr1,77539258,77539472,SRX5075175,SMARCA4,214
chr1,77546005,77546254,SRX5075175,SMARCA4,249
chr1,77565297,77565720,SRX5716470,SMARCA4,423
chr1,77565370,77565581,SRX5054308,FOSL2,211
chr1,77565406,77565607,SRX5075170,SMARCA4,201
chr1,77565434,77565643,SRX5075176,SMARCA4,209
chr1,77579670,77579923,SRX16500062,CTCF,253
chr1,77605379,77605601,SRX5075176,SMARCA4,222
chr1,77605392,77605651,SRX5075170,SMARCA4,259
chr1,77639110,77639371,SRX5054309,FOSL2,261
chr1,77652352,77652746,SRX5075170,SMARCA4,394
chr1,77652368,77652756,SRX5716470,SMARCA4,388
chr1,77652377,77652734,SRX5075175,SMARCA4,357
chr1,77652382,77652835,SRX5075176,SMARCA4,453
chr1,77652403,77652670,SRX5075169,SMARCA4,267
chr1,77652440,77652748,SRX5716469,SMARCA4,308
chr1,77652453,77652737,SRX5716467,SMARCA2,284
chr1,77682585,77683773,SRX20140895,INTS13,1188
chr1,77682616,77683064,SRX20140867,INTS10,448
chr1,77682627,77683488,SRX20140897,INTS13,861
chr1,77682634,77682967,SRX20140869,INTS10,333
chr1,77682682,77683108,SRX20140881,CPSF3L,426
chr1,77682744,77683103,SRX20140894,INTS13,359
chr1,77682800,77683206,SRX20140896,INTS13,406
chr1,77682865,77683088,SRX5075174,SMARCA4,223
chr1,77683223,77683791,SRX20140867,INTS10,568
chr1,77683241,77683848,SRX16500060,CTCF,607
chr1,77683264,77683764,SRX20140868,INTS10,500
chr1,77683298,77683835,SRX16500059,CTCF,537
chr1,77683305,77683711,SRX5716470,SMARCA4,406
chr1,77683323,77683809,SRX16500062,CTCF,486
chr1,77683333,77683702,SRX5075168,SMARCA4,369
chr1,77683347,77683788,SRX16500061,CTCF,441
chr1,77683348,77683772,SRX5075174,SMARCA4,424
chr1,77683352,77683739,SRX5075170,SMARCA4,387
chr1,77683359,77683811,SRX5075176,SMARCA4,452
chr1,77683369,77683805,SRX5075175,SMARCA4,436
chr1,77683385,77683660,SRX5716464,SMARCA4,275
chr1,77683389,77683674,SRX5716469,SMARCA4,285
chr1,77683418,77683692,SRX5716463,SMARCA4,274
chr1,77683460,77683910,SRX5075169,SMARCA4,450
chr1,77683540,77683836,SRX20140879,CPSF3L,296
chr1,77739777,77740216,SRX5075168,SMARCA4,439
chr1,77739784,77740230,SRX5075174,SMARCA4,446
chr1,77739823,77740116,SRX5054307,FOSL2,293
chr1,77758994,77759201,SRX5075175,SMARCA4,207
chr1,77759085,77759261,SRX5075176,SMARCA4,176
chr1,77759428,77759955,SRX20140895,INTS13,527
chr1,77759562,77759868,SRX20140868,INTS10,306
chr1,77759597,77760025,SRX5075174,SMARCA4,428
chr1,77759606,77760050,SRX5075175,SMARCA4,444
chr1,77759625,77760115,SRX5075168,SMARCA4,490
chr1,77759646,77759994,SRX5716470,SMARCA4,348
chr1,77759649,77759882,SRX5075169,SMARCA4,233
chr1,77759665,77760053,SRX5075176,SMARCA4,388
chr1,77759668,77760144,SRX5075170,SMARCA4,476
chr1,77759705,77759917,SRX5716463,SMARCA4,212
chr1,77762047,77762339,SRX5054308,FOSL2,292
chr1,77762064,77762360,SRX5054309,FOSL2,296
chr1,77762089,77762292,SRX5075169,SMARCA4,203
chr1,77779443,77779830,SRX20140895,INTS13,387
chr1,77779461,77779727,SRX5075168,SMARCA4,266
chr1,77779516,77779757,SRX5075174,SMARCA4,241
chr1,77779536,77779741,SRX5716464,SMARCA4,205
chr1,77779584,77779759,SRX5075176,SMARCA4,175
chr1,77810087,77810384,SRX5075176,SMARCA4,297
chr1,77832374,77832642,SRX5075176,SMARCA4,268
chr1,77832392,77832593,SRX5075170,SMARCA4,201
chr1,77832828,77833412,SRX5075170,SMARCA4,584
chr1,77832833,77833360,SRX5075169,SMARCA4,527
chr1,77832866,77833335,SRX5075175,SMARCA4,469
chr1,77832872,77833266,SRX5716469,SMARCA4,394
chr1,77832878,77833349,SRX5075176,SMARCA4,471
chr1,77832902,77833308,SRX5054309,FOSL2,406
chr1,77832910,77833258,SRX5020214,SMARCA2,348
chr1,77832918,77833284,SRX5716468,SMARCA2,366
chr1,77832922,77833331,SRX5716470,SMARCA4,409
chr1,77832943,77833322,SRX5716467,SMARCA2,379
chr1,77832986,77833342,SRX5020211,SMARCA2,356
chr1,77833001,77833195,SRX5075182,SMARCA2,194
chr1,77833124,77833325,SRX5054308,FOSL2,201
chr1,77857639,77857915,SRX5075169,SMARCA4,276
chr1,77857656,77857931,SRX5075176,SMARCA4,275
chr1,77857668,77857881,SRX5075170,SMARCA4,213
chr1,77857675,77857931,SRX5054309,FOSL2,256
chr1,77857721,77857946,SRX5716470,SMARCA4,225
chr1,77875028,77875322,SRX5054309,FOSL2,294
chr1,77875126,77875359,SRX5075169,SMARCA4,233
chr1,77888067,77888539,SRX5716470,SMARCA4,472
chr1,77888104,77888591,SRX5075176,SMARCA4,487
chr1,77888134,77888766,SRX5075170,SMARCA4,632
chr1,77888168,77888535,SRX5716469,SMARCA4,367
chr1,77888193,77888525,SRX5075175,SMARCA4,332
chr1,77888284,77889100,SRX20140895,INTS13,816
chr1,77888304,77888538,SRX5075169,SMARCA4,234
chr1,77888323,77888765,SRX5075168,SMARCA4,442
chr1,77888327,77888767,SRX5075174,SMARCA4,440
chr1,77888382,77888937,SRX20140868,INTS10,555
chr1,77888483,77888772,SRX20140897,INTS13,289
chr1,77888848,77889027,SRX5075168,SMARCA4,179
chr1,77889201,77889374,SRX5075174,SMARCA4,173
chr1,77889668,77890057,SRX5075169,SMARCA4,389
chr1,77889775,77890061,SRX5054309,FOSL2,286
chr1,77889784,77890039,SRX5054308,FOSL2,255
chr1,77889876,77890093,SRX5075175,SMARCA4,217
chr1,77900607,77901094,SRX16500059,CTCF,487
chr1,77900667,77901061,SRX16500062,CTCF,394
chr1,77900684,77901087,SRX16500060,CTCF,403
chr1,77900684,77901178,SRX16500061,CTCF,494
chr1,77900741,77901015,SRX5075174,SMARCA4,274
chr1,77900757,77900939,SRX5075168,SMARCA4,182
chr1,77900795,77900995,SRX5075170,SMARCA4,200
chr1,77925462,77925673,SRX5716470,SMARCA4,211
chr1,77925509,77925780,SRX5020211,SMARCA2,271
chr1,77949020,77949428,SRX5075170,SMARCA4,408
chr1,77949042,77949345,SRX5716469,SMARCA4,303
chr1,77949067,77949403,SRX5075176,SMARCA4,336
chr1,77949077,77949385,SRX5716470,SMARCA4,308
chr1,77949092,77949409,SRX5075169,SMARCA4,317
chr1,77949100,77949355,SRX5020211,SMARCA2,255
chr1,77949114,77949399,SRX5075175,SMARCA4,285
chr1,77949178,77949351,SRX5075174,SMARCA4,173
chr1,77954584,77954853,SRX5054309,FOSL2,269
chr1,77978096,77978376,SRX5075174,SMARCA4,280
chr1,77978175,77978543,SRX20140895,INTS13,368
chr1,77978240,77978439,SRX5075176,SMARCA4,199
chr1,77978365,77979049,SRX20140869,INTS10,684
chr1,77978611,77978959,SRX20140881,CPSF3L,348
chr1,77978753,77979710,SRX20140895,INTS13,957
chr1,77978785,77979172,SRX20140868,INTS10,387
chr1,77978785,77979644,SRX20140897,INTS13,859
chr1,77978942,77979591,SRX20140867,INTS10,649
chr1,77979000,77979490,SRX20140896,INTS13,490
chr1,77979080,77979289,SRX5716451,SOX2,209
chr1,77979084,77979572,SRX5075168,SMARCA4,488
chr1,77979137,77979625,SRX5075174,SMARCA4,488
chr1,77979165,77979443,SRX20140879,CPSF3L,278
chr1,77979191,77979449,SRX5716463,SMARCA4,258
chr1,77979225,77979529,SRX20140868,INTS10,304
chr1,77979228,77979521,SRX5716464,SMARCA4,293
chr1,77979239,77979455,SRX4174629,CTCF,216
chr1,77979247,77979592,SRX20140869,INTS10,345
chr1,77979265,77979746,SRX16500060,CTCF,481
chr1,77979267,77979816,SRX16500059,CTCF,549
chr1,77979295,77979621,SRX5075169,SMARCA4,326
chr1,77979316,77979674,SRX16500062,CTCF,358
chr1,77979321,77979621,SRX5716470,SMARCA4,300
chr1,77979327,77979653,SRX5075176,SMARCA4,326
chr1,77979329,77979661,SRX5075170,SMARCA4,332
chr1,77979347,77979561,SRX5075175,SMARCA4,214
chr1,77979349,77979770,SRX16500061,CTCF,421
chr1,78003949,78004759,SRX20140879,CPSF3L,810
chr1,78003950,78004957,SRX20140895,INTS13,1007
chr1,78003955,78004982,SRX20140867,INTS10,1027
chr1,78003970,78005112,SRX20140881,CPSF3L,1142
chr1,78003998,78004218,SRX5075169,SMARCA4,220
chr1,78004003,78004240,SRX5075176,SMARCA4,237
chr1,78004021,78004251,SRX5075170,SMARCA4,230
chr1,78004037,78004226,SRX5075174,SMARCA4,189
chr1,78004056,78004270,SRX5075168,SMARCA4,214
chr1,78004116,78004814,SRX20140896,INTS13,698
chr1,78004132,78004758,SRX20140868,INTS10,626
chr1,78004147,78004558,SRX20140897,INTS13,411
chr1,78004213,78004766,SRX20140894,INTS13,553
chr1,78004365,78005048,SRX20140869,INTS10,683
chr1,78004643,78004998,SRX5075174,SMARCA4,355
chr1,78004656,78005080,SRX20140897,INTS13,424
chr1,78004691,78004959,SRX5075176,SMARCA4,268
chr1,78004733,78004983,SRX5075170,SMARCA4,250
chr1,78004760,78005075,SRX5075168,SMARCA4,315
chr1,78004781,78004986,SRX5716464,SMARCA4,205
chr1,78005735,78006065,SRX5075176,SMARCA4,330
chr1,78005755,78006026,SRX5075169,SMARCA4,271
chr1,78005764,78006048,SRX5075170,SMARCA4,284
chr1,78005772,78006034,SRX5075175,SMARCA4,262
chr1,78005795,78006008,SRX5716469,SMARCA4,213
chr1,78005846,78006073,SRX5716470,SMARCA4,227
chr1,78005871,78006083,SRX5054309,FOSL2,212
chr1,78046191,78046402,SRX5075168,SMARCA4,211
chr1,78046257,78046501,SRX5075169,SMARCA4,244
chr1,78046343,78046560,SRX5075174,SMARCA4,217
chr1,78046347,78046581,SRX5075176,SMARCA4,234
chr1,78054622,78054837,SRX5054308,FOSL2,215
chr1,78061816,78062181,SRX5716469,SMARCA4,365
chr1,78061825,78062175,SRX5075169,SMARCA4,350
chr1,78061850,78062138,SRX5716467,SMARCA2,288
chr1,78061867,78062123,SRX5054309,FOSL2,256
chr1,78061871,78062210,SRX5075175,SMARCA4,339
chr1,78061896,78062126,SRX5075176,SMARCA4,230
chr1,78061922,78062196,SRX5054308,FOSL2,274
chr1,78061968,78062179,SRX5716470,SMARCA4,211
chr1,78070723,78071124,SRX5075176,SMARCA4,401
chr1,78070730,78071094,SRX5054309,FOSL2,364
chr1,78070735,78071089,SRX5075169,SMARCA4,354
chr1,78070755,78071044,SRX5054308,FOSL2,289
chr1,78070765,78071098,SRX5075175,SMARCA4,333
chr1,78070790,78071131,SRX5075170,SMARCA4,341
chr1,78079723,78079917,SRX5054308,FOSL2,194
chr1,78079752,78079958,SRX5054309,FOSL2,206
chr1,78095603,78095978,SRX5075169,SMARCA4,375
chr1,78095639,78096030,SRX5075175,SMARCA4,391
chr1,78095671,78096005,SRX5716469,SMARCA4,334
chr1,78095720,78095969,SRX5075176,SMARCA4,249
chr1,78095726,78095977,SRX5075170,SMARCA4,251
chr1,78101555,78101735,SRX5054308,FOSL2,180
chr1,78101571,78101869,SRX5075175,SMARCA4,298
chr1,78101573,78101841,SRX5716470,SMARCA4,268
chr1,78101574,78101889,SRX5716469,SMARCA4,315
chr1,78101583,78101923,SRX5075169,SMARCA4,340
chr1,78101588,78101809,SRX5054309,FOSL2,221
chr1,78101588,78101817,SRX5075170,SMARCA4,229
chr1,78101600,78101888,SRX5075176,SMARCA4,288
chr1,78102172,78102396,SRX5075169,SMARCA4,224
chr1,78102180,78102423,SRX5054308,FOSL2,243
chr1,78102180,78102423,SRX5054309,FOSL2,243
chr1,78104303,78104723,SRX5075169,SMARCA4,420
chr1,78104307,78104687,SRX5075175,SMARCA4,380
chr1,78104349,78104673,SRX5054308,FOSL2,324
chr1,78104369,78104707,SRX5054309,FOSL2,338
chr1,78104377,78104631,SRX5716467,SMARCA2,254
chr1,78104390,78104770,SRX5075170,SMARCA4,380
chr1,78104403,78104736,SRX5075176,SMARCA4,333
chr1,78104420,78104650,SRX5020214,SMARCA2,230
chr1,78114217,78114998,SRX4174629,CTCF,781
chr1,78114290,78114844,SRX16500060,CTCF,554
chr1,78114311,78114873,SRX16500062,CTCF,562
chr1,78114345,78114841,SRX16500059,CTCF,496
chr1,78114348,78114851,SRX16500061,CTCF,503
chr1,78114371,78114583,SRX5075169,SMARCA4,212
chr1,78114375,78114711,SRX5075168,SMARCA4,336
chr1,78114379,78114653,SRX5716470,SMARCA4,274
chr1,78114403,78114718,SRX5075174,SMARCA4,315
chr1,78114414,78114711,SRX5075176,SMARCA4,297
chr1,78114422,78114698,SRX5075170,SMARCA4,276
chr1,78114426,78114704,SRX5716463,SMARCA4,278
chr1,78114445,78114730,SRX5716464,SMARCA4,285
chr1,78130676,78131233,SRX16500059,CTCF,557
chr1,78130701,78131199,SRX16500061,CTCF,498
chr1,78130722,78131225,SRX16500060,CTCF,503
chr1,78130763,78131229,SRX16500062,CTCF,466
chr1,78130889,78131104,SRX4174629,CTCF,215
chr1,78130891,78131067,SRX5075174,SMARCA4,176
chr1,78144924,78145483,SRX16500059,CTCF,559
chr1,78144926,78145522,SRX16500061,CTCF,596
chr1,78144950,78145477,SRX16500060,CTCF,527
chr1,78144990,78145491,SRX16500062,CTCF,501
chr1,78145096,78145411,SRX5075174,SMARCA4,315
chr1,78145115,78145540,SRX4174629,CTCF,425
chr1,78145136,78145362,SRX5075169,SMARCA4,226
chr1,78145164,78145395,SRX5075176,SMARCA4,231
chr1,78145165,78145404,SRX5075170,SMARCA4,239
chr1,78145175,78145430,SRX5075168,SMARCA4,255
chr1,78155076,78155448,SRX5075174,SMARCA4,372
chr1,78155089,78155456,SRX5075168,SMARCA4,367
chr1,78155134,78155520,SRX5716463,SMARCA4,386
chr1,78157052,78157529,SRX5075170,SMARCA4,477
chr1,78157058,78157505,SRX5716468,SMARCA2,447
chr1,78157068,78157583,SRX5075176,SMARCA4,515
chr1,78157087,78157530,SRX5075169,SMARCA4,443
chr1,78157088,78157518,SRX5716467,SMARCA2,430
chr1,78157104,78157520,SRX5075175,SMARCA4,416
chr1,78157104,78157557,SRX5716469,SMARCA4,453
chr1,78157107,78157526,SRX5716470,SMARCA4,419
chr1,78157114,78157504,SRX5020211,SMARCA2,390
chr1,78157122,78157503,SRX5075181,SMARCA2,381
chr1,78157123,78157493,SRX5020214,SMARCA2,370
chr1,78157166,78157438,SRX5054308,FOSL2,272
chr1,78157168,78157473,SRX5054309,FOSL2,305
chr1,78176358,78176761,SRX5075176,SMARCA4,403
chr1,78176364,78176777,SRX5075170,SMARCA4,413
chr1,78176385,78176752,SRX5075169,SMARCA4,367
chr1,78176391,78176752,SRX5020211,SMARCA2,361
chr1,78176410,78176751,SRX5054308,FOSL2,341
chr1,78176435,78176718,SRX5054309,FOSL2,283
chr1,78176456,78176702,SRX5716470,SMARCA4,246
chr1,78176459,78176736,SRX5075175,SMARCA4,277
chr1,78176465,78176743,SRX5716469,SMARCA4,278
chr1,78224349,78224549,SRX5075176,SMARCA4,200
chr1,78224366,78224554,SRX5075169,SMARCA4,188
chr1,78224447,78224695,SRX5075170,SMARCA4,248
chr1,78225212,78225423,SRX5075176,SMARCA4,211
chr1,78225228,78225415,SRX5075170,SMARCA4,187
chr1,78279125,78279309,SRX5054309,FOSL2,184
chr1,78333393,78334011,SRX16500059,CTCF,618
chr1,78333406,78333866,SRX16500060,CTCF,460
chr1,78333428,78333823,SRX16500061,CTCF,395
chr1,78333445,78333787,SRX16500062,CTCF,342
chr1,78333471,78333733,SRX5075174,SMARCA4,262
chr1,78333509,78333715,SRX5075168,SMARCA4,206
chr1,78340005,78340451,SRX5075169,SMARCA4,446
chr1,78340036,78340376,SRX5075176,SMARCA4,340
chr1,78340043,78340371,SRX5075175,SMARCA4,328
chr1,78340079,78340332,SRX5054308,FOSL2,253
chr1,78340083,78340367,SRX5054309,FOSL2,284
chr1,78340101,78340404,SRX5716469,SMARCA4,303
chr1,78340109,78340412,SRX5075170,SMARCA4,303
chr1,78408110,78408603,SRX5075176,SMARCA4,493
chr1,78408133,78408514,SRX5075170,SMARCA4,381
chr1,78408162,78408472,SRX5716470,SMARCA4,310
chr1,78408172,78408453,SRX5075169,SMARCA4,281
chr1,78408190,78408516,SRX5716469,SMARCA4,326
chr1,78408228,78408513,SRX5716468,SMARCA2,285
chr1,78408228,78408526,SRX5716467,SMARCA2,298
chr1,78408262,78408590,SRX5075175,SMARCA4,328
chr1,78426796,78427138,SRX5075174,SMARCA4,342
chr1,78426823,78427047,SRX5075168,SMARCA4,224
chr1,78440495,78440794,SRX5054309,FOSL2,299
chr1,78440639,78440819,SRX5054308,FOSL2,180
chr1,78490870,78491192,SRX5075170,SMARCA4,322
chr1,78490885,78491229,SRX5075169,SMARCA4,344
chr1,78490903,78491167,SRX5075174,SMARCA4,264
chr1,78491734,78491989,SRX5075168,SMARCA4,255
chr1,78491787,78492027,SRX5075174,SMARCA4,240
chr1,78540105,78540377,SRX5075176,SMARCA4,272
chr1,78540147,78540403,SRX5054308,FOSL2,256
chr1,78540149,78540366,SRX5075170,SMARCA4,217
chr1,78540209,78540389,SRX5075169,SMARCA4,180
chr1,78586604,78586796,SRX5075169,SMARCA4,192
chr1,78586622,78586891,SRX5054308,FOSL2,269
chr1,78586653,78586943,SRX5054309,FOSL2,290
chr1,78607279,78607717,SRX16500060,CTCF,438
chr1,78607288,78607749,SRX16500062,CTCF,461
chr1,78607296,78607765,SRX16500059,CTCF,469
chr1,78607341,78607740,SRX16500061,CTCF,399
chr1,78617477,78617963,SRX16500060,CTCF,486
chr1,78617498,78617911,SRX16500059,CTCF,413
chr1,78617512,78617877,SRX16500062,CTCF,365
chr1,78617530,78617919,SRX16500061,CTCF,389
chr1,78617548,78617927,SRX5075168,SMARCA4,379
chr1,78617557,78617932,SRX5075174,SMARCA4,375
chr1,78617565,78617897,SRX5716463,SMARCA4,332
chr1,78617569,78617868,SRX5075170,SMARCA4,299
chr1,78617571,78617888,SRX5716464,SMARCA4,317
chr1,78617579,78617877,SRX5075176,SMARCA4,298
chr1,78617596,78617901,SRX5716470,SMARCA4,305
chr1,78617612,78617829,SRX4174629,CTCF,217
chr1,78617612,78617829,SRX5075169,SMARCA4,217
chr1,78617628,78617890,SRX5075175,SMARCA4,262
chr1,78619757,78619976,SRX5075176,SMARCA4,219
chr1,78619806,78620127,SRX5075170,SMARCA4,321
chr1,78619829,78620059,SRX5075169,SMARCA4,230
chr1,78620085,78620537,SRX5075176,SMARCA4,452
chr1,78620128,78620390,SRX5716469,SMARCA4,262
chr1,78620220,78620502,SRX5716470,SMARCA4,282
chr1,78620252,78620568,SRX5075170,SMARCA4,316
chr1,78620274,78620488,SRX5075175,SMARCA4,214
chr1,78620285,78620547,SRX5075169,SMARCA4,262
chr1,78649590,78649953,SRX5075176,SMARCA4,363
chr1,78649639,78649932,SRX5075169,SMARCA4,293
chr1,78649656,78649930,SRX5075170,SMARCA4,274
chr1,78649709,78649992,SRX5075175,SMARCA4,283
chr1,78668067,78668245,SRX5075170,SMARCA4,178
chr1,78676248,78676794,SRX16500060,CTCF,546
chr1,78676273,78676869,SRX16500059,CTCF,596
chr1,78676279,78676823,SRX16500061,CTCF,544
chr1,78676344,78676839,SRX16500062,CTCF,495
chr1,78676423,78676697,SRX5075170,SMARCA4,274
chr1,78676464,78676675,SRX5075174,SMARCA4,211
chr1,78688745,78688977,SRX5075170,SMARCA4,232
chr1,78688771,78689094,SRX5075176,SMARCA4,323
chr1,78715316,78715583,SRX5075174,SMARCA4,267
chr1,78716207,78716478,SRX5075176,SMARCA4,271
chr1,78716228,78716477,SRX5075169,SMARCA4,249
chr1,78716273,78716488,SRX5716467,SMARCA2,215
chr1,78716282,78716502,SRX5075170,SMARCA4,220
chr1,78716289,78716476,SRX5054309,FOSL2,187
chr1,78722934,78723287,SRX5716469,SMARCA4,353
chr1,78722951,78723356,SRX5075175,SMARCA4,405
chr1,78722957,78723401,SRX5020211,SMARCA2,444
chr1,78722962,78723307,SRX5716470,SMARCA4,345
chr1,78722971,78723453,SRX5075169,SMARCA4,482
chr1,78722977,78723333,SRX5716467,SMARCA2,356
chr1,78722977,78723360,SRX5716468,SMARCA2,383
chr1,78722984,78723313,SRX5054309,FOSL2,329
chr1,78723004,78723388,SRX5020214,SMARCA2,384
chr1,78723005,78723202,SRX5075182,SMARCA2,197
chr1,78723008,78723259,SRX5075181,SMARCA2,251
chr1,78723054,78723335,SRX5075176,SMARCA4,281
chr1,78723055,78723357,SRX5075170,SMARCA4,302
chr1,78743645,78743957,SRX5054309,FOSL2,312
chr1,78743697,78743903,SRX5054308,FOSL2,206
chr1,78743725,78743927,SRX5075170,SMARCA4,202
chr1,78743747,78743964,SRX5075176,SMARCA4,217
chr1,78759718,78760399,SRX5075176,SMARCA4,681
chr1,78759745,78760383,SRX5075170,SMARCA4,638
chr1,78759879,78760249,SRX5054308,FOSL2,370
chr1,78759890,78760134,SRX5054309,FOSL2,244
chr1,78759899,78760245,SRX5020211,SMARCA2,346
chr1,78759903,78760299,SRX5075169,SMARCA4,396
chr1,78759925,78760177,SRX5716469,SMARCA4,252
chr1,78759934,78760300,SRX5075175,SMARCA4,366
chr1,78759951,78760284,SRX5020214,SMARCA2,333
chr1,78760003,78760268,SRX5716467,SMARCA2,265
chr1,78760885,78761191,SRX5054309,FOSL2,306
chr1,78760983,78761176,SRX5054308,FOSL2,193
chr1,78779777,78780215,SRX5075176,SMARCA4,438
chr1,78779821,78780216,SRX5020211,SMARCA2,395
chr1,78779832,78780225,SRX5075169,SMARCA4,393
chr1,78779843,78780224,SRX5075170,SMARCA4,381
chr1,78779853,78780220,SRX5075175,SMARCA4,367
chr1,78779862,78780185,SRX5054308,FOSL2,323
chr1,78779868,78780228,SRX5054309,FOSL2,360
chr1,78779869,78780207,SRX5716467,SMARCA2,338
chr1,78779912,78780198,SRX5716470,SMARCA4,286
chr1,78779914,78780200,SRX5716469,SMARCA4,286
chr1,78787546,78787865,SRX5054309,FOSL2,319
chr1,78787546,78788287,SRX5075170,SMARCA4,741
chr1,78787552,78788156,SRX5054308,FOSL2,604
chr1,78787553,78787929,SRX5075169,SMARCA4,376
chr1,78787594,78787812,SRX5716467,SMARCA2,218
chr1,78787665,78787854,SRX5075176,SMARCA4,189
chr1,78787689,78787884,SRX5075175,SMARCA4,195
chr1,78788004,78788216,SRX5075169,SMARCA4,212
chr1,78788008,78788206,SRX5075175,SMARCA4,198
chr1,78788009,78788250,SRX5075176,SMARCA4,241
chr1,78802010,78802054,SRX1424894,POU3F2,44
chr1,78802010,78802061,SRX1424893,POU3F2,51
chr1,78802011,78802053,SRX1424891,POU3F2,42
chr1,78802011,78802053,SRX1424892,POU3F2,42
chr1,78831639,78832352,SRX5075176,SMARCA4,713
chr1,78831677,78832346,SRX5075170,SMARCA4,669
chr1,78831703,78832322,SRX5075175,SMARCA4,619
chr1,78831711,78832359,SRX5054309,FOSL2,648
chr1,78831715,78832321,SRX5075169,SMARCA4,606
chr1,78831735,78832206,SRX5020211,SMARCA2,471
chr1,78831742,78832159,SRX5716468,SMARCA2,417
chr1,78831747,78832270,SRX5020214,SMARCA2,523
chr1,78831753,78832316,SRX5716469,SMARCA4,563
chr1,78831758,78832142,SRX5075181,SMARCA2,384
chr1,78831775,78832203,SRX5054308,FOSL2,428
chr1,78831780,78832246,SRX5716467,SMARCA2,466
chr1,78831804,78832270,SRX5716470,SMARCA4,466
chr1,78833507,78833712,SRX5075169,SMARCA4,205
chr1,78833565,78833782,SRX5075176,SMARCA4,217
chr1,78833570,78833761,SRX5075175,SMARCA4,191
chr1,78839632,78840118,SRX16500061,CTCF,486
chr1,78839638,78840144,SRX16500059,CTCF,506
chr1,78839654,78840093,SRX16500062,CTCF,439
chr1,78839658,78840138,SRX16500060,CTCF,480
chr1,78839782,78839997,SRX5075174,SMARCA4,215
chr1,78839823,78840014,SRX5075168,SMARCA4,191
chr1,78840746,78841374,SRX5075169,SMARCA4,628
chr1,78840798,78841406,SRX5075170,SMARCA4,608
chr1,78840855,78841417,SRX5075176,SMARCA4,562
chr1,78840879,78841384,SRX5716469,SMARCA4,505
chr1,78840941,78841406,SRX5075175,SMARCA4,465
chr1,78840973,78841332,SRX5716470,SMARCA4,359
chr1,78840986,78841174,SRX5075174,SMARCA4,188
chr1,78840987,78841332,SRX5054309,FOSL2,345
chr1,78840993,78841363,SRX5054308,FOSL2,370
chr1,78841030,78841347,SRX5020214,SMARCA2,317
chr1,78841088,78841276,SRX5075168,SMARCA4,188
chr1,78841094,78841311,SRX5716468,SMARCA2,217
chr1,78841111,78841357,SRX5716467,SMARCA2,246
chr1,78841167,78841428,SRX5020211,SMARCA2,261
chr1,78885102,78885326,SRX5075176,SMARCA4,224
chr1,78892320,78892784,SRX5075176,SMARCA4,464
chr1,78892331,78892734,SRX5075169,SMARCA4,403
chr1,78892341,78892708,SRX5075170,SMARCA4,367
chr1,78892344,78892720,SRX5075175,SMARCA4,376
chr1,78892354,78892687,SRX5054308,FOSL2,333
chr1,78892383,78892593,SRX5054309,FOSL2,210
chr1,78892465,78892755,SRX5716469,SMARCA4,290
chr1,78894953,78895158,SRX5075176,SMARCA4,205
chr1,78918496,78918738,SRX5075169,SMARCA4,242
chr1,78980978,78981219,SRX5075168,SMARCA4,241
chr1,79006571,79006959,SRX5075174,SMARCA4,388
chr1,79006573,79006977,SRX5075169,SMARCA4,404
chr1,79006667,79006926,SRX5075170,SMARCA4,259
chr1,79006703,79006925,SRX5075175,SMARCA4,222
chr1,79042104,79042420,SRX5075175,SMARCA4,316
chr1,79042118,79042460,SRX5054309,FOSL2,342
chr1,79042120,79042380,SRX5075169,SMARCA4,260
chr1,79042124,79042463,SRX5054308,FOSL2,339
chr1,79042141,79042410,SRX5020211,SMARCA2,269
chr1,79042224,79042417,SRX5075176,SMARCA4,193
chr1,79043613,79043827,SRX5054309,FOSL2,214
chr1,79043613,79043836,SRX5075176,SMARCA4,223
chr1,79043627,79043841,SRX5075174,SMARCA4,214
chr1,79043629,79043818,SRX5075170,SMARCA4,189
chr1,79043648,79043835,SRX5075175,SMARCA4,187
chr1,79043679,79043898,SRX5075168,SMARCA4,219
chr1,79059577,79059797,SRX5054308,FOSL2,220
chr1,79069945,79070195,SRX16500061,CTCF,250
chr1,79072449,79072684,SRX5020211,SMARCA2,235
chr1,79079759,79080080,SRX5716467,SMARCA2,321
chr1,79079766,79080275,SRX5075169,SMARCA4,509
chr1,79079779,79080173,SRX5075174,SMARCA4,394
chr1,79079783,79080258,SRX5075170,SMARCA4,475
chr1,79079787,79080228,SRX5075176,SMARCA4,441
chr1,79079788,79080174,SRX5075168,SMARCA4,386
chr1,79079788,79080240,SRX5075175,SMARCA4,452
chr1,79079804,79080223,SRX5054308,FOSL2,419
chr1,79079806,79080231,SRX5054309,FOSL2,425
chr1,79079847,79080307,SRX5716470,SMARCA4,460
chr1,79079894,79080130,SRX5716469,SMARCA4,236
chr1,79079909,79080211,SRX5020211,SMARCA2,302
chr1,79100425,79100843,SRX5075176,SMARCA4,418
chr1,79100470,79100790,SRX5075175,SMARCA4,320
chr1,79100475,79100831,SRX5075170,SMARCA4,356
chr1,79100480,79100784,SRX5054309,FOSL2,304
chr1,79100483,79100793,SRX5054308,FOSL2,310
chr1,79100486,79100696,SRX5075168,SMARCA4,210
chr1,79100491,79100816,SRX5075169,SMARCA4,325
chr1,79100494,79100737,SRX5716470,SMARCA4,243
chr1,79100501,79100838,SRX5716469,SMARCA4,337
chr1,79100590,79100808,SRX5716467,SMARCA2,218
chr1,79117565,79117764,SRX5054308,FOSL2,199
chr1,79128698,79129065,SRX5075176,SMARCA4,367
chr1,79128720,79129074,SRX5075175,SMARCA4,354
chr1,79128725,79129102,SRX5075170,SMARCA4,377
chr1,79128743,79129157,SRX5716469,SMARCA4,414
chr1,79128744,79129070,SRX5054308,FOSL2,326
chr1,79128747,79129083,SRX5075169,SMARCA4,336
chr1,79128766,79129024,SRX5716470,SMARCA4,258
chr1,79128791,79129090,SRX5054309,FOSL2,299
chr1,79128802,79128981,SRX5054307,FOSL2,179
chr1,79138320,79138704,SRX20140895,INTS13,384
chr1,79161002,79161429,SRX5075169,SMARCA4,427
chr1,79161050,79161550,SRX5075175,SMARCA4,500
chr1,79161080,79161398,SRX5054309,FOSL2,318
chr1,79161091,79161463,SRX5075170,SMARCA4,372
chr1,79161097,79161518,SRX5716469,SMARCA4,421
chr1,79161134,79161602,SRX5054308,FOSL2,468
chr1,79161140,79161475,SRX5020211,SMARCA2,335
chr1,79161166,79161514,SRX5075176,SMARCA4,348
chr1,79161176,79161449,SRX5716470,SMARCA4,273
chr1,79161225,79161416,SRX5075174,SMARCA4,191
chr1,79161251,79161493,SRX5716467,SMARCA2,242
chr1,79188303,79188752,SRX5075176,SMARCA4,449
chr1,79188370,79188732,SRX5075169,SMARCA4,362
chr1,79188435,79188711,SRX5054309,FOSL2,276
chr1,79188439,79188672,SRX5075175,SMARCA4,233
chr1,79188440,79188723,SRX5054308,FOSL2,283
chr1,79188442,79188648,SRX5075170,SMARCA4,206
chr1,79193323,79193791,SRX5075170,SMARCA4,468
chr1,79193459,79193683,SRX5075176,SMARCA4,224
chr1,79193540,79193797,SRX5075175,SMARCA4,257
chr1,79197480,79197748,SRX16500060,CTCF,268
chr1,79197523,79197753,SRX16500061,CTCF,230
chr1,79198832,79199157,SRX5716469,SMARCA4,325
chr1,79198859,79199195,SRX5075175,SMARCA4,336
chr1,79198859,79199198,SRX5075170,SMARCA4,339
chr1,79198880,79199198,SRX5075169,SMARCA4,318
chr1,79198884,79199115,SRX5716470,SMARCA4,231
chr1,79198886,79199224,SRX5054309,FOSL2,338
chr1,79198906,79199169,SRX5075176,SMARCA4,263
chr1,79198912,79199148,SRX5054308,FOSL2,236
chr1,79207777,79208176,SRX5075170,SMARCA4,399
chr1,79207812,79208073,SRX5075176,SMARCA4,261
chr1,79235255,79235541,SRX5075174,SMARCA4,286
chr1,79235287,79235936,SRX5075170,SMARCA4,649
chr1,79235294,79235910,SRX5075176,SMARCA4,616
chr1,79235337,79236007,SRX5075169,SMARCA4,670
chr1,79235366,79235861,SRX5075175,SMARCA4,495
chr1,79235371,79235550,SRX5075168,SMARCA4,179
chr1,79235386,79235607,SRX5020211,SMARCA2,221
chr1,79235435,79235817,SRX5716470,SMARCA4,382
chr1,79235477,79235696,SRX5716467,SMARCA2,219
chr1,79235498,79235774,SRX5716469,SMARCA4,276
chr1,79235610,79235871,SRX5075168,SMARCA4,261
chr1,79235704,79235958,SRX5075174,SMARCA4,254
chr1,79259712,79260142,SRX16500060,CTCF,430
chr1,79259726,79260253,SRX16500059,CTCF,527
chr1,79259731,79260162,SRX16500061,CTCF,431
chr1,79259739,79260210,SRX16500062,CTCF,471
chr1,79259792,79260110,SRX5075174,SMARCA4,318
chr1,79259839,79260150,SRX5075168,SMARCA4,311
chr1,79259845,79260209,SRX5075169,SMARCA4,364
chr1,79259860,79260301,SRX5075176,SMARCA4,441
chr1,79259866,79260184,SRX5075170,SMARCA4,318
chr1,79259874,79260183,SRX5075175,SMARCA4,309
chr1,79259885,79260239,SRX5716470,SMARCA4,354
chr1,79259924,79260129,SRX5054309,FOSL2,205
chr1,79259938,79260204,SRX5716469,SMARCA4,266
chr1,79262974,79263180,SRX5075170,SMARCA4,206
chr1,79308412,79308672,SRX5075176,SMARCA4,260
chr1,79308417,79308719,SRX5075170,SMARCA4,302
chr1,79323100,79323829,SRX5075170,SMARCA4,729
chr1,79323121,79323710,SRX5075169,SMARCA4,589
chr1,79323135,79323714,SRX5075176,SMARCA4,579
chr1,79323137,79323650,SRX5054309,FOSL2,513
chr1,79323154,79323821,SRX5075175,SMARCA4,667
chr1,79323173,79323622,SRX5716470,SMARCA4,449
chr1,79323193,79323629,SRX5054308,FOSL2,436
chr1,79323206,79323664,SRX5716469,SMARCA4,458
chr1,79323226,79323587,SRX5020214,SMARCA2,361
chr1,79323229,79323555,SRX5020211,SMARCA2,326
chr1,79323229,79323607,SRX5716467,SMARCA2,378
chr1,79323265,79323614,SRX5075174,SMARCA4,349
chr1,79323296,79323499,SRX5054307,FOSL2,203
chr1,79323300,79323620,SRX5716460,Epitope tags,320
chr1,79323316,79323581,SRX5075182,SMARCA2,265
chr1,79323337,79323598,SRX5716468,SMARCA2,261
chr1,79323372,79323590,SRX5075168,SMARCA4,218
chr1,79353250,79353539,SRX16500060,CTCF,289
chr1,79353319,79353598,SRX16500059,CTCF,279
chr1,79353322,79353499,SRX5075174,SMARCA4,177
chr1,79353358,79353540,SRX5075170,SMARCA4,182
chr1,79353364,79353574,SRX16500062,CTCF,210
chr1,79353364,79353579,SRX5075168,SMARCA4,215
chr1,79362495,79362719,SRX16500062,CTCF,224
chr1,79373883,79374058,SRX5075176,SMARCA4,175
chr1,79475585,79475873,SRX5075168,SMARCA4,288
chr1,79475654,79475850,SRX5075174,SMARCA4,196
chr1,79484468,79484807,SRX5075168,SMARCA4,339
chr1,79484525,79484853,SRX5075174,SMARCA4,328
chr1,79497110,79497615,SRX16500059,CTCF,505
chr1,79497117,79497605,SRX16500061,CTCF,488
chr1,79497121,79497589,SRX16500060,CTCF,468
chr1,79497197,79497624,SRX16500062,CTCF,427
chr1,79497285,79497495,SRX5075169,SMARCA4,210
chr1,79497312,79497497,SRX5075170,SMARCA4,185
chr1,79499269,79500065,SRX5075174,SMARCA4,796
chr1,79499414,79500045,SRX5075168,SMARCA4,631
chr1,79499437,79499975,SRX5716464,SMARCA4,538
chr1,79499458,79499887,SRX20140879,CPSF3L,429
chr1,79499481,79499979,SRX5716463,SMARCA4,498
chr1,79499527,79499843,SRX20140895,INTS13,316
chr1,79499563,79499945,SRX5716451,SOX2,382
chr1,79499573,79499895,SRX20140881,CPSF3L,322
chr1,79499594,79499808,SRX20140867,INTS10,214
chr1,79499633,79499862,SRX5716454,SOX3,229
chr1,79499640,79499950,SRX5075170,SMARCA4,310
chr1,79499651,79499951,SRX5075176,SMARCA4,300
chr1,79556190,79556462,SRX16500060,CTCF,272
chr1,79556209,79556521,SRX16500059,CTCF,312
chr1,79599310,79599506,SRX5075176,SMARCA4,196
chr1,79599395,79599591,SRX5075170,SMARCA4,196
chr1,79617883,79618125,SRX16500059,CTCF,242
chr1,79617883,79618186,SRX16500060,CTCF,303
chr1,79617887,79618132,SRX16500061,CTCF,245
chr1,79633462,79633874,SRX5075169,SMARCA4,412
chr1,79633501,79633833,SRX5075170,SMARCA4,332
chr1,79633507,79633772,SRX5054308,FOSL2,265
chr1,79633510,79633829,SRX5054309,FOSL2,319
chr1,79633527,79633744,SRX5075176,SMARCA4,217
chr1,79633533,79633847,SRX5075175,SMARCA4,314
chr1,79633597,79633809,SRX5716469,SMARCA4,212
chr1,79657933,79658390,SRX5075170,SMARCA4,457
chr1,79657961,79658216,SRX5716469,SMARCA4,255
chr1,79657964,79658237,SRX5716470,SMARCA4,273
chr1,79657981,79658275,SRX5075175,SMARCA4,294
chr1,79657982,79658421,SRX5075176,SMARCA4,439
chr1,79657985,79658335,SRX5075169,SMARCA4,350
chr1,79657991,79658276,SRX5716467,SMARCA2,285
chr1,79663932,79664156,SRX5075176,SMARCA4,224
chr1,79664006,79664249,SRX5075168,SMARCA4,243
chr1,79708826,79708995,SRX5075170,SMARCA4,169
chr1,79711177,79711452,SRX5075169,SMARCA4,275
chr1,79711186,79711405,SRX5054308,FOSL2,219
chr1,79716424,79716886,SRX5075176,SMARCA4,462
chr1,79716429,79716775,SRX5716470,SMARCA4,346
chr1,79716440,79716858,SRX5075170,SMARCA4,418
chr1,79716463,79716859,SRX5716469,SMARCA4,396
chr1,79716473,79716787,SRX5075169,SMARCA4,314
chr1,79716490,79716824,SRX5054308,FOSL2,334
chr1,79716509,79716870,SRX5020211,SMARCA2,361
chr1,79716513,79716835,SRX5075175,SMARCA4,322
chr1,79716528,79716810,SRX5716467,SMARCA2,282
chr1,79716536,79716779,SRX5075174,SMARCA4,243
chr1,79716542,79716822,SRX5054309,FOSL2,280
chr1,79716600,79716808,SRX5075168,SMARCA4,208
chr1,79784156,79784637,SRX5075168,SMARCA4,481
chr1,79784241,79784652,SRX5075174,SMARCA4,411
chr1,79784259,79784590,SRX5716464,SMARCA4,331
chr1,79784396,79784616,SRX5716463,SMARCA4,220
chr1,79791676,79791856,SRX5054308,FOSL2,180
chr1,79811138,79811607,SRX5075175,SMARCA4,469
chr1,79811146,79811610,SRX5054308,FOSL2,464
chr1,79811152,79811588,SRX5054309,FOSL2,436
chr1,79811160,79811655,SRX5075169,SMARCA4,495
chr1,79811161,79811692,SRX5075176,SMARCA4,531
chr1,79811165,79811684,SRX5075170,SMARCA4,519
chr1,79811186,79811641,SRX5716469,SMARCA4,455
chr1,79811193,79811615,SRX5716467,SMARCA2,422
chr1,79811201,79811576,SRX5020211,SMARCA2,375
chr1,79811225,79811559,SRX5075168,SMARCA4,334
chr1,79811247,79811639,SRX5075174,SMARCA4,392
chr1,79811269,79811562,SRX5020214,SMARCA2,293
chr1,79811275,79811688,SRX5716470,SMARCA4,413
chr1,79817105,79817288,SRX5054308,FOSL2,183
chr1,79817185,79817388,SRX5054309,FOSL2,203
chr1,79827428,79827664,SRX5075169,SMARCA4,236
chr1,79827445,79827668,SRX5716470,SMARCA4,223
chr1,79827457,79827640,SRX5054309,FOSL2,183
chr1,79827496,79827692,SRX5075170,SMARCA4,196
chr1,79847652,79848120,SRX5716463,SMARCA4,468
chr1,79847676,79848196,SRX5075174,SMARCA4,520
chr1,79847696,79848054,SRX20140895,INTS13,358
chr1,79847709,79848165,SRX5075168,SMARCA4,456
chr1,79847776,79848128,SRX5716464,SMARCA4,352
chr1,79847792,79848046,SRX5075176,SMARCA4,254
chr1,79847817,79848085,SRX5075170,SMARCA4,268
chr1,79854062,79854262,SRX5075174,SMARCA4,200
chr1,79859526,79859803,SRX5075175,SMARCA4,277
chr1,79859538,79859918,SRX5054309,FOSL2,380
chr1,79859564,79859913,SRX5075176,SMARCA4,349
chr1,79859572,79859930,SRX5054308,FOSL2,358
chr1,79859584,79859848,SRX5075169,SMARCA4,264
chr1,79859587,79859915,SRX5075170,SMARCA4,328
chr1,79899915,79900280,SRX5075169,SMARCA4,365
chr1,79899940,79900278,SRX5054308,FOSL2,338
chr1,79899962,79900388,SRX5054309,FOSL2,426
chr1,79899976,79900217,SRX5716469,SMARCA4,241
chr1,79900005,79900348,SRX5075175,SMARCA4,343
chr1,79900006,79900244,SRX5075170,SMARCA4,238
chr1,79900106,79900311,SRX5020211,SMARCA2,205
chr1,79903288,79903620,SRX5075176,SMARCA4,332
chr1,79903562,79903832,SRX5716467,SMARCA2,270
chr1,79903635,79903839,SRX5020211,SMARCA2,204
chr1,79979465,79979699,SRX5075174,SMARCA4,234
chr1,79979534,79979728,SRX5075168,SMARCA4,194
chr1,79982136,79982654,SRX5075176,SMARCA4,518
chr1,79982147,79982600,SRX5075170,SMARCA4,453
chr1,79982189,79982440,SRX5075169,SMARCA4,251
chr1,79982214,79982474,SRX5716467,SMARCA2,260
chr1,80047648,80048313,SRX5075176,SMARCA4,665
chr1,80047669,80048311,SRX5075170,SMARCA4,642
chr1,80047699,80048219,SRX5075169,SMARCA4,520
chr1,80047710,80048258,SRX5075175,SMARCA4,548
chr1,80047717,80048271,SRX5716469,SMARCA4,554
chr1,80047740,80048255,SRX5054309,FOSL2,515
chr1,80047774,80048175,SRX5054308,FOSL2,401
chr1,80047776,80048245,SRX5716470,SMARCA4,469
chr1,80047811,80048175,SRX5020211,SMARCA2,364
chr1,80047822,80048215,SRX5020214,SMARCA2,393
chr1,80047827,80048161,SRX5716468,SMARCA2,334
chr1,80047855,80048264,SRX5716467,SMARCA2,409
chr1,80047869,80048106,SRX5075182,SMARCA2,237
chr1,80047886,80048196,SRX5075181,SMARCA2,310
chr1,80054100,80054612,SRX5075176,SMARCA4,512
chr1,80054108,80054496,SRX5075169,SMARCA4,388
chr1,80054112,80054565,SRX5075170,SMARCA4,453
chr1,80054133,80054454,SRX5054309,FOSL2,321
chr1,80054139,80054460,SRX5054308,FOSL2,321
chr1,80054141,80054504,SRX5075175,SMARCA4,363
chr1,80054194,80054418,SRX5716469,SMARCA4,224
chr1,80054211,80054480,SRX5020211,SMARCA2,269
chr1,80054214,80054439,SRX5716470,SMARCA4,225
chr1,80065965,80066431,SRX5716470,SMARCA4,466
chr1,80066053,80066344,SRX5075176,SMARCA4,291
chr1,80066057,80066367,SRX5716469,SMARCA4,310
chr1,80066089,80066345,SRX5075170,SMARCA4,256
chr1,80066093,80066334,SRX5075175,SMARCA4,241
chr1,80066167,80066415,SRX5716459,Epitope tags,248
chr1,80158787,80159167,SRX5075176,SMARCA4,380
chr1,80158938,80159208,SRX5075170,SMARCA4,270
chr1,80171020,80171439,SRX5075176,SMARCA4,419
chr1,80171115,80171472,SRX5075170,SMARCA4,357
chr1,80211993,80212387,SRX5075176,SMARCA4,394
chr1,80212010,80212235,SRX5716470,SMARCA4,225
chr1,80212028,80212335,SRX5716469,SMARCA4,307
chr1,80212031,80212292,SRX5716468,SMARCA2,261
chr1,80212072,80212362,SRX5075170,SMARCA4,290
chr1,80212082,80212355,SRX5075169,SMARCA4,273
chr1,80217351,80217734,SRX16500060,CTCF,383
chr1,80217366,80217768,SRX16500062,CTCF,402
chr1,80217374,80217767,SRX16500059,CTCF,393
chr1,80217438,80217734,SRX16500061,CTCF,296
chr1,80217468,80217729,SRX5075168,SMARCA4,261
chr1,80217474,80217734,SRX5075174,SMARCA4,260
chr1,80217475,80217717,SRX5075170,SMARCA4,242
chr1,80218028,80218504,SRX16500061,CTCF,476
chr1,80218041,80218442,SRX16500060,CTCF,401
chr1,80218073,80218469,SRX16500059,CTCF,396
chr1,80218151,80218484,SRX16500062,CTCF,333
chr1,80250772,80251084,SRX5075175,SMARCA4,312
chr1,80250787,80251076,SRX5075176,SMARCA4,289
chr1,80250799,80251051,SRX5054308,FOSL2,252
chr1,80250808,80251070,SRX5054309,FOSL2,262
chr1,80250820,80251086,SRX5075169,SMARCA4,266
chr1,80250850,80251071,SRX5075170,SMARCA4,221
chr1,80251637,80251913,SRX5075170,SMARCA4,276
chr1,80251649,80251886,SRX5075169,SMARCA4,237
chr1,80251652,80251909,SRX5716470,SMARCA4,257
chr1,80251654,80251895,SRX5075175,SMARCA4,241
chr1,80251667,80251960,SRX5075176,SMARCA4,293
chr1,80251693,80251915,SRX5716468,SMARCA2,222
chr1,80282638,80282829,SRX5075170,SMARCA4,191
chr1,80299381,80299641,SRX5075170,SMARCA4,260
chr1,80299392,80299715,SRX5075176,SMARCA4,323
chr1,80341093,80341334,SRX5075176,SMARCA4,241
chr1,80341102,80341325,SRX5716468,SMARCA2,223
chr1,80341113,80341406,SRX5716467,SMARCA2,293
chr1,80341158,80341400,SRX5716470,SMARCA4,242
chr1,80341165,80341384,SRX5075175,SMARCA4,219
chr1,80358253,80358525,SRX5054308,FOSL2,272
chr1,80375572,80375759,SRX5075175,SMARCA4,187
chr1,80417803,80418028,SRX5054309,FOSL2,225
chr1,80445154,80445351,SRX5054309,FOSL2,197
chr1,80445174,80445354,SRX5054308,FOSL2,180
chr1,80457391,80457811,SRX5075174,SMARCA4,420
chr1,80457459,80457821,SRX5075168,SMARCA4,362
chr1,80457553,80457810,SRX5716463,SMARCA4,257
chr1,80509993,80510259,SRX5075168,SMARCA4,266
chr1,80510024,80510302,SRX5716463,SMARCA4,278
chr1,80510041,80510214,SRX5075174,SMARCA4,173
chr1,80533004,80533202,SRX5075174,SMARCA4,198
chr1,80535047,80535277,SRX5054309,FOSL2,230
chr1,80542267,80542570,SRX5075169,SMARCA4,303
chr1,80542331,80542562,SRX5054308,FOSL2,231
chr1,80656021,80656361,SRX16500062,CTCF,340
chr1,80656034,80656457,SRX16500060,CTCF,423
chr1,80656050,80656366,SRX16500059,CTCF,316
chr1,80656089,80656410,SRX16500061,CTCF,321
chr1,80656155,80656439,SRX5075170,SMARCA4,284
chr1,80656725,80656905,SRX5075169,SMARCA4,180
chr1,80656729,80656909,SRX5054308,FOSL2,180
chr1,80657788,80658101,SRX5075168,SMARCA4,313
chr1,80657789,80658082,SRX5075174,SMARCA4,293
chr1,80657841,80658043,SRX5075169,SMARCA4,202
chr1,80674024,80674466,SRX5075176,SMARCA4,442
chr1,80674088,80674473,SRX5075170,SMARCA4,385
chr1,80674194,80674401,SRX5075169,SMARCA4,207
chr1,80675543,80675767,SRX5054309,FOSL2,224
chr1,80675559,80675921,SRX5075168,SMARCA4,362
chr1,80776114,80776381,SRX5075176,SMARCA4,267
chr1,80868557,80868769,SRX5054308,FOSL2,212
chr1,80868560,80868771,SRX5020211,SMARCA2,211
chr1,80868653,80868865,SRX5054309,FOSL2,212
chr1,80882498,80882850,SRX5075175,SMARCA4,352
chr1,80882520,80882899,SRX5075169,SMARCA4,379
chr1,80882528,80882869,SRX5020214,SMARCA2,341
chr1,80882557,80882859,SRX5075176,SMARCA4,302
chr1,80882567,80882931,SRX5054308,FOSL2,364
chr1,80882571,80882841,SRX5716469,SMARCA4,270
chr1,80882588,80882909,SRX5054309,FOSL2,321
chr1,80882596,80882928,SRX5020211,SMARCA2,332
chr1,80882604,80882895,SRX5716470,SMARCA4,291
chr1,80882624,80882861,SRX5075170,SMARCA4,237
chr1,80882625,80882846,SRX5075168,SMARCA4,221
chr1,80882630,80882854,SRX5075174,SMARCA4,224
chr1,80892576,80892963,SRX5075174,SMARCA4,387
chr1,80893171,80893381,SRX5075170,SMARCA4,210
chr1,80993298,80993752,SRX5075176,SMARCA4,454
chr1,80993302,80993648,SRX5075170,SMARCA4,346
chr1,81002361,81002562,SRX5054308,FOSL2,201
chr1,81006998,81007365,SRX5716470,SMARCA4,367
chr1,81007040,81007358,SRX5020211,SMARCA2,318
chr1,81007052,81007269,SRX5075169,SMARCA4,217
chr1,81007093,81007357,SRX5075181,SMARCA2,264
chr1,81007110,81007352,SRX5716468,SMARCA2,242
chr1,81007123,81007402,SRX5075176,SMARCA4,279
chr1,81007128,81007348,SRX5716469,SMARCA4,220
chr1,81007132,81007315,SRX5075170,SMARCA4,183
chr1,81007168,81007352,SRX5054309,FOSL2,184
chr1,81023326,81023533,SRX5075168,SMARCA4,207
chr1,81092917,81093579,SRX5075168,SMARCA4,662
chr1,81092959,81093522,SRX5075174,SMARCA4,563
chr1,81093073,81093494,SRX5716451,SOX2,421
chr1,81093115,81093502,SRX5716463,SMARCA4,387
chr1,81093206,81093474,SRX5716464,SMARCA4,268
chr1,81111939,81112132,SRX5075175,SMARCA4,193
chr1,81113777,81114118,SRX5054308,FOSL2,341
chr1,81113795,81114051,SRX5075169,SMARCA4,256
chr1,81113825,81114071,SRX5054309,FOSL2,246
chr1,81125762,81125995,SRX5075176,SMARCA4,233
chr1,81125796,81126143,SRX5075170,SMARCA4,347
chr1,81142367,81142610,SRX5020214,SMARCA2,243
chr1,81142388,81142666,SRX5020211,SMARCA2,278
chr1,81142403,81142754,SRX5054308,FOSL2,351
chr1,81142415,81142730,SRX5054309,FOSL2,315
chr1,81142427,81142777,SRX5075170,SMARCA4,350
chr1,81142434,81142694,SRX5716469,SMARCA4,260
chr1,81142441,81142689,SRX5075176,SMARCA4,248
chr1,81142458,81142759,SRX5075175,SMARCA4,301
chr1,81142463,81142702,SRX5075169,SMARCA4,239
chr1,81144270,81144617,SRX5075174,SMARCA4,347
chr1,81144301,81144555,SRX5075168,SMARCA4,254
chr1,81151415,81151601,SRX5054308,FOSL2,186
chr1,81155170,81155493,SRX5054309,FOSL2,323
chr1,81155209,81155423,SRX5075169,SMARCA4,214
chr1,81158619,81158880,SRX5075176,SMARCA4,261
chr1,81231711,81231912,SRX5075170,SMARCA4,201
chr1,81231769,81231992,SRX5075176,SMARCA4,223
chr1,81237343,81237743,SRX5075168,SMARCA4,400
chr1,81237419,81237589,SRX1424891,POU3F2,170
chr1,81237421,81237794,SRX5075174,SMARCA4,373
chr1,81237424,81238002,SRX5075176,SMARCA4,578
chr1,81237465,81237919,SRX5075170,SMARCA4,454
chr1,81237481,81237536,SRX1424892,POU3F2,55
chr1,81237481,81237661,SRX5054308,FOSL2,180
chr1,81254440,81254769,SRX16500059,CTCF,329
chr1,81265183,81265362,SRX5075168,SMARCA4,179
chr1,81266523,81266726,SRX5075175,SMARCA4,203
chr1,81266528,81266773,SRX5716469,SMARCA4,245
chr1,81287539,81287815,SRX5020211,SMARCA2,276
chr1,81287564,81287749,SRX5075169,SMARCA4,185
chr1,81304215,81304577,SRX5075169,SMARCA4,362
chr1,81304230,81304519,SRX5054309,FOSL2,289
chr1,81304253,81304503,SRX5075175,SMARCA4,250
chr1,81304262,81304505,SRX5075170,SMARCA4,243
chr1,81304291,81304466,SRX5075176,SMARCA4,175
chr1,81305904,81306287,SRX16500060,CTCF,383
chr1,81305936,81306262,SRX16500062,CTCF,326
chr1,81305939,81306273,SRX16500061,CTCF,334
chr1,81305954,81306333,SRX16500059,CTCF,379
chr1,81305989,81306287,SRX5075175,SMARCA4,298
chr1,81305996,81306424,SRX5075174,SMARCA4,428
chr1,81306012,81306484,SRX5075168,SMARCA4,472
chr1,81306020,81306322,SRX5075170,SMARCA4,302
chr1,81306020,81306329,SRX5075176,SMARCA4,309
chr1,81306022,81306318,SRX5716464,SMARCA4,296
chr1,81306036,81306244,SRX5075169,SMARCA4,208
chr1,81306063,81306310,SRX4174629,CTCF,247
chr1,81306076,81306360,SRX5716463,SMARCA4,284
chr1,81306139,81306406,SRX20140895,INTS13,267
chr1,81327873,81328129,SRX5075174,SMARCA4,256
chr1,81329041,81329405,SRX5075174,SMARCA4,364
chr1,81329065,81329420,SRX5075168,SMARCA4,355
chr1,81329147,81329407,SRX5716463,SMARCA4,260
chr1,81369334,81370009,SRX5075174,SMARCA4,675
chr1,81369384,81369736,SRX5075168,SMARCA4,352
chr1,81369399,81369622,SRX5716464,SMARCA4,223
chr1,81369406,81369677,SRX5716463,SMARCA4,271
chr1,81369475,81369727,SRX5075170,SMARCA4,252
chr1,81369890,81370209,SRX5075176,SMARCA4,319
chr1,81369910,81370219,SRX5075170,SMARCA4,309
chr1,81382765,81383130,SRX5075168,SMARCA4,365
chr1,81382895,81383200,SRX5075174,SMARCA4,305
chr1,81382964,81383196,SRX5716463,SMARCA4,232
chr1,81409842,81410041,SRX5075170,SMARCA4,199
chr1,81409857,81410107,SRX5075176,SMARCA4,250
chr1,81414394,81414827,SRX16500059,CTCF,433
chr1,81414406,81414811,SRX16500062,CTCF,405
chr1,81414406,81414822,SRX16500060,CTCF,416
chr1,81414449,81414825,SRX16500061,CTCF,376
chr1,81414463,81414683,SRX4174629,CTCF,220
chr1,81414490,81414821,SRX5075174,SMARCA4,331
chr1,81414497,81414928,SRX5075168,SMARCA4,431
chr1,81414582,81414807,SRX5075170,SMARCA4,225
chr1,81424076,81424288,SRX5716469,SMARCA4,212
chr1,81424093,81424272,SRX5075168,SMARCA4,179
chr1,81424099,81424309,SRX5075169,SMARCA4,210
chr1,81424147,81424365,SRX5075174,SMARCA4,218
chr1,81424150,81424373,SRX5075175,SMARCA4,223
chr1,81424212,81424423,SRX5716470,SMARCA4,211
chr1,81424270,81424549,SRX5075176,SMARCA4,279
chr1,81431030,81431691,SRX5075176,SMARCA4,661
chr1,81431044,81431790,SRX5075174,SMARCA4,746
chr1,81431049,81431453,SRX5716467,SMARCA2,404
chr1,81431053,81431564,SRX5075170,SMARCA4,511
chr1,81431066,81431482,SRX5075169,SMARCA4,416
chr1,81431085,81431525,SRX5716470,SMARCA4,440
chr1,81431102,81431653,SRX5075168,SMARCA4,551
chr1,81431133,81431436,SRX5020211,SMARCA2,303
chr1,81431180,81431537,SRX5075175,SMARCA4,357
chr1,81431228,81431457,SRX5054309,FOSL2,229
chr1,81431232,81431412,SRX5054308,FOSL2,180
chr1,81431239,81431471,SRX5716463,SMARCA4,232
chr1,81431246,81431642,SRX5716469,SMARCA4,396
chr1,81431321,81431638,SRX5716464,SMARCA4,317
chr1,81432088,81432358,SRX5075176,SMARCA4,270
chr1,81432115,81432346,SRX5075168,SMARCA4,231
chr1,81464412,81464926,SRX5075174,SMARCA4,514
chr1,81464649,81465067,SRX5075168,SMARCA4,418
chr1,81467518,81467823,SRX5075174,SMARCA4,305
chr1,81467552,81467793,SRX5075168,SMARCA4,241
chr1,81477740,81477930,SRX5054308,FOSL2,190
chr1,81478331,81478506,SRX5075176,SMARCA4,175
chr1,81496155,81496708,SRX5075168,SMARCA4,553
chr1,81496275,81496781,SRX5075174,SMARCA4,506
chr1,81496323,81496591,SRX5716464,SMARCA4,268
chr1,81496367,81496675,SRX5716463,SMARCA4,308
chr1,81496416,81496647,SRX5716454,SOX3,231
chr1,81498735,81498983,SRX5075170,SMARCA4,248
chr1,81506701,81507057,SRX5075168,SMARCA4,356
chr1,81506712,81507008,SRX5075174,SMARCA4,296
chr1,81509679,81509929,SRX5075174,SMARCA4,250
chr1,81542334,81542514,SRX5075169,SMARCA4,180
chr1,81549553,81549863,SRX16500061,CTCF,310
chr1,81549651,81549861,SRX16500062,CTCF,210
chr1,81559737,81560097,SRX16500060,CTCF,360
chr1,81559779,81560001,SRX16500062,CTCF,222
chr1,81577108,81577702,SRX5075174,SMARCA4,594
chr1,81577119,81577705,SRX5075168,SMARCA4,586
chr1,81577235,81577515,SRX20140895,INTS13,280
chr1,81577270,81577524,SRX5716454,SOX3,254
chr1,81577273,81577673,SRX5716463,SMARCA4,400
chr1,81577276,81577519,SRX5716451,SOX2,243
chr1,81577300,81577541,SRX5716464,SMARCA4,241
chr1,81598729,81598939,SRX5075174,SMARCA4,210
chr1,81598743,81599129,SRX20140895,INTS13,386
chr1,81598791,81599176,SRX20140868,INTS10,385
chr1,81617716,81617940,SRX5716469,SMARCA4,224
chr1,81617739,81617932,SRX5075176,SMARCA4,193
chr1,81664351,81664704,SRX5075176,SMARCA4,353
chr1,81664353,81664613,SRX5716470,SMARCA4,260
chr1,81664370,81664663,SRX5075170,SMARCA4,293
chr1,81664435,81664662,SRX5075169,SMARCA4,227
chr1,81670275,81670643,SRX5075170,SMARCA4,368
chr1,81670293,81670607,SRX5075169,SMARCA4,314
chr1,81670317,81670629,SRX5075176,SMARCA4,312
chr1,81670323,81670539,SRX5716467,SMARCA2,216
chr1,81670331,81670692,SRX5075175,SMARCA4,361
chr1,81670332,81670699,SRX5716470,SMARCA4,367
chr1,81670335,81670625,SRX5716469,SMARCA4,290
chr1,81670418,81670601,SRX5054309,FOSL2,183
chr1,81680030,81680270,SRX5075170,SMARCA4,240
chr1,81680037,81680219,SRX5075176,SMARCA4,182
chr1,81680064,81680261,SRX5075168,SMARCA4,197
chr1,81680108,81680316,SRX5075174,SMARCA4,208
chr1,81681560,81681893,SRX5075170,SMARCA4,333
chr1,81681607,81681977,SRX5075176,SMARCA4,370
chr1,81681731,81681928,SRX5075169,SMARCA4,197
chr1,81682417,81682763,SRX5075168,SMARCA4,346
chr1,81682433,81682818,SRX5075174,SMARCA4,385
chr1,81682466,81682741,SRX5054309,FOSL2,275
chr1,81682471,81682785,SRX5716463,SMARCA4,314
chr1,81682480,81682758,SRX5716464,SMARCA4,278
chr1,81682499,81682710,SRX5716470,SMARCA4,211
chr1,81689612,81689812,SRX5075170,SMARCA4,200
chr1,81695767,81696104,SRX5075176,SMARCA4,337
chr1,81695776,81696041,SRX5075170,SMARCA4,265
chr1,81695789,81696060,SRX5716470,SMARCA4,271
chr1,81695791,81696006,SRX5716467,SMARCA2,215
chr1,81695800,81696048,SRX5075175,SMARCA4,248
chr1,81695884,81696105,SRX5075169,SMARCA4,221
chr1,81702901,81703241,SRX5054309,FOSL2,340
chr1,81702905,81703332,SRX5075175,SMARCA4,427
chr1,81702930,81703251,SRX5075169,SMARCA4,321
chr1,81702942,81703232,SRX5054308,FOSL2,290
chr1,81702950,81703254,SRX5075170,SMARCA4,304
chr1,81702955,81703173,SRX5075176,SMARCA4,218
chr1,81702969,81703181,SRX5716469,SMARCA4,212
chr1,81707030,81707432,SRX5716470,SMARCA4,402
chr1,81707033,81707380,SRX5075176,SMARCA4,347
chr1,81707062,81707442,SRX5075169,SMARCA4,380
chr1,81707073,81707417,SRX5054308,FOSL2,344
chr1,81707086,81707393,SRX5054309,FOSL2,307
chr1,81707086,81707430,SRX5075175,SMARCA4,344
chr1,81707090,81707376,SRX5716469,SMARCA4,286
chr1,81707093,81707398,SRX5075170,SMARCA4,305
chr1,81707121,81707433,SRX5020211,SMARCA2,312
chr1,81707155,81707394,SRX5020214,SMARCA2,239
chr1,81717119,81717782,SRX5075170,SMARCA4,663
chr1,81717142,81717650,SRX5075175,SMARCA4,508
chr1,81717159,81717736,SRX5075176,SMARCA4,577
chr1,81717182,81717744,SRX5075169,SMARCA4,562
chr1,81717218,81717690,SRX5054308,FOSL2,472
chr1,81717233,81717691,SRX5054309,FOSL2,458
chr1,81717308,81717647,SRX5020214,SMARCA2,339
chr1,81717314,81717525,SRX5716470,SMARCA4,211
chr1,81717336,81717641,SRX5716467,SMARCA2,305
chr1,81717337,81717592,SRX5020211,SMARCA2,255
chr1,81717375,81717604,SRX5716469,SMARCA4,229
chr1,81760155,81760363,SRX5075168,SMARCA4,208
chr1,81760477,81760895,SRX16500059,CTCF,418
chr1,81760507,81760884,SRX16500061,CTCF,377
chr1,81760547,81760799,SRX16500062,CTCF,252
chr1,81760557,81760888,SRX16500060,CTCF,331
chr1,81793005,81793195,SRX5075175,SMARCA4,190
chr1,81800233,81801295,SRX20140895,INTS13,1062
chr1,81800247,81800535,SRX20140879,CPSF3L,288
chr1,81800252,81800591,SRX5075176,SMARCA4,339
chr1,81800254,81800768,SRX20140868,INTS10,514
chr1,81800266,81800616,SRX20140867,INTS10,350
chr1,81800292,81800537,SRX5075169,SMARCA4,245
chr1,81800310,81800552,SRX5075174,SMARCA4,242
chr1,81800331,81800609,SRX20140894,INTS13,278
chr1,81800370,81800581,SRX5075168,SMARCA4,211
chr1,81800969,81801332,SRX20140868,INTS10,363
chr1,81804278,81804626,SRX5075174,SMARCA4,348
chr1,81804308,81804566,SRX5075168,SMARCA4,258
chr1,81804349,81804601,SRX5716463,SMARCA4,252
chr1,81808772,81809172,SRX5075174,SMARCA4,400
chr1,81808776,81809176,SRX5075168,SMARCA4,400
chr1,81808825,81809124,SRX5716464,SMARCA4,299
chr1,81808840,81809048,SRX5716463,SMARCA4,208
chr1,81808943,81809188,SRX16500060,CTCF,245
chr1,81808950,81809197,SRX16500059,CTCF,247
chr1,81832636,81832922,SRX5075175,SMARCA4,286
chr1,81832698,81832913,SRX5020214,SMARCA2,215
chr1,81832712,81832934,SRX5075169,SMARCA4,222
chr1,81834910,81835290,SRX5075176,SMARCA4,380
chr1,81834942,81835186,SRX5075170,SMARCA4,244
chr1,81834967,81835228,SRX5075169,SMARCA4,261
chr1,81834980,81835297,SRX5075174,SMARCA4,317
chr1,81867236,81867419,SRX5075176,SMARCA4,183
chr1,81869415,81869597,SRX5075170,SMARCA4,182
chr1,81877031,81877266,SRX5075176,SMARCA4,235
chr1,81877138,81877690,SRX5075169,SMARCA4,552
chr1,81877195,81877598,SRX5054309,FOSL2,403
chr1,81877327,81877732,SRX5075176,SMARCA4,405
chr1,81877476,81877663,SRX5075175,SMARCA4,187
chr1,81877478,81877674,SRX5075170,SMARCA4,196
chr1,81887550,81887780,SRX5075169,SMARCA4,230
chr1,81900913,81901139,SRX5075169,SMARCA4,226
chr1,81920219,81920907,SRX5075174,SMARCA4,688
chr1,81920248,81920847,SRX5075168,SMARCA4,599
chr1,81920251,81920831,SRX5075176,SMARCA4,580
chr1,81920294,81920816,SRX5716463,SMARCA4,522
chr1,81920310,81920763,SRX5075169,SMARCA4,453
chr1,81920323,81920742,SRX5075170,SMARCA4,419
chr1,81920325,81920786,SRX5075175,SMARCA4,461
chr1,81920340,81920856,SRX20140895,INTS13,516
chr1,81920345,81920644,SRX20140867,INTS10,299
chr1,81920347,81920665,SRX5054309,FOSL2,318
chr1,81920349,81920595,SRX5054308,FOSL2,246
chr1,81920360,81920715,SRX5716469,SMARCA4,355
chr1,81920383,81920677,SRX20140881,CPSF3L,294
chr1,81920388,81920677,SRX5054307,FOSL2,289
chr1,81920388,81920781,SRX5716470,SMARCA4,393
chr1,81920396,81920745,SRX5716464,SMARCA4,349
chr1,81920427,81920669,SRX5716451,SOX2,242
chr1,81920478,81920693,SRX5716467,SMARCA2,215
chr1,81926720,81926988,SRX5075174,SMARCA4,268
chr1,81926781,81926961,SRX5075169,SMARCA4,180
chr1,81926796,81927026,SRX5075168,SMARCA4,230
chr1,81949653,81949694,SRX1424893,POU3F2,41
chr1,81954624,81954839,SRX5075174,SMARCA4,215
chr1,81978966,81979210,SRX5716463,SMARCA4,244
chr1,81978998,81979389,SRX5075174,SMARCA4,391
chr1,81979024,81979282,SRX5075168,SMARCA4,258
chr1,82044668,82044894,SRX5075176,SMARCA4,226
chr1,82044685,82044934,SRX5075170,SMARCA4,249
chr1,82077408,82077742,SRX5075169,SMARCA4,334
chr1,82077468,82077704,SRX5075176,SMARCA4,236
chr1,82077472,82077692,SRX5075170,SMARCA4,220
chr1,82090164,82090407,SRX16500060,CTCF,243
chr1,82090200,82090444,SRX16500061,CTCF,244
chr1,82110915,82111188,SRX5075176,SMARCA4,273
chr1,82110936,82111191,SRX5075170,SMARCA4,255
chr1,82110946,82111169,SRX5075175,SMARCA4,223
chr1,82111008,82111200,SRX5075169,SMARCA4,192
chr1,82125056,82125365,SRX5075168,SMARCA4,309
chr1,82125083,82125406,SRX5075174,SMARCA4,323
chr1,82125139,82125673,SRX20140895,INTS13,534
chr1,82125259,82125629,SRX20140868,INTS10,370
chr1,82129894,82130125,SRX5075176,SMARCA4,231
chr1,82153186,82153454,SRX5054308,FOSL2,268
chr1,82161459,82162125,SRX5075170,SMARCA4,666
chr1,82161490,82162151,SRX5075169,SMARCA4,661
chr1,82161511,82162059,SRX5716470,SMARCA4,548
chr1,82161559,82162043,SRX5716469,SMARCA4,484
chr1,82161581,82162119,SRX5075175,SMARCA4,538
chr1,82161598,82162052,SRX5075176,SMARCA4,454
chr1,82161598,82162220,SRX5075174,SMARCA4,622
chr1,82161632,82162161,SRX5075168,SMARCA4,529
chr1,82161664,82162004,SRX5716467,SMARCA2,340
chr1,82161672,82161995,SRX5716464,SMARCA4,323
chr1,82161702,82162080,SRX5020211,SMARCA2,378
chr1,82161703,82161974,SRX5075181,SMARCA2,271
chr1,82161722,82162039,SRX5716468,SMARCA2,317
chr1,82161759,82162151,SRX5716463,SMARCA4,392
chr1,82177228,82177565,SRX5075176,SMARCA4,337
chr1,82177238,82177510,SRX5054308,FOSL2,272
chr1,82177245,82177542,SRX5054309,FOSL2,297
chr1,82177249,82177497,SRX5075175,SMARCA4,248
chr1,82177258,82177543,SRX5075170,SMARCA4,285
chr1,82177265,82177508,SRX5075169,SMARCA4,243
chr1,82177324,82177556,SRX5716470,SMARCA4,232
chr1,82225478,82225783,SRX5075176,SMARCA4,305
chr1,82225504,82225804,SRX5075169,SMARCA4,300
chr1,82225514,82225758,SRX5075170,SMARCA4,244
chr1,82225523,82225775,SRX5075175,SMARCA4,252
chr1,82225538,82225752,SRX5054308,FOSL2,214
chr1,82226068,82226318,SRX5075170,SMARCA4,250
chr1,82226115,82226347,SRX5075176,SMARCA4,232
chr1,82227765,82227940,SRX5075176,SMARCA4,175
chr1,82227843,82228012,SRX5075170,SMARCA4,169
chr1,82230664,82231052,SRX5075168,SMARCA4,388
chr1,82230668,82231038,SRX5075174,SMARCA4,370
chr1,82230704,82231086,SRX5716463,SMARCA4,382
chr1,82230713,82230983,SRX5716464,SMARCA4,270
chr1,82260614,82260915,SRX5075176,SMARCA4,301
chr1,82260726,82260920,SRX5075170,SMARCA4,194
chr1,82269453,82269782,SRX5075176,SMARCA4,329
chr1,82269487,82269792,SRX5075170,SMARCA4,305
chr1,82269502,82269816,SRX5054308,FOSL2,314
chr1,82269512,82269825,SRX5054309,FOSL2,313
chr1,82269518,82269716,SRX5075169,SMARCA4,198
chr1,82273899,82274079,SRX5075169,SMARCA4,180
chr1,82317704,82317962,SRX5054308,FOSL2,258
chr1,82317715,82317959,SRX5054309,FOSL2,244
chr1,82317722,82317976,SRX5075169,SMARCA4,254
chr1,82343500,82343680,SRX5075169,SMARCA4,180
chr1,82343507,82343717,SRX5054309,FOSL2,210
chr1,82343516,82343724,SRX5075175,SMARCA4,208
chr1,82351880,82352105,SRX5075168,SMARCA4,225
chr1,82351954,82352290,SRX5075174,SMARCA4,336
chr1,82362347,82362558,SRX5716470,SMARCA4,211
chr1,82377255,82377525,SRX5075169,SMARCA4,270
chr1,82377273,82377546,SRX5075175,SMARCA4,273
chr1,82377276,82377552,SRX5075174,SMARCA4,276
chr1,82377313,82377489,SRX5075170,SMARCA4,176
chr1,82377313,82377530,SRX5075168,SMARCA4,217
chr1,82392546,82392852,SRX5054309,FOSL2,306
chr1,82392568,82392807,SRX5075170,SMARCA4,239
chr1,82392587,82392810,SRX5075176,SMARCA4,223
chr1,82392601,82392862,SRX5075175,SMARCA4,261
chr1,82392635,82392845,SRX5075169,SMARCA4,210
chr1,82462467,82462660,SRX5075169,SMARCA4,193
chr1,82464568,82464890,SRX5716469,SMARCA4,322
chr1,82464734,82464939,SRX5075170,SMARCA4,205
chr1,82464742,82464922,SRX5075169,SMARCA4,180
chr1,82485504,82486223,SRX5075168,SMARCA4,719
chr1,82485506,82485912,SRX5075176,SMARCA4,406
chr1,82485507,82485949,SRX5075170,SMARCA4,442
chr1,82485529,82485760,SRX5716470,SMARCA4,231
chr1,82485574,82485830,SRX5075175,SMARCA4,256
chr1,82485577,82485807,SRX5075169,SMARCA4,230
chr1,82485578,82485847,SRX5716469,SMARCA4,269
chr1,82485679,82486351,SRX5075174,SMARCA4,672
chr1,82485738,82486009,SRX5054307,FOSL2,271
chr1,82485771,82486069,SRX5054308,FOSL2,298
chr1,82485781,82486042,SRX5054309,FOSL2,261
chr1,82503930,82504120,SRX5075176,SMARCA4,190
chr1,82503955,82504179,SRX5716470,SMARCA4,224
chr1,82503998,82504220,SRX5075175,SMARCA4,222
chr1,82517648,82517893,SRX5075174,SMARCA4,245
chr1,82517672,82517882,SRX4174629,CTCF,210
chr1,82562475,82562787,SRX5075176,SMARCA4,312
chr1,82562486,82562694,SRX5075175,SMARCA4,208
chr1,82562514,82562813,SRX5075174,SMARCA4,299
chr1,82562515,82562857,SRX5716463,SMARCA4,342
chr1,82562562,82562889,SRX5075168,SMARCA4,327
chr1,82565063,82565929,SRX5075168,SMARCA4,866
chr1,82565108,82565891,SRX5075174,SMARCA4,783
chr1,82565165,82565369,SRX5716463,SMARCA4,204
chr1,82565184,82565461,SRX5075175,SMARCA4,277
chr1,82565198,82565949,SRX5075176,SMARCA4,751
chr1,82565216,82565513,SRX5054309,FOSL2,297
chr1,82565216,82565944,SRX5075170,SMARCA4,728
chr1,82565226,82565938,SRX5075169,SMARCA4,712
chr1,82565249,82565533,SRX5054308,FOSL2,284
chr1,82565292,82565535,SRX5716470,SMARCA4,243
chr1,82565641,82565944,SRX5054309,FOSL2,303
chr1,82565680,82565932,SRX5716469,SMARCA4,252
chr1,82565711,82565984,SRX5075175,SMARCA4,273
chr1,82593570,82593825,SRX5075170,SMARCA4,255
chr1,82593679,82593888,SRX5075176,SMARCA4,209
chr1,82604586,82604864,SRX16500059,CTCF,278
chr1,82604637,82604859,SRX16500061,CTCF,222
chr1,82604639,82604849,SRX16500062,CTCF,210
chr1,82613011,82613311,SRX5716463,SMARCA4,300
chr1,82613015,82613272,SRX5075174,SMARCA4,257
chr1,82613037,82613255,SRX5075168,SMARCA4,218
chr1,82632222,82632536,SRX5054309,FOSL2,314
chr1,82632250,82632482,SRX5054308,FOSL2,232
chr1,82632279,82632466,SRX5075175,SMARCA4,187
chr1,82632280,82632492,SRX5716469,SMARCA4,212
chr1,82655927,82656525,SRX5075176,SMARCA4,598
chr1,82655953,82656327,SRX5075170,SMARCA4,374
chr1,82656018,82656231,SRX5716470,SMARCA4,213
chr1,82656020,82656343,SRX5716468,SMARCA2,323
chr1,82656028,82656301,SRX5716469,SMARCA4,273
chr1,82656046,82656285,SRX5075175,SMARCA4,239
chr1,82656067,82656302,SRX5716467,SMARCA2,235
chr1,82656452,82656629,SRX5075170,SMARCA4,177
chr1,82695520,82695819,SRX5054309,FOSL2,299
chr1,82695528,82695803,SRX5054308,FOSL2,275
chr1,82695564,82695744,SRX5075169,SMARCA4,180
chr1,82701449,82701820,SRX5054309,FOSL2,371
chr1,82701497,82701777,SRX5054308,FOSL2,280
chr1,82706713,82707094,SRX5075175,SMARCA4,381
chr1,82706745,82707183,SRX5075169,SMARCA4,438
chr1,82706754,82707028,SRX5716469,SMARCA4,274
chr1,82706773,82707111,SRX5054308,FOSL2,338
chr1,82706792,82707119,SRX5054309,FOSL2,327
chr1,82706805,82707079,SRX5020214,SMARCA2,274
chr1,82706829,82707065,SRX5075170,SMARCA4,236
chr1,82706849,82707097,SRX5075176,SMARCA4,248
chr1,82706860,82707071,SRX5716470,SMARCA4,211
chr1,82706886,82707131,SRX5020211,SMARCA2,245
chr1,82775401,82775825,SRX16500059,CTCF,424
chr1,82775416,82775771,SRX16500060,CTCF,355
chr1,82775460,82775763,SRX16500062,CTCF,303
chr1,82775469,82775789,SRX16500061,CTCF,320
chr1,82775508,82775726,SRX5075168,SMARCA4,218
chr1,82775569,82775773,SRX5716463,SMARCA4,204
chr1,82785357,82785707,SRX5075170,SMARCA4,350
chr1,82785367,82785654,SRX5716469,SMARCA4,287
chr1,82785378,82785683,SRX5075176,SMARCA4,305
chr1,82785409,82785743,SRX5054309,FOSL2,334
chr1,82785476,82785674,SRX5075169,SMARCA4,198
chr1,82785493,82785713,SRX5054308,FOSL2,220
chr1,82792694,82793142,SRX5075174,SMARCA4,448
chr1,82792803,82793061,SRX5075168,SMARCA4,258
chr1,82795530,82795821,SRX5054309,FOSL2,291
chr1,82795594,82795781,SRX5075175,SMARCA4,187
chr1,82795599,82795883,SRX5075168,SMARCA4,284
chr1,82795609,82795818,SRX5054308,FOSL2,209
chr1,82795614,82795864,SRX5075176,SMARCA4,250
chr1,82795615,82795874,SRX5075170,SMARCA4,259
chr1,82795627,82795858,SRX5075174,SMARCA4,231
chr1,82807096,82807320,SRX5075170,SMARCA4,224
chr1,82836386,82836569,SRX5075170,SMARCA4,183
chr1,82838001,82838270,SRX5075175,SMARCA4,269
chr1,82879817,82880247,SRX5075170,SMARCA4,430
chr1,82879928,82880216,SRX5075176,SMARCA4,288
chr1,82915103,82915370,SRX5075174,SMARCA4,267
chr1,82915150,82915396,SRX5075168,SMARCA4,246
chr1,82920483,82920702,SRX5054309,FOSL2,219
chr1,82921848,82922046,SRX5075168,SMARCA4,198
chr1,82927582,82928146,SRX5075176,SMARCA4,564
chr1,82927589,82928139,SRX5075170,SMARCA4,550
chr1,82927727,82928025,SRX5075174,SMARCA4,298
chr1,82927735,82928001,SRX5020211,SMARCA2,266
chr1,82927776,82928040,SRX5075169,SMARCA4,264
chr1,82927796,82928001,SRX5054308,FOSL2,205
chr1,82927799,82928039,SRX5075168,SMARCA4,240
chr1,82927826,82928044,SRX5716469,SMARCA4,218
chr1,82938457,82938756,SRX5075176,SMARCA4,299
chr1,82938501,82938736,SRX5075170,SMARCA4,235
chr1,82945483,82945770,SRX5075176,SMARCA4,287
chr1,82945485,82945654,SRX5075170,SMARCA4,169
chr1,82945812,82946585,SRX5075170,SMARCA4,773
chr1,82945989,82946425,SRX5075176,SMARCA4,436
chr1,82946055,82946455,SRX5716470,SMARCA4,400
chr1,82946117,82946444,SRX5716467,SMARCA2,327
chr1,82946192,82946443,SRX5716468,SMARCA2,251
chr1,82946239,82946419,SRX5075169,SMARCA4,180
chr1,82994814,82995354,SRX5075176,SMARCA4,540
chr1,82994908,82995287,SRX5075170,SMARCA4,379
chr1,82994925,82995272,SRX5075169,SMARCA4,347
chr1,83060733,83060929,SRX5075176,SMARCA4,196
chr1,83098277,83098646,SRX5075170,SMARCA4,369
chr1,83098290,83098611,SRX5075176,SMARCA4,321
chr1,83102620,83103058,SRX5075168,SMARCA4,438
chr1,83102676,83103140,SRX5075174,SMARCA4,464
chr1,83135684,83136085,SRX5716470,SMARCA4,401
chr1,83135700,83136021,SRX5075176,SMARCA4,321
chr1,83135735,83136067,SRX5716469,SMARCA4,332
chr1,83135764,83136058,SRX5075175,SMARCA4,294
chr1,83135800,83136027,SRX5716468,SMARCA2,227
chr1,83135817,83136090,SRX5075169,SMARCA4,273
chr1,83135831,83136144,SRX5075170,SMARCA4,313
chr1,83151146,83151611,SRX5075176,SMARCA4,465
chr1,83151152,83151575,SRX5075169,SMARCA4,423
chr1,83151155,83151587,SRX5075170,SMARCA4,432
chr1,83151157,83151516,SRX5716469,SMARCA4,359
chr1,83151157,83151602,SRX5075175,SMARCA4,445
chr1,83151210,83151494,SRX5054308,FOSL2,284
chr1,83151216,83151517,SRX5054309,FOSL2,301
chr1,83151231,83151507,SRX5716467,SMARCA2,276
chr1,83151241,83151478,SRX5020214,SMARCA2,237
chr1,83151287,83151547,SRX5716460,Epitope tags,260
chr1,83151309,83151537,SRX5716470,SMARCA4,228
chr1,83158380,83158826,SRX5075174,SMARCA4,446
chr1,83158500,83158790,SRX5716463,SMARCA4,290
chr1,83158506,83158819,SRX5075168,SMARCA4,313
chr1,83216795,83217031,SRX5075170,SMARCA4,236
chr1,83216801,83217058,SRX5075176,SMARCA4,257
chr1,83246752,83247115,SRX5075170,SMARCA4,363
chr1,83246798,83247176,SRX5075176,SMARCA4,378
chr1,83271736,83271996,SRX5075168,SMARCA4,260
chr1,83332368,83332551,SRX5054309,FOSL2,183
chr1,83343065,83343254,SRX5075176,SMARCA4,189
chr1,83343833,83344034,SRX5075170,SMARCA4,201
chr1,83343841,83344044,SRX5075176,SMARCA4,203
chr1,83410850,83411296,SRX5075176,SMARCA4,446
chr1,83410871,83411300,SRX5075170,SMARCA4,429
chr1,83410881,83411294,SRX5716470,SMARCA4,413
chr1,83410900,83411261,SRX5716469,SMARCA4,361
chr1,83410904,83411214,SRX5075175,SMARCA4,310
chr1,83410914,83411203,SRX5716467,SMARCA2,289
chr1,83410965,83411220,SRX5075169,SMARCA4,255
chr1,83410975,83411247,SRX5020211,SMARCA2,272
chr1,83410998,83411249,SRX5075181,SMARCA2,251
chr1,83413323,83413792,SRX5075174,SMARCA4,469
chr1,83413337,83414156,SRX5075168,SMARCA4,819
chr1,83413345,83413726,SRX5716463,SMARCA4,381
chr1,83413888,83414132,SRX5075174,SMARCA4,244
chr1,83425816,83425870,SRX1424892,POU3F2,54
chr1,83457739,83458226,SRX5716470,SMARCA4,487
chr1,83457782,83458123,SRX5075170,SMARCA4,341
chr1,83457785,83458163,SRX5075175,SMARCA4,378
chr1,83508545,83508948,SRX5075170,SMARCA4,403
chr1,83508581,83508874,SRX5075175,SMARCA4,293
chr1,83508597,83508998,SRX5075176,SMARCA4,401
chr1,83508662,83508961,SRX5075169,SMARCA4,299
chr1,83516375,83516662,SRX5075176,SMARCA4,287
chr1,83516407,83516779,SRX5075170,SMARCA4,372
chr1,83516430,83516668,SRX5075175,SMARCA4,238
chr1,83516459,83516766,SRX5716469,SMARCA4,307
chr1,83516473,83516742,SRX5075169,SMARCA4,269
chr1,83528201,83528419,SRX5054309,FOSL2,218
chr1,83528260,83528513,SRX5075170,SMARCA4,253
chr1,83528291,83528485,SRX5054308,FOSL2,194
chr1,83528317,83528492,SRX5075176,SMARCA4,175
chr1,83545518,83545814,SRX16500060,CTCF,296
chr1,83545538,83545821,SRX16500061,CTCF,283
chr1,83547857,83548130,SRX5075176,SMARCA4,273
chr1,83547911,83548149,SRX5716470,SMARCA4,238
chr1,83547911,83548220,SRX5075170,SMARCA4,309
chr1,83547924,83548294,SRX5716469,SMARCA4,370
chr1,83547931,83548209,SRX5075169,SMARCA4,278
chr1,83547947,83548175,SRX5716467,SMARCA2,228
chr1,83547957,83548191,SRX5054309,FOSL2,234
chr1,83548025,83548210,SRX5054308,FOSL2,185
chr1,83554259,83554489,SRX5075170,SMARCA4,230
chr1,83559487,83559946,SRX5075168,SMARCA4,459
chr1,83559523,83559888,SRX5075174,SMARCA4,365
chr1,83559579,83559792,SRX5716463,SMARCA4,213
chr1,83559579,83559873,SRX5716464,SMARCA4,294
chr1,83574839,83575118,SRX5075168,SMARCA4,279
chr1,83619445,83619696,SRX5075176,SMARCA4,251
chr1,83619500,83619808,SRX5075170,SMARCA4,308
chr1,83641239,83641682,SRX5075170,SMARCA4,443
chr1,83641319,83641581,SRX5075174,SMARCA4,262
chr1,83641344,83641635,SRX5716470,SMARCA4,291
chr1,83641357,83641726,SRX5075175,SMARCA4,369
chr1,83641505,83641703,SRX5075176,SMARCA4,198
chr1,83641789,83642065,SRX5075170,SMARCA4,276
chr1,83692423,83692809,SRX5075174,SMARCA4,386
chr1,83692472,83692814,SRX5075168,SMARCA4,342
chr1,83692543,83692762,SRX5054309,FOSL2,219
chr1,83692594,83692763,SRX5075170,SMARCA4,169
chr1,83692601,83693474,SRX20140895,INTS13,873
chr1,83692918,83693458,SRX20140868,INTS10,540
chr1,83693026,83693230,SRX5075168,SMARCA4,204
chr1,83693032,83693222,SRX5075174,SMARCA4,190
chr1,83693423,83693657,SRX5075168,SMARCA4,234
chr1,83693435,83693643,SRX5075169,SMARCA4,208
chr1,83693440,83693633,SRX5075170,SMARCA4,193
chr1,83741263,83741862,SRX5075168,SMARCA4,599
chr1,83741293,83741841,SRX5075174,SMARCA4,548
chr1,83741323,83741799,SRX20140895,INTS13,476
chr1,83741413,83741603,SRX5716451,SOX2,190
chr1,83741420,83741745,SRX5716463,SMARCA4,325
chr1,83741438,83741725,SRX20140868,INTS10,287
chr1,83748093,83748395,SRX5075174,SMARCA4,302
chr1,83748095,83748410,SRX5075168,SMARCA4,315
chr1,83749574,83749871,SRX5075174,SMARCA4,297
chr1,83749587,83749899,SRX5075168,SMARCA4,312
chr1,83749669,83749844,SRX5075176,SMARCA4,175
chr1,83770006,83770274,SRX5075176,SMARCA4,268
chr1,83777551,83777673,SRX1424893,POU3F2,122
chr1,83777616,83777693,SRX1424894,POU3F2,77
chr1,83779167,83779428,SRX5075174,SMARCA4,261
chr1,83779231,83779429,SRX5075168,SMARCA4,198
chr1,83787775,83787976,SRX5075174,SMARCA4,201
chr1,83804905,83805376,SRX5075174,SMARCA4,471
chr1,83804914,83805377,SRX5075168,SMARCA4,463
chr1,83804947,83805355,SRX5716463,SMARCA4,408
chr1,83815244,83815588,SRX5075176,SMARCA4,344
chr1,83815338,83815636,SRX5075170,SMARCA4,298
chr1,83822252,83822477,SRX5054309,FOSL2,225
chr1,83857067,83857401,SRX5075170,SMARCA4,334
chr1,83857078,83857403,SRX5075176,SMARCA4,325
chr1,83857088,83857268,SRX5054308,FOSL2,180
chr1,83857113,83857354,SRX5075175,SMARCA4,241
chr1,83857117,83857377,SRX5716470,SMARCA4,260
chr1,83857126,83857355,SRX5716469,SMARCA4,229
chr1,83857136,83857405,SRX5075169,SMARCA4,269
chr1,83857137,83857568,SRX16500061,CTCF,431
chr1,83857155,83857499,SRX16500062,CTCF,344
chr1,83857162,83857545,SRX16500060,CTCF,383
chr1,83857178,83857562,SRX16500059,CTCF,384
chr1,83857185,83857469,SRX5075168,SMARCA4,284
chr1,83857196,83857422,SRX5075174,SMARCA4,226
chr1,83882896,83883265,SRX5075170,SMARCA4,369
chr1,83882897,83883255,SRX5075175,SMARCA4,358
chr1,83882901,83883188,SRX5075168,SMARCA4,287
chr1,83882902,83883299,SRX5075176,SMARCA4,397
chr1,83882911,83883244,SRX5075169,SMARCA4,333
chr1,83882929,83883246,SRX5075174,SMARCA4,317
chr1,83882937,83883273,SRX5716470,SMARCA4,336
chr1,83882939,83883253,SRX5716469,SMARCA4,314
chr1,83882987,83883269,SRX5716467,SMARCA2,282
chr1,83883028,83883225,SRX5054309,FOSL2,197
chr1,83889848,83890066,SRX5054308,FOSL2,218
chr1,83889862,83890048,SRX5075169,SMARCA4,186
chr1,83900584,83900813,SRX5075175,SMARCA4,229
chr1,83900585,83900760,SRX5075176,SMARCA4,175
chr1,83900600,83900865,SRX5054308,FOSL2,265
chr1,83900619,83900830,SRX5716470,SMARCA4,211
chr1,83900626,83900866,SRX5054309,FOSL2,240
chr1,83900645,83900899,SRX5075169,SMARCA4,254
chr1,83905226,83905846,SRX16500059,CTCF,620
chr1,83905234,83905804,SRX16500062,CTCF,570
chr1,83905239,83905907,SRX16500060,CTCF,668
chr1,83905277,83905798,SRX16500061,CTCF,521
chr1,83905378,83905577,SRX5075168,SMARCA4,199
chr1,83905447,83905657,SRX5716463,SMARCA4,210
chr1,83913685,83914101,SRX5075170,SMARCA4,416
chr1,83913792,83914187,SRX5075176,SMARCA4,395
chr1,83913867,83914121,SRX5054308,FOSL2,254
chr1,83913876,83914103,SRX5054309,FOSL2,227
chr1,83913885,83914072,SRX5075175,SMARCA4,187
chr1,83931623,83932145,SRX16500060,CTCF,522
chr1,83931626,83932131,SRX16500059,CTCF,505
chr1,83931641,83932083,SRX16500061,CTCF,442
chr1,83931666,83932086,SRX16500062,CTCF,420
chr1,83931744,83932016,SRX5075174,SMARCA4,272
chr1,83931759,83932018,SRX5075170,SMARCA4,259
chr1,83931764,83932062,SRX5075168,SMARCA4,298
chr1,83931788,83931985,SRX5075169,SMARCA4,197
chr1,83931803,83932008,SRX5716464,SMARCA4,205
chr1,83931810,83932025,SRX5075176,SMARCA4,215
chr1,83959978,83960392,SRX5075170,SMARCA4,414
chr1,83959981,83960350,SRX5054309,FOSL2,369
chr1,83960010,83960304,SRX5716469,SMARCA4,294
chr1,83960025,83960341,SRX5075175,SMARCA4,316
chr1,83960026,83960350,SRX5054308,FOSL2,324
chr1,83960046,83960371,SRX5075169,SMARCA4,325
chr1,83960078,83960379,SRX5075176,SMARCA4,301
chr1,83960131,83960341,SRX5020214,SMARCA2,210
chr1,83962008,83962221,SRX5075170,SMARCA4,213
chr1,83970095,83970343,SRX5075176,SMARCA4,248
chr1,83970162,83970445,SRX5075170,SMARCA4,283
chr1,83978209,83978385,SRX5075176,SMARCA4,176
chr1,83996559,83997016,SRX5075170,SMARCA4,457
chr1,83996562,83997029,SRX5075169,SMARCA4,467
chr1,83996577,83997067,SRX5075176,SMARCA4,490
chr1,83996601,83997035,SRX5075175,SMARCA4,434
chr1,83996634,83996989,SRX5054309,FOSL2,355
chr1,83996643,83996965,SRX5716469,SMARCA4,322
chr1,83996653,83996843,SRX5054308,FOSL2,190
chr1,83996666,83996883,SRX5716467,SMARCA2,217
chr1,83996682,83997030,SRX5716470,SMARCA4,348
chr1,83996764,83997052,SRX5716468,SMARCA2,288
chr1,83998776,83999676,SRX20140895,INTS13,900
chr1,83998868,83999506,SRX20140868,INTS10,638
chr1,83998923,83999444,SRX20140867,INTS10,521
chr1,83998937,83999220,SRX20140879,CPSF3L,283
chr1,83999014,83999652,SRX5075174,SMARCA4,638
chr1,83999167,83999363,SRX5075168,SMARCA4,196
chr1,83999447,83999683,SRX5075168,SMARCA4,236
chr1,84002448,84002628,SRX5054308,FOSL2,180
chr1,84077390,84078161,SRX5075176,SMARCA4,771
chr1,84077461,84078026,SRX5075169,SMARCA4,565
chr1,84077468,84078024,SRX5075170,SMARCA4,556
chr1,84077480,84078542,SRX20140895,INTS13,1062
chr1,84077495,84078525,SRX5075174,SMARCA4,1030
chr1,84077637,84077980,SRX20140868,INTS10,343
chr1,84077664,84078149,SRX5075168,SMARCA4,485
chr1,84077666,84077951,SRX5716470,SMARCA4,285
chr1,84077790,84078126,SRX20140867,INTS10,336
chr1,84078430,84078609,SRX5075168,SMARCA4,179
chr1,84089471,84089646,SRX5075170,SMARCA4,175
chr1,84089486,84089748,SRX5054309,FOSL2,262
chr1,84089502,84089710,SRX5075176,SMARCA4,208
chr1,84089555,84089738,SRX5054308,FOSL2,183
chr1,84103316,84103745,SRX5075170,SMARCA4,429
chr1,84103365,84103689,SRX5075174,SMARCA4,324
chr1,84103373,84103727,SRX5075169,SMARCA4,354
chr1,84103376,84103757,SRX5075175,SMARCA4,381
chr1,84103379,84103675,SRX5716470,SMARCA4,296
chr1,84103384,84103719,SRX5054309,FOSL2,335
chr1,84103385,84103780,SRX5075176,SMARCA4,395
chr1,84103406,84103745,SRX5075168,SMARCA4,339
chr1,84103446,84103741,SRX5054308,FOSL2,295
chr1,84103470,84103765,SRX5716469,SMARCA4,295
chr1,84107585,84107908,SRX5075175,SMARCA4,323
chr1,84107606,84107933,SRX5075169,SMARCA4,327
chr1,84107630,84107841,SRX5075170,SMARCA4,211
chr1,84107653,84107862,SRX5054309,FOSL2,209
chr1,84107655,84107911,SRX5054308,FOSL2,256
chr1,84122724,84123171,SRX16500059,CTCF,447
chr1,84122773,84123192,SRX16500060,CTCF,419
chr1,84122818,84123171,SRX16500061,CTCF,353
chr1,84122851,84123132,SRX16500062,CTCF,281
chr1,84122862,84123107,SRX5075170,SMARCA4,245
chr1,84122870,84123131,SRX5075176,SMARCA4,261
chr1,84122893,84123066,SRX5075174,SMARCA4,173
chr1,84141126,84141574,SRX16500060,CTCF,448
chr1,84141225,84141526,SRX16500061,CTCF,301
chr1,84141231,84141578,SRX16500059,CTCF,347
chr1,84141279,84141523,SRX16500062,CTCF,244
chr1,84144107,84144294,SRX5075175,SMARCA4,187
chr1,84144171,84144439,SRX5075170,SMARCA4,268
chr1,84144179,84144419,SRX5075176,SMARCA4,240
chr1,84146428,84146719,SRX5075175,SMARCA4,291
chr1,84146429,84146783,SRX5054309,FOSL2,354
chr1,84146443,84146744,SRX5054308,FOSL2,301
chr1,84146460,84146769,SRX5075176,SMARCA4,309
chr1,84146467,84146727,SRX5075170,SMARCA4,260
chr1,84146469,84146762,SRX5075169,SMARCA4,293
chr1,84146474,84146718,SRX5716469,SMARCA4,244
chr1,84156131,84156701,SRX5075170,SMARCA4,570
chr1,84156163,84156503,SRX5716460,Epitope tags,340
chr1,84156175,84156687,SRX5075169,SMARCA4,512
chr1,84156198,84156756,SRX5716469,SMARCA4,558
chr1,84156206,84156666,SRX5075176,SMARCA4,460
chr1,84156215,84156700,SRX5075175,SMARCA4,485
chr1,84156258,84156630,SRX5054308,FOSL2,372
chr1,84156266,84156650,SRX5054309,FOSL2,384
chr1,84156307,84156623,SRX5716467,SMARCA2,316
chr1,84156309,84156591,SRX5716470,SMARCA4,282
chr1,84156378,84156607,SRX5020214,SMARCA2,229
chr1,84156414,84156647,SRX5020211,SMARCA2,233
chr1,84174103,84174627,SRX5075168,SMARCA4,524
chr1,84174131,84174604,SRX5075176,SMARCA4,473
chr1,84174138,84174713,SRX5075174,SMARCA4,575
chr1,84174194,84174597,SRX5075175,SMARCA4,403
chr1,84174221,84174657,SRX5075170,SMARCA4,436
chr1,84174223,84174615,SRX5075169,SMARCA4,392
chr1,84174236,84174585,SRX5716460,Epitope tags,349
chr1,84174272,84174611,SRX5054308,FOSL2,339
chr1,84174288,84174653,SRX5054309,FOSL2,365
chr1,84174289,84174698,SRX5716469,SMARCA4,409
chr1,84174304,84174598,SRX5716470,SMARCA4,294
chr1,84174359,84174614,SRX5020211,SMARCA2,255
chr1,84247446,84247626,SRX5054308,FOSL2,180
chr1,84247465,84247697,SRX5075175,SMARCA4,232
chr1,84247469,84247736,SRX5716469,SMARCA4,267
chr1,84247491,84247727,SRX5075169,SMARCA4,236
chr1,84253888,84254296,SRX5075169,SMARCA4,408
chr1,84253916,84254292,SRX5075170,SMARCA4,376
chr1,84253967,84254283,SRX5075175,SMARCA4,316
chr1,84253976,84254226,SRX5054309,FOSL2,250
chr1,84253978,84254332,SRX5075176,SMARCA4,354
chr1,84254006,84254269,SRX5716469,SMARCA4,263
chr1,84298377,84298634,SRX5075174,SMARCA4,257
chr1,84298389,84298917,SRX20140895,INTS13,528
chr1,84298402,84298582,SRX5075170,SMARCA4,180
chr1,84298404,84298784,SRX5075168,SMARCA4,380
chr1,84347640,84347869,SRX5075169,SMARCA4,229
chr1,84347641,84347845,SRX5075170,SMARCA4,204
chr1,84353738,84354085,SRX5054309,FOSL2,347
chr1,84353743,84354170,SRX5075170,SMARCA4,427
chr1,84353752,84354020,SRX5075175,SMARCA4,268
chr1,84353777,84354178,SRX5075176,SMARCA4,401
chr1,84353781,84354023,SRX5054308,FOSL2,242
chr1,84353782,84354062,SRX5075169,SMARCA4,280
chr1,84353846,84354057,SRX5716470,SMARCA4,211
chr1,84353849,84354062,SRX5716469,SMARCA4,213
chr1,84365347,84366006,SRX5075170,SMARCA4,659
chr1,84365358,84365941,SRX5075175,SMARCA4,583
chr1,84365384,84365997,SRX5054309,FOSL2,613
chr1,84365416,84365999,SRX5075169,SMARCA4,583
chr1,84365422,84366006,SRX5075176,SMARCA4,584
chr1,84365462,84365977,SRX5054308,FOSL2,515
chr1,84365470,84365908,SRX5020214,SMARCA2,438
chr1,84365478,84366040,SRX5075174,SMARCA4,562
chr1,84365480,84365871,SRX5716470,SMARCA4,391
chr1,84365481,84365955,SRX5716467,SMARCA2,474
chr1,84365544,84365935,SRX5716469,SMARCA4,391
chr1,84365547,84366080,SRX5075168,SMARCA4,533
chr1,84365577,84365886,SRX5020211,SMARCA2,309
chr1,84365599,84365865,SRX5054307,FOSL2,266
chr1,84365629,84366059,SRX5716460,Epitope tags,430
chr1,84365664,84365922,SRX5075182,SMARCA2,258
chr1,84377448,84377869,SRX5075170,SMARCA4,421
chr1,84377476,84377774,SRX5075169,SMARCA4,298
chr1,84377477,84377811,SRX5075175,SMARCA4,334
chr1,84377486,84377837,SRX5075176,SMARCA4,351
chr1,84377544,84377791,SRX5716467,SMARCA2,247
chr1,84377562,84377768,SRX5054308,FOSL2,206
chr1,84379172,84379466,SRX5054309,FOSL2,294
chr1,84379183,84379491,SRX5075169,SMARCA4,308
chr1,84379233,84379443,SRX5054308,FOSL2,210
chr1,84379236,84379451,SRX5075175,SMARCA4,215
chr1,84379699,84379981,SRX5716469,SMARCA4,282
chr1,84415450,84415694,SRX5054309,FOSL2,244
chr1,84415472,84415652,SRX5054308,FOSL2,180
chr1,84415531,84415724,SRX5075170,SMARCA4,193
chr1,84415534,84415714,SRX5075169,SMARCA4,180
chr1,84428230,84428504,SRX5075174,SMARCA4,274
chr1,84428263,84428566,SRX5075168,SMARCA4,303
chr1,84433670,84434092,SRX5075170,SMARCA4,422
chr1,84433678,84433992,SRX5020211,SMARCA2,314
chr1,84433696,84434086,SRX5075176,SMARCA4,390
chr1,84433715,84434105,SRX5716469,SMARCA4,390
chr1,84433720,84434332,SRX16500059,CTCF,612
chr1,84433725,84434249,SRX16500060,CTCF,524
chr1,84433742,84434107,SRX5075168,SMARCA4,365
chr1,84433760,84434249,SRX16500061,CTCF,489
chr1,84433764,84434191,SRX16500062,CTCF,427
chr1,84433770,84433992,SRX5054308,FOSL2,222
chr1,84433781,84434119,SRX5075174,SMARCA4,338
chr1,84433801,84434049,SRX5075169,SMARCA4,248
chr1,84433807,84433994,SRX5075175,SMARCA4,187
chr1,84433823,84434065,SRX5716463,SMARCA4,242
chr1,84433902,84434140,SRX4174629,CTCF,238
chr1,84442194,84442458,SRX16500061,CTCF,264
chr1,84442206,84442521,SRX16500060,CTCF,315
chr1,84442263,84442569,SRX16500059,CTCF,306
chr1,84442276,84442605,SRX5075170,SMARCA4,329
chr1,84442289,84442586,SRX5075175,SMARCA4,297
chr1,84442308,84442608,SRX5075169,SMARCA4,300
chr1,84442308,84442663,SRX5054309,FOSL2,355
chr1,84442317,84442625,SRX5054308,FOSL2,308
chr1,84442317,84442644,SRX5075176,SMARCA4,327
chr1,84442360,84442603,SRX5716469,SMARCA4,243
chr1,84478893,84479506,SRX20140869,INTS10,613
chr1,84479064,84479504,SRX5075168,SMARCA4,440
chr1,84479086,84479414,SRX20140879,CPSF3L,328
chr1,84479086,84479699,SRX20140895,INTS13,613
chr1,84479125,84479743,SRX5075174,SMARCA4,618
chr1,84479140,84479567,SRX20140868,INTS10,427
chr1,84479175,84479394,SRX20140867,INTS10,219
chr1,84479186,84479479,SRX20140897,INTS13,293
chr1,84479221,84479579,SRX5716470,SMARCA4,358
chr1,84479243,84479484,SRX5075169,SMARCA4,241
chr1,84479296,84479742,SRX5075170,SMARCA4,446
chr1,84479323,84479498,SRX5075176,SMARCA4,175
chr1,84479323,84479615,SRX5716463,SMARCA4,292
chr1,84479630,84479820,SRX5075175,SMARCA4,190
chr1,84505727,84505914,SRX5075175,SMARCA4,187
chr1,84505774,84505985,SRX5075176,SMARCA4,211
chr1,84505863,84506823,SRX20140895,INTS13,960
chr1,84505876,84506087,SRX5716470,SMARCA4,211
chr1,84505953,84506267,SRX20140868,INTS10,314
chr1,84506099,84506912,SRX5075174,SMARCA4,813
chr1,84506183,84506493,SRX5075170,SMARCA4,310
chr1,84506266,84506870,SRX5075168,SMARCA4,604
chr1,84506334,84506509,SRX5075176,SMARCA4,175
chr1,84506344,84506781,SRX5716469,SMARCA4,437
chr1,84506347,84506668,SRX20140867,INTS10,321
chr1,84506354,84506843,SRX20140879,CPSF3L,489
chr1,84506370,84506641,SRX20140881,CPSF3L,271
chr1,84506402,84506834,SRX5075169,SMARCA4,432
chr1,84506478,84506737,SRX5054309,FOSL2,259
chr1,84506503,84506761,SRX5054308,FOSL2,258
chr1,84506570,84506882,SRX5075170,SMARCA4,312
chr1,84506578,84506886,SRX5075176,SMARCA4,308
chr1,84506588,84506839,SRX5075175,SMARCA4,251
chr1,84540028,84540249,SRX5075169,SMARCA4,221
chr1,84550931,84551106,SRX5075176,SMARCA4,175
chr1,84573862,84574047,SRX5075169,SMARCA4,185
chr1,84573904,84574180,SRX5716470,SMARCA4,276
chr1,84573989,84574490,SRX5075176,SMARCA4,501
chr1,84574051,84574731,SRX5075174,SMARCA4,680
chr1,84574095,84574496,SRX20140895,INTS13,401
chr1,84574116,84574453,SRX5075170,SMARCA4,337
chr1,84574121,84574433,SRX5716469,SMARCA4,312
chr1,84574137,84574660,SRX5075168,SMARCA4,523
chr1,84574177,84574474,SRX5075175,SMARCA4,297
chr1,84574324,84574673,SRX5075169,SMARCA4,349
chr1,84583288,84583899,SRX5075174,SMARCA4,611
chr1,84583423,84584068,SRX5075170,SMARCA4,645
chr1,84583665,84583988,SRX5075175,SMARCA4,323
chr1,84583694,84583921,SRX5075169,SMARCA4,227
chr1,84583790,84584086,SRX5075176,SMARCA4,296
chr1,84598973,84599782,SRX5075176,SMARCA4,809
chr1,84599043,84599754,SRX5075169,SMARCA4,711
chr1,84599128,84599741,SRX5716469,SMARCA4,613
chr1,84599129,84599810,SRX5075175,SMARCA4,681
chr1,84599171,84599746,SRX5054309,FOSL2,575
chr1,84599209,84599741,SRX5054308,FOSL2,532
chr1,84599233,84599768,SRX5075170,SMARCA4,535
chr1,84599349,84599642,SRX5716460,Epitope tags,293
chr1,84611800,84612033,SRX5716470,SMARCA4,233
chr1,84611893,84612154,SRX5075176,SMARCA4,261
chr1,84619289,84619796,SRX5075170,SMARCA4,507
chr1,84619299,84619772,SRX5716469,SMARCA4,473
chr1,84619307,84619900,SRX5075176,SMARCA4,593
chr1,84619316,84619777,SRX5075174,SMARCA4,461
chr1,84619360,84619709,SRX5075168,SMARCA4,349
chr1,84619367,84620005,SRX5075175,SMARCA4,638
chr1,84619402,84619867,SRX5075169,SMARCA4,465
chr1,84619404,84619861,SRX5716470,SMARCA4,457
chr1,84619410,84619718,SRX5054309,FOSL2,308
chr1,84619424,84619703,SRX5716467,SMARCA2,279
chr1,84619427,84619637,SRX5054308,FOSL2,210
chr1,84620665,84621322,SRX16500061,CTCF,657
chr1,84620686,84621317,SRX16500059,CTCF,631
chr1,84620714,84621267,SRX16500062,CTCF,553
chr1,84620715,84621270,SRX4174629,CTCF,555
chr1,84620744,84621304,SRX16500060,CTCF,560
chr1,84620816,84621182,SRX5075176,SMARCA4,366
chr1,84620889,84621177,SRX5075170,SMARCA4,288
chr1,84632813,84633179,SRX5716460,Epitope tags,366
chr1,84632824,84633302,SRX5075176,SMARCA4,478
chr1,84632830,84633368,SRX5075170,SMARCA4,538
chr1,84632893,84633364,SRX5075169,SMARCA4,471
chr1,84632895,84633243,SRX5716469,SMARCA4,348
chr1,84632900,84633314,SRX5716470,SMARCA4,414
chr1,84632926,84633412,SRX5075175,SMARCA4,486
chr1,84632927,84633300,SRX5075168,SMARCA4,373
chr1,84632930,84633309,SRX5075174,SMARCA4,379
chr1,84632943,84633273,SRX5054308,FOSL2,330
chr1,84632945,84633303,SRX5054309,FOSL2,358
chr1,84632961,84633161,SRX5020211,SMARCA2,200
chr1,84632964,84633244,SRX5716467,SMARCA2,280
chr1,84689799,84690074,SRX5075174,SMARCA4,275
chr1,84689878,84690113,SRX16500059,CTCF,235
chr1,84689887,84690948,SRX20140895,INTS13,1061
chr1,84689889,84690064,SRX5075176,SMARCA4,175
chr1,84689913,84690197,SRX5075175,SMARCA4,284
chr1,84690133,84690919,SRX20140868,INTS10,786
chr1,84690196,84690789,SRX20140867,INTS10,593
chr1,84690201,84690494,SRX5075169,SMARCA4,293
chr1,84690217,84690894,SRX5075174,SMARCA4,677
chr1,84690220,84690885,SRX5075168,SMARCA4,665
chr1,84690282,84690872,SRX5075170,SMARCA4,590
chr1,84690295,84690869,SRX5075176,SMARCA4,574
chr1,84690422,84690876,SRX5075175,SMARCA4,454
chr1,84690529,84690885,SRX5054307,FOSL2,356
chr1,84690558,84690828,SRX5075169,SMARCA4,270
chr1,84690569,84690857,SRX5054309,FOSL2,288
chr1,84690588,84690870,SRX20140879,CPSF3L,282
chr1,84690638,84690918,SRX5054308,FOSL2,280
chr1,84698110,84698568,SRX5075176,SMARCA4,458
chr1,84698119,84698593,SRX5075170,SMARCA4,474
chr1,84698166,84698430,SRX5716470,SMARCA4,264
chr1,84698168,84698953,SRX5075169,SMARCA4,785
chr1,84698182,84698551,SRX5716469,SMARCA4,369
chr1,84698193,84698569,SRX5075175,SMARCA4,376
chr1,84698214,84698515,SRX5054308,FOSL2,301
chr1,84698219,84698458,SRX5716467,SMARCA2,239
chr1,84698222,84698501,SRX5054309,FOSL2,279
chr1,84698226,84698421,SRX5075168,SMARCA4,195
chr1,84698387,84698797,SRX5716460,Epitope tags,410
chr1,84698624,84699008,SRX5075176,SMARCA4,384
chr1,84698650,84699012,SRX5075170,SMARCA4,362
chr1,84698682,84698973,SRX5054309,FOSL2,291
chr1,84698742,84699001,SRX5075175,SMARCA4,259
chr1,84712267,84712598,SRX5075169,SMARCA4,331
chr1,84712275,84712597,SRX5054308,FOSL2,322
chr1,84712306,84712595,SRX5054309,FOSL2,289
chr1,84712344,84712568,SRX5075170,SMARCA4,224
chr1,84712355,84712594,SRX5075176,SMARCA4,239
chr1,84715640,84716080,SRX5075174,SMARCA4,440
chr1,84715807,84716126,SRX20140895,INTS13,319
chr1,84715820,84716221,SRX5075168,SMARCA4,401
chr1,84715844,84716052,SRX5716454,SOX3,208
chr1,84715856,84716109,SRX5716451,SOX2,253
chr1,84715874,84716107,SRX5716463,SMARCA4,233
chr1,84720321,84720604,SRX20140868,INTS10,283
chr1,84720413,84720681,SRX20140895,INTS13,268
chr1,84721191,84721447,SRX5054309,FOSL2,256
chr1,84724405,84724628,SRX16500062,CTCF,223
chr1,84724407,84724673,SRX16500059,CTCF,266
chr1,84724426,84724687,SRX16500060,CTCF,261
chr1,84727749,84728165,SRX5075170,SMARCA4,416
chr1,84727768,84728175,SRX5075176,SMARCA4,407
chr1,84750056,84750375,SRX5716464,SMARCA4,319
chr1,84750090,84750304,SRX5075174,SMARCA4,214
chr1,84753492,84753968,SRX16500059,CTCF,476
chr1,84753500,84753980,SRX16500060,CTCF,480
chr1,84753505,84753935,SRX16500062,CTCF,430
chr1,84753524,84753957,SRX16500061,CTCF,433
chr1,84753527,84753859,SRX4174629,CTCF,332
chr1,84753563,84753820,SRX5075170,SMARCA4,257
chr1,84753573,84753777,SRX5075168,SMARCA4,204
chr1,84753587,84753800,SRX5075174,SMARCA4,213
chr1,84753603,84753817,SRX5075176,SMARCA4,214
chr1,84772249,84772783,SRX16500061,CTCF,534
chr1,84772261,84772761,SRX16500059,CTCF,500
chr1,84772278,84772741,SRX16500062,CTCF,463
chr1,84772294,84772802,SRX16500060,CTCF,508
chr1,84772332,84772680,SRX5075168,SMARCA4,348
chr1,84772346,84772661,SRX5075174,SMARCA4,315
chr1,84772372,84772670,SRX4174629,CTCF,298
chr1,84772386,84772624,SRX5075175,SMARCA4,238
chr1,84772388,84772710,SRX5075176,SMARCA4,322
chr1,84772421,84772691,SRX5075170,SMARCA4,270
chr1,84772449,84772638,SRX5075169,SMARCA4,189
chr1,84782415,84782860,SRX16500060,CTCF,445
chr1,84782434,84782810,SRX16500061,CTCF,376
chr1,84782481,84782821,SRX16500059,CTCF,340
chr1,84782497,84782713,SRX5075174,SMARCA4,216
chr1,84782537,84782793,SRX16500062,CTCF,256
chr1,84834412,84834759,SRX5075176,SMARCA4,347
chr1,84834419,84834774,SRX5075170,SMARCA4,355
chr1,84834467,84834780,SRX5075169,SMARCA4,313
chr1,84834472,84834765,SRX5716469,SMARCA4,293
chr1,84834482,84834674,SRX5075175,SMARCA4,192
chr1,84834508,84834757,SRX5716470,SMARCA4,249
chr1,84834513,84834696,SRX5054309,FOSL2,183
chr1,84846474,84846721,SRX5075169,SMARCA4,247
chr1,84847162,84847687,SRX5716470,SMARCA4,525
chr1,84847203,84847622,SRX5075170,SMARCA4,419
chr1,84847236,84847606,SRX5075176,SMARCA4,370
chr1,84847237,84847557,SRX5075175,SMARCA4,320
chr1,84847291,84847548,SRX5716467,SMARCA2,257
chr1,84847292,84847627,SRX5075169,SMARCA4,335
chr1,84847311,84847605,SRX5716469,SMARCA4,294
chr1,84883398,84883577,SRX5075176,SMARCA4,179
chr1,84883409,84883606,SRX5075170,SMARCA4,197
chr1,84892974,84893326,SRX5075174,SMARCA4,352
chr1,84893033,84893374,SRX5075168,SMARCA4,341
chr1,84936129,84936443,SRX4174629,CTCF,314
chr1,84936170,84936659,SRX16500059,CTCF,489
chr1,84936175,84936655,SRX16500061,CTCF,480
chr1,84936187,84936614,SRX16500062,CTCF,427
chr1,84936206,84936542,SRX5075174,SMARCA4,336
chr1,84936206,84936674,SRX16500060,CTCF,468
chr1,84936217,84936422,SRX5716464,SMARCA4,205
chr1,84936233,84936502,SRX5075170,SMARCA4,269
chr1,84936243,84936537,SRX5075168,SMARCA4,294
chr1,84936274,84936497,SRX5075169,SMARCA4,223
chr1,84936289,84936547,SRX5075176,SMARCA4,258
chr1,84936321,84936527,SRX5716463,SMARCA4,206
chr1,84944669,84945354,SRX16500059,CTCF,685
chr1,84944685,84945357,SRX4174629,CTCF,672
chr1,84944690,84945358,SRX16500060,CTCF,668
chr1,84944698,84945326,SRX16500062,CTCF,628
chr1,84944716,84945344,SRX5075174,SMARCA4,628
chr1,84944737,84945338,SRX16500061,CTCF,601
chr1,84944791,84945341,SRX5075168,SMARCA4,550
chr1,84944844,84945307,SRX5716463,SMARCA4,463
chr1,84944844,84945345,SRX5075170,SMARCA4,501
chr1,84944863,84945384,SRX5075176,SMARCA4,521
chr1,84944882,84945401,SRX5075175,SMARCA4,519
chr1,84944934,84945432,SRX5716470,SMARCA4,498
chr1,84944995,84945368,SRX5075169,SMARCA4,373
chr1,84945076,84945318,SRX5716464,SMARCA4,242
chr1,84945174,84945492,SRX5716469,SMARCA4,318
chr1,84946011,84946328,SRX5054309,FOSL2,317
chr1,84996962,84997282,SRX5075174,SMARCA4,320
chr1,84997007,84997182,SRX5075176,SMARCA4,175
chr1,84997009,84997254,SRX5075168,SMARCA4,245
chr1,84999097,84999347,SRX5054309,FOSL2,250
chr1,85019969,85020211,SRX5716464,SMARCA4,242
chr1,85020000,85020290,SRX5716463,SMARCA4,290
chr1,85020083,85020323,SRX5075174,SMARCA4,240
chr1,85027866,85028087,SRX16500060,CTCF,221
chr1,85061672,85061975,SRX5054308,FOSL2,303
chr1,85061679,85062063,SRX5075169,SMARCA4,384
chr1,85061689,85061948,SRX5054309,FOSL2,259
chr1,85061702,85062151,SRX5716469,SMARCA4,449
chr1,85061740,85062095,SRX5075170,SMARCA4,355
chr1,85061752,85061973,SRX5716467,SMARCA2,221
chr1,85061756,85062090,SRX5075176,SMARCA4,334
chr1,85061761,85062007,SRX5075175,SMARCA4,246
chr1,85061780,85062139,SRX5716470,SMARCA4,359
chr1,85061953,85062458,SRX5075174,SMARCA4,505
chr1,85062153,85062477,SRX5075170,SMARCA4,324
chr1,85062170,85062524,SRX5075168,SMARCA4,354
chr1,85091796,85092063,SRX5075170,SMARCA4,267
chr1,85091893,85092122,SRX5054308,FOSL2,229
chr1,85109376,85109781,SRX16500061,CTCF,405
chr1,85109380,85109832,SRX16500059,CTCF,452
chr1,85109381,85109793,SRX16500062,CTCF,412
chr1,85109384,85109889,SRX16500060,CTCF,505
chr1,85109429,85109699,SRX5075174,SMARCA4,270
chr1,85109438,85109704,SRX4174629,CTCF,266
chr1,85109465,85109679,SRX5075168,SMARCA4,214
chr1,85128417,85128709,SRX5075175,SMARCA4,292
chr1,85128459,85128786,SRX5075169,SMARCA4,327
chr1,85128468,85128671,SRX5054308,FOSL2,203
chr1,85147087,85147314,SRX5716470,SMARCA4,227
chr1,85147167,85147347,SRX5075169,SMARCA4,180
chr1,85178442,85178753,SRX5075174,SMARCA4,311
chr1,85178460,85178679,SRX5075168,SMARCA4,219
chr1,85178498,85178740,SRX5716463,SMARCA4,242
chr1,85200793,85201966,SRX20140895,INTS13,1173
chr1,85201274,85201939,SRX20140868,INTS10,665
chr1,85201304,85201930,SRX5716469,SMARCA4,626
chr1,85201334,85201877,SRX20140881,CPSF3L,543
chr1,85201367,85201912,SRX5075169,SMARCA4,545
chr1,85201386,85201940,SRX20140867,INTS10,554
chr1,85201422,85201801,SRX20140869,INTS10,379
chr1,85201460,85201921,SRX20140897,INTS13,461
chr1,85201463,85201894,SRX5075175,SMARCA4,431
chr1,85201464,85201814,SRX20140896,INTS13,350
chr1,85201473,85201872,SRX20140879,CPSF3L,399
chr1,85201514,85202022,SRX5075174,SMARCA4,508
chr1,85201521,85201911,SRX5716463,SMARCA4,390
chr1,85201527,85201912,SRX5075176,SMARCA4,385
chr1,85201540,85201993,SRX5716470,SMARCA4,453
chr1,85201557,85201977,SRX5075168,SMARCA4,420
chr1,85201606,85201931,SRX5075170,SMARCA4,325
chr1,85201623,85201976,SRX5716464,SMARCA4,353
chr1,85225835,85226267,SRX5075168,SMARCA4,432
chr1,85225875,85226078,SRX5716451,SOX2,203
chr1,85225911,85226302,SRX5075174,SMARCA4,391
chr1,85225935,85226245,SRX5716463,SMARCA4,310
chr1,85244166,85244484,SRX5075176,SMARCA4,318
chr1,85254731,85255170,SRX16500059,CTCF,439
chr1,85254732,85255125,SRX16500060,CTCF,393
chr1,85254733,85255116,SRX16500061,CTCF,383
chr1,85254739,85255136,SRX16500062,CTCF,397
chr1,85254830,85254999,SRX5075170,SMARCA4,169
chr1,85259338,85259870,SRX20140895,INTS13,532
chr1,85259458,85259858,SRX20140881,CPSF3L,400
chr1,85259482,85259976,SRX5075168,SMARCA4,494
chr1,85259500,85259842,SRX20140867,INTS10,342
chr1,85259516,85260008,SRX16500061,CTCF,492
chr1,85259523,85260084,SRX16500059,CTCF,561
chr1,85259539,85259940,SRX5716464,SMARCA4,401
chr1,85259546,85260009,SRX16500060,CTCF,463
chr1,85259561,85259840,SRX5054307,FOSL2,279
chr1,85259563,85259824,SRX20140879,CPSF3L,261
chr1,85259572,85260007,SRX16500062,CTCF,435
chr1,85259605,85259961,SRX5075174,SMARCA4,356
chr1,85259622,85259812,SRX5716451,SOX2,190
chr1,85259638,85260212,SRX5075170,SMARCA4,574
chr1,85259645,85259941,SRX4174629,CTCF,296
chr1,85259647,85259895,SRX5054309,FOSL2,248
chr1,85259667,85259972,SRX5716470,SMARCA4,305
chr1,85259678,85260044,SRX5075176,SMARCA4,366
chr1,85259684,85259992,SRX5075169,SMARCA4,308
chr1,85259740,85259948,SRX5716463,SMARCA4,208
chr1,85275201,85275434,SRX5075176,SMARCA4,233
chr1,85275230,85275487,SRX5054309,FOSL2,257
chr1,85275237,85275466,SRX5075169,SMARCA4,229
chr1,85275253,85275454,SRX5075170,SMARCA4,201
chr1,85275261,85275475,SRX5054308,FOSL2,214
chr1,85276087,85276866,SRX5075174,SMARCA4,779
chr1,85276151,85276581,SRX20140881,CPSF3L,430
chr1,85276153,85276602,SRX20140895,INTS13,449
chr1,85276195,85276571,SRX20140867,INTS10,376
chr1,85276215,85276478,SRX20140879,CPSF3L,263
chr1,85276223,85276562,SRX20140897,INTS13,339
chr1,85276278,85276630,SRX20140868,INTS10,352
chr1,85276329,85276961,SRX5716463,SMARCA4,632
chr1,85276337,85276686,SRX5075170,SMARCA4,349
chr1,85276417,85276780,SRX5716451,SOX2,363
chr1,85276437,85277023,SRX5075168,SMARCA4,586
chr1,85276567,85276886,SRX5054307,FOSL2,319
chr1,85276603,85276934,SRX5075176,SMARCA4,331
chr1,85278850,85279235,SRX5075170,SMARCA4,385
chr1,85278851,85279172,SRX5075175,SMARCA4,321
chr1,85278885,85279217,SRX5075176,SMARCA4,332
chr1,85278894,85279225,SRX5054309,FOSL2,331
chr1,85278903,85279232,SRX5075169,SMARCA4,329
chr1,85278904,85279227,SRX5054308,FOSL2,323
chr1,85278946,85279125,SRX5075182,SMARCA2,179
chr1,85289480,85289813,SRX5054308,FOSL2,333
chr1,85289490,85289807,SRX5075169,SMARCA4,317
chr1,85289506,85289874,SRX5075175,SMARCA4,368
chr1,85289511,85289819,SRX5716469,SMARCA4,308
chr1,85289512,85289920,SRX5075176,SMARCA4,408
chr1,85289539,85289856,SRX5075170,SMARCA4,317
chr1,85289562,85289860,SRX5054309,FOSL2,298
chr1,85295098,85295418,SRX5075170,SMARCA4,320
chr1,85297746,85298264,SRX5075170,SMARCA4,518
chr1,85297776,85298352,SRX5075176,SMARCA4,576
chr1,85297783,85298232,SRX5075169,SMARCA4,449
chr1,85297788,85298257,SRX5075175,SMARCA4,469
chr1,85297823,85298264,SRX5054309,FOSL2,441
chr1,85297835,85298210,SRX5716469,SMARCA4,375
chr1,85297839,85298193,SRX5716468,SMARCA2,354
chr1,85297853,85298198,SRX5716467,SMARCA2,345
chr1,85297853,85298266,SRX5054308,FOSL2,413
chr1,85297862,85298105,SRX5716470,SMARCA4,243
chr1,85297889,85298201,SRX5075181,SMARCA2,312
chr1,85297899,85298136,SRX5020211,SMARCA2,237
chr1,85297953,85298220,SRX5020214,SMARCA2,267
chr1,85297995,85298247,SRX5075168,SMARCA4,252
chr1,85308021,85308742,SRX4174629,CTCF,721
chr1,85308044,85308565,SRX16500062,CTCF,521
chr1,85308074,85308611,SRX16500059,CTCF,537
chr1,85308093,85308607,SRX16500060,CTCF,514
chr1,85308095,85308563,SRX16500061,CTCF,468
chr1,85308172,85308529,SRX5075170,SMARCA4,357
chr1,85308174,85308535,SRX5075168,SMARCA4,361
chr1,85308208,85308518,SRX5075169,SMARCA4,310
chr1,85308230,85308527,SRX5075176,SMARCA4,297
chr1,85308235,85308486,SRX5716463,SMARCA4,251
chr1,85308239,85308544,SRX5075174,SMARCA4,305
chr1,85308246,85308541,SRX5716470,SMARCA4,295
chr1,85308346,85308534,SRX5075175,SMARCA4,188
chr1,85313889,85314295,SRX5075170,SMARCA4,406
chr1,85313895,85314310,SRX5716469,SMARCA4,415
chr1,85313903,85314323,SRX5075176,SMARCA4,420
chr1,85313940,85314342,SRX5075169,SMARCA4,402
chr1,85313942,85314330,SRX5716470,SMARCA4,388
chr1,85313965,85314312,SRX5054309,FOSL2,347
chr1,85313986,85314311,SRX5075175,SMARCA4,325
chr1,85313992,85314305,SRX5054308,FOSL2,313
chr1,85320387,85320631,SRX5054309,FOSL2,244
chr1,85320453,85320637,SRX5054308,FOSL2,184
chr1,85320467,85320656,SRX5075169,SMARCA4,189
chr1,85328852,85329402,SRX5075174,SMARCA4,550
chr1,85328865,85329439,SRX5075168,SMARCA4,574
chr1,85328889,85329292,SRX5054308,FOSL2,403
chr1,85328896,85329363,SRX5075176,SMARCA4,467
chr1,85328912,85329266,SRX5716469,SMARCA4,354
chr1,85328913,85329337,SRX5054309,FOSL2,424
chr1,85328921,85329360,SRX5075170,SMARCA4,439
chr1,85328923,85329288,SRX5075169,SMARCA4,365
chr1,85328930,85329288,SRX5075175,SMARCA4,358
chr1,85328949,85329329,SRX5716463,SMARCA4,380
chr1,85328999,85329292,SRX5020214,SMARCA2,293
chr1,85329004,85329240,SRX5716470,SMARCA4,236
chr1,85329008,85329213,SRX5716464,SMARCA4,205
chr1,85329022,85329237,SRX5716467,SMARCA2,215
chr1,85329024,85329280,SRX5054307,FOSL2,256
chr1,85330910,85331268,SRX5075169,SMARCA4,358
chr1,85330936,85331287,SRX5075170,SMARCA4,351
chr1,85330988,85331315,SRX5075175,SMARCA4,327
chr1,85330994,85331329,SRX5075176,SMARCA4,335
chr1,85331018,85331232,SRX5716470,SMARCA4,214
chr1,85343592,85344584,SRX5075168,SMARCA4,992
chr1,85343596,85344129,SRX5075175,SMARCA4,533
chr1,85343636,85344149,SRX5075169,SMARCA4,513
chr1,85343639,85344149,SRX5020211,SMARCA2,510
chr1,85343643,85343940,SRX5716460,Epitope tags,297
chr1,85343667,85344496,SRX5075174,SMARCA4,829
chr1,85343691,85344097,SRX5716467,SMARCA2,406
chr1,85343710,85344179,SRX5075176,SMARCA4,469
chr1,85343710,85344436,SRX5054309,FOSL2,726
chr1,85343713,85344201,SRX5020214,SMARCA2,488
chr1,85343718,85344166,SRX5054308,FOSL2,448
chr1,85343750,85344153,SRX5716469,SMARCA4,403
chr1,85343752,85344108,SRX5075170,SMARCA4,356
chr1,85343776,85344141,SRX5716470,SMARCA4,365
chr1,85343876,85344116,SRX5716463,SMARCA4,240
chr1,85343913,85344110,SRX5716451,SOX2,197
chr1,85344041,85344542,SRX16500061,CTCF,501
chr1,85344226,85344563,SRX16500060,CTCF,337
chr1,85344227,85344534,SRX16500059,CTCF,307
chr1,85344270,85344521,SRX16500062,CTCF,251
chr1,85344378,85344597,SRX5716469,SMARCA4,219
chr1,85356032,85356535,SRX5075168,SMARCA4,503
chr1,85356088,85356545,SRX5075174,SMARCA4,457
chr1,85356193,85356436,SRX5716464,SMARCA4,243
chr1,85360182,85360415,SRX5054308,FOSL2,233
chr1,85361118,85361516,SRX5075169,SMARCA4,398
chr1,85361131,85361452,SRX5716469,SMARCA4,321
chr1,85361153,85361412,SRX5075175,SMARCA4,259
chr1,85361170,85361384,SRX5075176,SMARCA4,214
chr1,85361193,85361467,SRX5020211,SMARCA2,274
chr1,85361268,85361528,SRX5054308,FOSL2,260
chr1,85366438,85366826,SRX5075170,SMARCA4,388
chr1,85366442,85366789,SRX5075169,SMARCA4,347
chr1,85366445,85366805,SRX5075176,SMARCA4,360
chr1,85366448,85366867,SRX5054309,FOSL2,419
chr1,85366449,85366776,SRX5054308,FOSL2,327
chr1,85366486,85366754,SRX5075175,SMARCA4,268
chr1,85366537,85366749,SRX5716469,SMARCA4,212
chr1,85372791,85372991,SRX5075169,SMARCA4,200
chr1,85375250,85375752,SRX5075174,SMARCA4,502
chr1,85375308,85375802,SRX5075168,SMARCA4,494
chr1,85393624,85393874,SRX5075168,SMARCA4,250
chr1,85406975,85407615,SRX5716469,SMARCA4,640
chr1,85407041,85407575,SRX5075169,SMARCA4,534
chr1,85407050,85407490,SRX5716467,SMARCA2,440
chr1,85407056,85407569,SRX5075176,SMARCA4,513
chr1,85407075,85407567,SRX5075170,SMARCA4,492
chr1,85407077,85407885,SRX5075168,SMARCA4,808
chr1,85407080,85407609,SRX5716470,SMARCA4,529
chr1,85407094,85407605,SRX5075174,SMARCA4,511
chr1,85407100,85407517,SRX5716460,Epitope tags,417
chr1,85407115,85407568,SRX5054308,FOSL2,453
chr1,85407120,85407543,SRX5075175,SMARCA4,423
chr1,85407139,85407582,SRX5716463,SMARCA4,443
chr1,85407146,85407478,SRX5716464,SMARCA4,332
chr1,85407156,85407559,SRX5054309,FOSL2,403
chr1,85407162,85407518,SRX5020211,SMARCA2,356
chr1,85407193,85407498,SRX5020214,SMARCA2,305
chr1,85407199,85407619,SRX5716451,SOX2,420
chr1,85407208,85407537,SRX5716468,SMARCA2,329
chr1,85407229,85407422,SRX5054307,FOSL2,193
chr1,85407861,85408115,SRX5075174,SMARCA4,254
chr1,85411548,85411940,SRX20140881,CPSF3L,392
chr1,85413329,85413582,SRX5075176,SMARCA4,253
chr1,85413347,85413547,SRX5075170,SMARCA4,200
chr1,85438390,85438724,SRX5075176,SMARCA4,334
chr1,85438394,85438752,SRX5075174,SMARCA4,358
chr1,85438421,85438710,SRX5075168,SMARCA4,289
chr1,85438431,85438688,SRX5075170,SMARCA4,257
chr1,85464391,85464768,SRX5075174,SMARCA4,377
chr1,85464506,85464728,SRX5075176,SMARCA4,222
chr1,85464520,85465433,SRX20140895,INTS13,913
chr1,85464557,85464861,SRX5075170,SMARCA4,304
chr1,85464697,85464934,SRX5716469,SMARCA4,237
chr1,85464717,85465127,SRX20140868,INTS10,410
chr1,85464850,85465317,SRX20140867,INTS10,467
chr1,85465131,85465340,SRX5075176,SMARCA4,209
chr1,85465145,85465341,SRX5075174,SMARCA4,196
chr1,85465180,85465390,SRX5075168,SMARCA4,210
chr1,85465201,85465449,SRX5075170,SMARCA4,248
chr1,85494951,85495146,SRX5075170,SMARCA4,195
chr1,85494963,85495157,SRX5075176,SMARCA4,194
chr1,85495626,85495813,SRX5075175,SMARCA4,187
chr1,85502771,85503293,SRX16500059,CTCF,522
chr1,85502779,85503329,SRX16500060,CTCF,550
chr1,85502786,85503179,SRX16500061,CTCF,393
chr1,85502803,85503157,SRX16500062,CTCF,354
chr1,85502836,85503032,SRX5075174,SMARCA4,196
chr1,85520771,85521208,SRX5075170,SMARCA4,437
chr1,85520792,85521164,SRX5075175,SMARCA4,372
chr1,85520843,85521164,SRX5054309,FOSL2,321
chr1,85520853,85521133,SRX5075176,SMARCA4,280
chr1,85520899,85521159,SRX5054308,FOSL2,260
chr1,85520935,85521150,SRX5716467,SMARCA2,215
chr1,85521468,85521829,SRX5075175,SMARCA4,361
chr1,85521497,85521715,SRX5716469,SMARCA4,218
chr1,85521498,85521758,SRX5054309,FOSL2,260
chr1,85521502,85521731,SRX5716470,SMARCA4,229
chr1,85521502,85521800,SRX5075168,SMARCA4,298
chr1,85521511,85521749,SRX5075174,SMARCA4,238
chr1,85521513,85521775,SRX5075169,SMARCA4,262
chr1,85521525,85521778,SRX5075170,SMARCA4,253
chr1,85521526,85521784,SRX5075176,SMARCA4,258
chr1,85527072,85527667,SRX5075174,SMARCA4,595
chr1,85527095,85527714,SRX5075168,SMARCA4,619
chr1,85527117,85527486,SRX5075169,SMARCA4,369
chr1,85527120,85527680,SRX20140895,INTS13,560
chr1,85527125,85527616,SRX5716464,SMARCA4,491
chr1,85527141,85527633,SRX5716463,SMARCA4,492
chr1,85527166,85527572,SRX5075170,SMARCA4,406
chr1,85527200,85527490,SRX5716454,SOX3,290
chr1,85527215,85527428,SRX5075175,SMARCA4,213
chr1,85527234,85527505,SRX5716470,SMARCA4,271
chr1,85527236,85527532,SRX20140868,INTS10,296
chr1,85527240,85527520,SRX20140867,INTS10,280
chr1,85527242,85527465,SRX5075176,SMARCA4,223
chr1,85527263,85527494,SRX5054308,FOSL2,231
chr1,85527273,85527527,SRX5716451,SOX2,254
chr1,85527303,85527541,SRX5020214,SMARCA2,238
chr1,85534691,85534908,SRX5075169,SMARCA4,217
chr1,85544881,85545092,SRX5716470,SMARCA4,211
chr1,85545074,85545272,SRX5075169,SMARCA4,198
chr1,85553916,85554255,SRX5075174,SMARCA4,339
chr1,85554017,85554317,SRX5075168,SMARCA4,300
chr1,85569164,85569466,SRX5075170,SMARCA4,302
chr1,85569190,85569507,SRX5075176,SMARCA4,317
chr1,85569198,85569485,SRX5054309,FOSL2,287
chr1,85569200,85569477,SRX5054308,FOSL2,277
chr1,85569227,85569466,SRX5075169,SMARCA4,239
chr1,85569234,85569477,SRX5075175,SMARCA4,243
chr1,85569241,85569440,SRX5075174,SMARCA4,199
chr1,85576651,85577041,SRX20140868,INTS10,390
chr1,85576655,85577153,SRX20140895,INTS13,498
chr1,85576851,85577185,SRX20140867,INTS10,334
chr1,85576906,85577417,SRX16500060,CTCF,511
chr1,85576915,85577376,SRX16500059,CTCF,461
chr1,85576919,85577352,SRX16500062,CTCF,433
chr1,85576947,85577310,SRX16500061,CTCF,363
chr1,85576975,85577242,SRX5075170,SMARCA4,267
chr1,85577023,85577299,SRX5075174,SMARCA4,276
chr1,85577033,85577238,SRX5716464,SMARCA4,205
chr1,85577039,85577305,SRX5075176,SMARCA4,266
chr1,85577140,85577327,SRX5075175,SMARCA4,187
chr1,85578395,85578733,SRX5075176,SMARCA4,338
chr1,85578459,85578750,SRX5716470,SMARCA4,291
chr1,85578493,85578699,SRX5075169,SMARCA4,206
chr1,85578539,85578836,SRX5054309,FOSL2,297
chr1,85578568,85578821,SRX5054308,FOSL2,253
chr1,85580581,85581481,SRX20140895,INTS13,900
chr1,85580615,85581073,SRX20140896,INTS13,458
chr1,85580620,85581108,SRX20140867,INTS10,488
chr1,85580634,85581021,SRX20140897,INTS13,387
chr1,85580634,85581101,SRX20140868,INTS10,467
chr1,85580649,85581049,SRX20140879,CPSF3L,400
chr1,85580691,85581130,SRX20140881,CPSF3L,439
chr1,85580726,85581040,SRX20140894,INTS13,314
chr1,85580729,85581064,SRX20140880,CPSF3L,335
chr1,85580734,85581062,SRX20140869,INTS10,328
chr1,85581201,85581586,SRX16500059,CTCF,385
chr1,85581202,85581529,SRX16500062,CTCF,327
chr1,85581230,85581572,SRX16500060,CTCF,342
chr1,85581249,85581572,SRX16500061,CTCF,323
chr1,85582429,85582708,SRX16500059,CTCF,279
chr1,85582468,85582701,SRX16500060,CTCF,233
chr1,85582472,85582748,SRX16500062,CTCF,276
chr1,85582475,85582778,SRX16500061,CTCF,303
chr1,85584145,85584638,SRX20140881,CPSF3L,493
chr1,85584204,85584610,SRX5075174,SMARCA4,406
chr1,85584327,85584583,SRX5716463,SMARCA4,256
chr1,85584334,85584547,SRX5716454,SOX3,213
chr1,85584339,85584522,SRX5054309,FOSL2,183
chr1,85584414,85584608,SRX5075168,SMARCA4,194
chr1,85607037,85607794,SRX5075174,SMARCA4,757
chr1,85607060,85607773,SRX5075169,SMARCA4,713
chr1,85607080,85607718,SRX5075175,SMARCA4,638
chr1,85607098,85607785,SRX5075176,SMARCA4,687
chr1,85607101,85607734,SRX5054309,FOSL2,633
chr1,85607102,85607713,SRX5054308,FOSL2,611
chr1,85607127,85607673,SRX5716469,SMARCA4,546
chr1,85607136,85607778,SRX5075168,SMARCA4,642
chr1,85607153,85607728,SRX5716470,SMARCA4,575
chr1,85607180,85607558,SRX5075181,SMARCA2,378
chr1,85607182,85607705,SRX5075170,SMARCA4,523
chr1,85607185,85607565,SRX20140867,INTS10,380
chr1,85607188,85607641,SRX20140881,CPSF3L,453
chr1,85607212,85607751,SRX5716463,SMARCA4,539
chr1,85607253,85607628,SRX5020211,SMARCA2,375
chr1,85607278,85607696,SRX5716468,SMARCA2,418
chr1,85607287,85607709,SRX5716467,SMARCA2,422
chr1,85607293,85607672,SRX5716464,SMARCA4,379
chr1,85607297,85607613,SRX5020214,SMARCA2,316
chr1,85607320,85607655,SRX5054307,FOSL2,335
chr1,85607372,85607606,SRX5716454,SOX3,234
chr1,85607400,85607611,SRX5716451,SOX2,211
chr1,85611954,85612291,SRX5716469,SMARCA4,337
chr1,85611963,85612326,SRX5075176,SMARCA4,363
chr1,85611963,85612346,SRX5716470,SMARCA4,383
chr1,85611979,85612283,SRX5075169,SMARCA4,304
chr1,85611983,85612318,SRX5075170,SMARCA4,335
chr1,85612017,85612329,SRX5075175,SMARCA4,312
chr1,85612685,85612896,SRX5716470,SMARCA4,211
chr1,85612737,85613102,SRX5075169,SMARCA4,365
chr1,85612782,85613100,SRX5075175,SMARCA4,318
chr1,85623075,85623381,SRX5054309,FOSL2,306
chr1,85623076,85623393,SRX5054308,FOSL2,317
chr1,85623211,85623477,SRX5075169,SMARCA4,266
chr1,85628686,85629023,SRX5054309,FOSL2,337
chr1,85628695,85629424,SRX5075170,SMARCA4,729
chr1,85628697,85629301,SRX5075176,SMARCA4,604
chr1,85628705,85629280,SRX5075175,SMARCA4,575
chr1,85628737,85628952,SRX5716467,SMARCA2,215
chr1,85628739,85628995,SRX5716468,SMARCA2,256
chr1,85628739,85629037,SRX5716469,SMARCA4,298
chr1,85628745,85629009,SRX5054308,FOSL2,264
chr1,85628751,85629310,SRX5716470,SMARCA4,559
chr1,85628760,85629477,SRX5075169,SMARCA4,717
chr1,85628788,85629058,SRX5075174,SMARCA4,270
chr1,85654400,85654750,SRX5054309,FOSL2,350
chr1,85654408,85654694,SRX5054308,FOSL2,286
chr1,85654441,85654733,SRX5075174,SMARCA4,292
chr1,85654477,85654710,SRX5075169,SMARCA4,233
chr1,85654489,85654676,SRX5075175,SMARCA4,187
chr1,85654500,85654751,SRX5075176,SMARCA4,251
chr1,85654510,85654707,SRX5075168,SMARCA4,197
chr1,85654518,85654716,SRX5075170,SMARCA4,198
chr1,85659857,85660051,SRX5075170,SMARCA4,194
chr1,85681020,85681450,SRX5075168,SMARCA4,430
chr1,85681021,85681480,SRX5075174,SMARCA4,459
chr1,85681075,85681403,SRX5075169,SMARCA4,328
chr1,85681096,85681345,SRX5075170,SMARCA4,249
chr1,85681096,85681385,SRX5716463,SMARCA4,289
chr1,85681102,85681345,SRX5075176,SMARCA4,243
chr1,85681150,85681365,SRX5054308,FOSL2,215
chr1,85681163,85681390,SRX5716470,SMARCA4,227
chr1,85681171,85681398,SRX5716469,SMARCA4,227
chr1,85681180,85681370,SRX5716451,SOX2,190
chr1,85681201,85681490,SRX5716467,SMARCA2,289
chr1,85681206,85681411,SRX5716454,SOX3,205
chr1,85692703,85693095,SRX16500059,CTCF,392
chr1,85692752,85693065,SRX16500060,CTCF,313
chr1,85692766,85693013,SRX16500062,CTCF,247
chr1,85692768,85693045,SRX16500061,CTCF,277
chr1,85692775,85692988,SRX5075170,SMARCA4,213
chr1,85692822,85693007,SRX5075176,SMARCA4,185
chr1,85708115,85708740,SRX5075176,SMARCA4,625
chr1,85708136,85708729,SRX5716470,SMARCA4,593
chr1,85708162,85708825,SRX20140895,INTS13,663
chr1,85708221,85708751,SRX20140869,INTS10,530
chr1,85708250,85708742,SRX5075168,SMARCA4,492
chr1,85708255,85708827,SRX5075174,SMARCA4,572
chr1,85708260,85708724,SRX5075170,SMARCA4,464
chr1,85708271,85708477,SRX5075169,SMARCA4,206
chr1,85708282,85708544,SRX20140897,INTS13,262
chr1,85708309,85708605,SRX5716463,SMARCA4,296
chr1,85708345,85708833,SRX16500062,CTCF,488
chr1,85708376,85708886,SRX16500060,CTCF,510
chr1,85708387,85708633,SRX5716467,SMARCA2,246
chr1,85708389,85708952,SRX16500059,CTCF,563
chr1,85708451,85708732,SRX20140867,INTS10,281
chr1,85708458,85708714,SRX5054309,FOSL2,256
chr1,85708493,85708837,SRX16500061,CTCF,344
chr1,85708513,85708742,SRX5075175,SMARCA4,229
chr1,85708550,85708786,SRX5716469,SMARCA4,236
chr1,85818587,85818771,SRX5075169,SMARCA4,184
chr1,85822816,85823040,SRX5075181,SMARCA2,224
chr1,85850140,85850595,SRX5075175,SMARCA4,455
chr1,85850163,85850591,SRX5075176,SMARCA4,428
chr1,85850168,85850585,SRX5075169,SMARCA4,417
chr1,85850171,85850637,SRX5075170,SMARCA4,466
chr1,85850176,85850585,SRX5716469,SMARCA4,409
chr1,85850187,85850600,SRX5020211,SMARCA2,413
chr1,85850206,85850602,SRX5054309,FOSL2,396
chr1,85850213,85850578,SRX5054308,FOSL2,365
chr1,85850223,85850575,SRX5716467,SMARCA2,352
chr1,85850226,85850594,SRX5716470,SMARCA4,368
chr1,85850227,85850528,SRX5020214,SMARCA2,301
chr1,85850244,85850536,SRX5075182,SMARCA2,292
chr1,85850251,85850458,SRX5075181,SMARCA2,207
chr1,85850285,85850505,SRX5716468,SMARCA2,220
chr1,85850347,85850530,SRX5054307,FOSL2,183
chr1,85862542,85862725,SRX5075174,SMARCA4,183
chr1,85884584,85885023,SRX16500060,CTCF,439
chr1,85884591,85885031,SRX16500059,CTCF,440
chr1,85884662,85885022,SRX16500062,CTCF,360
chr1,85884672,85885073,SRX16500061,CTCF,401
chr1,85894597,85895082,SRX16500060,CTCF,485
chr1,85894673,85895066,SRX16500059,CTCF,393
chr1,85894676,85894992,SRX5075168,SMARCA4,316
chr1,85894689,85895052,SRX16500061,CTCF,363
chr1,85894696,85895072,SRX16500062,CTCF,376
chr1,85894720,85895007,SRX5075176,SMARCA4,287
chr1,85894721,85894996,SRX5075174,SMARCA4,275
chr1,85894724,85894955,SRX5075169,SMARCA4,231
chr1,85894727,85895005,SRX5075170,SMARCA4,278
chr1,85894731,85895009,SRX5716463,SMARCA4,278
chr1,85894742,85894977,SRX5716470,SMARCA4,235
chr1,85898909,85899248,SRX5054309,FOSL2,339
chr1,85898943,85899184,SRX5054308,FOSL2,241
chr1,85940665,85940985,SRX5716469,SMARCA4,320
chr1,85940741,85941005,SRX5716470,SMARCA4,264
chr1,85992762,85993312,SRX5075175,SMARCA4,550
chr1,85992769,85993276,SRX5075176,SMARCA4,507
chr1,85992796,85993262,SRX5716467,SMARCA2,466
chr1,85992802,85993227,SRX5716470,SMARCA4,425
chr1,85992810,85993281,SRX5075170,SMARCA4,471
chr1,85992814,85993148,SRX5054309,FOSL2,334
chr1,85992825,85993357,SRX5075169,SMARCA4,532
chr1,85992844,85993245,SRX5020211,SMARCA2,401
chr1,85992867,85993345,SRX5716469,SMARCA4,478
chr1,85992884,85993169,SRX5054308,FOSL2,285
chr1,85992889,85993151,SRX5716468,SMARCA2,262
chr1,85992963,85993199,SRX5075181,SMARCA2,236
chr1,86018230,86018701,SRX16500061,CTCF,471
chr1,86018246,86018732,SRX16500059,CTCF,486
chr1,86018273,86018739,SRX16500062,CTCF,466
chr1,86018300,86018912,SRX16500060,CTCF,612
chr1,86018308,86018596,SRX5716470,SMARCA4,288
chr1,86018309,86018664,SRX5075174,SMARCA4,355
chr1,86018326,86018548,SRX4174629,CTCF,222
chr1,86018333,86018617,SRX5716463,SMARCA4,284
chr1,86018336,86018674,SRX5075168,SMARCA4,338
chr1,86018338,86018641,SRX5075176,SMARCA4,303
chr1,86018341,86018611,SRX5716464,SMARCA4,270
chr1,86018344,86018637,SRX5075169,SMARCA4,293
chr1,86018349,86018615,SRX5075170,SMARCA4,266
chr1,86018367,86018577,SRX5075175,SMARCA4,210
chr1,86067641,86067984,SRX5020211,SMARCA2,343
chr1,86067661,86067954,SRX5075170,SMARCA4,293
chr1,86067671,86067988,SRX5075176,SMARCA4,317
chr1,86067673,86067878,SRX5075175,SMARCA4,205
chr1,86067691,86067969,SRX5716467,SMARCA2,278
chr1,86067707,86068025,SRX5075169,SMARCA4,318
chr1,86067714,86067950,SRX5054308,FOSL2,236
chr1,86068340,86068692,SRX5075170,SMARCA4,352
chr1,86068462,86068642,SRX5075169,SMARCA4,180
chr1,86082315,86082550,SRX16500059,CTCF,235
chr1,86090189,86090542,SRX5075170,SMARCA4,353
chr1,86090217,86090516,SRX5075176,SMARCA4,299
chr1,86137473,86137867,SRX5075169,SMARCA4,394
chr1,86137484,86137858,SRX5075168,SMARCA4,374
chr1,86137499,86137865,SRX5054309,FOSL2,366
chr1,86137501,86137890,SRX5075174,SMARCA4,389
chr1,86137502,86137871,SRX5075170,SMARCA4,369
chr1,86137507,86137919,SRX5075175,SMARCA4,412
chr1,86137524,86137956,SRX5716469,SMARCA4,432
chr1,86137529,86137884,SRX5075176,SMARCA4,355
chr1,86137554,86137881,SRX5054308,FOSL2,327
chr1,86137567,86137876,SRX5020211,SMARCA2,309
chr1,86137635,86137907,SRX5716470,SMARCA4,272
chr1,86137646,86137861,SRX5020214,SMARCA2,215
chr1,86151502,86151753,SRX5054309,FOSL2,251
chr1,86156709,86157207,SRX5075174,SMARCA4,498
chr1,86156776,86157179,SRX5075176,SMARCA4,403
chr1,86156785,86157163,SRX5075168,SMARCA4,378
chr1,86156853,86157213,SRX5075175,SMARCA4,360
chr1,86156936,86157174,SRX5075170,SMARCA4,238
chr1,86201180,86201732,SRX5075168,SMARCA4,552
chr1,86201355,86201723,SRX5075174,SMARCA4,368
chr1,86205753,86206069,SRX5054309,FOSL2,316
chr1,86205813,86206062,SRX5054308,FOSL2,249
chr1,86207250,86207671,SRX5075170,SMARCA4,421
chr1,86207309,86207696,SRX5075176,SMARCA4,387
chr1,86207319,86207746,SRX5075169,SMARCA4,427
chr1,86207395,86207624,SRX5075175,SMARCA4,229
chr1,86207400,86207593,SRX5054309,FOSL2,193
chr1,86239959,86240176,SRX5075174,SMARCA4,217
chr1,86370454,86370831,SRX5716470,SMARCA4,377
chr1,86370466,86370800,SRX5020211,SMARCA2,334
chr1,86370488,86370887,SRX5054308,FOSL2,399
chr1,86370499,86370811,SRX5075176,SMARCA4,312
chr1,86370514,86370815,SRX5075175,SMARCA4,301
chr1,86370527,86370786,SRX5075181,SMARCA2,259
chr1,86370542,86370810,SRX5054309,FOSL2,268
chr1,86370545,86370968,SRX5716469,SMARCA4,423
chr1,86370551,86370785,SRX5020214,SMARCA2,234
chr1,86370576,86370795,SRX5075170,SMARCA4,219
chr1,86370576,86370834,SRX5716467,SMARCA2,258
chr1,86370589,86370801,SRX5075169,SMARCA4,212
chr1,86370654,86370899,SRX5075182,SMARCA2,245
chr1,86375735,86375983,SRX5020211,SMARCA2,248
chr1,86375749,86376042,SRX5716470,SMARCA4,293
chr1,86375792,86375991,SRX5075181,SMARCA2,199
chr1,86375805,86375980,SRX5075176,SMARCA4,175
chr1,86375828,86376013,SRX5075169,SMARCA4,185
chr1,86380229,86380701,SRX16500060,CTCF,472
chr1,86380235,86380719,SRX16500059,CTCF,484
chr1,86380251,86380720,SRX16500061,CTCF,469
chr1,86380271,86380618,SRX5075168,SMARCA4,347
chr1,86380273,86380723,SRX16500062,CTCF,450
chr1,86395773,86396409,SRX20140895,INTS13,636
chr1,86395885,86396548,SRX5075174,SMARCA4,663
chr1,86395966,86396321,SRX5716470,SMARCA4,355
chr1,86395974,86396649,SRX5075168,SMARCA4,675
chr1,86395981,86396532,SRX5075170,SMARCA4,551
chr1,86396116,86396372,SRX5716463,SMARCA4,256
chr1,86396153,86396403,SRX5075175,SMARCA4,250
chr1,86396186,86396499,SRX5716464,SMARCA4,313
chr1,86396378,86396669,SRX5716470,SMARCA4,291
chr1,86396381,86396556,SRX5075176,SMARCA4,175
chr1,86419305,86419589,SRX16500060,CTCF,284
chr1,86419328,86419581,SRX16500062,CTCF,253
chr1,86419348,86419662,SRX16500059,CTCF,314
chr1,86429821,86430326,SRX5075170,SMARCA4,505
chr1,86429824,86430270,SRX5075169,SMARCA4,446
chr1,86429825,86430314,SRX5075176,SMARCA4,489
chr1,86429863,86430198,SRX5075175,SMARCA4,335
chr1,86429869,86430194,SRX5054309,FOSL2,325
chr1,86429957,86430166,SRX5054308,FOSL2,209
chr1,86430004,86430289,SRX5716469,SMARCA4,285
chr1,86471386,86471613,SRX5075176,SMARCA4,227
chr1,86471413,86471608,SRX5075170,SMARCA4,195
chr1,86473934,86474490,SRX16500059,CTCF,556
chr1,86473939,86474442,SRX16500062,CTCF,503
chr1,86473969,86474455,SRX16500061,CTCF,486
chr1,86474003,86474453,SRX16500060,CTCF,450
chr1,86474109,86474315,SRX5716463,SMARCA4,206
chr1,86474126,86474394,SRX5075174,SMARCA4,268
chr1,86474188,86474427,SRX5075168,SMARCA4,239
chr1,86487062,86487468,SRX5075176,SMARCA4,406
chr1,86487128,86487542,SRX5075170,SMARCA4,414
chr1,86487139,86487474,SRX5075175,SMARCA4,335
chr1,86487155,86487391,SRX5716469,SMARCA4,236
chr1,86487161,86487452,SRX5054308,FOSL2,291
chr1,86487186,86487419,SRX5054309,FOSL2,233
chr1,86487196,86487511,SRX5075169,SMARCA4,315
chr1,86491560,86491936,SRX5075176,SMARCA4,376
chr1,86491597,86491884,SRX5075170,SMARCA4,287
chr1,86499675,86500186,SRX4174629,CTCF,511
chr1,86499895,86500440,SRX16500060,CTCF,545
chr1,86499940,86500419,SRX16500062,CTCF,479
chr1,86499943,86500466,SRX16500059,CTCF,523
chr1,86499959,86500460,SRX16500061,CTCF,501
chr1,86500032,86500236,SRX5716463,SMARCA4,204
chr1,86500067,86500314,SRX5075174,SMARCA4,247
chr1,86502206,86502427,SRX16500060,CTCF,221
chr1,86502837,86503045,SRX5054308,FOSL2,208
chr1,86507918,86508416,SRX16500059,CTCF,498
chr1,86507934,86508378,SRX16500060,CTCF,444
chr1,86507975,86508403,SRX16500062,CTCF,428
chr1,86507980,86508387,SRX16500061,CTCF,407
chr1,86515680,86516024,SRX16500060,CTCF,344
chr1,86648300,86648585,SRX5054309,FOSL2,285
chr1,86648347,86648606,SRX5075168,SMARCA4,259
chr1,86648370,86648616,SRX5075174,SMARCA4,246
chr1,86687648,86687909,SRX16500059,CTCF,261
chr1,86687667,86687991,SRX16500060,CTCF,324
chr1,86695517,86695697,SRX5054308,FOSL2,180
chr1,86704141,86704800,SRX5075168,SMARCA4,659
chr1,86704196,86705308,SRX20140895,INTS13,1112
chr1,86704227,86705023,SRX16500059,CTCF,796
chr1,86704272,86705141,SRX16500060,CTCF,869
chr1,86704286,86704995,SRX16500061,CTCF,709
chr1,86704294,86704659,SRX4174629,CTCF,365
chr1,86704299,86705025,SRX16500062,CTCF,726
chr1,86704313,86704944,SRX5075176,SMARCA4,631
chr1,86704315,86705062,SRX5075174,SMARCA4,747
chr1,86704318,86704843,SRX5716470,SMARCA4,525
chr1,86704342,86704756,SRX5075170,SMARCA4,414
chr1,86704352,86704715,SRX5075169,SMARCA4,363
chr1,86704358,86704646,SRX5716463,SMARCA4,288
chr1,86704364,86705009,SRX20140868,INTS10,645
chr1,86704401,86704789,SRX20140881,CPSF3L,388
chr1,86704441,86704660,SRX5716464,SMARCA4,219
chr1,86704449,86704659,SRX5075175,SMARCA4,210
chr1,86704477,86704779,SRX20140869,INTS10,302
chr1,86704514,86704997,SRX20140867,INTS10,483
chr1,86704518,86704784,SRX20140897,INTS13,266
chr1,86741824,86742403,SRX16500059,CTCF,579
chr1,86741874,86742350,SRX16500061,CTCF,476
chr1,86741889,86742345,SRX16500060,CTCF,456
chr1,86741969,86742360,SRX16500062,CTCF,391
chr1,86742017,86742270,SRX5075168,SMARCA4,253
chr1,86742147,86742416,SRX4174629,CTCF,269
chr1,86774218,86774712,SRX5075174,SMARCA4,494
chr1,86774240,86774510,SRX5075168,SMARCA4,270
chr1,86774280,86774746,SRX5075169,SMARCA4,466
chr1,86774283,86774698,SRX5075175,SMARCA4,415
chr1,86774294,86774754,SRX5716469,SMARCA4,460
chr1,86774305,86774647,SRX5054309,FOSL2,342
chr1,86774306,86774827,SRX5075170,SMARCA4,521
chr1,86774312,86774654,SRX5075176,SMARCA4,342
chr1,86774392,86774635,SRX5054308,FOSL2,243
chr1,86774456,86774823,SRX5716470,SMARCA4,367
chr1,86780994,86781311,SRX5054309,FOSL2,317
chr1,86781008,86781298,SRX5075170,SMARCA4,290
chr1,86781013,86781280,SRX5054308,FOSL2,267
chr1,86781032,86781227,SRX5075176,SMARCA4,195
chr1,86781039,86781212,SRX5075174,SMARCA4,173
chr1,86781063,86781301,SRX5075175,SMARCA4,238
chr1,86788456,86788663,SRX5054308,FOSL2,207
chr1,86788514,86788953,SRX5075176,SMARCA4,439
chr1,86788516,86789012,SRX5054309,FOSL2,496
chr1,86788527,86789030,SRX5075169,SMARCA4,503
chr1,86788591,86789094,SRX5075175,SMARCA4,503
chr1,86788695,86789018,SRX5716469,SMARCA4,323
chr1,86788709,86788968,SRX5716470,SMARCA4,259
chr1,86788728,86788943,SRX5716467,SMARCA2,215
chr1,86788747,86789020,SRX5054308,FOSL2,273
chr1,86792897,86793639,SRX5075174,SMARCA4,742
chr1,86792922,86793552,SRX5075168,SMARCA4,630
chr1,86793061,86793335,SRX5716463,SMARCA4,274
chr1,86793136,86793330,SRX5716451,SOX2,194
chr1,86793176,86793417,SRX5075170,SMARCA4,241
chr1,86793180,86793411,SRX5716470,SMARCA4,231
chr1,86793183,86793376,SRX5075176,SMARCA4,193
chr1,86806502,86806765,SRX5075174,SMARCA4,263
chr1,86806526,86806824,SRX5075168,SMARCA4,298
chr1,86825262,86825566,SRX5716470,SMARCA4,304
chr1,86825368,86825580,SRX5716469,SMARCA4,212
chr1,86833433,86833904,SRX4174629,CTCF,471
chr1,86833441,86834015,SRX16500060,CTCF,574
chr1,86833531,86834008,SRX16500059,CTCF,477
chr1,86833563,86833971,SRX16500061,CTCF,408
chr1,86833585,86833944,SRX16500062,CTCF,359
chr1,86833603,86833944,SRX5075174,SMARCA4,341
chr1,86833638,86833979,SRX5075176,SMARCA4,341
chr1,86833643,86833892,SRX5075175,SMARCA4,249
chr1,86833671,86833979,SRX5075168,SMARCA4,308
chr1,86833673,86833901,SRX5716463,SMARCA4,228
chr1,86833697,86833960,SRX5075170,SMARCA4,263
chr1,86833712,86833973,SRX5075169,SMARCA4,261
chr1,86846111,86846634,SRX5075175,SMARCA4,523
chr1,86846120,86846627,SRX5716469,SMARCA4,507
chr1,86846131,86846700,SRX5075170,SMARCA4,569
chr1,86846138,86846701,SRX5075176,SMARCA4,563
chr1,86846147,86846676,SRX5075169,SMARCA4,529
chr1,86846158,86846602,SRX5020211,SMARCA2,444
chr1,86846162,86846650,SRX5054309,FOSL2,488
chr1,86846167,86846553,SRX5716468,SMARCA2,386
chr1,86846172,86846557,SRX5716467,SMARCA2,385
chr1,86846185,86846616,SRX5054308,FOSL2,431
chr1,86846221,86846622,SRX5716470,SMARCA4,401
chr1,86846227,86846541,SRX5020214,SMARCA2,314
chr1,86846313,86846593,SRX5075182,SMARCA2,280
chr1,86913999,86914266,SRX20140895,INTS13,267
chr1,86914038,86914347,SRX5075170,SMARCA4,309
chr1,86914101,86914831,SRX5075168,SMARCA4,730
chr1,86914109,86914576,SRX5716463,SMARCA4,467
chr1,86914118,86914796,SRX5075174,SMARCA4,678
chr1,86914143,86914323,SRX5075169,SMARCA4,180
chr1,86914186,86914613,SRX5716451,SOX2,427
chr1,86914222,86914582,SRX5716454,SOX3,360
chr1,86914261,86914581,SRX5054307,FOSL2,320
chr1,86914265,86914541,SRX5716453,SOX2,276
chr1,86914367,86914550,SRX5075176,SMARCA4,183
chr1,86914401,86914581,SRX5054308,FOSL2,180
chr1,86914552,86915484,SRX20140895,INTS13,932
chr1,86950704,86951054,SRX5075168,SMARCA4,350
chr1,86950732,86951032,SRX5075174,SMARCA4,300
chr1,86975967,86976499,SRX5075168,SMARCA4,532
chr1,86975991,86976551,SRX5075174,SMARCA4,560
chr1,86976072,86976375,SRX5716454,SOX3,303
chr1,86976090,86976473,SRX5716463,SMARCA4,383
chr1,86976133,86976405,SRX5716451,SOX2,272
chr1,86976189,86976497,SRX5716464,SMARCA4,308
chr1,87000450,87000758,SRX5075168,SMARCA4,308
chr1,87000635,87000891,SRX5075174,SMARCA4,256
chr1,87025055,87025499,SRX16500061,CTCF,444
chr1,87025154,87025558,SRX16500060,CTCF,404
chr1,87025187,87025600,SRX16500059,CTCF,413
chr1,87025234,87025549,SRX5075168,SMARCA4,315
chr1,87025259,87025524,SRX16500062,CTCF,265
chr1,87025307,87025492,SRX5075176,SMARCA4,185
chr1,87025332,87025507,SRX5075174,SMARCA4,175
chr1,87061765,87061943,SRX5075170,SMARCA4,178
chr1,87061998,87062167,SRX5075170,SMARCA4,169
chr1,87084140,87084663,SRX16500061,CTCF,523
chr1,87084179,87084749,SRX16500059,CTCF,570
chr1,87084180,87084644,SRX16500062,CTCF,464
chr1,87084183,87084734,SRX16500060,CTCF,551
chr1,87084242,87084494,SRX5075176,SMARCA4,252
chr1,87084308,87084513,SRX5075170,SMARCA4,205
chr1,87093353,87093574,SRX5054309,FOSL2,221
chr1,87093391,87093598,SRX5075170,SMARCA4,207
chr1,87115534,87115910,SRX5075170,SMARCA4,376
chr1,87115594,87115838,SRX5054309,FOSL2,244
chr1,87115600,87115849,SRX5054308,FOSL2,249
chr1,87115604,87115871,SRX5075176,SMARCA4,267
chr1,87115613,87115851,SRX5075169,SMARCA4,238
chr1,87115633,87115820,SRX5075175,SMARCA4,187
chr1,87117710,87118053,SRX5075168,SMARCA4,343
chr1,87117784,87118084,SRX5075176,SMARCA4,300
chr1,87117790,87118050,SRX5075174,SMARCA4,260
chr1,87117805,87118063,SRX5054309,FOSL2,258
chr1,87117814,87118072,SRX5075169,SMARCA4,258
chr1,87117829,87118051,SRX5054308,FOSL2,222
chr1,87117830,87118065,SRX5716469,SMARCA4,235
chr1,87117845,87118059,SRX5075175,SMARCA4,214
chr1,87117866,87118081,SRX5075170,SMARCA4,215
chr1,87131654,87132178,SRX16500062,CTCF,524
chr1,87131661,87132162,SRX16500059,CTCF,501
chr1,87131675,87132153,SRX16500060,CTCF,478
chr1,87131707,87132180,SRX16500061,CTCF,473
chr1,87131759,87132121,SRX5075176,SMARCA4,362
chr1,87131759,87132208,SRX5075170,SMARCA4,449
chr1,87131768,87132123,SRX5075168,SMARCA4,355
chr1,87131772,87132043,SRX5716469,SMARCA4,271
chr1,87131780,87132173,SRX5075174,SMARCA4,393
chr1,87131782,87132065,SRX5716464,SMARCA4,283
chr1,87131783,87132116,SRX5075169,SMARCA4,333
chr1,87131784,87132138,SRX5716463,SMARCA4,354
chr1,87131800,87132129,SRX5716470,SMARCA4,329
chr1,87131805,87132067,SRX4174629,CTCF,262
chr1,87131807,87132121,SRX5075175,SMARCA4,314
chr1,87149529,87149925,SRX5075176,SMARCA4,396
chr1,87151798,87152265,SRX16500059,CTCF,467
chr1,87151854,87152296,SRX16500060,CTCF,442
chr1,87151868,87152243,SRX16500062,CTCF,375
chr1,87151881,87152251,SRX16500061,CTCF,370
chr1,87151926,87152333,SRX5075174,SMARCA4,407
chr1,87151941,87152275,SRX5075168,SMARCA4,334
chr1,87151948,87152195,SRX5075169,SMARCA4,247
chr1,87151996,87152261,SRX5075175,SMARCA4,265
chr1,87152002,87152275,SRX5075170,SMARCA4,273
chr1,87152008,87152323,SRX4174629,CTCF,315
chr1,87168349,87168585,SRX16500062,CTCF,236
chr1,87169246,87169843,SRX20140895,INTS13,597
chr1,87169437,87169711,SRX5075168,SMARCA4,274
chr1,87169572,87169805,SRX5716464,SMARCA4,233
chr1,87204052,87204246,SRX5075170,SMARCA4,194
chr1,87224182,87224445,SRX5075175,SMARCA4,263
chr1,87224191,87224525,SRX5054309,FOSL2,334
chr1,87224195,87224533,SRX5075169,SMARCA4,338
chr1,87224199,87224490,SRX5054308,FOSL2,291
chr1,87224211,87224482,SRX5075176,SMARCA4,271
chr1,87224235,87224404,SRX5075170,SMARCA4,169
chr1,87226213,87226728,SRX5075176,SMARCA4,515
chr1,87226226,87226773,SRX5075170,SMARCA4,547
chr1,87226247,87226801,SRX5716470,SMARCA4,554
chr1,87226253,87226818,SRX5075168,SMARCA4,565
chr1,87226256,87226734,SRX5075169,SMARCA4,478
chr1,87226287,87226777,SRX5075175,SMARCA4,490
chr1,87226289,87226844,SRX5075174,SMARCA4,555
chr1,87226295,87226698,SRX5054309,FOSL2,403
chr1,87226302,87226660,SRX5020214,SMARCA2,358
chr1,87226359,87226713,SRX5716467,SMARCA2,354
chr1,87226374,87226724,SRX5716468,SMARCA2,350
chr1,87226386,87226629,SRX5054308,FOSL2,243
chr1,87226386,87226843,SRX5716469,SMARCA4,457
chr1,87226397,87226639,SRX5020211,SMARCA2,242
chr1,87226454,87226648,SRX5075181,SMARCA2,194
chr1,87226588,87226876,SRX5716460,Epitope tags,288
chr1,87255536,87255735,SRX5054309,FOSL2,199
chr1,87273356,87273686,SRX5075168,SMARCA4,330
chr1,87273517,87273704,SRX5075174,SMARCA4,187
chr1,87278829,87279121,SRX5075169,SMARCA4,292
chr1,87278843,87279146,SRX5075176,SMARCA4,303
chr1,87278854,87279080,SRX5716470,SMARCA4,226
chr1,87278856,87279118,SRX5075175,SMARCA4,262
chr1,87278874,87279136,SRX5054309,FOSL2,262
chr1,87278935,87279123,SRX5075170,SMARCA4,188
chr1,87280213,87280434,SRX16500060,CTCF,221
chr1,87292728,87293359,SRX16500060,CTCF,631
chr1,87292857,87293378,SRX16500059,CTCF,521
chr1,87292861,87293406,SRX16500061,CTCF,545
chr1,87292917,87293346,SRX16500062,CTCF,429
chr1,87292963,87293264,SRX5075168,SMARCA4,301
chr1,87292984,87293211,SRX5716463,SMARCA4,227
chr1,87292985,87293298,SRX5075174,SMARCA4,313
chr1,87292994,87293246,SRX5075176,SMARCA4,252
chr1,87293008,87293212,SRX5075170,SMARCA4,204
chr1,87293014,87293225,SRX5716470,SMARCA4,211
chr1,87293033,87293213,SRX5075169,SMARCA4,180
chr1,87293292,87293508,SRX4174629,CTCF,216
chr1,87311607,87311791,SRX5075176,SMARCA4,184
chr1,87325916,87326469,SRX16500059,CTCF,553
chr1,87325948,87326382,SRX16500061,CTCF,434
chr1,87325959,87326450,SRX16500060,CTCF,491
chr1,87325962,87326431,SRX16500062,CTCF,469
chr1,87326018,87326345,SRX5075168,SMARCA4,327
chr1,87326023,87326299,SRX5075174,SMARCA4,276
chr1,87326067,87326283,SRX5075170,SMARCA4,216
chr1,87326086,87326282,SRX5075176,SMARCA4,196
chr1,87326131,87326441,SRX4174629,CTCF,310
chr1,87328182,87328452,SRX5716463,SMARCA4,270
chr1,87328188,87329204,SRX20140895,INTS13,1016
chr1,87328195,87328969,SRX20140868,INTS10,774
chr1,87328260,87328471,SRX5075174,SMARCA4,211
chr1,87328294,87328506,SRX5716451,SOX2,212
chr1,87328310,87329057,SRX20140867,INTS10,747
chr1,87328682,87329118,SRX20140897,INTS13,436
chr1,87328782,87329176,SRX20140881,CPSF3L,394
chr1,87328840,87329081,SRX20140879,CPSF3L,241
chr1,87334442,87334732,SRX16500062,CTCF,290
chr1,87335263,87335681,SRX20140895,INTS13,418
chr1,87335294,87335595,SRX5075169,SMARCA4,301
chr1,87335364,87335614,SRX5075168,SMARCA4,250
chr1,87335368,87335619,SRX5075176,SMARCA4,251
chr1,87335426,87335595,SRX5075170,SMARCA4,169
chr1,87392268,87392513,SRX5075175,SMARCA4,245
chr1,87392282,87392474,SRX5075169,SMARCA4,192
chr1,87392866,87393148,SRX5075169,SMARCA4,282
chr1,87392885,87393151,SRX5054309,FOSL2,266
chr1,87402119,87402575,SRX5020211,SMARCA2,456
chr1,87402121,87402612,SRX5075169,SMARCA4,491
chr1,87402140,87402533,SRX5075175,SMARCA4,393
chr1,87402148,87402622,SRX5075176,SMARCA4,474
chr1,87402177,87402747,SRX5075170,SMARCA4,570
chr1,87402188,87402547,SRX5716469,SMARCA4,359
chr1,87402196,87402511,SRX5716467,SMARCA2,315
chr1,87402197,87402555,SRX5054309,FOSL2,358
chr1,87402204,87402541,SRX5054308,FOSL2,337
chr1,87402251,87402618,SRX5716470,SMARCA4,367
chr1,87410829,87411318,SRX5075170,SMARCA4,489
chr1,87410856,87411218,SRX5075176,SMARCA4,362
chr1,87410919,87411133,SRX5075169,SMARCA4,214
chr1,87410925,87411123,SRX5075175,SMARCA4,198
chr1,87423886,87424100,SRX5075170,SMARCA4,214
chr1,87423912,87424087,SRX5075176,SMARCA4,175
chr1,87426693,87427168,SRX5716470,SMARCA4,475
chr1,87426706,87427202,SRX5075170,SMARCA4,496
chr1,87426732,87427191,SRX5075169,SMARCA4,459
chr1,87426766,87427164,SRX5075176,SMARCA4,398
chr1,87426792,87427158,SRX5075175,SMARCA4,366
chr1,87426817,87427152,SRX5054308,FOSL2,335
chr1,87426826,87427171,SRX5054309,FOSL2,345
chr1,87426835,87427245,SRX5716469,SMARCA4,410
chr1,87426838,87427084,SRX5020211,SMARCA2,246
chr1,87426841,87427053,SRX5020214,SMARCA2,212
chr1,87426845,87427052,SRX5075181,SMARCA2,207
chr1,87426880,87427104,SRX5716467,SMARCA2,224
chr1,87426946,87427145,SRX5075174,SMARCA4,199
chr1,87429022,87429301,SRX5075168,SMARCA4,279
chr1,87451615,87451920,SRX5075175,SMARCA4,305
chr1,87451700,87451967,SRX5075169,SMARCA4,267
chr1,87451702,87451885,SRX5054309,FOSL2,183
chr1,87513356,87513548,SRX5075168,SMARCA4,192
chr1,87644912,87645309,SRX5075174,SMARCA4,397
chr1,87644957,87645248,SRX5075168,SMARCA4,291
chr1,87685749,87685929,SRX5075168,SMARCA4,180
chr1,87706226,87706537,SRX5075169,SMARCA4,311
chr1,87706258,87706492,SRX5054309,FOSL2,234
chr1,87760271,87760459,SRX5054309,FOSL2,188
chr1,87795303,87795592,SRX5075176,SMARCA4,289
chr1,87795321,87795612,SRX5075175,SMARCA4,291
chr1,87795333,87795686,SRX5054309,FOSL2,353
chr1,87795338,87795673,SRX5716469,SMARCA4,335
chr1,87795339,87795667,SRX5054308,FOSL2,328
chr1,87795409,87795597,SRX5075169,SMARCA4,188
chr1,87805937,87806370,SRX5716469,SMARCA4,433
chr1,87805944,87806460,SRX5716470,SMARCA4,516
chr1,87805971,87806323,SRX5054308,FOSL2,352
chr1,87806016,87806252,SRX5054309,FOSL2,236
chr1,87806032,87806293,SRX5075176,SMARCA4,261
chr1,87806070,87806358,SRX5075175,SMARCA4,288
chr1,87806111,87806376,SRX5075170,SMARCA4,265
chr1,87820677,87820970,SRX5075168,SMARCA4,293
chr1,87826710,87826949,SRX5075170,SMARCA4,239
chr1,87826715,87827002,SRX5075176,SMARCA4,287
chr1,87833237,87833424,SRX5075175,SMARCA4,187
chr1,87833271,87833478,SRX5075170,SMARCA4,207
chr1,87833324,87833641,SRX5075169,SMARCA4,317
chr1,87869646,87869932,SRX5054309,FOSL2,286
chr1,87941329,87941510,SRX5075170,SMARCA4,181
chr1,87941402,87941609,SRX5075176,SMARCA4,207
chr1,87953668,87954090,SRX16500059,CTCF,422
chr1,87953677,87954133,SRX16500060,CTCF,456
chr1,87953679,87954103,SRX16500062,CTCF,424
chr1,87953688,87954140,SRX16500061,CTCF,452
chr1,87953742,87954046,SRX4174629,CTCF,304
chr1,87953836,87954029,SRX5075168,SMARCA4,193
chr1,87956055,87956406,SRX5075175,SMARCA4,351
chr1,87956093,87956442,SRX5075169,SMARCA4,349
chr1,87956095,87956469,SRX5075170,SMARCA4,374
chr1,87956096,87956448,SRX5075176,SMARCA4,352
chr1,87956111,87956421,SRX5716460,Epitope tags,310
chr1,87956138,87956384,SRX5054309,FOSL2,246
chr1,87956149,87956388,SRX5716470,SMARCA4,239
chr1,87956173,87956415,SRX5716469,SMARCA4,242
chr1,87968186,87968445,SRX5075168,SMARCA4,259
chr1,87968255,87968492,SRX5075169,SMARCA4,237
chr1,88061485,88061953,SRX16500060,CTCF,468
chr1,88061503,88061888,SRX16500062,CTCF,385
chr1,88061513,88061935,SRX16500059,CTCF,422
chr1,88061536,88061885,SRX16500061,CTCF,349
chr1,88061542,88062067,SRX4174629,CTCF,525
chr1,88061987,88062176,SRX5054309,FOSL2,189
chr1,88063645,88063929,SRX5075176,SMARCA4,284
chr1,88063683,88063863,SRX5075169,SMARCA4,180
chr1,88063705,88063947,SRX5054309,FOSL2,242
chr1,88063732,88063912,SRX5054308,FOSL2,180
chr1,88063747,88063932,SRX5075170,SMARCA4,185
chr1,88079040,88079456,SRX16500060,CTCF,416
chr1,88079063,88079416,SRX16500062,CTCF,353
chr1,88079074,88079390,SRX16500061,CTCF,316
chr1,88079074,88079450,SRX16500059,CTCF,376
chr1,88180426,88180918,SRX16500061,CTCF,492
chr1,88180434,88180928,SRX16500060,CTCF,494
chr1,88180479,88180883,SRX16500062,CTCF,404
chr1,88180486,88180948,SRX16500059,CTCF,462
chr1,88180503,88180925,SRX5075174,SMARCA4,422
chr1,88180511,88180884,SRX5716470,SMARCA4,373
chr1,88180511,88180947,SRX5075168,SMARCA4,436
chr1,88180515,88180884,SRX5075170,SMARCA4,369
chr1,88180543,88180860,SRX5075169,SMARCA4,317
chr1,88180543,88180874,SRX5716464,SMARCA4,331
chr1,88180547,88180880,SRX5075175,SMARCA4,333
chr1,88180550,88180890,SRX4174629,CTCF,340
chr1,88180552,88180887,SRX5716463,SMARCA4,335
chr1,88180554,88180883,SRX5075176,SMARCA4,329
chr1,88180572,88180809,SRX5716469,SMARCA4,237
chr1,88221424,88221799,SRX5054309,FOSL2,375
chr1,88228145,88228349,SRX5716463,SMARCA4,204
chr1,88228223,88228472,SRX5075168,SMARCA4,249
chr1,88228237,88228460,SRX5075174,SMARCA4,223
chr1,88228314,88228532,SRX5075170,SMARCA4,218
chr1,88237069,88237485,SRX5075169,SMARCA4,416
chr1,88237128,88237350,SRX5075175,SMARCA4,222
chr1,88237136,88237461,SRX5075170,SMARCA4,325
chr1,88237151,88237351,SRX5020211,SMARCA2,200
chr1,88237184,88237480,SRX5075176,SMARCA4,296
chr1,88237194,88237374,SRX5054308,FOSL2,180
chr1,88276182,88276372,SRX5054308,FOSL2,190
chr1,88276187,88276522,SRX5054309,FOSL2,335
chr1,88276211,88276491,SRX5075169,SMARCA4,280
chr1,88276223,88276471,SRX5075175,SMARCA4,248
chr1,88276232,88276448,SRX5075170,SMARCA4,216
chr1,88303103,88303560,SRX16500059,CTCF,457
chr1,88303113,88303528,SRX16500060,CTCF,415
chr1,88303160,88303456,SRX16500062,CTCF,296
chr1,88303176,88303474,SRX16500061,CTCF,298
chr1,88327570,88328014,SRX5716460,Epitope tags,444
chr1,88327575,88328101,SRX5075170,SMARCA4,526
chr1,88327583,88328220,SRX5075176,SMARCA4,637
chr1,88327612,88328134,SRX5075175,SMARCA4,522
chr1,88327628,88328123,SRX5075169,SMARCA4,495
chr1,88327634,88328110,SRX5716469,SMARCA4,476
chr1,88327637,88328097,SRX5054309,FOSL2,460
chr1,88327638,88328233,SRX5075168,SMARCA4,595
chr1,88327639,88328051,SRX5054308,FOSL2,412
chr1,88327641,88327913,SRX5716459,Epitope tags,272
chr1,88327647,88328079,SRX5716470,SMARCA4,432
chr1,88327660,88328253,SRX5075174,SMARCA4,593
chr1,88327676,88328051,SRX5716467,SMARCA2,375
chr1,88327691,88328028,SRX5054307,FOSL2,337
chr1,88327700,88328046,SRX5020211,SMARCA2,346
chr1,88327724,88327990,SRX5075181,SMARCA2,266
chr1,88327724,88328009,SRX5020214,SMARCA2,285
chr1,88327731,88327935,SRX5716463,SMARCA4,204
chr1,88370068,88370252,SRX5075174,SMARCA4,184
chr1,88378655,88378877,SRX5075170,SMARCA4,222
chr1,88378719,88378902,SRX5054309,FOSL2,183
chr1,88378724,88378935,SRX5716470,SMARCA4,211
chr1,88378751,88378974,SRX5716469,SMARCA4,223
chr1,88462475,88463164,SRX20140895,INTS13,689
chr1,88462492,88462947,SRX5075168,SMARCA4,455
chr1,88462494,88462887,SRX5075174,SMARCA4,393
chr1,88462506,88462933,SRX5075176,SMARCA4,427
chr1,88462531,88462967,SRX5075169,SMARCA4,436
chr1,88462537,88462797,SRX5075170,SMARCA4,260
chr1,88462574,88463014,SRX5075175,SMARCA4,440
chr1,88462604,88462813,SRX5716463,SMARCA4,209
chr1,88462692,88463026,SRX20140868,INTS10,334
chr1,88549505,88549868,SRX16500061,CTCF,363
chr1,88549541,88549809,SRX16500060,CTCF,268
chr1,88549548,88549916,SRX16500062,CTCF,368
chr1,88549550,88549867,SRX16500059,CTCF,317
chr1,88595381,88595635,SRX5054308,FOSL2,254
chr1,88595393,88595688,SRX5054309,FOSL2,295
chr1,88595418,88595672,SRX16500059,CTCF,254
chr1,88595422,88595644,SRX5075174,SMARCA4,222
chr1,88595424,88595626,SRX5075168,SMARCA4,202
chr1,88595424,88595723,SRX16500062,CTCF,299
chr1,88595456,88595635,SRX5054307,FOSL2,179
chr1,88608067,88608565,SRX16500059,CTCF,498
chr1,88608082,88608564,SRX16500060,CTCF,482
chr1,88608124,88608555,SRX16500061,CTCF,431
chr1,88608150,88608590,SRX16500062,CTCF,440
chr1,88608196,88608394,SRX5075174,SMARCA4,198
chr1,88608274,88608453,SRX5075168,SMARCA4,179
chr1,88612262,88612603,SRX5716463,SMARCA4,341
chr1,88612264,88612607,SRX5075174,SMARCA4,343
chr1,88612278,88612627,SRX5075168,SMARCA4,349
chr1,88612283,88612591,SRX5716451,SOX2,308
chr1,88612297,88612563,SRX5716454,SOX3,266
chr1,88648728,88649163,SRX5075168,SMARCA4,435
chr1,88648735,88649146,SRX5075174,SMARCA4,411
chr1,88648736,88649044,SRX5716464,SMARCA4,308
chr1,88648754,88649112,SRX5716463,SMARCA4,358
chr1,88655513,88656225,SRX16500060,CTCF,712
chr1,88655610,88656300,SRX16500059,CTCF,690
chr1,88655622,88656217,SRX16500062,CTCF,595
chr1,88655628,88656253,SRX16500061,CTCF,625
chr1,88683853,88684222,SRX5716470,SMARCA4,369
chr1,88683868,88684270,SRX5075170,SMARCA4,402
chr1,88683870,88684322,SRX5075174,SMARCA4,452
chr1,88683878,88684392,SRX5075176,SMARCA4,514
chr1,88683884,88684311,SRX5075168,SMARCA4,427
chr1,88683901,88684683,SRX20140895,INTS13,782
chr1,88683952,88684265,SRX5075169,SMARCA4,313
chr1,88683954,88684163,SRX5075175,SMARCA4,209
chr1,88683954,88684513,SRX20140867,INTS10,559
chr1,88683957,88684520,SRX20140897,INTS13,563
chr1,88684002,88684565,SRX20140881,CPSF3L,563
chr1,88684020,88684213,SRX5716451,SOX2,193
chr1,88684025,88684578,SRX20140868,INTS10,553
chr1,88684098,88684317,SRX5716464,SMARCA4,219
chr1,88684138,88684331,SRX5054309,FOSL2,193
chr1,88684234,88684476,SRX16500059,CTCF,242
chr1,88684283,88684602,SRX20140869,INTS10,319
chr1,88731368,88731841,SRX5075175,SMARCA4,473
chr1,88731426,88731879,SRX5075170,SMARCA4,453
chr1,88731437,88731858,SRX5716469,SMARCA4,421
chr1,88731450,88731896,SRX5075169,SMARCA4,446
chr1,88731456,88731928,SRX5075176,SMARCA4,472
chr1,88731504,88731888,SRX5716467,SMARCA2,384
chr1,88731523,88731887,SRX5054309,FOSL2,364
chr1,88731535,88731834,SRX5054308,FOSL2,299
chr1,88731575,88731811,SRX5716470,SMARCA4,236
chr1,88731617,88731823,SRX5020214,SMARCA2,206
chr1,88773570,88773893,SRX5075170,SMARCA4,323
chr1,88773597,88773864,SRX5054308,FOSL2,267
chr1,88773609,88773856,SRX5054309,FOSL2,247
chr1,88773612,88773884,SRX5716469,SMARCA4,272
chr1,88773697,88773931,SRX5075176,SMARCA4,234
chr1,88800330,88800821,SRX16500059,CTCF,491
chr1,88800421,88800738,SRX16500061,CTCF,317
chr1,88800425,88800820,SRX16500060,CTCF,395
chr1,88800436,88800765,SRX16500062,CTCF,329
chr1,88802960,88803254,SRX5075169,SMARCA4,294
chr1,88803003,88803212,SRX5054308,FOSL2,209
chr1,88803024,88803279,SRX5716469,SMARCA4,255
chr1,88803025,88803233,SRX5075170,SMARCA4,208
chr1,88803026,88803282,SRX5075175,SMARCA4,256
chr1,88803040,88803315,SRX5054309,FOSL2,275
chr1,88847417,88848019,SRX5075168,SMARCA4,602
chr1,88847435,88847882,SRX5716463,SMARCA4,447
chr1,88847438,88848012,SRX5075174,SMARCA4,574
chr1,88847598,88847858,SRX5716454,SOX3,260
chr1,88847602,88847797,SRX5716451,SOX2,195
chr1,88867732,88868150,SRX5075169,SMARCA4,418
chr1,88867738,88868123,SRX5075175,SMARCA4,385
chr1,88867746,88868062,SRX5054309,FOSL2,316
chr1,88867796,88868062,SRX5054308,FOSL2,266
chr1,88867836,88868075,SRX5020211,SMARCA2,239
chr1,88876921,88877336,SRX5075169,SMARCA4,415
chr1,88876959,88877226,SRX5716470,SMARCA4,267
chr1,88876966,88877181,SRX5716467,SMARCA2,215
chr1,88876979,88877244,SRX5075175,SMARCA4,265
chr1,88876984,88877235,SRX5075176,SMARCA4,251
chr1,88877053,88877222,SRX5075170,SMARCA4,169
chr1,88877230,88877802,SRX16500059,CTCF,572
chr1,88877271,88877767,SRX16500062,CTCF,496
chr1,88877339,88877832,SRX16500060,CTCF,493
chr1,88877358,88877767,SRX16500061,CTCF,409
chr1,88877412,88877605,SRX5075170,SMARCA4,193
chr1,88877468,88877678,SRX5075174,SMARCA4,210
chr1,88877473,88877682,SRX5075168,SMARCA4,209
chr1,88891228,88891860,SRX20140895,INTS13,632
chr1,88891275,88891761,SRX20140881,CPSF3L,486
chr1,88891298,88891725,SRX20140879,CPSF3L,427
chr1,88891314,88891585,SRX20140896,INTS13,271
chr1,88891322,88891749,SRX20140897,INTS13,427
chr1,88891326,88891717,SRX20140868,INTS10,391
chr1,88891333,88891720,SRX20140869,INTS10,387
chr1,88891340,88891758,SRX20140867,INTS10,418
chr1,88891349,88891744,SRX5075175,SMARCA4,395
chr1,88891352,88891710,SRX20140894,INTS13,358
chr1,88891363,88891912,SRX5075174,SMARCA4,549
chr1,88891378,88891804,SRX5075168,SMARCA4,426
chr1,88891383,88891614,SRX5075169,SMARCA4,231
chr1,88891403,88891833,SRX5075176,SMARCA4,430
chr1,88891413,88891713,SRX5716469,SMARCA4,300
chr1,88891563,88891933,SRX5716470,SMARCA4,370
chr1,88891614,88891871,SRX5075170,SMARCA4,257
chr1,88935809,88936338,SRX16500060,CTCF,529
chr1,88935819,88936333,SRX16500061,CTCF,514
chr1,88935821,88936353,SRX16500062,CTCF,532
chr1,88935848,88936420,SRX16500059,CTCF,572
chr1,88935970,88936256,SRX5075174,SMARCA4,286
chr1,88936033,88936242,SRX5075168,SMARCA4,209
chr1,88973469,88973953,SRX16500060,CTCF,484
chr1,88973497,88973958,SRX16500059,CTCF,461
chr1,88973502,88974065,SRX16500062,CTCF,563
chr1,88973566,88973972,SRX16500061,CTCF,406
chr1,88973622,88973813,SRX5075174,SMARCA4,191
chr1,88973661,88973830,SRX5075170,SMARCA4,169
chr1,88983906,88984173,SRX16500060,CTCF,267
chr1,88983914,88984200,SRX16500059,CTCF,286
chr1,88983915,88984202,SRX16500062,CTCF,287
chr1,88983917,88984110,SRX5075168,SMARCA4,193
chr1,88983944,88984130,SRX5075176,SMARCA4,186
chr1,88984908,88985338,SRX5075169,SMARCA4,430
chr1,88984926,88985334,SRX5054308,FOSL2,408
chr1,88984987,88985429,SRX5075176,SMARCA4,442
chr1,88985013,88985363,SRX5054309,FOSL2,350
chr1,88985068,88985362,SRX5075175,SMARCA4,294
chr1,88985069,88985376,SRX5075170,SMARCA4,307
chr1,88985086,88985359,SRX5716469,SMARCA4,273
chr1,88992282,88992948,SRX20140895,INTS13,666
chr1,88992284,88992759,SRX20140881,CPSF3L,475
chr1,88992339,88992752,SRX20140879,CPSF3L,413
chr1,88992346,88992781,SRX20140868,INTS10,435
chr1,88992348,88992691,SRX5075169,SMARCA4,343
chr1,88992371,88992768,SRX20140867,INTS10,397
chr1,88992385,88992878,SRX5075176,SMARCA4,493
chr1,88992387,88992796,SRX5075174,SMARCA4,409
chr1,88992389,88992791,SRX20140897,INTS13,402
chr1,88992406,88992809,SRX20140896,INTS13,403
chr1,88992415,88992712,SRX20140894,INTS13,297
chr1,88992455,88992696,SRX5716470,SMARCA4,241
chr1,88992460,88992897,SRX5075170,SMARCA4,437
chr1,88992466,88993343,SRX5075168,SMARCA4,877
chr1,88992470,88992765,SRX20140869,INTS10,295
chr1,88992493,88992698,SRX5075175,SMARCA4,205
chr1,88992636,88993129,SRX5054309,FOSL2,493
chr1,88992705,88993130,SRX5054308,FOSL2,425
chr1,88992734,88992961,SRX5716454,SOX3,227
chr1,88992761,88993165,SRX5054307,FOSL2,404
chr1,88992857,88993092,SRX5075174,SMARCA4,235
chr1,88992951,88993156,SRX5716464,SMARCA4,205
chr1,88993064,88993247,SRX5075176,SMARCA4,183
chr1,88993128,88993361,SRX5716470,SMARCA4,233
chr1,88998615,88999069,SRX16500062,CTCF,454
chr1,88998618,88999140,SRX16500059,CTCF,522
chr1,88998652,88999105,SRX16500061,CTCF,453
chr1,88998652,88999122,SRX16500060,CTCF,470
chr1,88998776,88998975,SRX5075168,SMARCA4,199
chr1,88998792,88998977,SRX5075176,SMARCA4,185
chr1,88998825,88998994,SRX5075170,SMARCA4,169
chr1,88998840,88999094,SRX5075174,SMARCA4,254
chr1,88998911,88999121,SRX4174629,CTCF,210
chr1,89021833,89022003,SRX5075170,SMARCA4,170
chr1,89022656,89023020,SRX5075169,SMARCA4,364
chr1,89022670,89023067,SRX5716470,SMARCA4,397
chr1,89022683,89022968,SRX5075175,SMARCA4,285
chr1,89022686,89023063,SRX5075176,SMARCA4,377
chr1,89022695,89023091,SRX5716469,SMARCA4,396
chr1,89022715,89023044,SRX5054309,FOSL2,329
chr1,89022717,89023002,SRX5075170,SMARCA4,285
chr1,89022778,89023016,SRX5054308,FOSL2,238
chr1,89041045,89041391,SRX5054308,FOSL2,346
chr1,89041064,89041284,SRX5716469,SMARCA4,220
chr1,89041073,89041440,SRX5075169,SMARCA4,367
chr1,89041078,89041380,SRX5054309,FOSL2,302
chr1,89065132,89065351,SRX5075176,SMARCA4,219
chr1,89065147,89065470,SRX5075170,SMARCA4,323
chr1,89065221,89065427,SRX5075169,SMARCA4,206
chr1,89067737,89067953,SRX20140867,INTS10,216
chr1,89085802,89086094,SRX4174629,CTCF,292
chr1,89125907,89126257,SRX5075169,SMARCA4,350
chr1,89125941,89126314,SRX5054308,FOSL2,373
chr1,89125949,89126341,SRX5075176,SMARCA4,392
chr1,89125963,89126332,SRX5075170,SMARCA4,369
chr1,89125972,89126300,SRX5054309,FOSL2,328
chr1,89125982,89126171,SRX5075175,SMARCA4,189
chr1,89262686,89262927,SRX5054309,FOSL2,241
chr1,89271608,89271854,SRX5054309,FOSL2,246
chr1,89356739,89356927,SRX5054309,FOSL2,188
chr1,89358243,89358720,SRX16500059,CTCF,477
chr1,89358248,89358822,SRX16500060,CTCF,574
chr1,89358282,89358685,SRX4174629,CTCF,403
chr1,89358307,89358555,SRX5716463,SMARCA4,248
chr1,89358307,89358734,SRX16500061,CTCF,427
chr1,89358318,89358580,SRX5075170,SMARCA4,262
chr1,89358321,89358681,SRX16500062,CTCF,360
chr1,89358330,89358616,SRX5075174,SMARCA4,286
chr1,89358335,89358634,SRX5075168,SMARCA4,299
chr1,89455090,89455606,SRX16500059,CTCF,516
chr1,89455093,89455585,SRX16500060,CTCF,492
chr1,89455112,89455547,SRX16500061,CTCF,435
chr1,89455129,89455573,SRX16500062,CTCF,444
chr1,89455216,89455485,SRX5075174,SMARCA4,269
chr1,89455263,89455454,SRX5075169,SMARCA4,191
chr1,89483110,89483688,SRX16500060,CTCF,578
chr1,89483129,89483667,SRX16500059,CTCF,538
chr1,89483141,89483633,SRX16500062,CTCF,492
chr1,89483175,89483638,SRX16500061,CTCF,463
chr1,89483290,89483584,SRX5075174,SMARCA4,294
chr1,89483301,89483669,SRX4174629,CTCF,368
chr1,89483317,89483600,SRX5075168,SMARCA4,283
chr1,89516108,89516398,SRX5075169,SMARCA4,290
chr1,89516113,89516338,SRX5075175,SMARCA4,225
chr1,89516121,89516387,SRX5075176,SMARCA4,266
chr1,89516127,89516351,SRX5075170,SMARCA4,224
chr1,89516133,89516348,SRX5054308,FOSL2,215
chr1,89516152,89516405,SRX5054309,FOSL2,253
chr1,89519784,89520262,SRX16500060,CTCF,478
chr1,89519827,89520156,SRX16500062,CTCF,329
chr1,89519833,89520138,SRX16500061,CTCF,305
chr1,89519855,89520127,SRX16500059,CTCF,272
chr1,89524277,89525206,SRX20140895,INTS13,929
chr1,89524282,89525210,SRX20140868,INTS10,928
chr1,89524383,89525063,SRX5075170,SMARCA4,680
chr1,89524397,89525022,SRX5075169,SMARCA4,625
chr1,89524441,89525068,SRX5075175,SMARCA4,627
chr1,89524447,89525099,SRX5075176,SMARCA4,652
chr1,89524458,89524813,SRX5054308,FOSL2,355
chr1,89524464,89525019,SRX5075174,SMARCA4,555
chr1,89524532,89524990,SRX5075168,SMARCA4,458
chr1,89524543,89524959,SRX5054309,FOSL2,416
chr1,89524582,89525065,SRX20140867,INTS10,483
chr1,89524738,89525136,SRX5716469,SMARCA4,398
chr1,89524750,89525032,SRX5716470,SMARCA4,282
chr1,89527776,89528079,SRX5075168,SMARCA4,303
chr1,89547763,89547932,SRX5075170,SMARCA4,169
chr1,89564035,89564454,SRX5716470,SMARCA4,419
chr1,89564117,89564475,SRX5054309,FOSL2,358
chr1,89564259,89564442,SRX5075176,SMARCA4,183
chr1,89566868,89567164,SRX5075174,SMARCA4,296
chr1,89575943,89576303,SRX5075168,SMARCA4,360
chr1,89575955,89576136,SRX5075176,SMARCA4,181
chr1,89576040,89576333,SRX5075174,SMARCA4,293
chr1,89598957,89599455,SRX16500060,CTCF,498
chr1,89598976,89599509,SRX16500059,CTCF,533
chr1,89598995,89599505,SRX16500061,CTCF,510
chr1,89599020,89599523,SRX16500062,CTCF,503
chr1,89599035,89599299,SRX5716463,SMARCA4,264
chr1,89599036,89599333,SRX5075176,SMARCA4,297
chr1,89599038,89599324,SRX5075168,SMARCA4,286
chr1,89599063,89599344,SRX5075174,SMARCA4,281
chr1,89599088,89599293,SRX5716464,SMARCA4,205
chr1,89599102,89599342,SRX5075170,SMARCA4,240
chr1,89603814,89604011,SRX5075175,SMARCA4,197
chr1,89605698,89606025,SRX5075169,SMARCA4,327
chr1,89605756,89606007,SRX5075175,SMARCA4,251
chr1,89605757,89606003,SRX5075170,SMARCA4,246
chr1,89605768,89606092,SRX5716470,SMARCA4,324
chr1,89605779,89606136,SRX5075176,SMARCA4,357
chr1,89605796,89606052,SRX5075168,SMARCA4,256
chr1,89615992,89616276,SRX16500060,CTCF,284
chr1,89632661,89633579,SRX20140895,INTS13,918
chr1,89632702,89633235,SRX20140868,INTS10,533
chr1,89632710,89633224,SRX5075174,SMARCA4,514
chr1,89632713,89633152,SRX5075168,SMARCA4,439
chr1,89632734,89633307,SRX16500060,CTCF,573
chr1,89632744,89633156,SRX16500059,CTCF,412
chr1,89632800,89633147,SRX5716470,SMARCA4,347
chr1,89632815,89633143,SRX5075176,SMARCA4,328
chr1,89632885,89633106,SRX5716464,SMARCA4,221
chr1,89632886,89633279,SRX5075175,SMARCA4,393
chr1,89632933,89633167,SRX5075169,SMARCA4,234
chr1,89633461,89633648,SRX5075168,SMARCA4,187
chr1,89636128,89636582,SRX5054309,FOSL2,454
chr1,89636280,89636492,SRX5054308,FOSL2,212
chr1,89659878,89660083,SRX5075176,SMARCA4,205
chr1,89670186,89670548,SRX5075174,SMARCA4,362
chr1,89670301,89670516,SRX5075168,SMARCA4,215
chr1,89698100,89698281,SRX5075170,SMARCA4,181
chr1,89698119,89698352,SRX5075169,SMARCA4,233
chr1,89698127,89698303,SRX5075176,SMARCA4,176
chr1,89708717,89709189,SRX5075170,SMARCA4,472
chr1,89708727,89709111,SRX5716469,SMARCA4,384
chr1,89708736,89709091,SRX5075176,SMARCA4,355
chr1,89708747,89709214,SRX5716470,SMARCA4,467
chr1,89708756,89708968,SRX5054308,FOSL2,212
chr1,89708758,89708953,SRX5075168,SMARCA4,195
chr1,89708769,89709136,SRX5075169,SMARCA4,367
chr1,89708770,89709189,SRX5075175,SMARCA4,419
chr1,89708782,89709160,SRX5716467,SMARCA2,378
chr1,89708783,89709115,SRX5054309,FOSL2,332
chr1,89708799,89709239,SRX5075174,SMARCA4,440
chr1,89708804,89709077,SRX5020211,SMARCA2,273
chr1,89708815,89709062,SRX5075181,SMARCA2,247
chr1,89708828,89709094,SRX5716468,SMARCA2,266
chr1,89709935,89710226,SRX5054309,FOSL2,291
chr1,89710053,89710309,SRX5075169,SMARCA4,256
chr1,89719602,89719955,SRX5075176,SMARCA4,353
chr1,89719649,89719981,SRX5075175,SMARCA4,332
chr1,89719651,89719987,SRX5716470,SMARCA4,336
chr1,89719686,89719987,SRX5075170,SMARCA4,301
chr1,89719695,89719956,SRX5075169,SMARCA4,261
chr1,89721384,89721667,SRX5075170,SMARCA4,283
chr1,89721404,89721664,SRX5075169,SMARCA4,260
chr1,89721404,89721721,SRX5075176,SMARCA4,317
chr1,89721413,89721668,SRX5054308,FOSL2,255
chr1,89721419,89721626,SRX5054309,FOSL2,207
chr1,89721468,89721655,SRX5075175,SMARCA4,187
chr1,89724732,89725328,SRX5075175,SMARCA4,596
chr1,89724863,89725313,SRX5075176,SMARCA4,450
chr1,89724870,89725323,SRX5075170,SMARCA4,453
chr1,89724913,89725277,SRX5716469,SMARCA4,364
chr1,89724919,89725267,SRX5054308,FOSL2,348
chr1,89724925,89725245,SRX5716470,SMARCA4,320
chr1,89724951,89725295,SRX5075169,SMARCA4,344
chr1,89724971,89725324,SRX5054309,FOSL2,353
chr1,89724981,89725279,SRX5716467,SMARCA2,298
chr1,89762839,89763440,SRX16500061,CTCF,601
chr1,89762842,89763403,SRX16500060,CTCF,561
chr1,89762844,89763374,SRX5075168,SMARCA4,530
chr1,89762877,89763299,SRX5075175,SMARCA4,422
chr1,89762883,89763282,SRX5075176,SMARCA4,399
chr1,89762883,89763363,SRX5075174,SMARCA4,480
chr1,89762883,89763431,SRX16500059,CTCF,548
chr1,89762917,89763421,SRX16500062,CTCF,504
chr1,89762932,89763315,SRX5075170,SMARCA4,383
chr1,89762933,89763366,SRX4174629,CTCF,433
chr1,89762938,89763234,SRX5716470,SMARCA4,296
chr1,89762940,89763274,SRX5716463,SMARCA4,334
chr1,89762948,89763277,SRX5716464,SMARCA4,329
chr1,89762973,89763285,SRX5075169,SMARCA4,312
chr1,89763002,89763274,SRX5716469,SMARCA4,272
chr1,89780661,89781057,SRX16500060,CTCF,396
chr1,89780671,89781019,SRX16500059,CTCF,348
chr1,89780705,89781001,SRX16500061,CTCF,296
chr1,89780737,89780966,SRX16500062,CTCF,229
chr1,89780772,89780965,SRX5075176,SMARCA4,193
chr1,89781955,89782125,SRX5075170,SMARCA4,170
chr1,89794430,89794634,SRX5716463,SMARCA4,204
chr1,89794430,89794635,SRX5075175,SMARCA4,205
chr1,89794451,89794700,SRX5075176,SMARCA4,249
chr1,89801997,89802329,SRX5075168,SMARCA4,332
chr1,89802006,89802383,SRX5075174,SMARCA4,377
chr1,89802985,89803197,SRX5054309,FOSL2,212
chr1,89804490,89805111,SRX16500059,CTCF,621
chr1,89804548,89805071,SRX16500061,CTCF,523
chr1,89804597,89805063,SRX16500060,CTCF,466
chr1,89804615,89805132,SRX16500062,CTCF,517
chr1,89804696,89804980,SRX5075174,SMARCA4,284
chr1,89804699,89804962,SRX5075169,SMARCA4,263
chr1,89804704,89804914,SRX5054309,FOSL2,210
chr1,89804716,89805039,SRX4174629,CTCF,323
chr1,89804719,89805027,SRX5716463,SMARCA4,308
chr1,89804729,89805021,SRX5075168,SMARCA4,292
chr1,89804732,89804978,SRX5075170,SMARCA4,246
chr1,89804735,89804944,SRX5075175,SMARCA4,209
chr1,89804741,89804993,SRX5075176,SMARCA4,252
chr1,89804744,89804989,SRX5716470,SMARCA4,245
chr1,89804812,89805027,SRX5716464,SMARCA4,215
chr1,89808443,89808666,SRX5075168,SMARCA4,223
chr1,89808445,89808736,SRX5075174,SMARCA4,291
chr1,89808466,89808728,SRX5054308,FOSL2,262
chr1,89808469,89808672,SRX5075170,SMARCA4,203
chr1,89808469,89808696,SRX5054309,FOSL2,227
chr1,89808504,89808734,SRX5075176,SMARCA4,230
chr1,89820630,89821354,SRX20140895,INTS13,724
chr1,89820642,89821050,SRX5075168,SMARCA4,408
chr1,89820663,89821052,SRX5075174,SMARCA4,389
chr1,89820667,89821083,SRX20140868,INTS10,416
chr1,89820691,89821143,SRX20140897,INTS13,452
chr1,89820717,89821084,SRX5075170,SMARCA4,367
chr1,89820730,89821125,SRX5075175,SMARCA4,395
chr1,89820751,89821170,SRX20140867,INTS10,419
chr1,89820763,89820938,SRX5075176,SMARCA4,175
chr1,89821109,89821580,SRX5075169,SMARCA4,471
chr1,89821310,89821513,SRX5075175,SMARCA4,203
chr1,89821348,89821663,SRX5075176,SMARCA4,315
chr1,89821617,89821970,SRX5075168,SMARCA4,353
chr1,89831855,89832137,SRX5075174,SMARCA4,282
chr1,89831929,89832145,SRX5075168,SMARCA4,216
chr1,89843198,89843557,SRX5075168,SMARCA4,359
chr1,89843255,89843657,SRX16500059,CTCF,402
chr1,89843263,89843623,SRX5075170,SMARCA4,360
chr1,89843278,89843537,SRX5075175,SMARCA4,259
chr1,89843281,89843662,SRX16500062,CTCF,381
chr1,89843288,89843649,SRX16500060,CTCF,361
chr1,89843304,89843521,SRX5075174,SMARCA4,217
chr1,89843343,89843635,SRX5075169,SMARCA4,292
chr1,89855455,89855661,SRX5075175,SMARCA4,206
chr1,89855465,89856030,SRX5075169,SMARCA4,565
chr1,89855481,89855790,SRX5075176,SMARCA4,309
chr1,89855568,89855988,SRX5054308,FOSL2,420
chr1,89855574,89855931,SRX5716469,SMARCA4,357
chr1,89855676,89855924,SRX5716470,SMARCA4,248
chr1,89855714,89856030,SRX5075175,SMARCA4,316
chr1,89855792,89856023,SRX5054309,FOSL2,231
chr1,89865770,89866270,SRX5716469,SMARCA4,500
chr1,89865782,89866275,SRX5075176,SMARCA4,493
chr1,89865793,89866330,SRX5054309,FOSL2,537
chr1,89865795,89866180,SRX5075170,SMARCA4,385
chr1,89865807,89866295,SRX5075169,SMARCA4,488
chr1,89865812,89866162,SRX5054308,FOSL2,350
chr1,89865914,89866169,SRX5716470,SMARCA4,255
chr1,89865916,89866236,SRX5075175,SMARCA4,320
chr1,89873710,89874208,SRX5716469,SMARCA4,498
chr1,89873714,89874214,SRX5075170,SMARCA4,500
chr1,89873726,89874137,SRX5075169,SMARCA4,411
chr1,89873749,89874077,SRX5716467,SMARCA2,328
chr1,89873768,89874261,SRX5075176,SMARCA4,493
chr1,89873783,89874096,SRX5020211,SMARCA2,313
chr1,89873793,89874140,SRX5716470,SMARCA4,347
chr1,89873801,89874105,SRX5054308,FOSL2,304
chr1,89873804,89874031,SRX5716468,SMARCA2,227
chr1,89873844,89874092,SRX5075181,SMARCA2,248
chr1,89873848,89874092,SRX5054309,FOSL2,244
chr1,89873856,89874047,SRX5075175,SMARCA4,191
chr1,89884201,89884374,SRX5075170,SMARCA4,173
chr1,89884215,89884406,SRX5075176,SMARCA4,191
chr1,89885153,89885528,SRX5075176,SMARCA4,375
chr1,89885166,89885533,SRX5054309,FOSL2,367
chr1,89885169,89885523,SRX5716469,SMARCA4,354
chr1,89885182,89885544,SRX5075170,SMARCA4,362
chr1,89885187,89885551,SRX5075169,SMARCA4,364
chr1,89885194,89885613,SRX5075175,SMARCA4,419
chr1,89885195,89885586,SRX5054308,FOSL2,391
chr1,89885233,89885557,SRX5716467,SMARCA2,324
chr1,89885259,89885484,SRX5716470,SMARCA4,225
chr1,89885268,89885549,SRX5020214,SMARCA2,281
chr1,89890188,89890418,SRX5075170,SMARCA4,230
chr1,89890225,89890509,SRX5075168,SMARCA4,284
chr1,89890232,89890462,SRX5075176,SMARCA4,230
chr1,89890233,89890544,SRX5054308,FOSL2,311
chr1,89890258,89890467,SRX5075174,SMARCA4,209
chr1,89893988,89894510,SRX5075175,SMARCA4,522
chr1,89894122,89894548,SRX5075169,SMARCA4,426
chr1,89894153,89894439,SRX5075176,SMARCA4,286
chr1,89894163,89894522,SRX5075170,SMARCA4,359
chr1,89894199,89894488,SRX5054309,FOSL2,289
chr1,89894239,89894475,SRX5716467,SMARCA2,236
chr1,89894248,89894453,SRX5054308,FOSL2,205
chr1,89894251,89894589,SRX5716470,SMARCA4,338
chr1,89894274,89894537,SRX5020214,SMARCA2,263
chr1,89906541,89907124,SRX5075170,SMARCA4,583
chr1,89906627,89907148,SRX5075176,SMARCA4,521
chr1,89906649,89907069,SRX5075175,SMARCA4,420
chr1,89906656,89907049,SRX5716469,SMARCA4,393
chr1,89906669,89907091,SRX5075174,SMARCA4,422
chr1,89906675,89907067,SRX5054309,FOSL2,392
chr1,89906692,89907104,SRX5075169,SMARCA4,412
chr1,89906699,89907027,SRX5716470,SMARCA4,328
chr1,89906714,89907044,SRX5054308,FOSL2,330
chr1,89906734,89907037,SRX5075168,SMARCA4,303
chr1,89906735,89906974,SRX5716464,SMARCA4,239
chr1,89906736,89907002,SRX5716468,SMARCA2,266
chr1,89906738,89907030,SRX5716467,SMARCA2,292
chr1,89910832,89911155,SRX5075168,SMARCA4,323
chr1,89910854,89911123,SRX5075169,SMARCA4,269
chr1,89910856,89911081,SRX5075176,SMARCA4,225
chr1,89910866,89911114,SRX5020214,SMARCA2,248
chr1,89910870,89911173,SRX5075174,SMARCA4,303
chr1,89910879,89911205,SRX5054309,FOSL2,326
chr1,89910895,89911320,SRX5716469,SMARCA4,425
chr1,89910925,89911143,SRX5716464,SMARCA4,218
chr1,89910936,89911222,SRX5716470,SMARCA4,286
chr1,89938288,89938566,SRX5716469,SMARCA4,278
chr1,89938320,89938583,SRX5075175,SMARCA4,263
chr1,89938408,89938594,SRX5054309,FOSL2,186
chr1,89939059,89939411,SRX5075174,SMARCA4,352
chr1,89939073,89939591,SRX20140895,INTS13,518
chr1,89939124,89939476,SRX5075168,SMARCA4,352
chr1,89939155,89939345,SRX5716451,SOX2,190
chr1,89945957,89946160,SRX5054308,FOSL2,203
chr1,89945965,89946172,SRX5075170,SMARCA4,207
chr1,89951957,89952318,SRX5075174,SMARCA4,361
chr1,89951992,89952397,SRX5054309,FOSL2,405
chr1,89952011,89952467,SRX5075169,SMARCA4,456
chr1,89952069,89952431,SRX5716469,SMARCA4,362
chr1,89952081,89952335,SRX5716470,SMARCA4,254
chr1,89952124,89952431,SRX5054308,FOSL2,307
chr1,89952137,89952365,SRX5075175,SMARCA4,228
chr1,89953264,89953647,SRX5075169,SMARCA4,383
chr1,89953297,89953481,SRX5075176,SMARCA4,184
chr1,89953302,89953554,SRX5054309,FOSL2,252
chr1,89953303,89953551,SRX5075175,SMARCA4,248
chr1,89953358,89953598,SRX5075170,SMARCA4,240
chr1,89965198,89965435,SRX5075169,SMARCA4,237
chr1,89965226,89965460,SRX5716469,SMARCA4,234
chr1,89965227,89965488,SRX5716470,SMARCA4,261
chr1,89965266,89965453,SRX5075175,SMARCA4,187
chr1,89965295,89965558,SRX5716467,SMARCA2,263
chr1,89974983,89975379,SRX5075169,SMARCA4,396
chr1,89975013,89975466,SRX5075170,SMARCA4,453
chr1,89975023,89975403,SRX5075175,SMARCA4,380
chr1,89975045,89975424,SRX5075176,SMARCA4,379
chr1,89978782,89979059,SRX5054309,FOSL2,277
chr1,89980584,89980913,SRX5075176,SMARCA4,329
chr1,89980675,89980878,SRX5075175,SMARCA4,203
chr1,89980707,89980948,SRX5716467,SMARCA2,241
chr1,89980717,89980933,SRX5075169,SMARCA4,216
chr1,89987127,89987633,SRX16500060,CTCF,506
chr1,89987142,89987632,SRX16500059,CTCF,490
chr1,89987173,89987637,SRX16500062,CTCF,464
chr1,89987185,89987629,SRX16500061,CTCF,444
chr1,89987204,89987515,SRX5075174,SMARCA4,311
chr1,89987213,89987429,SRX5075176,SMARCA4,216
chr1,89987251,89987491,SRX5075168,SMARCA4,240
chr1,89994636,89995042,SRX5054309,FOSL2,406
chr1,89994656,89995347,SRX5075170,SMARCA4,691
chr1,89994662,89995161,SRX5054308,FOSL2,499
chr1,89994698,89995329,SRX5075174,SMARCA4,631
chr1,89994706,89995182,SRX5075176,SMARCA4,476
chr1,89994732,89994956,SRX5075169,SMARCA4,224
chr1,89994784,89995603,SRX20140895,INTS13,819
chr1,89994790,89995294,SRX5075168,SMARCA4,504
chr1,89994825,89995334,SRX5716470,SMARCA4,509
chr1,89994828,89995544,SRX20140867,INTS10,716
chr1,89994862,89995572,SRX20140897,INTS13,710
chr1,89994869,89995525,SRX20140868,INTS10,656
chr1,89994869,89995592,SRX20140881,CPSF3L,723
chr1,89994874,89995084,SRX5020211,SMARCA2,210
chr1,89994880,89995490,SRX20140869,INTS10,610
chr1,89994949,89995325,SRX5716463,SMARCA4,376
chr1,89994954,89995510,SRX20140879,CPSF3L,556
chr1,89994995,89995434,SRX20140896,INTS13,439
chr1,89995044,89995419,SRX20140870,INTS10,375
chr1,89995111,89995527,SRX5075175,SMARCA4,416
chr1,89995308,89995612,SRX5075169,SMARCA4,304
chr1,89995519,89995761,SRX5075176,SMARCA4,242
chr1,90045984,90046419,SRX16500060,CTCF,435
chr1,90046001,90046391,SRX16500062,CTCF,390
chr1,90046008,90046433,SRX16500059,CTCF,425
chr1,90046016,90046395,SRX16500061,CTCF,379
chr1,90046018,90046323,SRX5075168,SMARCA4,305
chr1,90046057,90046329,SRX5075174,SMARCA4,272
chr1,90046072,90046260,SRX5075176,SMARCA4,188
chr1,90046086,90046319,SRX5075170,SMARCA4,233
chr1,90075017,90075285,SRX5716467,SMARCA2,268
chr1,90075040,90075220,SRX5075169,SMARCA4,180
chr1,90075099,90075311,SRX5075170,SMARCA4,212
chr1,90114406,90114929,SRX16500061,CTCF,523
chr1,90114415,90114943,SRX16500060,CTCF,528
chr1,90114468,90114992,SRX16500059,CTCF,524
chr1,90114519,90114941,SRX16500062,CTCF,422
chr1,90114558,90114890,SRX5075168,SMARCA4,332
chr1,90114577,90114868,SRX5075174,SMARCA4,291
chr1,90132993,90133445,SRX16500059,CTCF,452
chr1,90133034,90133431,SRX16500060,CTCF,397
chr1,90133039,90133318,SRX4174629,CTCF,279
chr1,90133058,90133451,SRX16500062,CTCF,393
chr1,90133078,90133433,SRX16500061,CTCF,355
chr1,90187201,90187387,SRX5075168,SMARCA4,186
chr1,90281976,90282342,SRX5075176,SMARCA4,366
chr1,90281991,90282304,SRX5075170,SMARCA4,313
chr1,90282004,90282341,SRX5054308,FOSL2,337
chr1,90282014,90282343,SRX5716469,SMARCA4,329
chr1,90282016,90282378,SRX5075175,SMARCA4,362
chr1,90282023,90282337,SRX5075169,SMARCA4,314
chr1,90282023,90282338,SRX5054309,FOSL2,315
chr1,90282065,90282291,SRX5716467,SMARCA2,226
chr1,90282094,90282305,SRX5716468,SMARCA2,211
chr1,90291401,90291842,SRX5075176,SMARCA4,441
chr1,90291426,90291804,SRX5075170,SMARCA4,378
chr1,90291464,90291787,SRX5716470,SMARCA4,323
chr1,90291470,90291819,SRX5716469,SMARCA4,349
chr1,90291472,90291755,SRX5020211,SMARCA2,283
chr1,90291495,90291903,SRX5075169,SMARCA4,408
chr1,90291496,90291792,SRX5054309,FOSL2,296
chr1,90291500,90291877,SRX5075175,SMARCA4,377
chr1,90291519,90291805,SRX5054308,FOSL2,286
chr1,90313766,90314174,SRX5075168,SMARCA4,408
chr1,90313812,90314261,SRX5075174,SMARCA4,449
chr1,90371077,90371409,SRX5054309,FOSL2,332
chr1,90371171,90371412,SRX5075181,SMARCA2,241
chr1,90371236,90371455,SRX5716470,SMARCA4,219
chr1,90386926,90387424,SRX5075169,SMARCA4,498
chr1,90386989,90387474,SRX5075175,SMARCA4,485
chr1,90387008,90387344,SRX5020214,SMARCA2,336
chr1,90387035,90387395,SRX5075176,SMARCA4,360
chr1,90387037,90387490,SRX5075170,SMARCA4,453
chr1,90387078,90387424,SRX5054309,FOSL2,346
chr1,90387127,90387355,SRX5054308,FOSL2,228
chr1,90391106,90391513,SRX5075168,SMARCA4,407
chr1,90391158,90391529,SRX5075174,SMARCA4,371
chr1,90391176,90391391,SRX5075169,SMARCA4,215
chr1,90391184,90391485,SRX5075170,SMARCA4,301
chr1,90391185,90391398,SRX5075176,SMARCA4,213
chr1,90391206,90391421,SRX5054307,FOSL2,215
chr1,90403014,90403661,SRX5075174,SMARCA4,647
chr1,90403039,90403725,SRX5075168,SMARCA4,686
chr1,90403064,90403567,SRX5716463,SMARCA4,503
chr1,90403096,90403555,SRX5716469,SMARCA4,459
chr1,90403098,90403659,SRX5075170,SMARCA4,561
chr1,90403102,90403695,SRX5075176,SMARCA4,593
chr1,90403108,90403616,SRX5054309,FOSL2,508
chr1,90403144,90403591,SRX5020211,SMARCA2,447
chr1,90403160,90403631,SRX5075175,SMARCA4,471
chr1,90403161,90403559,SRX5054307,FOSL2,398
chr1,90403162,90403603,SRX5716467,SMARCA2,441
chr1,90403164,90403606,SRX5054308,FOSL2,442
chr1,90403173,90403692,SRX5075169,SMARCA4,519
chr1,90403175,90403673,SRX5716470,SMARCA4,498
chr1,90403199,90403423,SRX5716451,SOX2,224
chr1,90403200,90403470,SRX5716454,SOX3,270
chr1,90403208,90403488,SRX5075181,SMARCA2,280
chr1,90403225,90403613,SRX5020214,SMARCA2,388
chr1,90403226,90403590,SRX5716468,SMARCA2,364
chr1,90403243,90403483,SRX5716453,SOX2,240
chr1,90403254,90403663,SRX5716459,Epitope tags,409
chr1,90403279,90403567,SRX5075182,SMARCA2,288
chr1,90403289,90403720,SRX5716460,Epitope tags,431
chr1,90412482,90412786,SRX5075168,SMARCA4,304
chr1,90412585,90412872,SRX5075170,SMARCA4,287
chr1,90412617,90412925,SRX5075176,SMARCA4,308
chr1,90412659,90413055,SRX5075174,SMARCA4,396
chr1,90417189,90417456,SRX5054309,FOSL2,267
chr1,90417203,90417459,SRX5054308,FOSL2,256
chr1,90417207,90417447,SRX5075169,SMARCA4,240
chr1,90434531,90434853,SRX16500059,CTCF,322
chr1,90434546,90434819,SRX16500061,CTCF,273
chr1,90434573,90434882,SRX16500060,CTCF,309
chr1,90475644,90475902,SRX16500061,CTCF,258
chr1,90475663,90475970,SRX16500059,CTCF,307
chr1,90475676,90476006,SRX16500060,CTCF,330
chr1,90475694,90475947,SRX16500062,CTCF,253
chr1,90475694,90475953,SRX5075174,SMARCA4,259
chr1,90475742,90475964,SRX5075168,SMARCA4,222
chr1,90488246,90488966,SRX5075176,SMARCA4,720
chr1,90488299,90488627,SRX5716459,Epitope tags,328
chr1,90488316,90489001,SRX5054309,FOSL2,685
chr1,90488326,90488957,SRX5075170,SMARCA4,631
chr1,90488329,90489009,SRX5054308,FOSL2,680
chr1,90488338,90488995,SRX5075169,SMARCA4,657
chr1,90488364,90488932,SRX5020211,SMARCA2,568
chr1,90488402,90488955,SRX5075175,SMARCA4,553
chr1,90488417,90488893,SRX5075181,SMARCA2,476
chr1,90488425,90488903,SRX5716469,SMARCA4,478
chr1,90488462,90488899,SRX5716470,SMARCA4,437
chr1,90488480,90488940,SRX5716467,SMARCA2,460
chr1,90488524,90488866,SRX5716468,SMARCA2,342
chr1,90488556,90488806,SRX5075182,SMARCA2,250
chr1,90502704,90503046,SRX5075174,SMARCA4,342
chr1,90502721,90503080,SRX5075168,SMARCA4,359
chr1,90512497,90512748,SRX5075174,SMARCA4,251
chr1,90534647,90534931,SRX5075168,SMARCA4,284
chr1,90534694,90535250,SRX5075174,SMARCA4,556
chr1,90534724,90534959,SRX5716463,SMARCA4,235
chr1,90534755,90535095,SRX20140895,INTS13,340
chr1,90551100,90551335,SRX16500059,CTCF,235
chr1,90579151,90579714,SRX16500059,CTCF,563
chr1,90579157,90579602,SRX16500062,CTCF,445
chr1,90579229,90579636,SRX16500060,CTCF,407
chr1,90579260,90579636,SRX16500061,CTCF,376
chr1,90579299,90579538,SRX5075174,SMARCA4,239
chr1,90579388,90579580,SRX5075168,SMARCA4,192
chr1,90614828,90615213,SRX16500060,CTCF,385
chr1,90614843,90615245,SRX16500059,CTCF,402
chr1,90614895,90615219,SRX16500062,CTCF,324
chr1,90614912,90615224,SRX16500061,CTCF,312
chr1,90707346,90707642,SRX5716470,SMARCA4,296
chr1,90707356,90707611,SRX5075175,SMARCA4,255
chr1,90707357,90707610,SRX5075169,SMARCA4,253
chr1,90707379,90707647,SRX5075170,SMARCA4,268
chr1,90707388,90707651,SRX5075176,SMARCA4,263
chr1,90707396,90707612,SRX5075168,SMARCA4,216
chr1,90707444,90707626,SRX5075174,SMARCA4,182
chr1,90721323,90721856,SRX16500059,CTCF,533
chr1,90721367,90721797,SRX16500061,CTCF,430
chr1,90721368,90721855,SRX16500062,CTCF,487
chr1,90721381,90721854,SRX16500060,CTCF,473
chr1,90721465,90721759,SRX4174629,CTCF,294
chr1,90721501,90721766,SRX5075168,SMARCA4,265
chr1,90721538,90721752,SRX5075174,SMARCA4,214
chr1,90723772,90724017,SRX16500059,CTCF,245
chr1,90723784,90724034,SRX16500061,CTCF,250
chr1,90723785,90724028,SRX16500060,CTCF,243
chr1,90723789,90724039,SRX16500062,CTCF,250
chr1,90729419,90729811,SRX16500062,CTCF,392
chr1,90729428,90729854,SRX16500060,CTCF,426
chr1,90729444,90729848,SRX16500059,CTCF,404
chr1,90729472,90729804,SRX16500061,CTCF,332
chr1,90729508,90729739,SRX5075174,SMARCA4,231
chr1,90850804,90851675,SRX20140895,INTS13,871
chr1,90850983,90851276,SRX5075174,SMARCA4,293
chr1,90851221,90851919,SRX16500061,CTCF,698
chr1,90851328,90851866,SRX16500059,CTCF,538
chr1,90851349,90851878,SRX16500060,CTCF,529
chr1,90851362,90851788,SRX5075176,SMARCA4,426
chr1,90851365,90851942,SRX16500062,CTCF,577
chr1,90851376,90851668,SRX5716469,SMARCA4,292
chr1,90851434,90851687,SRX5075175,SMARCA4,253
chr1,90851435,90851944,SRX5075174,SMARCA4,509
chr1,90851437,90851838,SRX5075169,SMARCA4,401
chr1,90851475,90851836,SRX5075170,SMARCA4,361
chr1,90851482,90851907,SRX5075168,SMARCA4,425
chr1,90851485,90851748,SRX5716470,SMARCA4,263
chr1,90851518,90851731,SRX5716463,SMARCA4,213
chr1,90851529,90851734,SRX5716464,SMARCA4,205
chr1,90926323,90926373,SRX1424891,POU3F2,50
chr1,90926938,90927298,SRX5075168,SMARCA4,360
chr1,90926954,90927245,SRX5716463,SMARCA4,291
chr1,90926975,90927348,SRX5075174,SMARCA4,373
chr1,90964368,90964838,SRX16500062,CTCF,470
chr1,90964408,90964902,SRX16500059,CTCF,494
chr1,90964409,90964876,SRX16500061,CTCF,467
chr1,90964442,90964840,SRX16500060,CTCF,398
chr1,90964513,90964692,SRX5075170,SMARCA4,179
chr1,90964539,90964735,SRX5075174,SMARCA4,196
chr1,90964554,90964746,SRX5075176,SMARCA4,192
chr1,90974335,90974737,SRX5075176,SMARCA4,402
chr1,90974377,90974722,SRX5075170,SMARCA4,345
chr1,90974402,90974688,SRX5054308,FOSL2,286
chr1,90974414,90974756,SRX5054309,FOSL2,342
chr1,90974429,90974677,SRX5075169,SMARCA4,248
chr1,90974448,90974660,SRX5075174,SMARCA4,212
chr1,90974458,90974715,SRX5075175,SMARCA4,257
chr1,90987855,90988075,SRX5075168,SMARCA4,220
chr1,90987950,90988133,SRX5075174,SMARCA4,183
chr1,91021162,91021472,SRX5716470,SMARCA4,310
chr1,91021180,91021691,SRX5075174,SMARCA4,511
chr1,91021223,91022417,SRX20140895,INTS13,1194
chr1,91021305,91021636,SRX20140896,INTS13,331
chr1,91021330,91021610,SRX5075170,SMARCA4,280
chr1,91021343,91022329,SRX20140867,INTS10,986
chr1,91021359,91021647,SRX5075168,SMARCA4,288
chr1,91021363,91022155,SRX20140897,INTS13,792
chr1,91021377,91022416,SRX20140868,INTS10,1039
chr1,91021519,91022264,SRX20140869,INTS10,745
chr1,91021725,91021936,SRX5075168,SMARCA4,211
chr1,91021748,91022323,SRX20140879,CPSF3L,575
chr1,91021777,91022284,SRX20140881,CPSF3L,507
chr1,91021782,91022057,SRX20140896,INTS13,275
chr1,91022022,91022297,SRX5716470,SMARCA4,275
chr1,91022050,91022330,SRX5075170,SMARCA4,280
chr1,91022056,91022462,SRX5075168,SMARCA4,406
chr1,91022060,91022444,SRX5075176,SMARCA4,384
chr1,91022140,91022387,SRX5716463,SMARCA4,247
chr1,91022155,91022357,SRX5075174,SMARCA4,202
chr1,91037057,91037334,SRX5075181,SMARCA2,277
chr1,91037064,91037343,SRX5020211,SMARCA2,279
chr1,91037069,91037296,SRX5716470,SMARCA4,227
chr1,91037086,91037376,SRX5075176,SMARCA4,290
chr1,91037089,91037355,SRX5716469,SMARCA4,266
chr1,91037091,91037341,SRX5075170,SMARCA4,250
chr1,91037114,91037374,SRX5054308,FOSL2,260
chr1,91165204,91165721,SRX16500059,CTCF,517
chr1,91165219,91165686,SRX16500061,CTCF,467
chr1,91165249,91165685,SRX16500060,CTCF,436
chr1,91165254,91165676,SRX16500062,CTCF,422
chr1,91165287,91165614,SRX5075174,SMARCA4,327
chr1,91165297,91165585,SRX5075168,SMARCA4,288
chr1,91165311,91165573,SRX5716464,SMARCA4,262
chr1,91165315,91166470,SRX4174629,CTCF,1155
chr1,91165347,91165538,SRX5075170,SMARCA4,191
chr1,91165372,91165547,SRX5075176,SMARCA4,175
chr1,91166001,91166525,SRX16500059,CTCF,524
chr1,91166036,91166559,SRX16500060,CTCF,523
chr1,91166042,91166482,SRX16500062,CTCF,440
chr1,91166100,91166518,SRX16500061,CTCF,418
chr1,91166152,91166381,SRX5716463,SMARCA4,229
chr1,91166165,91166490,SRX5075168,SMARCA4,325
chr1,91166174,91166423,SRX5075170,SMARCA4,249
chr1,91166186,91166532,SRX5075174,SMARCA4,346
chr1,91166201,91166479,SRX5075176,SMARCA4,278
chr1,91173374,91173581,SRX5075169,SMARCA4,207
chr1,91173390,91173752,SRX5075170,SMARCA4,362
chr1,91173396,91173750,SRX5075176,SMARCA4,354
chr1,91244775,91245032,SRX16500061,CTCF,257
chr1,91244783,91245053,SRX16500062,CTCF,270
chr1,91244852,91245087,SRX16500059,CTCF,235
chr1,91273914,91274199,SRX5075168,SMARCA4,285
chr1,91273953,91274145,SRX5075174,SMARCA4,192
chr1,91278768,91279065,SRX16500059,CTCF,297
chr1,91278810,91279096,SRX16500061,CTCF,286
chr1,91278828,91279095,SRX16500060,CTCF,267
chr1,91278840,91279034,SRX5075176,SMARCA4,194
chr1,91282622,91283133,SRX16500059,CTCF,511
chr1,91282628,91283124,SRX16500060,CTCF,496
chr1,91282666,91283092,SRX16500062,CTCF,426
chr1,91282676,91283097,SRX16500061,CTCF,421
chr1,91282745,91283025,SRX5075168,SMARCA4,280
chr1,91282760,91283041,SRX5075174,SMARCA4,281
chr1,91282771,91283025,SRX5716463,SMARCA4,254
chr1,91282803,91283120,SRX5075170,SMARCA4,317
chr1,91282807,91283044,SRX5075169,SMARCA4,237
chr1,91282813,91283036,SRX5716469,SMARCA4,223
chr1,91282816,91283026,SRX4174629,CTCF,210
chr1,91282820,91283035,SRX5075176,SMARCA4,215
chr1,91282857,91283057,SRX5075175,SMARCA4,200
chr1,91335648,91335913,SRX5075170,SMARCA4,265
chr1,91335671,91335894,SRX5075176,SMARCA4,223
chr1,91335688,91335969,SRX5054309,FOSL2,281
chr1,91335691,91335929,SRX5054308,FOSL2,238
chr1,91383370,91383850,SRX5716470,SMARCA4,480
chr1,91383387,91383832,SRX5716469,SMARCA4,445
chr1,91383394,91383858,SRX5075170,SMARCA4,464
chr1,91383407,91383860,SRX5075176,SMARCA4,453
chr1,91383436,91383880,SRX5075169,SMARCA4,444
chr1,91383450,91383768,SRX5020214,SMARCA2,318
chr1,91383474,91383848,SRX5716467,SMARCA2,374
chr1,91383475,91383791,SRX5716468,SMARCA2,316
chr1,91383484,91383827,SRX5075175,SMARCA4,343
chr1,91383516,91383796,SRX5020211,SMARCA2,280
chr1,91383518,91383875,SRX5054309,FOSL2,357
chr1,91383523,91383863,SRX5054308,FOSL2,340
chr1,91387139,91387609,SRX16500061,CTCF,470
chr1,91387151,91387582,SRX16500062,CTCF,431
chr1,91387174,91387549,SRX4174629,CTCF,375
chr1,91387198,91387658,SRX16500059,CTCF,460
chr1,91387201,91387627,SRX16500060,CTCF,426
chr1,91387234,91387545,SRX1424893,POU3F2,311
chr1,91387235,91387534,SRX1424891,POU3F2,299
chr1,91387236,91387536,SRX1424892,POU3F2,300
chr1,91387236,91387541,SRX1424894,POU3F2,305
chr1,91387249,91387521,SRX20140895,INTS13,272
chr1,91387251,91387513,SRX20140867,INTS10,262
chr1,91387299,91387594,SRX5716455,SOX3,295
chr1,91397578,91397912,SRX5075176,SMARCA4,334
chr1,91397597,91397817,SRX5054309,FOSL2,220
chr1,91397601,91397991,SRX5075170,SMARCA4,390
chr1,91397611,91397934,SRX5716469,SMARCA4,323
chr1,91397618,91397952,SRX5054308,FOSL2,334
chr1,91397643,91397907,SRX5075169,SMARCA4,264
chr1,91397667,91397884,SRX5716467,SMARCA2,217
chr1,91397680,91397946,SRX5075175,SMARCA4,266
chr1,91401207,91401510,SRX5075168,SMARCA4,303
chr1,91401223,91401533,SRX5075174,SMARCA4,310
chr1,91401284,91401550,SRX5716463,SMARCA4,266
chr1,91401289,91401529,SRX5716464,SMARCA4,240
chr1,91401846,91402327,SRX16500060,CTCF,481
chr1,91401864,91402267,SRX16500059,CTCF,403
chr1,91401878,91402339,SRX16500061,CTCF,461
chr1,91401952,91402343,SRX16500062,CTCF,391
chr1,91404196,91404786,SRX5075174,SMARCA4,590
chr1,91404197,91404933,SRX5075169,SMARCA4,736
chr1,91404219,91404900,SRX5075170,SMARCA4,681
chr1,91404235,91404940,SRX20140895,INTS13,705
chr1,91404243,91404858,SRX5075176,SMARCA4,615
chr1,91404257,91404758,SRX5075168,SMARCA4,501
chr1,91404281,91404866,SRX20140868,INTS10,585
chr1,91404399,91404842,SRX20140867,INTS10,443
chr1,91404430,91404828,SRX20140897,INTS13,398
chr1,91404462,91404882,SRX5716470,SMARCA4,420
chr1,91404483,91404848,SRX20140881,CPSF3L,365
chr1,91404514,91404924,SRX5075175,SMARCA4,410
chr1,91404582,91404892,SRX20140879,CPSF3L,310
chr1,91404613,91404881,SRX5716469,SMARCA4,268
chr1,91450225,91450695,SRX5075170,SMARCA4,470
chr1,91450263,91450635,SRX5075169,SMARCA4,372
chr1,91450343,91450601,SRX5075175,SMARCA4,258
chr1,91450352,91450668,SRX5075176,SMARCA4,316
chr1,91450361,91450588,SRX5020211,SMARCA2,227
chr1,91450455,91450718,SRX5716469,SMARCA4,263
chr1,91477129,91477412,SRX5075176,SMARCA4,283
chr1,91477172,91477402,SRX5075170,SMARCA4,230
chr1,91490567,91490915,SRX5075170,SMARCA4,348
chr1,91490619,91490896,SRX5075176,SMARCA4,277
chr1,91500577,91500775,SRX5075170,SMARCA4,198
chr1,91500623,91500827,SRX5075176,SMARCA4,204
chr1,91500632,91500874,SRX5075174,SMARCA4,242
chr1,91500661,91500974,SRX5075168,SMARCA4,313
chr1,91500860,91501769,SRX20140895,INTS13,909
chr1,91500868,91501604,SRX20140867,INTS10,736
chr1,91501150,91501612,SRX20140868,INTS10,462
chr1,91501181,91501713,SRX16500060,CTCF,532
chr1,91501204,91501590,SRX5075175,SMARCA4,386
chr1,91501215,91501708,SRX16500059,CTCF,493
chr1,91501216,91501787,SRX5075174,SMARCA4,571
chr1,91501222,91501482,SRX5716470,SMARCA4,260
chr1,91501235,91501777,SRX5075169,SMARCA4,542
chr1,91501247,91501699,SRX16500062,CTCF,452
chr1,91501270,91501665,SRX16500061,CTCF,395
chr1,91501288,91501734,SRX5075170,SMARCA4,446
chr1,91501315,91501660,SRX5075168,SMARCA4,345
chr1,91501323,91501570,SRX20140879,CPSF3L,247
chr1,91501331,91501575,SRX5075176,SMARCA4,244
chr1,91501341,91501637,SRX5716463,SMARCA4,296
chr1,91501404,91501710,SRX4174629,CTCF,306
chr1,91511337,91511790,SRX16500061,CTCF,453
chr1,91511344,91511779,SRX16500059,CTCF,435
chr1,91511361,91511798,SRX16500062,CTCF,437
chr1,91511406,91511808,SRX16500060,CTCF,402
chr1,91511473,91511689,SRX5075174,SMARCA4,216
chr1,91511536,91511762,SRX5075168,SMARCA4,226
chr1,91511546,91511735,SRX5075176,SMARCA4,189
chr1,91513228,91513486,SRX16500061,CTCF,258
chr1,91513247,91513529,SRX16500060,CTCF,282
chr1,91527837,91528011,SRX5075170,SMARCA4,174
chr1,91529814,91530199,SRX16500060,CTCF,385
chr1,91529853,91530189,SRX16500059,CTCF,336
chr1,91529884,91530137,SRX16500062,CTCF,253
chr1,91529924,91530213,SRX16500061,CTCF,289
chr1,91537300,91537543,SRX5075176,SMARCA4,243
chr1,91537305,91537598,SRX5075169,SMARCA4,293
chr1,91537314,91537585,SRX5075175,SMARCA4,271
chr1,91537376,91537555,SRX5075170,SMARCA4,179
chr1,91548590,91548811,SRX5075170,SMARCA4,221
chr1,91555113,91555347,SRX16500061,CTCF,234
chr1,91555470,91555683,SRX5054308,FOSL2,213
chr1,91557077,91557338,SRX5716470,SMARCA4,261
chr1,91564795,91565375,SRX5075176,SMARCA4,580
chr1,91564801,91565756,SRX5075174,SMARCA4,955
chr1,91564813,91565811,SRX5075168,SMARCA4,998
chr1,91564858,91565363,SRX5075170,SMARCA4,505
chr1,91564884,91565152,SRX5716470,SMARCA4,268
chr1,91564909,91565273,SRX5716469,SMARCA4,364
chr1,91564914,91565195,SRX5716467,SMARCA2,281
chr1,91564932,91565259,SRX5075169,SMARCA4,327
chr1,91564948,91565226,SRX5075175,SMARCA4,278
chr1,91564950,91565784,SRX20140895,INTS13,834
chr1,91564964,91565432,SRX5716451,SOX2,468
chr1,91564989,91565475,SRX20140860,SOX2,486
chr1,91564994,91565644,SRX5716463,SMARCA4,650
chr1,91564995,91565610,SRX20140867,INTS10,615
chr1,91565023,91565671,SRX20140868,INTS10,648
chr1,91565035,91565395,SRX5716464,SMARCA4,360
chr1,91565043,91565573,SRX20140880,CPSF3L,530
chr1,91565069,91565658,SRX20140879,CPSF3L,589
chr1,91565077,91565548,SRX5716454,SOX3,471
chr1,91565084,91565677,SRX20140881,CPSF3L,593
chr1,91565111,91565648,SRX20140894,INTS13,537
chr1,91565123,91565427,SRX20140861,SOX2,304
chr1,91565594,91565655,SRX1424891,POU3F2,61
chr1,91565601,91565667,SRX1424893,POU3F2,66
chr1,91569736,91570076,SRX5054309,FOSL2,340
chr1,91569769,91570288,SRX5075175,SMARCA4,519
chr1,91569783,91570019,SRX5054308,FOSL2,236
chr1,91569790,91570236,SRX5075170,SMARCA4,446
chr1,91569792,91570246,SRX5075169,SMARCA4,454
chr1,91569853,91570232,SRX5075176,SMARCA4,379
chr1,91569855,91570132,SRX5716470,SMARCA4,277
chr1,91569859,91570121,SRX5716469,SMARCA4,262
chr1,91582549,91582935,SRX5054308,FOSL2,386
chr1,91582554,91582946,SRX5054309,FOSL2,392
chr1,91582600,91582899,SRX5075176,SMARCA4,299
chr1,91582613,91582979,SRX5075170,SMARCA4,366
chr1,91582622,91583071,SRX5075169,SMARCA4,449
chr1,91582623,91582984,SRX5020211,SMARCA2,361
chr1,91582624,91582953,SRX5075175,SMARCA4,329
chr1,91582642,91582897,SRX5020214,SMARCA2,255
chr1,91582657,91582931,SRX5716470,SMARCA4,274
chr1,91582690,91582898,SRX5075182,SMARCA2,208
chr1,91583250,91583716,SRX5075176,SMARCA4,466
chr1,91583253,91583651,SRX5075169,SMARCA4,398
chr1,91583264,91583704,SRX5075170,SMARCA4,440
chr1,91583396,91583709,SRX5075175,SMARCA4,313
chr1,91589559,91589751,SRX5075176,SMARCA4,192
chr1,91589566,91589832,SRX5075170,SMARCA4,266
chr1,91596498,91596757,SRX5054308,FOSL2,259
chr1,91596520,91596720,SRX5075176,SMARCA4,200
chr1,91596520,91596762,SRX5054309,FOSL2,242
chr1,91596563,91596743,SRX5075170,SMARCA4,180
chr1,91604516,91605084,SRX5075176,SMARCA4,568
chr1,91604537,91605128,SRX5075170,SMARCA4,591
chr1,91604578,91605016,SRX5716470,SMARCA4,438
chr1,91604617,91604961,SRX5075175,SMARCA4,344
chr1,91604671,91604871,SRX5075169,SMARCA4,200
chr1,91604720,91605040,SRX5716467,SMARCA2,320
chr1,91604760,91604992,SRX5716469,SMARCA4,232
chr1,91617340,91617717,SRX5075176,SMARCA4,377
chr1,91617384,91617639,SRX5075169,SMARCA4,255
chr1,91617403,91617729,SRX5075170,SMARCA4,326
chr1,91617569,91617831,SRX16500060,CTCF,262
chr1,91619848,91620142,SRX5075176,SMARCA4,294
chr1,91619946,91620275,SRX5075170,SMARCA4,329
chr1,91622086,91622345,SRX5075170,SMARCA4,259
chr1,91644980,91645439,SRX5075168,SMARCA4,459
chr1,91645168,91645378,SRX5075174,SMARCA4,210
chr1,91645178,91645427,SRX5716463,SMARCA4,249
chr1,91650692,91651113,SRX5075170,SMARCA4,421
chr1,91650728,91651113,SRX5075175,SMARCA4,385
chr1,91650728,91651177,SRX5075176,SMARCA4,449
chr1,91650729,91651178,SRX5075169,SMARCA4,449
chr1,91650772,91651084,SRX5054309,FOSL2,312
chr1,91650835,91651109,SRX5054308,FOSL2,274
chr1,91650842,91651151,SRX5716469,SMARCA4,309
chr1,91651580,91652128,SRX5716470,SMARCA4,548
chr1,91651616,91652173,SRX5075176,SMARCA4,557
chr1,91651617,91652097,SRX5075170,SMARCA4,480
chr1,91651671,91652128,SRX5716469,SMARCA4,457
chr1,91651684,91652095,SRX5075175,SMARCA4,411
chr1,91651690,91652100,SRX5075169,SMARCA4,410
chr1,91651728,91652081,SRX5716468,SMARCA2,353
chr1,91651754,91651954,SRX5020211,SMARCA2,200
chr1,91651763,91652185,SRX5716467,SMARCA2,422
chr1,91651786,91652039,SRX5054309,FOSL2,253
chr1,91651812,91652017,SRX5054308,FOSL2,205
chr1,91684453,91685160,SRX5075170,SMARCA4,707
chr1,91684685,91685207,SRX5075176,SMARCA4,522
chr1,91699555,91699916,SRX5075176,SMARCA4,361
chr1,91699574,91699898,SRX5075169,SMARCA4,324
chr1,91699585,91699925,SRX5075170,SMARCA4,340
chr1,91699668,91699881,SRX5075175,SMARCA4,213
chr1,91700394,91700597,SRX5054309,FOSL2,203
chr1,91700819,91701354,SRX5075176,SMARCA4,535
chr1,91700833,91701252,SRX5716470,SMARCA4,419
chr1,91700836,91701374,SRX5075170,SMARCA4,538
chr1,91700885,91701288,SRX5075169,SMARCA4,403
chr1,91700897,91701203,SRX5075175,SMARCA4,306
chr1,91700914,91701295,SRX5716469,SMARCA4,381
chr1,91700915,91701245,SRX5716467,SMARCA2,330
chr1,91700959,91701281,SRX5716468,SMARCA2,322
chr1,91725783,91726656,SRX5075176,SMARCA4,873
chr1,91725819,91726466,SRX5075170,SMARCA4,647
chr1,91725862,91726238,SRX5075175,SMARCA4,376
chr1,91725885,91726193,SRX5716469,SMARCA4,308
chr1,91725928,91726261,SRX5054309,FOSL2,333
chr1,91725943,91726249,SRX5716467,SMARCA2,306
chr1,91725970,91726735,SRX5075169,SMARCA4,765
chr1,91726013,91726224,SRX5716470,SMARCA4,211
chr1,91726034,91726220,SRX5054308,FOSL2,186
chr1,91726075,91726335,SRX5716460,Epitope tags,260
chr1,91726467,91726668,SRX5075175,SMARCA4,201
chr1,91731379,91731701,SRX5075170,SMARCA4,322
chr1,91731394,91731666,SRX5075176,SMARCA4,272
chr1,91732554,91732837,SRX5054308,FOSL2,283
chr1,91732557,91732888,SRX5054309,FOSL2,331
chr1,91732579,91733083,SRX5075169,SMARCA4,504
chr1,91732604,91732833,SRX5075176,SMARCA4,229
chr1,91732628,91732873,SRX5716469,SMARCA4,245
chr1,91732650,91732889,SRX5075175,SMARCA4,239
chr1,91736939,91737361,SRX5075168,SMARCA4,422
chr1,91736965,91737277,SRX5075176,SMARCA4,312
chr1,91736991,91737289,SRX5075175,SMARCA4,298
chr1,91736991,91737408,SRX5075174,SMARCA4,417
chr1,91737002,91737283,SRX5716470,SMARCA4,281
chr1,91737055,91737310,SRX5716463,SMARCA4,255
chr1,91737094,91737275,SRX5075169,SMARCA4,181
chr1,91737097,91737368,SRX5075170,SMARCA4,271
chr1,91742674,91743012,SRX5716467,SMARCA2,338
chr1,91742822,91743295,SRX5075176,SMARCA4,473
chr1,91742870,91743151,SRX5075170,SMARCA4,281
chr1,91742872,91743058,SRX5075169,SMARCA4,186
chr1,91742897,91743166,SRX5075175,SMARCA4,269
chr1,91745626,91745852,SRX5075170,SMARCA4,226
chr1,91750422,91750659,SRX5075175,SMARCA4,237
chr1,91750429,91750737,SRX5054308,FOSL2,308
chr1,91750468,91750742,SRX5075169,SMARCA4,274
chr1,91750478,91750715,SRX5054309,FOSL2,237
chr1,91751158,91751741,SRX5075170,SMARCA4,583
chr1,91751166,91751740,SRX5075176,SMARCA4,574
chr1,91751217,91751490,SRX5716470,SMARCA4,273
chr1,91751331,91751579,SRX5716468,SMARCA2,248
chr1,91751366,91751698,SRX5075175,SMARCA4,332
chr1,91751378,91751687,SRX5716467,SMARCA2,309
chr1,91754341,91754603,SRX5054308,FOSL2,262
chr1,91755320,91755522,SRX5075176,SMARCA4,202
chr1,91755346,91755587,SRX5075170,SMARCA4,241
chr1,91768831,91769047,SRX5075175,SMARCA4,216
chr1,91768858,91769075,SRX5075169,SMARCA4,217
chr1,91769711,91770061,SRX5075174,SMARCA4,350
chr1,91769783,91770038,SRX5075168,SMARCA4,255
chr1,91769797,91770043,SRX5716464,SMARCA4,246
chr1,91778905,91779181,SRX5075174,SMARCA4,276
chr1,91779065,91779324,SRX5075168,SMARCA4,259
chr1,91781229,91781703,SRX5716467,SMARCA2,474
chr1,91781232,91781735,SRX5075175,SMARCA4,503
chr1,91781237,91781834,SRX5075176,SMARCA4,597
chr1,91781242,91781800,SRX5075169,SMARCA4,558
chr1,91781251,91781799,SRX5075170,SMARCA4,548
chr1,91781273,91781693,SRX5716469,SMARCA4,420
chr1,91781312,91781773,SRX5054308,FOSL2,461
chr1,91781313,91781659,SRX5716468,SMARCA2,346
chr1,91781323,91781647,SRX5020211,SMARCA2,324
chr1,91781343,91781714,SRX5716470,SMARCA4,371
chr1,91781349,91781768,SRX5054309,FOSL2,419
chr1,91781371,91781657,SRX5716460,Epitope tags,286
chr1,91781380,91781686,SRX5075181,SMARCA2,306
chr1,91781432,91781663,SRX5020214,SMARCA2,231
chr1,91781433,91781648,SRX5054307,FOSL2,215
chr1,91791235,91791469,SRX16500060,CTCF,234
chr1,91791352,91791563,SRX4174629,CTCF,211
chr1,91795446,91795968,SRX5075176,SMARCA4,522
chr1,91795503,91796051,SRX5075170,SMARCA4,548
chr1,91795512,91795946,SRX5075175,SMARCA4,434
chr1,91795560,91796008,SRX5075169,SMARCA4,448
chr1,91795584,91795956,SRX5716469,SMARCA4,372
chr1,91795591,91795935,SRX5020211,SMARCA2,344
chr1,91795606,91795941,SRX5054308,FOSL2,335
chr1,91795640,91795886,SRX5716470,SMARCA4,246
chr1,91795642,91795880,SRX5716467,SMARCA2,238
chr1,91795679,91796054,SRX5716468,SMARCA2,375
chr1,91795925,91796170,SRX5054309,FOSL2,245
chr1,91804614,91804861,SRX5054309,FOSL2,247
chr1,91804643,91804852,SRX5054308,FOSL2,209
chr1,91806187,91806974,SRX5075176,SMARCA4,787
chr1,91806223,91806809,SRX5075175,SMARCA4,586
chr1,91806247,91806825,SRX5075170,SMARCA4,578
chr1,91806292,91806695,SRX5716470,SMARCA4,403
chr1,91806426,91806689,SRX5716467,SMARCA2,263
chr1,91818240,91818593,SRX5075168,SMARCA4,353
chr1,91818300,91818574,SRX5075174,SMARCA4,274
chr1,91818327,91818780,SRX5075176,SMARCA4,453
chr1,91818343,91818821,SRX5075170,SMARCA4,478
chr1,91830227,91830503,SRX5075170,SMARCA4,276
chr1,91830249,91830620,SRX5075176,SMARCA4,371
chr1,91830254,91830639,SRX5716470,SMARCA4,385
chr1,91830263,91830520,SRX5075175,SMARCA4,257
chr1,91830265,91830581,SRX5716469,SMARCA4,316
chr1,91830284,91830624,SRX5075169,SMARCA4,340
chr1,91830321,91830532,SRX5716468,SMARCA2,211
chr1,91830328,91830550,SRX5716467,SMARCA2,222
chr1,91844856,91845393,SRX5075170,SMARCA4,537
chr1,91844877,91845324,SRX5075175,SMARCA4,447
chr1,91844878,91845328,SRX5716470,SMARCA4,450
chr1,91844893,91845373,SRX5075169,SMARCA4,480
chr1,91844901,91845374,SRX5075176,SMARCA4,473
chr1,91844926,91845289,SRX5716469,SMARCA4,363
chr1,91844926,91845296,SRX5716468,SMARCA2,370
chr1,91844948,91845415,SRX5054309,FOSL2,467
chr1,91844960,91845313,SRX5716467,SMARCA2,353
chr1,91845045,91845396,SRX5054308,FOSL2,351
chr1,91845047,91845335,SRX5020214,SMARCA2,288
chr1,91846105,91846307,SRX5075176,SMARCA4,202
chr1,91851138,91851689,SRX5075176,SMARCA4,551
chr1,91851199,91851671,SRX5075169,SMARCA4,472
chr1,91851269,91851637,SRX5075170,SMARCA4,368
chr1,91851326,91851628,SRX5716467,SMARCA2,302
chr1,91851344,91851637,SRX5716470,SMARCA4,293
chr1,91851359,91851595,SRX5716469,SMARCA4,236
chr1,91864014,91864687,SRX5075176,SMARCA4,673
chr1,91864016,91864248,SRX5716469,SMARCA4,232
chr1,91864061,91864699,SRX5075170,SMARCA4,638
chr1,91864090,91864650,SRX5075175,SMARCA4,560
chr1,91864104,91864748,SRX5075169,SMARCA4,644
chr1,91864143,91864497,SRX5716470,SMARCA4,354
chr1,91872715,91872915,SRX5075168,SMARCA4,200
chr1,91876776,91877102,SRX5075176,SMARCA4,326
chr1,91876800,91877145,SRX5075170,SMARCA4,345
chr1,91876810,91877023,SRX5716470,SMARCA4,213
chr1,91876838,91877075,SRX5075169,SMARCA4,237
chr1,91876850,91877050,SRX5075175,SMARCA4,200
chr1,91883354,91883600,SRX16500060,CTCF,246
chr1,91883421,91883681,SRX16500059,CTCF,260
chr1,91885724,91886612,SRX20140895,INTS13,888
chr1,91885845,91886215,SRX5075174,SMARCA4,370
chr1,91885936,91886520,SRX20140868,INTS10,584
chr1,91885942,91886501,SRX5075170,SMARCA4,559
chr1,91885989,91886431,SRX20140867,INTS10,442
chr1,91885990,91886493,SRX5075176,SMARCA4,503
chr1,91886019,91886468,SRX5075168,SMARCA4,449
chr1,91886025,91886336,SRX5075169,SMARCA4,311
chr1,91886284,91886457,SRX5075174,SMARCA4,173
chr1,91891941,91892353,SRX5075170,SMARCA4,412
chr1,91891983,91892285,SRX5054309,FOSL2,302
chr1,91891996,91892325,SRX5075169,SMARCA4,329
chr1,91892013,91892301,SRX5075176,SMARCA4,288
chr1,91892036,91892267,SRX5075175,SMARCA4,231
chr1,91900548,91900869,SRX5075175,SMARCA4,321
chr1,91900558,91900896,SRX5075169,SMARCA4,338
chr1,91900560,91900910,SRX5075170,SMARCA4,350
chr1,91900568,91900902,SRX5054309,FOSL2,334
chr1,91900570,91900837,SRX5020214,SMARCA2,267
chr1,91900576,91900912,SRX5075176,SMARCA4,336
chr1,91900596,91900877,SRX5054308,FOSL2,281
chr1,91900598,91900854,SRX5716469,SMARCA4,256
chr1,91924139,91924411,SRX5075176,SMARCA4,272
chr1,91924171,91924487,SRX5075170,SMARCA4,316
chr1,91924172,91924542,SRX5054308,FOSL2,370
chr1,91924192,91924422,SRX5075169,SMARCA4,230
chr1,91924200,91924520,SRX5054309,FOSL2,320
chr1,91924214,91924517,SRX5075175,SMARCA4,303
chr1,91924267,91924513,SRX5020211,SMARCA2,246
chr1,91927228,91927762,SRX16500060,CTCF,534
chr1,91927260,91927717,SRX16500062,CTCF,457
chr1,91927264,91927788,SRX16500059,CTCF,524
chr1,91927275,91927766,SRX16500061,CTCF,491
chr1,91927575,91927831,SRX4174629,CTCF,256
chr1,91929283,91929573,SRX5716470,SMARCA4,290
chr1,91929297,91929710,SRX5075176,SMARCA4,413
chr1,91929327,91929626,SRX5075170,SMARCA4,299
chr1,91929373,91929620,SRX5075175,SMARCA4,247
chr1,91997567,91998065,SRX16500060,CTCF,498
chr1,91997582,91998034,SRX16500061,CTCF,452
chr1,91997620,91997993,SRX16500062,CTCF,373
chr1,91997638,91998072,SRX16500059,CTCF,434
chr1,92029751,92030010,SRX5075170,SMARCA4,259
chr1,92029775,92030437,SRX20140895,INTS13,662
chr1,92029793,92030301,SRX5075169,SMARCA4,508
chr1,92029878,92030339,SRX20140868,INTS10,461
chr1,92029985,92030285,SRX5075174,SMARCA4,300
chr1,92030872,92031090,SRX5075168,SMARCA4,218
chr1,92030964,92031163,SRX5075174,SMARCA4,199
chr1,92030968,92031171,SRX5075176,SMARCA4,203
chr1,92030982,92031210,SRX5075170,SMARCA4,228
chr1,92037320,92037840,SRX5075174,SMARCA4,520
chr1,92037322,92037856,SRX5716463,SMARCA4,534
chr1,92037331,92037854,SRX5075168,SMARCA4,523
chr1,92037349,92037667,SRX5716464,SMARCA4,318
chr1,92037405,92037764,SRX5075176,SMARCA4,359
chr1,92037420,92037710,SRX5075170,SMARCA4,290
chr1,92037425,92037650,SRX5054307,FOSL2,225
chr1,92037439,92037736,SRX5054309,FOSL2,297
chr1,92037456,92037650,SRX5054308,FOSL2,194
chr1,92037479,92037735,SRX5716469,SMARCA4,256
chr1,92037526,92037780,SRX20140867,INTS10,254
chr1,92037527,92037762,SRX5075169,SMARCA4,235
chr1,92052111,92052296,SRX5075168,SMARCA4,185
chr1,92080054,92080712,SRX5075174,SMARCA4,658
chr1,92080064,92080486,SRX5716469,SMARCA4,422
chr1,92080126,92080846,SRX5075168,SMARCA4,720
chr1,92080131,92080728,SRX5075170,SMARCA4,597
chr1,92080153,92080416,SRX5075176,SMARCA4,263
chr1,92080217,92080488,SRX5075175,SMARCA4,271
chr1,92080318,92080708,SRX5075169,SMARCA4,390
chr1,92080332,92080733,SRX20140895,INTS13,401
chr1,92080349,92080859,SRX5716470,SMARCA4,510
chr1,92080613,92080923,SRX5075176,SMARCA4,310
chr1,92087529,92087940,SRX5075176,SMARCA4,411
chr1,92087542,92087891,SRX5716470,SMARCA4,349
chr1,92087560,92087906,SRX5075170,SMARCA4,346
chr1,92087561,92087883,SRX5716467,SMARCA2,322
chr1,92087577,92087955,SRX5075175,SMARCA4,378
chr1,92087602,92087826,SRX5716468,SMARCA2,224
chr1,92087613,92087895,SRX5075169,SMARCA4,282
chr1,92087621,92087851,SRX5716469,SMARCA4,230
chr1,92117512,92117783,SRX5075174,SMARCA4,271
chr1,92168712,92169045,SRX5075174,SMARCA4,333
chr1,92168724,92169052,SRX5075168,SMARCA4,328
chr1,92184665,92185102,SRX5075169,SMARCA4,437
chr1,92184668,92185084,SRX5075170,SMARCA4,416
chr1,92184671,92185049,SRX5075176,SMARCA4,378
chr1,92184690,92185046,SRX5716470,SMARCA4,356
chr1,92184692,92184968,SRX5054309,FOSL2,276
chr1,92184692,92185002,SRX5020214,SMARCA2,310
chr1,92184694,92184968,SRX5716468,SMARCA2,274
chr1,92184704,92185066,SRX5716469,SMARCA4,362
chr1,92184711,92185012,SRX5075175,SMARCA4,301
chr1,92184721,92184983,SRX5054308,FOSL2,262
chr1,92184724,92185041,SRX5716467,SMARCA2,317
chr1,92184725,92185011,SRX5020211,SMARCA2,286
chr1,92184733,92185061,SRX5075181,SMARCA2,328
chr1,92184746,92184935,SRX5075182,SMARCA2,189
chr1,92277129,92277437,SRX5075169,SMARCA4,308
chr1,92277149,92277435,SRX5054309,FOSL2,286
chr1,92277179,92277496,SRX5075175,SMARCA4,317
chr1,92277194,92277450,SRX5075170,SMARCA4,256
chr1,92277218,92277477,SRX5054308,FOSL2,259
chr1,92291349,92291789,SRX16500060,CTCF,440
chr1,92291354,92291774,SRX16500059,CTCF,420
chr1,92291374,92291711,SRX5075176,SMARCA4,337
chr1,92291384,92291721,SRX16500062,CTCF,337
chr1,92291412,92291725,SRX16500061,CTCF,313
chr1,92291429,92291684,SRX5075174,SMARCA4,255
chr1,92291429,92291688,SRX5075170,SMARCA4,259
chr1,92291440,92291701,SRX5075169,SMARCA4,261
chr1,92291456,92291675,SRX5716470,SMARCA4,219
chr1,92291458,92291669,SRX5075168,SMARCA4,211
chr1,92298501,92299249,SRX20140895,INTS13,748
chr1,92298556,92299210,SRX5075174,SMARCA4,654
chr1,92298565,92299212,SRX5075168,SMARCA4,647
chr1,92298567,92299281,SRX5075176,SMARCA4,714
chr1,92298569,92299230,SRX5075170,SMARCA4,661
chr1,92298574,92299172,SRX20140869,INTS10,598
chr1,92298596,92298814,SRX5075175,SMARCA4,218
chr1,92298596,92299184,SRX20140867,INTS10,588
chr1,92298602,92299150,SRX20140897,INTS13,548
chr1,92298616,92298947,SRX5075169,SMARCA4,331
chr1,92298619,92299247,SRX20140868,INTS10,628
chr1,92298624,92299038,SRX20140879,CPSF3L,414
chr1,92298640,92298921,SRX5716469,SMARCA4,281
chr1,92298666,92299134,SRX20140881,CPSF3L,468
chr1,92298775,92299063,SRX20140896,INTS13,288
chr1,92298984,92299359,SRX5075175,SMARCA4,375
chr1,92299020,92299271,SRX5075169,SMARCA4,251
chr1,92310032,92310505,SRX16500061,CTCF,473
chr1,92310040,92310480,SRX16500062,CTCF,440
chr1,92310058,92310482,SRX16500060,CTCF,424
chr1,92310112,92310537,SRX16500059,CTCF,425
chr1,92411555,92411877,SRX5054309,FOSL2,322
chr1,92411565,92411853,SRX5054308,FOSL2,288
chr1,92411571,92411798,SRX5075176,SMARCA4,227
chr1,92411618,92411846,SRX5075170,SMARCA4,228
chr1,92411650,92411830,SRX5075169,SMARCA4,180
chr1,92442334,92442548,SRX5075168,SMARCA4,214
chr1,92442479,92442710,SRX5075174,SMARCA4,231
chr1,92486876,92487125,SRX5075168,SMARCA4,249
chr1,92502193,92502543,SRX5054309,FOSL2,350
chr1,92502218,92502508,SRX5716469,SMARCA4,290
chr1,92502221,92502496,SRX5075176,SMARCA4,275
chr1,92502224,92502512,SRX5075169,SMARCA4,288
chr1,92502226,92502417,SRX5054308,FOSL2,191
chr1,92502244,92502536,SRX5075170,SMARCA4,292
chr1,92502253,92502500,SRX5075175,SMARCA4,247
chr1,92577585,92577910,SRX5054308,FOSL2,325
chr1,92577615,92577974,SRX5075176,SMARCA4,359
chr1,92577645,92577913,SRX5054309,FOSL2,268
chr1,92577650,92577837,SRX5075169,SMARCA4,187
chr1,92577658,92577921,SRX5075170,SMARCA4,263
chr1,92577686,92577922,SRX5075175,SMARCA4,236
chr1,92584489,92584749,SRX5054308,FOSL2,260
chr1,92584500,92584767,SRX5054309,FOSL2,267
chr1,92599182,92599526,SRX16500061,CTCF,344
chr1,92599194,92599593,SRX16500060,CTCF,399
chr1,92599220,92599566,SRX16500059,CTCF,346
chr1,92599224,92599698,SRX16500062,CTCF,474
chr1,92623162,92623565,SRX16500062,CTCF,403
chr1,92623234,92623534,SRX16500060,CTCF,300
chr1,92623241,92623592,SRX16500059,CTCF,351
chr1,92623275,92623536,SRX16500061,CTCF,261
chr1,92749026,92749269,SRX16500060,CTCF,243
chr1,92749125,92749391,SRX16500062,CTCF,266
chr1,92749164,92749346,SRX5075168,SMARCA4,182
chr1,92753945,92754412,SRX5075176,SMARCA4,467
chr1,92753956,92754528,SRX5075169,SMARCA4,572
chr1,92753962,92754406,SRX5075170,SMARCA4,444
chr1,92753962,92754406,SRX5075175,SMARCA4,444
chr1,92753964,92754381,SRX5054308,FOSL2,417
chr1,92753965,92754296,SRX5020211,SMARCA2,331
chr1,92753967,92754429,SRX5054309,FOSL2,462
chr1,92753993,92754371,SRX5716469,SMARCA4,378
chr1,92754019,92754252,SRX5716467,SMARCA2,233
chr1,92754047,92754290,SRX5020214,SMARCA2,243
chr1,92754158,92754431,SRX5075182,SMARCA2,273
chr1,92784525,92785464,SRX5716470,SMARCA4,939
chr1,92784624,92785571,SRX5075170,SMARCA4,947
chr1,92784650,92785052,SRX5716469,SMARCA4,402
chr1,92784736,92785570,SRX5075176,SMARCA4,834
chr1,92784756,92785621,SRX20140895,INTS13,865
chr1,92784798,92785206,SRX20140897,INTS13,408
chr1,92784801,92785624,SRX5075168,SMARCA4,823
chr1,92784873,92785420,SRX5075175,SMARCA4,547
chr1,92784883,92785171,SRX20140867,INTS10,288
chr1,92784889,92785156,SRX20140869,INTS10,267
chr1,92784930,92785391,SRX5075169,SMARCA4,461
chr1,92784990,92785560,SRX5075174,SMARCA4,570
chr1,92785113,92785454,SRX5716451,SOX2,341
chr1,92785164,92785423,SRX5716463,SMARCA4,259
chr1,92785288,92785586,SRX20140869,INTS10,298
chr1,92785312,92785604,SRX20140868,INTS10,292
chr1,92785334,92785570,SRX20140879,CPSF3L,236
chr1,92785339,92785649,SRX20140881,CPSF3L,310
chr1,92792337,92792542,SRX5075168,SMARCA4,205
chr1,92795223,92795506,SRX5075170,SMARCA4,283
chr1,92795236,92795530,SRX5054308,FOSL2,294
chr1,92795244,92795507,SRX5075175,SMARCA4,263
chr1,92795247,92795511,SRX5075176,SMARCA4,264
chr1,92795251,92795511,SRX5020211,SMARCA2,260
chr1,92795254,92795500,SRX5075169,SMARCA4,246
chr1,92795257,92795510,SRX5716470,SMARCA4,253
chr1,92795281,92795551,SRX5716467,SMARCA2,270
chr1,92795282,92795543,SRX5054309,FOSL2,261
chr1,92804662,92805038,SRX5075168,SMARCA4,376
chr1,92804680,92805175,SRX5075174,SMARCA4,495
chr1,92804800,92805107,SRX5716463,SMARCA4,307
chr1,92804820,92805089,SRX5716464,SMARCA4,269
chr1,92818324,92818717,SRX16500062,CTCF,393
chr1,92818331,92818800,SRX16500059,CTCF,469
chr1,92818349,92818735,SRX16500061,CTCF,386
chr1,92818372,92818743,SRX16500060,CTCF,371
chr1,92831672,92832452,SRX16500059,CTCF,780
chr1,92831686,92832460,SRX16500060,CTCF,774
chr1,92831701,92832459,SRX16500061,CTCF,758
chr1,92831728,92832335,SRX16500062,CTCF,607
chr1,92831747,92832362,SRX5075174,SMARCA4,615
chr1,92831756,92832118,SRX4174629,CTCF,362
chr1,92831770,92832221,SRX5075168,SMARCA4,451
chr1,92831784,92832289,SRX5716463,SMARCA4,505
chr1,92831785,92832207,SRX5075176,SMARCA4,422
chr1,92831787,92832450,SRX20140895,INTS13,663
chr1,92831808,92832189,SRX5716464,SMARCA4,381
chr1,92831849,92832325,SRX20140868,INTS10,476
chr1,92831857,92832176,SRX5075170,SMARCA4,319
chr1,92831857,92832329,SRX20140867,INTS10,472
chr1,92831872,92832367,SRX20140869,INTS10,495
chr1,92831879,92832438,SRX20140897,INTS13,559
chr1,92831906,92832364,SRX20140879,CPSF3L,458
chr1,92831910,92832518,SRX20140881,CPSF3L,608
chr1,92832006,92832296,SRX20140896,INTS13,290
chr1,92832038,92832323,SRX20140894,INTS13,285
chr1,92858754,92859387,SRX16500060,CTCF,633
chr1,92858822,92859381,SRX16500062,CTCF,559
chr1,92858827,92859370,SRX16500059,CTCF,543
chr1,92858834,92859355,SRX16500061,CTCF,521
chr1,92858847,92859513,SRX4174629,CTCF,666
chr1,92858883,92859214,SRX5075174,SMARCA4,331
chr1,92858938,92859203,SRX5075169,SMARCA4,265
chr1,92858963,92859209,SRX5075176,SMARCA4,246
chr1,92858964,92859193,SRX5075168,SMARCA4,229
chr1,92858965,92859230,SRX5075170,SMARCA4,265
chr1,92859007,92859224,SRX5716470,SMARCA4,217
chr1,92859030,92859221,SRX5075175,SMARCA4,191
chr1,92909344,92909672,SRX5075169,SMARCA4,328
chr1,92909346,92909682,SRX5075176,SMARCA4,336
chr1,92909350,92909580,SRX5054309,FOSL2,230
chr1,92909372,92909661,SRX5075175,SMARCA4,289
chr1,92929471,92929853,SRX5075176,SMARCA4,382
chr1,92929590,92929860,SRX5075175,SMARCA4,270
chr1,92929597,92929850,SRX5075170,SMARCA4,253
chr1,92929612,92929809,SRX5054309,FOSL2,197
chr1,92934439,92935142,SRX5716470,SMARCA4,703
chr1,92934474,92935116,SRX5716469,SMARCA4,642
chr1,92934488,92935070,SRX5075169,SMARCA4,582
chr1,92934505,92935158,SRX5075170,SMARCA4,653
chr1,92934507,92935016,SRX5054308,FOSL2,509
chr1,92934516,92935118,SRX5075175,SMARCA4,602
chr1,92934530,92935059,SRX5716468,SMARCA2,529
chr1,92934531,92935102,SRX5716467,SMARCA2,571
chr1,92934536,92935137,SRX5075176,SMARCA4,601
chr1,92934561,92935119,SRX5054309,FOSL2,558
chr1,92934565,92935043,SRX5020214,SMARCA2,478
chr1,92934577,92935006,SRX5075181,SMARCA2,429
chr1,92934596,92934999,SRX5075182,SMARCA2,403
chr1,92934616,92935015,SRX5020211,SMARCA2,399
chr1,92934768,92935024,SRX5716453,SOX2,256
chr1,92940563,92940953,SRX5054309,FOSL2,390
chr1,92940568,92940892,SRX5075170,SMARCA4,324
chr1,92940570,92940866,SRX5716467,SMARCA2,296
chr1,92940584,92940946,SRX5075169,SMARCA4,362
chr1,92940595,92940916,SRX5075176,SMARCA4,321
chr1,92940602,92940965,SRX5075175,SMARCA4,363
chr1,92940607,92940916,SRX5054308,FOSL2,309
chr1,92940626,92940865,SRX5020214,SMARCA2,239
chr1,92950377,92950666,SRX5075170,SMARCA4,289
chr1,92950388,92950689,SRX5075176,SMARCA4,301
chr1,92950399,92950727,SRX5716469,SMARCA4,328
chr1,92950414,92950725,SRX5075169,SMARCA4,311
chr1,92950420,92950727,SRX5054309,FOSL2,307
chr1,92950421,92950695,SRX5054308,FOSL2,274
chr1,92951267,92951442,SRX5075170,SMARCA4,175
chr1,92951288,92951595,SRX5075169,SMARCA4,307
chr1,92960354,92960552,SRX5075168,SMARCA4,198
chr1,92960369,92960793,SRX16500059,CTCF,424
chr1,92960402,92960606,SRX5075176,SMARCA4,204
chr1,92960402,92960630,SRX5075170,SMARCA4,228
chr1,92960409,92960801,SRX16500061,CTCF,392
chr1,92960411,92960751,SRX16500060,CTCF,340
chr1,92960435,92960642,SRX5075174,SMARCA4,207
chr1,92960442,92960805,SRX16500062,CTCF,363
chr1,92960984,92961359,SRX16500059,CTCF,375
chr1,92961113,92961960,SRX20140895,INTS13,847
chr1,92961137,92961391,SRX16500060,CTCF,254
chr1,92961338,92961829,SRX5075170,SMARCA4,491
chr1,92961405,92961736,SRX5075176,SMARCA4,331
chr1,92961556,92961866,SRX5075168,SMARCA4,310
chr1,92961573,92961983,SRX20140868,INTS10,410
chr1,92961604,92961903,SRX5075174,SMARCA4,299
chr1,92961771,92962003,SRX5075175,SMARCA4,232
chr1,92961854,92962054,SRX5075176,SMARCA4,200
chr1,92962394,92962573,SRX5075176,SMARCA4,179
chr1,92968395,92968805,SRX16500062,CTCF,410
chr1,92968415,92968923,SRX16500060,CTCF,508
chr1,92968423,92968783,SRX16500061,CTCF,360
chr1,92968464,92968780,SRX16500059,CTCF,316
chr1,92993976,92994559,SRX16500059,CTCF,583
chr1,92994067,92994564,SRX16500060,CTCF,497
chr1,92994069,92994562,SRX16500061,CTCF,493
chr1,92994095,92994456,SRX4174629,CTCF,361
chr1,92994101,92994542,SRX16500062,CTCF,441
chr1,92994124,92994424,SRX5075168,SMARCA4,300
chr1,92994132,92994378,SRX5075170,SMARCA4,246
chr1,92994158,92994369,SRX5075176,SMARCA4,211
chr1,92994168,92994407,SRX5716463,SMARCA4,239
chr1,92994229,92994416,SRX5075174,SMARCA4,187
chr1,93000763,93000982,SRX5075170,SMARCA4,219
chr1,93015586,93015910,SRX5075176,SMARCA4,324
chr1,93015630,93015881,SRX5054309,FOSL2,251
chr1,93015639,93015839,SRX5054308,FOSL2,200
chr1,93015664,93015901,SRX5075170,SMARCA4,237
chr1,93015680,93016013,SRX5075175,SMARCA4,333
chr1,93021445,93022026,SRX16500059,CTCF,581
chr1,93021482,93022026,SRX16500062,CTCF,544
chr1,93021487,93022025,SRX16500060,CTCF,538
chr1,93021515,93021978,SRX16500061,CTCF,463
chr1,93021653,93021911,SRX5075168,SMARCA4,258
chr1,93021658,93021881,SRX5716464,SMARCA4,223
chr1,93021680,93021880,SRX5075174,SMARCA4,200
chr1,93056285,93056596,SRX5075176,SMARCA4,311
chr1,93056297,93056559,SRX5716470,SMARCA4,262
chr1,93056299,93056515,SRX5075175,SMARCA4,216
chr1,93056303,93056589,SRX5075170,SMARCA4,286
chr1,93056313,93056525,SRX5075168,SMARCA4,212
chr1,93056320,93056546,SRX5075174,SMARCA4,226
chr1,93062207,93062478,SRX16500061,CTCF,271
chr1,93062237,93062530,SRX16500060,CTCF,293
chr1,93062246,93062518,SRX16500059,CTCF,272
chr1,93062260,93062576,SRX16500062,CTCF,316
chr1,93078761,93079527,SRX20140895,INTS13,766
chr1,93078790,93079471,SRX20140868,INTS10,681
chr1,93078796,93079337,SRX20140894,INTS13,541
chr1,93078796,93079355,SRX20140879,CPSF3L,559
chr1,93078840,93079506,SRX20140881,CPSF3L,666
chr1,93078842,93079485,SRX20140867,INTS10,643
chr1,93078866,93079428,SRX5075176,SMARCA4,562
chr1,93078870,93079412,SRX20140896,INTS13,542
chr1,93078870,93079480,SRX20140897,INTS13,610
chr1,93078880,93079410,SRX20140869,INTS10,530
chr1,93078886,93079337,SRX20140880,CPSF3L,451
chr1,93078898,93079312,SRX5075170,SMARCA4,414
chr1,93078925,93079240,SRX5716463,SMARCA4,315
chr1,93078933,93079315,SRX5075175,SMARCA4,382
chr1,93078943,93079320,SRX5075168,SMARCA4,377
chr1,93078946,93079342,SRX5075174,SMARCA4,396
chr1,93078959,93079280,SRX5716470,SMARCA4,321
chr1,93079001,93079244,SRX5716469,SMARCA4,243
chr1,93079012,93079322,SRX5075169,SMARCA4,310
chr1,93079024,93079314,SRX20140870,INTS10,290
chr1,93079044,93079297,SRX5716451,SOX2,253
chr1,93079055,93079328,SRX5716453,SOX2,273
chr1,93079060,93079269,SRX5716454,SOX3,209
chr1,93080359,93080856,SRX16500061,CTCF,497
chr1,93080393,93080792,SRX16500062,CTCF,399
chr1,93080405,93080778,SRX16500060,CTCF,373
chr1,93080464,93080738,SRX5075175,SMARCA4,274
chr1,93080472,93080745,SRX5075176,SMARCA4,273
chr1,93080493,93080732,SRX5075170,SMARCA4,239
chr1,93080501,93080759,SRX5716470,SMARCA4,258
chr1,93080502,93080743,SRX5075174,SMARCA4,241
chr1,93080514,93080764,SRX16500059,CTCF,250
chr1,93080520,93080717,SRX5075168,SMARCA4,197
chr1,93081786,93082075,SRX5716469,SMARCA4,289
chr1,93081789,93082034,SRX5020211,SMARCA2,245
chr1,93081806,93082036,SRX5075175,SMARCA4,230
chr1,93081810,93082093,SRX5075169,SMARCA4,283
chr1,93081859,93082047,SRX5054309,FOSL2,188
chr1,93081887,93082072,SRX5054308,FOSL2,185
chr1,93106297,93106541,SRX5716470,SMARCA4,244
chr1,93111602,93111875,SRX5054308,FOSL2,273
chr1,93179655,93179934,SRX5054309,FOSL2,279
chr1,93179667,93179848,SRX5054308,FOSL2,181
chr1,93179680,93179904,SRX5075175,SMARCA4,224
chr1,93179714,93179938,SRX5075170,SMARCA4,224
chr1,93179813,93180941,SRX20140895,INTS13,1128
chr1,93179891,93180825,SRX20140897,INTS13,934
chr1,93179973,93180492,SRX20140867,INTS10,519
chr1,93180294,93180569,SRX5075170,SMARCA4,275
chr1,93180389,93180651,SRX5716463,SMARCA4,262
chr1,93180407,93180684,SRX5075176,SMARCA4,277
chr1,93180416,93180646,SRX5716464,SMARCA4,230
chr1,93180431,93180757,SRX5075168,SMARCA4,326
chr1,93180438,93180705,SRX5075174,SMARCA4,267
chr1,93180454,93180706,SRX16500059,CTCF,252
chr1,93180458,93180722,SRX16500060,CTCF,264
chr1,93235744,93235959,SRX5075174,SMARCA4,215
chr1,93255280,93255532,SRX5716469,SMARCA4,252
chr1,93255290,93255470,SRX5075169,SMARCA4,180
chr1,93255302,93255542,SRX5075175,SMARCA4,240
chr1,93255306,93255557,SRX5054309,FOSL2,251
chr1,93255313,93255493,SRX5054308,FOSL2,180
chr1,93304518,93305083,SRX16500060,CTCF,565
chr1,93304580,93305047,SRX16500059,CTCF,467
chr1,93304606,93305029,SRX16500061,CTCF,423
chr1,93304623,93305036,SRX16500062,CTCF,413
chr1,93304669,93304960,SRX5075168,SMARCA4,291
chr1,93304727,93304944,SRX5075170,SMARCA4,217
chr1,93304730,93304980,SRX5075174,SMARCA4,250
chr1,93304735,93304961,SRX5075176,SMARCA4,226
chr1,93304789,93305042,SRX5716463,SMARCA4,253
chr1,93324835,93325179,SRX5075169,SMARCA4,344
chr1,93324857,93325218,SRX5075175,SMARCA4,361
chr1,93324872,93325161,SRX5075170,SMARCA4,289
chr1,93324895,93325122,SRX5075176,SMARCA4,227
chr1,93324907,93325128,SRX5054309,FOSL2,221
chr1,93338416,93338806,SRX5054309,FOSL2,390
chr1,93338440,93338922,SRX5075170,SMARCA4,482
chr1,93338448,93338817,SRX5075175,SMARCA4,369
chr1,93338448,93338831,SRX5075169,SMARCA4,383
chr1,93338464,93338791,SRX5054308,FOSL2,327
chr1,93338491,93338744,SRX5716469,SMARCA4,253
chr1,93338541,93338777,SRX5075176,SMARCA4,236
chr1,93338567,93338831,SRX5716470,SMARCA4,264
chr1,93345450,93346190,SRX20140895,INTS13,740
chr1,93345518,93346006,SRX20140868,INTS10,488
chr1,93345529,93345996,SRX5075176,SMARCA4,467
chr1,93345573,93345982,SRX20140897,INTS13,409
chr1,93345580,93345840,SRX5716469,SMARCA4,260
chr1,93345586,93346066,SRX5075174,SMARCA4,480
chr1,93345589,93345893,SRX5075170,SMARCA4,304
chr1,93345593,93345830,SRX20140879,CPSF3L,237
chr1,93345614,93345920,SRX20140881,CPSF3L,306
chr1,93345616,93346065,SRX20140867,INTS10,449
chr1,93345624,93345910,SRX5075175,SMARCA4,286
chr1,93345632,93345922,SRX5075169,SMARCA4,290
chr1,93345671,93346058,SRX5075168,SMARCA4,387
chr1,93345682,93345897,SRX5716467,SMARCA2,215
chr1,93345725,93345990,SRX5716470,SMARCA4,265
chr1,93353483,93353685,SRX5075170,SMARCA4,202
chr1,93353554,93353753,SRX5075176,SMARCA4,199
chr1,93430603,93430869,SRX5075174,SMARCA4,266
chr1,93437934,93438400,SRX16500060,CTCF,466
chr1,93437950,93438404,SRX16500059,CTCF,454
chr1,93437952,93438440,SRX16500061,CTCF,488
chr1,93437953,93438420,SRX16500062,CTCF,467
chr1,93437986,93438309,SRX5075174,SMARCA4,323
chr1,93438009,93438225,SRX5716464,SMARCA4,216
chr1,93438015,93438333,SRX5075168,SMARCA4,318
chr1,93438043,93438312,SRX5075175,SMARCA4,269
chr1,93438047,93438342,SRX5075169,SMARCA4,295
chr1,93438057,93438318,SRX5075170,SMARCA4,261
chr1,93438061,93438306,SRX5716463,SMARCA4,245
chr1,93438102,93438277,SRX5075176,SMARCA4,175
chr1,93447798,93448240,SRX5075174,SMARCA4,442
chr1,93447842,93448222,SRX5075168,SMARCA4,380
chr1,93447852,93448185,SRX5075170,SMARCA4,333
chr1,93447859,93448978,SRX20140895,INTS13,1119
chr1,93447943,93448611,SRX20140867,INTS10,668
chr1,93447967,93448152,SRX5075169,SMARCA4,185
chr1,93447987,93448164,SRX5075176,SMARCA4,177
chr1,93448011,93448796,SRX20140868,INTS10,785
chr1,93448586,93448872,SRX5075169,SMARCA4,286
chr1,93472009,93472217,SRX5075176,SMARCA4,208
chr1,93472029,93472241,SRX5075169,SMARCA4,212
chr1,93472076,93472310,SRX5054309,FOSL2,234
chr1,93519477,93519721,SRX5054309,FOSL2,244
chr1,93538010,93538281,SRX5075175,SMARCA4,271
chr1,93538023,93538243,SRX5075169,SMARCA4,220
chr1,93538038,93538266,SRX5075170,SMARCA4,228
chr1,93538040,93538215,SRX5075176,SMARCA4,175
chr1,93538042,93538281,SRX5054308,FOSL2,239
chr1,93538072,93538288,SRX5054309,FOSL2,216
chr1,93552663,93553040,SRX5075170,SMARCA4,377
chr1,93552673,93553003,SRX5075175,SMARCA4,330
chr1,93552709,93552949,SRX5075169,SMARCA4,240
chr1,93553089,93553363,SRX5075168,SMARCA4,274
chr1,93553173,93553346,SRX5075174,SMARCA4,173
chr1,93553190,93553401,SRX5075170,SMARCA4,211
chr1,93554192,93554367,SRX5075176,SMARCA4,175
chr1,93565665,93566109,SRX5075170,SMARCA4,444
chr1,93565754,93566026,SRX5716469,SMARCA4,272
chr1,93565776,93566296,SRX5075176,SMARCA4,520
chr1,93565792,93566109,SRX5716470,SMARCA4,317
chr1,93565817,93566105,SRX5075175,SMARCA4,288
chr1,93567402,93567708,SRX5054308,FOSL2,306
chr1,93567440,93567747,SRX5075174,SMARCA4,307
chr1,93567445,93567753,SRX5054309,FOSL2,308
chr1,93567453,93567675,SRX5075176,SMARCA4,222
chr1,93567487,93567720,SRX5075170,SMARCA4,233
chr1,93575544,93576072,SRX5075174,SMARCA4,528
chr1,93575558,93575742,SRX5075170,SMARCA4,184
chr1,93575558,93576098,SRX5075176,SMARCA4,540
chr1,93575611,93575822,SRX5075175,SMARCA4,211
chr1,93575789,93576047,SRX5716470,SMARCA4,258
chr1,93575798,93576094,SRX5716469,SMARCA4,296
chr1,93575813,93576902,SRX5075170,SMARCA4,1089
chr1,93575902,93576167,SRX5075168,SMARCA4,265
chr1,93576152,93576908,SRX5075176,SMARCA4,756
chr1,93576155,93576811,SRX5716467,SMARCA2,656
chr1,93576281,93576843,SRX5075169,SMARCA4,562
chr1,93576314,93576807,SRX5716470,SMARCA4,493
chr1,93576335,93576808,SRX5075175,SMARCA4,473
chr1,93576352,93576823,SRX5020211,SMARCA2,471
chr1,93576367,93576804,SRX5716469,SMARCA4,437
chr1,93576381,93576629,SRX5054309,FOSL2,248
chr1,93576395,93576854,SRX5716468,SMARCA2,459
chr1,93576423,93576773,SRX5054308,FOSL2,350
chr1,93576428,93576673,SRX5075174,SMARCA4,245
chr1,93576467,93576732,SRX5075181,SMARCA2,265
chr1,93576515,93576717,SRX5075182,SMARCA2,202
chr1,93579985,93580251,SRX5075170,SMARCA4,266
chr1,93580008,93580263,SRX5054309,FOSL2,255
chr1,93580035,93580215,SRX5075169,SMARCA4,180
chr1,93584292,93584699,SRX5716467,SMARCA2,407
chr1,93584331,93584555,SRX5075176,SMARCA4,224
chr1,93584340,93584553,SRX5716469,SMARCA4,213
chr1,93584341,93584554,SRX5716470,SMARCA4,213
chr1,93593879,93594108,SRX5075174,SMARCA4,229
chr1,93605796,93606179,SRX5075170,SMARCA4,383
chr1,93605828,93606220,SRX5075169,SMARCA4,392
chr1,93605829,93606179,SRX5075176,SMARCA4,350
chr1,93605831,93606199,SRX5075175,SMARCA4,368
chr1,93605873,93606316,SRX5054309,FOSL2,443
chr1,93605879,93606141,SRX5716469,SMARCA4,262
chr1,93605881,93606193,SRX5054308,FOSL2,312
chr1,93608549,93608791,SRX5075176,SMARCA4,242
chr1,93614929,93615317,SRX5075176,SMARCA4,388
chr1,93614960,93615258,SRX5075170,SMARCA4,298
chr1,93615067,93615300,SRX5054309,FOSL2,233
chr1,93615160,93615340,SRX5054308,FOSL2,180
chr1,93615638,93616219,SRX5054309,FOSL2,581
chr1,93615694,93615985,SRX5054308,FOSL2,291
chr1,93615716,93616057,SRX5075175,SMARCA4,341
chr1,93615726,93615939,SRX5075170,SMARCA4,213
chr1,93615744,93616105,SRX5075176,SMARCA4,361
chr1,93615756,93616108,SRX5075169,SMARCA4,352
chr1,93623851,93624142,SRX5716469,SMARCA4,291
chr1,93623851,93624164,SRX5075169,SMARCA4,313
chr1,93623886,93624191,SRX5075170,SMARCA4,305
chr1,93623916,93624198,SRX5075175,SMARCA4,282
chr1,93623935,93624162,SRX5054309,FOSL2,227
chr1,93623970,93624145,SRX5075176,SMARCA4,175
chr1,93625503,93626026,SRX5075176,SMARCA4,523
chr1,93625504,93625995,SRX5075170,SMARCA4,491
chr1,93625523,93625940,SRX5075175,SMARCA4,417
chr1,93625558,93625884,SRX5075169,SMARCA4,326
chr1,93625589,93625894,SRX5054308,FOSL2,305
chr1,93625595,93625911,SRX5054309,FOSL2,316
chr1,93625605,93625859,SRX5075174,SMARCA4,254
chr1,93625617,93625931,SRX5716467,SMARCA2,314
chr1,93625623,93625932,SRX5716470,SMARCA4,309
chr1,93625631,93625996,SRX5716469,SMARCA4,365
chr1,93625695,93625957,SRX5020211,SMARCA2,262
chr1,93629310,93629884,SRX16500061,CTCF,574
chr1,93629344,93629877,SRX16500059,CTCF,533
chr1,93629386,93629906,SRX16500060,CTCF,520
chr1,93629406,93629868,SRX16500062,CTCF,462
chr1,93629533,93629896,SRX5075168,SMARCA4,363
chr1,93629585,93630013,SRX4174629,CTCF,428
chr1,93635720,93636578,SRX20140895,INTS13,858
chr1,93635749,93636690,SRX5075168,SMARCA4,941
chr1,93635770,93636747,SRX5075174,SMARCA4,977
chr1,93635979,93636657,SRX5716463,SMARCA4,678
chr1,93636017,93636578,SRX20140867,INTS10,561
chr1,93636032,93636298,SRX5075176,SMARCA4,266
chr1,93636152,93636557,SRX20140868,INTS10,405
chr1,93636179,93636514,SRX20140860,SOX2,335
chr1,93636188,93636444,SRX20140861,SOX2,256
chr1,93636235,93636602,SRX5716451,SOX2,367
chr1,93636237,93636562,SRX5075170,SMARCA4,325
chr1,93636244,93636624,SRX5716464,SMARCA4,380
chr1,93636257,93636576,SRX20140881,CPSF3L,319
chr1,93636257,93636577,SRX5075169,SMARCA4,320
chr1,93636258,93636578,SRX5716454,SOX3,320
chr1,93636276,93636527,SRX20140879,CPSF3L,251
chr1,93636304,93636590,SRX5716470,SMARCA4,286
chr1,93636328,93636544,SRX5075175,SMARCA4,216
chr1,93636360,93636535,SRX5075176,SMARCA4,175
chr1,93638894,93639183,SRX5075170,SMARCA4,289
chr1,93638914,93639263,SRX5075176,SMARCA4,349
chr1,93638993,93639239,SRX5075174,SMARCA4,246
chr1,93638995,93639293,SRX5075168,SMARCA4,298
chr1,93641616,93641906,SRX5054308,FOSL2,290
chr1,93641649,93641934,SRX5075170,SMARCA4,285
chr1,93641656,93641856,SRX5075175,SMARCA4,200
chr1,93641659,93641901,SRX5716469,SMARCA4,242
chr1,93641666,93641904,SRX5054309,FOSL2,238
chr1,93641672,93641916,SRX5075176,SMARCA4,244
chr1,93641675,93641898,SRX5075169,SMARCA4,223
chr1,93661975,93662425,SRX5075168,SMARCA4,450
chr1,93662040,93662460,SRX5075176,SMARCA4,420
chr1,93662084,93662348,SRX5716469,SMARCA4,264
chr1,93662086,93662433,SRX5075170,SMARCA4,347
chr1,93662103,93662304,SRX5075174,SMARCA4,201
chr1,93662103,93662451,SRX5054309,FOSL2,348
chr1,93662118,93662448,SRX5075169,SMARCA4,330
chr1,93662125,93662437,SRX5054308,FOSL2,312
chr1,93662148,93662408,SRX5716460,Epitope tags,260
chr1,93662157,93662427,SRX5075175,SMARCA4,270
chr1,93662202,93662413,SRX5020211,SMARCA2,211
chr1,93662487,93662844,SRX5075168,SMARCA4,357
chr1,93662502,93662793,SRX5075174,SMARCA4,291
chr1,93669392,93669804,SRX5075168,SMARCA4,412
chr1,93669471,93669755,SRX5075174,SMARCA4,284
chr1,93680617,93681134,SRX16500059,CTCF,517
chr1,93680621,93681121,SRX16500060,CTCF,500
chr1,93680665,93681072,SRX16500061,CTCF,407
chr1,93680714,93681072,SRX16500062,CTCF,358
chr1,93680723,93680952,SRX4174629,CTCF,229
chr1,93680725,93680951,SRX5075175,SMARCA4,226
chr1,93680725,93680964,SRX5075168,SMARCA4,239
chr1,93680737,93680979,SRX5075176,SMARCA4,242
chr1,93680766,93681051,SRX5075170,SMARCA4,285
chr1,93680784,93681016,SRX5716464,SMARCA4,232
chr1,93680789,93681060,SRX5075174,SMARCA4,271
chr1,93681529,93681994,SRX20140895,INTS13,465
chr1,93681669,93681950,SRX5075176,SMARCA4,281
chr1,93681673,93681980,SRX5075174,SMARCA4,307
chr1,93681691,93681992,SRX5075175,SMARCA4,301
chr1,93681771,93682007,SRX5075169,SMARCA4,236
chr1,93681773,93682059,SRX5075170,SMARCA4,286
chr1,93681786,93682051,SRX5075168,SMARCA4,265
chr1,93693299,93693553,SRX5075176,SMARCA4,254
chr1,93693336,93693613,SRX5054309,FOSL2,277
chr1,93693364,93693599,SRX5054308,FOSL2,235
chr1,93693365,93693563,SRX5075175,SMARCA4,198
chr1,93693375,93693567,SRX5075169,SMARCA4,192
chr1,93693403,93693596,SRX5075170,SMARCA4,193
chr1,93701611,93702002,SRX5075169,SMARCA4,391
chr1,93701613,93701847,SRX5020214,SMARCA2,234
chr1,93701619,93701972,SRX5075175,SMARCA4,353
chr1,93701637,93701952,SRX5075170,SMARCA4,315
chr1,93701640,93701950,SRX5054308,FOSL2,310
chr1,93701644,93701946,SRX5716469,SMARCA4,302
chr1,93701654,93701978,SRX5054309,FOSL2,324
chr1,93701671,93701982,SRX5075176,SMARCA4,311
chr1,93701767,93701978,SRX5716470,SMARCA4,211
chr1,93722178,93722520,SRX5075169,SMARCA4,342
chr1,93722211,93722510,SRX5075170,SMARCA4,299
chr1,93722301,93722574,SRX5716470,SMARCA4,273
chr1,93722345,93723217,SRX5075168,SMARCA4,872
chr1,93722366,93722576,SRX16500062,CTCF,210
chr1,93722373,93722619,SRX20140860,SOX2,246
chr1,93722395,93722708,SRX20140894,INTS13,313
chr1,93722408,93723296,SRX5075174,SMARCA4,888
chr1,93722411,93722854,SRX20140879,CPSF3L,443
chr1,93722416,93723324,SRX20140895,INTS13,908
chr1,93722423,93722640,SRX20140867,INTS10,217
chr1,93722467,93722678,SRX5075176,SMARCA4,211
chr1,93722475,93723139,SRX20140868,INTS10,664
chr1,93722526,93722792,SRX5716463,SMARCA4,266
chr1,93722686,93722891,SRX5716464,SMARCA4,205
chr1,93722759,93723007,SRX5075175,SMARCA4,248
chr1,93732514,93732850,SRX16500060,CTCF,336
chr1,93732589,93732799,SRX16500062,CTCF,210
chr1,93735794,93736068,SRX5075175,SMARCA4,274
chr1,93735816,93736082,SRX5054308,FOSL2,266
chr1,93735837,93736117,SRX5075169,SMARCA4,280
chr1,93735852,93736114,SRX5054309,FOSL2,262
chr1,93735879,93736091,SRX5716469,SMARCA4,212
chr1,93738373,93738583,SRX5075169,SMARCA4,210
chr1,93738438,93738637,SRX5075175,SMARCA4,199
chr1,93744630,93744942,SRX5075176,SMARCA4,312
chr1,93744649,93744916,SRX5075170,SMARCA4,267
chr1,93744668,93744906,SRX5716470,SMARCA4,238
chr1,93754160,93754748,SRX5075170,SMARCA4,588
chr1,93754219,93754789,SRX5075169,SMARCA4,570
chr1,93754267,93754801,SRX5075176,SMARCA4,534
chr1,93754280,93754801,SRX5054309,FOSL2,521
chr1,93754301,93754636,SRX5716460,Epitope tags,335
chr1,93754356,93754781,SRX5054308,FOSL2,425
chr1,93754360,93754846,SRX5075175,SMARCA4,486
chr1,93754470,93754941,SRX5716469,SMARCA4,471
chr1,93754482,93754785,SRX5716467,SMARCA2,303
chr1,93754518,93754749,SRX5716470,SMARCA4,231
chr1,93757661,93757960,SRX5075168,SMARCA4,299
chr1,93757684,93757944,SRX5075174,SMARCA4,260
chr1,93757747,93757955,SRX5716463,SMARCA4,208
chr1,93758910,93759178,SRX5075176,SMARCA4,268
chr1,93758953,93759205,SRX5075170,SMARCA4,252
chr1,93759009,93759228,SRX5716470,SMARCA4,219
chr1,93774763,93774941,SRX5075176,SMARCA4,178
chr1,93779434,93780155,SRX5075170,SMARCA4,721
chr1,93779438,93780241,SRX5075176,SMARCA4,803
chr1,93779460,93780172,SRX5716469,SMARCA4,712
chr1,93779464,93780225,SRX5716470,SMARCA4,761
chr1,93779477,93780044,SRX5054309,FOSL2,567
chr1,93779491,93780194,SRX5075169,SMARCA4,703
chr1,93779496,93780041,SRX5716467,SMARCA2,545
chr1,93779512,93780120,SRX5075175,SMARCA4,608
chr1,93779518,93779955,SRX5075181,SMARCA2,437
chr1,93779539,93779804,SRX5020214,SMARCA2,265
chr1,93779541,93780107,SRX5054308,FOSL2,566
chr1,93779545,93779997,SRX5716459,Epitope tags,452
chr1,93779556,93779757,SRX5075168,SMARCA4,201
chr1,93779581,93780109,SRX5020211,SMARCA2,528
chr1,93797830,93798785,SRX5075170,SMARCA4,955
chr1,93797838,93798774,SRX5075169,SMARCA4,936
chr1,93797965,93798787,SRX5075176,SMARCA4,822
chr1,93797968,93798672,SRX5716467,SMARCA2,704
chr1,93797980,93798776,SRX5075175,SMARCA4,796
chr1,93798087,93798267,SRX5054308,FOSL2,180
chr1,93798203,93798762,SRX5716470,SMARCA4,559
chr1,93798246,93798766,SRX5020211,SMARCA2,520
chr1,93798296,93798676,SRX5020214,SMARCA2,380
chr1,93798325,93798627,SRX5075181,SMARCA2,302
chr1,93798334,93798703,SRX5716469,SMARCA4,369
chr1,93798371,93798712,SRX5054309,FOSL2,341
chr1,93798379,93798742,SRX5054308,FOSL2,363
chr1,93798387,93798705,SRX5075182,SMARCA2,318
chr1,93798395,93798708,SRX5716468,SMARCA2,313
chr1,93804395,93804750,SRX5054308,FOSL2,355
chr1,93804410,93804909,SRX5075170,SMARCA4,499
chr1,93804411,93804874,SRX5075176,SMARCA4,463
chr1,93804422,93804763,SRX5054309,FOSL2,341
chr1,93804427,93804871,SRX5075175,SMARCA4,444
chr1,93804437,93804832,SRX5075169,SMARCA4,395
chr1,93804485,93804937,SRX5716469,SMARCA4,452
chr1,93804503,93804698,SRX5075182,SMARCA2,195
chr1,93810366,93810583,SRX5075170,SMARCA4,217
chr1,93813840,93814377,SRX4174629,CTCF,537
chr1,93813924,93814406,SRX16500059,CTCF,482
chr1,93813936,93814381,SRX16500061,CTCF,445
chr1,93813941,93814421,SRX16500062,CTCF,480
chr1,93813966,93814416,SRX16500060,CTCF,450
chr1,93814002,93814270,SRX5075168,SMARCA4,268
chr1,93814056,93814316,SRX5075174,SMARCA4,260
chr1,93814094,93814263,SRX5075170,SMARCA4,169
chr1,93815315,93815710,SRX5075170,SMARCA4,395
chr1,93815325,93815713,SRX5054309,FOSL2,388
chr1,93815355,93815696,SRX5075176,SMARCA4,341
chr1,93815362,93815662,SRX5054308,FOSL2,300
chr1,93815386,93815687,SRX5075169,SMARCA4,301
chr1,93815398,93815660,SRX5075175,SMARCA4,262
chr1,93827856,93828165,SRX5054309,FOSL2,309
chr1,93827869,93828117,SRX5075170,SMARCA4,248
chr1,93827880,93828060,SRX5075169,SMARCA4,180
chr1,93827915,93828095,SRX5054308,FOSL2,180
chr1,93827971,93828216,SRX5075175,SMARCA4,245
chr1,93844080,93844609,SRX16500061,CTCF,529
chr1,93844080,93844637,SRX16500059,CTCF,557
chr1,93844215,93844549,SRX4174629,CTCF,334
chr1,93844215,93844591,SRX16500062,CTCF,376
chr1,93844227,93844616,SRX16500060,CTCF,389
chr1,93844325,93844500,SRX5075176,SMARCA4,175
chr1,93845576,93846025,SRX5075169,SMARCA4,449
chr1,93845597,93846024,SRX5075170,SMARCA4,427
chr1,93845638,93845996,SRX5075175,SMARCA4,358
chr1,93845759,93846056,SRX5054309,FOSL2,297
chr1,93845834,93846017,SRX5054308,FOSL2,183
chr1,93846153,93846966,SRX20140895,INTS13,813
chr1,93846183,93846442,SRX5075168,SMARCA4,259
chr1,93846246,93846450,SRX5075174,SMARCA4,204
chr1,93847038,93848176,SRX20140895,INTS13,1138
chr1,93847194,93847648,SRX20140867,INTS10,454
chr1,93847236,93847636,SRX20140897,INTS13,400
chr1,93847237,93847706,SRX20140869,INTS10,469
chr1,93847246,93848061,SRX20140868,INTS10,815
chr1,93847325,93847758,SRX20140881,CPSF3L,433
chr1,93847597,93847937,SRX20140894,INTS13,340
chr1,93850697,93851084,SRX16500059,CTCF,387
chr1,93850724,93851107,SRX16500060,CTCF,383
chr1,93850727,93851107,SRX16500061,CTCF,380
chr1,93850760,93851110,SRX16500062,CTCF,350
chr1,93874022,93874497,SRX16500061,CTCF,475
chr1,93874040,93874280,SRX4174629,CTCF,240
chr1,93874058,93874492,SRX16500060,CTCF,434
chr1,93874061,93874492,SRX16500059,CTCF,431
chr1,93874068,93874312,SRX5075174,SMARCA4,244
chr1,93874103,93874506,SRX16500062,CTCF,403
chr1,93874143,93874316,SRX5075170,SMARCA4,173
chr1,93878912,93879638,SRX20140895,INTS13,726
chr1,93878914,93879669,SRX20140869,INTS10,755
chr1,93878980,93879573,SRX20140868,INTS10,593
chr1,93878992,93879569,SRX20140897,INTS13,577
chr1,93879003,93879564,SRX20140867,INTS10,561
chr1,93879013,93879605,SRX5075168,SMARCA4,592
chr1,93879018,93879572,SRX20140881,CPSF3L,554
chr1,93879070,93879599,SRX5075174,SMARCA4,529
chr1,93879074,93879660,SRX20140879,CPSF3L,586
chr1,93879113,93879533,SRX20140896,INTS13,420
chr1,93879153,93879485,SRX5716464,SMARCA4,332
chr1,93879155,93879502,SRX5075176,SMARCA4,347
chr1,93879161,93879379,SRX5716451,SOX2,218
chr1,93879168,93879510,SRX5075170,SMARCA4,342
chr1,93879189,93879457,SRX5075175,SMARCA4,268
chr1,93879223,93879559,SRX20140894,INTS13,336
chr1,93879252,93879541,SRX5716470,SMARCA4,289
chr1,93879258,93879519,SRX5716463,SMARCA4,261
chr1,93879280,93879526,SRX5716469,SMARCA4,246
chr1,93879311,93879543,SRX5075169,SMARCA4,232
chr1,93909180,93909847,SRX20140895,INTS13,667
chr1,93909209,93909744,SRX20140868,INTS10,535
chr1,93909233,93909951,SRX5075168,SMARCA4,718
chr1,93909245,93909704,SRX20140867,INTS10,459
chr1,93909267,93909845,SRX5716470,SMARCA4,578
chr1,93909285,93909643,SRX5716463,SMARCA4,358
chr1,93909311,93909830,SRX5075169,SMARCA4,519
chr1,93909323,93909898,SRX5075170,SMARCA4,575
chr1,93909341,93909948,SRX5075174,SMARCA4,607
chr1,93909357,93909687,SRX5054309,FOSL2,330
chr1,93909361,93909833,SRX5075176,SMARCA4,472
chr1,93909375,93909677,SRX5054308,FOSL2,302
chr1,93909383,93909838,SRX5075175,SMARCA4,455
chr1,93909400,93909644,SRX20140897,INTS13,244
chr1,93909413,93909628,SRX5716467,SMARCA2,215
chr1,93909416,93909959,SRX16500060,CTCF,543
chr1,93909419,93909983,SRX16500059,CTCF,564
chr1,93909427,93909752,SRX5716469,SMARCA4,325
chr1,93909444,93909965,SRX16500062,CTCF,521
chr1,93909504,93909970,SRX16500061,CTCF,466
chr1,93909612,93909860,SRX5716464,SMARCA4,248
chr1,93909622,93910089,SRX4174629,CTCF,467
chr1,93964725,93964938,SRX5054308,FOSL2,213
chr1,93964757,93964974,SRX5054309,FOSL2,217
chr1,93967291,93967529,SRX5075169,SMARCA4,238
chr1,93977631,93977870,SRX5075169,SMARCA4,239
chr1,93977700,93977897,SRX5075175,SMARCA4,197
chr1,93979544,93979993,SRX5716470,SMARCA4,449
chr1,93979638,93979953,SRX5020211,SMARCA2,315
chr1,93979678,93980050,SRX5716469,SMARCA4,372
chr1,93979678,93980139,SRX5075176,SMARCA4,461
chr1,93979704,93979928,SRX5075175,SMARCA4,224
chr1,93979731,93980302,SRX5075170,SMARCA4,571
chr1,93979756,93980124,SRX5716468,SMARCA2,368
chr1,93979772,93980032,SRX5075169,SMARCA4,260
chr1,93979776,93980101,SRX5716467,SMARCA2,325
chr1,93980447,93980823,SRX16500061,CTCF,376
chr1,93980449,93980850,SRX16500059,CTCF,401
chr1,93980479,93980826,SRX16500062,CTCF,347
chr1,93980480,93980951,SRX16500060,CTCF,471
chr1,93980518,93980708,SRX5075174,SMARCA4,190
chr1,93980532,93980735,SRX5075168,SMARCA4,203
chr1,93980932,93981183,SRX5054309,FOSL2,251
chr1,93980971,93981160,SRX5054308,FOSL2,189
chr1,93989056,93989284,SRX5075170,SMARCA4,228
chr1,94005107,94005276,SRX5075170,SMARCA4,169
chr1,94012742,94013085,SRX20140895,INTS13,343
chr1,94020727,94021164,SRX5075176,SMARCA4,437
chr1,94020772,94021106,SRX5716469,SMARCA4,334
chr1,94020776,94021119,SRX5716470,SMARCA4,343
chr1,94020788,94021209,SRX5075169,SMARCA4,421
chr1,94020805,94021122,SRX5075170,SMARCA4,317
chr1,94020809,94021149,SRX5075175,SMARCA4,340
chr1,94020817,94021194,SRX5054309,FOSL2,377
chr1,94020923,94021187,SRX5054308,FOSL2,264
chr1,94025764,94026291,SRX16500061,CTCF,527
chr1,94025776,94026281,SRX16500062,CTCF,505
chr1,94025785,94026357,SRX16500060,CTCF,572
chr1,94025803,94026304,SRX16500059,CTCF,501
chr1,94025942,94026195,SRX5075174,SMARCA4,253
chr1,94025958,94026213,SRX5075176,SMARCA4,255
chr1,94025963,94026264,SRX4174629,CTCF,301
chr1,94025964,94026249,SRX5075168,SMARCA4,285
chr1,94026021,94026220,SRX5075169,SMARCA4,199
chr1,94036804,94037029,SRX5020211,SMARCA2,225
chr1,94038536,94038913,SRX5075170,SMARCA4,377
chr1,94038563,94038835,SRX5075169,SMARCA4,272
chr1,94038570,94038810,SRX5075176,SMARCA4,240
chr1,94038575,94038765,SRX5075168,SMARCA4,190
chr1,94038598,94038843,SRX5716470,SMARCA4,245
chr1,94038600,94038828,SRX5075174,SMARCA4,228
chr1,94039381,94039948,SRX16500061,CTCF,567
chr1,94039448,94039909,SRX16500062,CTCF,461
chr1,94039456,94039933,SRX16500060,CTCF,477
chr1,94039462,94039972,SRX16500059,CTCF,510
chr1,94039504,94039894,SRX4174629,CTCF,390
chr1,94039529,94039874,SRX5075168,SMARCA4,345
chr1,94039550,94039811,SRX5075174,SMARCA4,261
chr1,94039638,94039902,SRX5716463,SMARCA4,264
chr1,94040213,94040436,SRX5075169,SMARCA4,223
chr1,94045343,94045934,SRX5075169,SMARCA4,591
chr1,94045387,94045912,SRX5075170,SMARCA4,525
chr1,94045404,94045975,SRX5716470,SMARCA4,571
chr1,94045407,94045957,SRX5075176,SMARCA4,550
chr1,94045435,94045981,SRX5075175,SMARCA4,546
chr1,94045452,94046031,SRX16500060,CTCF,579
chr1,94045488,94046020,SRX16500061,CTCF,532
chr1,94045495,94046004,SRX4174629,CTCF,509
chr1,94045522,94045982,SRX16500059,CTCF,460
chr1,94045541,94046012,SRX16500062,CTCF,471
chr1,94045597,94045916,SRX5075168,SMARCA4,319
chr1,94045604,94045925,SRX5075174,SMARCA4,321
chr1,94045638,94045850,SRX5716463,SMARCA4,212
chr1,94045641,94045967,SRX5716468,SMARCA2,326
chr1,94045652,94045916,SRX5716464,SMARCA4,264
chr1,94045675,94045886,SRX5075181,SMARCA2,211
chr1,94045676,94045886,SRX5054309,FOSL2,210
chr1,94045708,94045983,SRX20140895,INTS13,275
chr1,94061326,94061860,SRX16500060,CTCF,534
chr1,94061357,94061834,SRX16500059,CTCF,477
chr1,94061388,94061802,SRX16500061,CTCF,414
chr1,94061417,94061803,SRX16500062,CTCF,386
chr1,94061431,94061792,SRX4174629,CTCF,361
chr1,94061471,94061718,SRX5075168,SMARCA4,247
chr1,94061480,94061744,SRX5075174,SMARCA4,264
chr1,94063357,94063620,SRX5075175,SMARCA4,263
chr1,94063379,94063651,SRX5075169,SMARCA4,272
chr1,94063389,94063664,SRX5075170,SMARCA4,275
chr1,94063399,94063634,SRX5716469,SMARCA4,235
chr1,94063409,94063704,SRX5075176,SMARCA4,295
chr1,94063424,94063663,SRX5075174,SMARCA4,239
chr1,94063440,94063709,SRX5716470,SMARCA4,269
chr1,94068964,94069297,SRX5075175,SMARCA4,333
chr1,94068973,94069258,SRX5075170,SMARCA4,285
chr1,94068982,94069320,SRX5075169,SMARCA4,338
chr1,94069024,94069293,SRX5075176,SMARCA4,269
chr1,94069087,94069315,SRX5716470,SMARCA4,228
chr1,94069529,94069826,SRX5075176,SMARCA4,297
chr1,94069532,94069775,SRX5075170,SMARCA4,243
chr1,94069629,94069852,SRX5075169,SMARCA4,223
chr1,94072051,94072275,SRX5075176,SMARCA4,224
chr1,94072075,94072317,SRX5075168,SMARCA4,242
chr1,94079045,94079290,SRX5075174,SMARCA4,245
chr1,94081755,94082318,SRX5075170,SMARCA4,563
chr1,94081787,94082306,SRX5075176,SMARCA4,519
chr1,94081842,94082325,SRX5075169,SMARCA4,483
chr1,94081869,94082273,SRX5075175,SMARCA4,404
chr1,94081881,94082225,SRX5716467,SMARCA2,344
chr1,94081885,94082235,SRX5716470,SMARCA4,350
chr1,94081905,94082285,SRX5716469,SMARCA4,380
chr1,94081944,94082251,SRX5054309,FOSL2,307
chr1,94081970,94082254,SRX5054308,FOSL2,284
chr1,94092151,94092763,SRX5075174,SMARCA4,612
chr1,94092177,94092749,SRX5075168,SMARCA4,572
chr1,94092221,94092579,SRX5716464,SMARCA4,358
chr1,94092288,94092684,SRX5716463,SMARCA4,396
chr1,94092345,94092580,SRX5054307,FOSL2,235
chr1,94092377,94092628,SRX5054309,FOSL2,251
chr1,94094496,94094814,SRX5075170,SMARCA4,318
chr1,94095056,94095709,SRX5075175,SMARCA4,653
chr1,94095095,94095716,SRX5075169,SMARCA4,621
chr1,94095102,94095739,SRX5075170,SMARCA4,637
chr1,94095109,94095737,SRX5075176,SMARCA4,628
chr1,94095177,94095646,SRX5716467,SMARCA2,469
chr1,94095236,94095732,SRX5716469,SMARCA4,496
chr1,94095287,94095601,SRX5054308,FOSL2,314
chr1,94095290,94095710,SRX5020211,SMARCA2,420
chr1,94095358,94095737,SRX5716470,SMARCA4,379
chr1,94095401,94095702,SRX5716468,SMARCA2,301
chr1,94106208,94106454,SRX5716469,SMARCA4,246
chr1,94106215,94106569,SRX5075170,SMARCA4,354
chr1,94106223,94106505,SRX5716470,SMARCA4,282
chr1,94106232,94106551,SRX5075175,SMARCA4,319
chr1,94106234,94106554,SRX5075169,SMARCA4,320
chr1,94106242,94106487,SRX5020214,SMARCA2,245
chr1,94106268,94106581,SRX5075176,SMARCA4,313
chr1,94106287,94106502,SRX5716467,SMARCA2,215
chr1,94106752,94107014,SRX5075170,SMARCA4,262
chr1,94106821,94107020,SRX5075169,SMARCA4,199
chr1,94106829,94107056,SRX5075175,SMARCA4,227
chr1,94113923,94114291,SRX5075174,SMARCA4,368
chr1,94113989,94114256,SRX5075168,SMARCA4,267
chr1,94116553,94116832,SRX5075168,SMARCA4,279
chr1,94116580,94116886,SRX5075175,SMARCA4,306
chr1,94116581,94116895,SRX5075174,SMARCA4,314
chr1,94116582,94116878,SRX5716469,SMARCA4,296
chr1,94116600,94116899,SRX5075176,SMARCA4,299
chr1,94116615,94116923,SRX5716470,SMARCA4,308
chr1,94116619,94116899,SRX5075169,SMARCA4,280
chr1,94116620,94116938,SRX5075170,SMARCA4,318
chr1,94116640,94116900,SRX5716468,SMARCA2,260
chr1,94116661,94116885,SRX5716467,SMARCA2,224
chr1,94116668,94117032,SRX20140869,INTS10,364
chr1,94130910,94131102,SRX5054309,FOSL2,192
chr1,94131324,94131572,SRX5075174,SMARCA4,248
chr1,94131371,94131552,SRX5075168,SMARCA4,181
chr1,94141876,94142553,SRX5075175,SMARCA4,677
chr1,94141915,94142524,SRX5075176,SMARCA4,609
chr1,94141934,94142451,SRX5075169,SMARCA4,517
chr1,94141970,94142534,SRX5075170,SMARCA4,564
chr1,94142037,94142444,SRX5054309,FOSL2,407
chr1,94142056,94142423,SRX5716467,SMARCA2,367
chr1,94142102,94142475,SRX5054308,FOSL2,373
chr1,94142132,94142448,SRX5716469,SMARCA4,316
chr1,94142179,94142384,SRX5020214,SMARCA2,205
chr1,94147562,94147737,SRX5075176,SMARCA4,175
chr1,94154985,94155254,SRX5075175,SMARCA4,269
chr1,94155037,94155338,SRX5075169,SMARCA4,301
chr1,94155061,94155311,SRX5075176,SMARCA4,250
chr1,94155073,94155332,SRX5075170,SMARCA4,259
chr1,94160738,94161169,SRX5075170,SMARCA4,431
chr1,94160759,94161169,SRX5075176,SMARCA4,410
chr1,94160783,94161189,SRX5716469,SMARCA4,406
chr1,94160798,94161166,SRX5716470,SMARCA4,368
chr1,94160815,94161133,SRX5054308,FOSL2,318
chr1,94160815,94161169,SRX5075169,SMARCA4,354
chr1,94160819,94161140,SRX5054309,FOSL2,321
chr1,94160823,94161150,SRX5075175,SMARCA4,327
chr1,94160846,94161173,SRX5716467,SMARCA2,327
chr1,94160856,94161171,SRX5020211,SMARCA2,315
chr1,94160942,94161141,SRX5075174,SMARCA4,199
chr1,94237094,94237450,SRX20140881,CPSF3L,356
chr1,94237253,94237749,SRX20140867,INTS10,496
chr1,94237455,94237851,SRX20140895,INTS13,396
chr1,94237508,94237794,SRX20140897,INTS13,286
chr1,94237519,94237882,SRX5075168,SMARCA4,363
chr1,94237543,94237825,SRX5075170,SMARCA4,282
chr1,94237564,94237885,SRX5716463,SMARCA4,321
chr1,94237580,94237800,SRX5075169,SMARCA4,220
chr1,94237599,94237971,SRX5075174,SMARCA4,372
chr1,94237657,94237832,SRX5075176,SMARCA4,175
chr1,94240791,94241200,SRX16500059,CTCF,409
chr1,94240795,94241252,SRX16500061,CTCF,457
chr1,94240845,94241261,SRX16500060,CTCF,416
chr1,94240857,94241241,SRX16500062,CTCF,384
chr1,94247195,94247953,SRX5075170,SMARCA4,758
chr1,94247312,94247833,SRX5716470,SMARCA4,521
chr1,94247337,94247907,SRX5075175,SMARCA4,570
chr1,94247422,94247999,SRX5075174,SMARCA4,577
chr1,94247467,94248015,SRX5075168,SMARCA4,548
chr1,94247499,94247970,SRX5075169,SMARCA4,471
chr1,94247555,94247980,SRX5716464,SMARCA4,425
chr1,94247562,94247776,SRX20140867,INTS10,214
chr1,94247568,94247887,SRX5716469,SMARCA4,319
chr1,94247573,94247926,SRX5075176,SMARCA4,353
chr1,94258811,94259171,SRX5716469,SMARCA4,360
chr1,94258811,94259281,SRX5075170,SMARCA4,470
chr1,94258814,94259160,SRX5054308,FOSL2,346
chr1,94258818,94259152,SRX5054309,FOSL2,334
chr1,94258820,94259223,SRX5075175,SMARCA4,403
chr1,94258830,94259253,SRX5075169,SMARCA4,423
chr1,94258847,94259146,SRX5075176,SMARCA4,299
chr1,94265103,94265379,SRX5075175,SMARCA4,276
chr1,94266016,94266383,SRX5075174,SMARCA4,367
chr1,94266082,94266348,SRX5075168,SMARCA4,266
chr1,94270711,94271143,SRX5075170,SMARCA4,432
chr1,94270723,94271159,SRX5075176,SMARCA4,436
chr1,94270725,94271164,SRX5075169,SMARCA4,439
chr1,94270736,94271140,SRX5075175,SMARCA4,404
chr1,94270752,94271115,SRX5054308,FOSL2,363
chr1,94270774,94271120,SRX5054309,FOSL2,346
chr1,94270788,94271089,SRX5716469,SMARCA4,301
chr1,94270829,94271034,SRX5020214,SMARCA2,205
chr1,94276937,94277121,SRX5075176,SMARCA4,184
chr1,94276963,94277132,SRX5075170,SMARCA4,169
chr1,94276966,94277232,SRX5716467,SMARCA2,266
chr1,94285399,94285640,SRX5054309,FOSL2,241
chr1,94285423,94285605,SRX5054308,FOSL2,182
chr1,94300202,94300574,SRX5075168,SMARCA4,372
chr1,94300220,94300591,SRX5075174,SMARCA4,371
chr1,94300224,94300527,SRX5054309,FOSL2,303
chr1,94300267,94300492,SRX5054307,FOSL2,225
chr1,94300278,94300499,SRX5054308,FOSL2,221
chr1,94300306,94300502,SRX5075169,SMARCA4,196
chr1,94305732,94306047,SRX5054308,FOSL2,315
chr1,94305733,94305938,SRX5020214,SMARCA2,205
chr1,94305733,94306020,SRX5716470,SMARCA4,287
chr1,94305735,94305947,SRX5075169,SMARCA4,212
chr1,94305759,94305992,SRX5054309,FOSL2,233
chr1,94305785,94306021,SRX5020211,SMARCA2,236
chr1,94325546,94326318,SRX5075176,SMARCA4,772
chr1,94325572,94326305,SRX5075170,SMARCA4,733
chr1,94325574,94326282,SRX5716467,SMARCA2,708
chr1,94325578,94326221,SRX5075175,SMARCA4,643
chr1,94325580,94326189,SRX5054309,FOSL2,609
chr1,94325582,94326283,SRX5075169,SMARCA4,701
chr1,94325588,94326194,SRX5054308,FOSL2,606
chr1,94325621,94326152,SRX5020214,SMARCA2,531
chr1,94325656,94325911,SRX5716468,SMARCA2,255
chr1,94325657,94326160,SRX5716469,SMARCA4,503
chr1,94325678,94326249,SRX5020211,SMARCA2,571
chr1,94325750,94326183,SRX5716470,SMARCA4,433
chr1,94327273,94327678,SRX5075174,SMARCA4,405
chr1,94327345,94327769,SRX5075168,SMARCA4,424
chr1,94335751,94336277,SRX16500060,CTCF,526
chr1,94335754,94336288,SRX16500062,CTCF,534
chr1,94335776,94336282,SRX4174629,CTCF,506
chr1,94335791,94336276,SRX16500061,CTCF,485
chr1,94335791,94336346,SRX16500059,CTCF,555
chr1,94335822,94336107,SRX5075169,SMARCA4,285
chr1,94335884,94336116,SRX5075176,SMARCA4,232
chr1,94335891,94336151,SRX5075168,SMARCA4,260
chr1,94335914,94336185,SRX5075174,SMARCA4,271
chr1,94335917,94336138,SRX5716470,SMARCA4,221
chr1,94335944,94336136,SRX5075170,SMARCA4,192
chr1,94398413,94398649,SRX5054309,FOSL2,236
chr1,94417425,94417665,SRX5075176,SMARCA4,240
chr1,94417802,94418828,SRX20140895,INTS13,1026
chr1,94417806,94418461,SRX5075169,SMARCA4,655
chr1,94417866,94418285,SRX5716470,SMARCA4,419
chr1,94417904,94418517,SRX5075170,SMARCA4,613
chr1,94417928,94418593,SRX20140868,INTS10,665
chr1,94417956,94418562,SRX5075174,SMARCA4,606
chr1,94417961,94418564,SRX5075176,SMARCA4,603
chr1,94417964,94418396,SRX5716469,SMARCA4,432
chr1,94417965,94418310,SRX20140897,INTS13,345
chr1,94417968,94418478,SRX5075175,SMARCA4,510
chr1,94417971,94418578,SRX5075168,SMARCA4,607
chr1,94417995,94418598,SRX20140867,INTS10,603
chr1,94418101,94418387,SRX5716464,SMARCA4,286
chr1,94418165,94418478,SRX5716463,SMARCA4,313
chr1,94418195,94418382,SRX5054308,FOSL2,187
chr1,94418346,94418873,SRX20140881,CPSF3L,527
chr1,94418370,94418652,SRX5716470,SMARCA4,282
chr1,94418403,94418684,SRX20140879,CPSF3L,281
chr1,94463785,94463964,SRX5075168,SMARCA4,179
chr1,94463812,94464042,SRX5075174,SMARCA4,230
chr1,94463855,94464090,SRX16500060,CTCF,235
chr1,94468793,94469005,SRX5054308,FOSL2,212
chr1,94481408,94481909,SRX16500059,CTCF,501
chr1,94481417,94481857,SRX16500061,CTCF,440
chr1,94481443,94481852,SRX5075174,SMARCA4,409
chr1,94481447,94481909,SRX16500060,CTCF,462
chr1,94481454,94481910,SRX16500062,CTCF,456
chr1,94481476,94481784,SRX5075170,SMARCA4,308
chr1,94481513,94481831,SRX5075168,SMARCA4,318
chr1,94481519,94481847,SRX4174629,CTCF,328
chr1,94481588,94481814,SRX5716463,SMARCA4,226
chr1,94481624,94481861,SRX5075169,SMARCA4,237
chr1,94481635,94481834,SRX5075176,SMARCA4,199
chr1,94514047,94514546,SRX16500059,CTCF,499
chr1,94514107,94514580,SRX16500060,CTCF,473
chr1,94514112,94514556,SRX16500061,CTCF,444
chr1,94514117,94514546,SRX16500062,CTCF,429
chr1,94514122,94514459,SRX4174629,CTCF,337
chr1,94514152,94514464,SRX5075169,SMARCA4,312
chr1,94514166,94514454,SRX5075176,SMARCA4,288
chr1,94514171,94514441,SRX5075168,SMARCA4,270
chr1,94514176,94514477,SRX5075174,SMARCA4,301
chr1,94514180,94514467,SRX5075170,SMARCA4,287
chr1,94514205,94514420,SRX5075175,SMARCA4,215
chr1,94522267,94522662,SRX16500059,CTCF,395
chr1,94522315,94522621,SRX16500061,CTCF,306
chr1,94522318,94522689,SRX16500060,CTCF,371
chr1,94522339,94522665,SRX16500062,CTCF,326
chr1,94522368,94522686,SRX5075170,SMARCA4,318
chr1,94522373,94522666,SRX5075168,SMARCA4,293
chr1,94522388,94522615,SRX5075176,SMARCA4,227
chr1,94522447,94522638,SRX5075169,SMARCA4,191
chr1,94522447,94522710,SRX5075174,SMARCA4,263
chr1,94541532,94542134,SRX20140895,INTS13,602
chr1,94541601,94542194,SRX5075174,SMARCA4,593
chr1,94541709,94542192,SRX5075168,SMARCA4,483
chr1,94541771,94542135,SRX5075176,SMARCA4,364
chr1,94541782,94542153,SRX5075175,SMARCA4,371
chr1,94541788,94542122,SRX5716469,SMARCA4,334
chr1,94541797,94542167,SRX5054309,FOSL2,370
chr1,94541808,94542122,SRX5054308,FOSL2,314
chr1,94541808,94542165,SRX5075170,SMARCA4,357
chr1,94541810,94542165,SRX5075169,SMARCA4,355
chr1,94541835,94542101,SRX5054307,FOSL2,266
chr1,94541838,94542116,SRX5716470,SMARCA4,278
chr1,94541930,94542163,SRX5716463,SMARCA4,233
chr1,94545116,94545445,SRX5075169,SMARCA4,329
chr1,94545128,94545482,SRX5075176,SMARCA4,354
chr1,94545144,94545458,SRX5075170,SMARCA4,314
chr1,94545165,94545464,SRX5075175,SMARCA4,299
chr1,94545196,94545407,SRX5716470,SMARCA4,211
chr1,94553451,94553648,SRX5075170,SMARCA4,197
chr1,94553479,94553654,SRX5075176,SMARCA4,175
chr1,94554604,94554827,SRX5075170,SMARCA4,223
chr1,94579825,94580228,SRX5075175,SMARCA4,403
chr1,94579848,94580220,SRX5075176,SMARCA4,372
chr1,94579850,94580243,SRX5075169,SMARCA4,393
chr1,94579862,94580174,SRX5054309,FOSL2,312
chr1,94579877,94580169,SRX5054308,FOSL2,292
chr1,94579882,94580202,SRX5075170,SMARCA4,320
chr1,94579891,94580220,SRX5716469,SMARCA4,329
chr1,94579905,94580147,SRX5020211,SMARCA2,242
chr1,94579919,94580170,SRX5716470,SMARCA4,251
chr1,94579937,94580207,SRX5716467,SMARCA2,270
chr1,94590851,94591121,SRX5054309,FOSL2,270
chr1,94590860,94591106,SRX5075169,SMARCA4,246
chr1,94591943,94592501,SRX20140895,INTS13,558
chr1,94592510,94592860,SRX5716464,SMARCA4,350
chr1,94592548,94592972,SRX5075174,SMARCA4,424
chr1,94592554,94593004,SRX5075168,SMARCA4,450
chr1,94592602,94592824,SRX5716451,SOX2,222
chr1,94592678,94592949,SRX5716463,SMARCA4,271
chr1,94599510,94599725,SRX16500062,CTCF,215
chr1,94599510,94599771,SRX16500059,CTCF,261
chr1,94599518,94599777,SRX16500060,CTCF,259
chr1,94605730,94606151,SRX5075176,SMARCA4,421
chr1,94605749,94606141,SRX5075170,SMARCA4,392
chr1,94605759,94606155,SRX5075175,SMARCA4,396
chr1,94605763,94606055,SRX5716469,SMARCA4,292
chr1,94605765,94606073,SRX5054309,FOSL2,308
chr1,94605775,94606085,SRX5075169,SMARCA4,310
chr1,94605777,94606016,SRX5716470,SMARCA4,239
chr1,94605786,94606090,SRX5054308,FOSL2,304
chr1,94605815,94606099,SRX5716467,SMARCA2,284
chr1,94605835,94606035,SRX5020211,SMARCA2,200
chr1,94616451,94616703,SRX5075174,SMARCA4,252
chr1,94616519,94616762,SRX5716463,SMARCA4,243
chr1,94616581,94616786,SRX5075168,SMARCA4,205
chr1,94621466,94621729,SRX5075170,SMARCA4,263
chr1,94621574,94621766,SRX5075176,SMARCA4,192
chr1,94622714,94623050,SRX5075174,SMARCA4,336
chr1,94622720,94623014,SRX5716463,SMARCA4,294
chr1,94622782,94623017,SRX5716470,SMARCA4,235
chr1,94622830,94623053,SRX5075168,SMARCA4,223
chr1,94623637,94623923,SRX5075175,SMARCA4,286
chr1,94623646,94623972,SRX5075176,SMARCA4,326
chr1,94623670,94623982,SRX5716469,SMARCA4,312
chr1,94623707,94624020,SRX5075170,SMARCA4,313
chr1,94623764,94624016,SRX5075169,SMARCA4,252
chr1,94633132,94633400,SRX5075169,SMARCA4,268
chr1,94646065,94646533,SRX5054309,FOSL2,468
chr1,94646071,94646429,SRX5716469,SMARCA4,358
chr1,94646106,94646507,SRX5075170,SMARCA4,401
chr1,94646116,94646468,SRX5716467,SMARCA2,352
chr1,94646117,94646470,SRX5075176,SMARCA4,353
chr1,94646130,94646435,SRX5716470,SMARCA4,305
chr1,94646141,94646531,SRX5075169,SMARCA4,390
chr1,94646148,94646496,SRX5054308,FOSL2,348
chr1,94646155,94646563,SRX5075175,SMARCA4,408
chr1,94648346,94648599,SRX5054308,FOSL2,253
chr1,94648368,94648622,SRX5075175,SMARCA4,254
chr1,94654027,94654347,SRX5054308,FOSL2,320
chr1,94654058,94654268,SRX5075175,SMARCA4,210
chr1,94654102,94654334,SRX5075168,SMARCA4,232
chr1,94654109,94654380,SRX5075174,SMARCA4,271
chr1,94654117,94654330,SRX5054309,FOSL2,213
chr1,94654121,94654361,SRX5075170,SMARCA4,240
chr1,94654138,94654362,SRX5075176,SMARCA4,224
chr1,94660916,94661537,SRX5075168,SMARCA4,621
chr1,94660924,94661497,SRX5075174,SMARCA4,573
chr1,94660941,94661370,SRX5716463,SMARCA4,429
chr1,94661007,94661363,SRX5716464,SMARCA4,356
chr1,94661041,94661266,SRX5716451,SOX2,225
chr1,94688544,94689104,SRX5075168,SMARCA4,560
chr1,94688569,94689052,SRX5075174,SMARCA4,483
chr1,94688584,94688923,SRX5716464,SMARCA4,339
chr1,94688613,94688960,SRX20140879,CPSF3L,347
chr1,94688679,94688950,SRX5716463,SMARCA4,271
chr1,94688723,94688937,SRX20140867,INTS10,214
chr1,94693096,94693348,SRX16500060,CTCF,252
chr1,94698395,94698650,SRX5054309,FOSL2,255
chr1,94702242,94702947,SRX5075176,SMARCA4,705
chr1,94702412,94702838,SRX5716469,SMARCA4,426
chr1,94702453,94702929,SRX5075169,SMARCA4,476
chr1,94702469,94702920,SRX5716470,SMARCA4,451
chr1,94702497,94702964,SRX5075170,SMARCA4,467
chr1,94702509,94702908,SRX5716467,SMARCA2,399
chr1,94702533,94702898,SRX5020211,SMARCA2,365
chr1,94702542,94702932,SRX5716468,SMARCA2,390
chr1,94702563,94702888,SRX5054308,FOSL2,325
chr1,94702659,94702912,SRX5075175,SMARCA4,253
chr1,94713657,94714227,SRX5075176,SMARCA4,570
chr1,94713674,94714284,SRX5075170,SMARCA4,610
chr1,94713721,94714252,SRX5075169,SMARCA4,531
chr1,94713738,94714054,SRX5075175,SMARCA4,316
chr1,94713782,94714164,SRX5054309,FOSL2,382
chr1,94713814,94714223,SRX5716469,SMARCA4,409
chr1,94713828,94714123,SRX5054308,FOSL2,295
chr1,94713864,94714194,SRX5716467,SMARCA2,330
chr1,94727767,94728273,SRX5075175,SMARCA4,506
chr1,94727770,94728244,SRX5716470,SMARCA4,474
chr1,94727791,94728246,SRX5716467,SMARCA2,455
chr1,94727794,94728346,SRX5075176,SMARCA4,552
chr1,94727803,94728365,SRX5075169,SMARCA4,562
chr1,94727816,94728300,SRX5054309,FOSL2,484
chr1,94727833,94728367,SRX5716469,SMARCA4,534
chr1,94727848,94728151,SRX5716468,SMARCA2,303
chr1,94727870,94728351,SRX5075170,SMARCA4,481
chr1,94727874,94728276,SRX5054308,FOSL2,402
chr1,94727897,94728301,SRX5075174,SMARCA4,404
chr1,94727902,94728245,SRX5020214,SMARCA2,343
chr1,94728007,94728243,SRX5020211,SMARCA2,236
chr1,94728090,94728269,SRX5075168,SMARCA4,179
chr1,94729310,94729623,SRX5075170,SMARCA4,313
chr1,94729341,94729604,SRX5075176,SMARCA4,263
chr1,94729359,94729593,SRX5020211,SMARCA2,234
chr1,94729392,94729588,SRX5075169,SMARCA4,196
chr1,94739643,94740104,SRX5054309,FOSL2,461
chr1,94739645,94740062,SRX5075175,SMARCA4,417
chr1,94739697,94740050,SRX5075170,SMARCA4,353
chr1,94739734,94740064,SRX5054308,FOSL2,330
chr1,94739775,94740073,SRX5075169,SMARCA4,298
chr1,94743830,94744053,SRX5075170,SMARCA4,223
chr1,94743898,94744162,SRX5075176,SMARCA4,264
chr1,94755624,94756146,SRX5075170,SMARCA4,522
chr1,94755669,94756142,SRX5075176,SMARCA4,473
chr1,94755696,94756065,SRX5054309,FOSL2,369
chr1,94755710,94756033,SRX5054308,FOSL2,323
chr1,94755723,94756062,SRX5716469,SMARCA4,339
chr1,94755744,94756016,SRX5716468,SMARCA2,272
chr1,94755746,94756073,SRX5075175,SMARCA4,327
chr1,94755753,94755990,SRX5716470,SMARCA4,237
chr1,94755764,94756056,SRX5075169,SMARCA4,292
chr1,94755779,94756041,SRX5020211,SMARCA2,262
chr1,94755825,94756097,SRX5020214,SMARCA2,272
chr1,94773783,94774117,SRX5075176,SMARCA4,334
chr1,94773820,94774052,SRX5054308,FOSL2,232
chr1,94773826,94774069,SRX5054309,FOSL2,243
chr1,94773827,94774266,SRX5075170,SMARCA4,439
chr1,94773829,94774219,SRX5075169,SMARCA4,390
chr1,94773832,94774115,SRX5075175,SMARCA4,283
chr1,94774009,94774316,SRX5020211,SMARCA2,307
chr1,94783398,94784103,SRX5075176,SMARCA4,705
chr1,94783429,94784057,SRX5075175,SMARCA4,628
chr1,94783433,94784011,SRX5716470,SMARCA4,578
chr1,94783443,94784042,SRX5075170,SMARCA4,599
chr1,94783467,94784146,SRX5075169,SMARCA4,679
chr1,94783476,94783994,SRX5716469,SMARCA4,518
chr1,94783523,94784019,SRX5054309,FOSL2,496
chr1,94783580,94784041,SRX5716467,SMARCA2,461
chr1,94783583,94784055,SRX5054308,FOSL2,472
chr1,94783592,94784050,SRX5716468,SMARCA2,458
chr1,94783619,94784029,SRX5020211,SMARCA2,410
chr1,94783625,94784026,SRX5020214,SMARCA2,401
chr1,94783628,94783853,SRX5075182,SMARCA2,225
chr1,94783782,94784004,SRX5075181,SMARCA2,222
chr1,94792532,94793299,SRX5075169,SMARCA4,767
chr1,94792535,94793187,SRX5075170,SMARCA4,652
chr1,94792546,94793275,SRX5075176,SMARCA4,729
chr1,94792616,94793349,SRX5075175,SMARCA4,733
chr1,94792626,94793099,SRX5054309,FOSL2,473
chr1,94792647,94793165,SRX5054308,FOSL2,518
chr1,94792679,94793233,SRX5716469,SMARCA4,554
chr1,94792699,94793116,SRX5020211,SMARCA2,417
chr1,94792758,94793275,SRX5716470,SMARCA4,517
chr1,94792760,94793175,SRX5716467,SMARCA2,415
chr1,94792985,94793303,SRX5716468,SMARCA2,318
chr1,94802032,94802244,SRX5075176,SMARCA4,212
chr1,94802035,94802317,SRX16500059,CTCF,282
chr1,94802057,94802365,SRX16500060,CTCF,308
chr1,94803516,94803685,SRX5075170,SMARCA4,169
chr1,94803572,94803808,SRX5075176,SMARCA4,236
chr1,94805677,94806193,SRX4174629,CTCF,516
chr1,94805758,94806220,SRX16500062,CTCF,462
chr1,94805772,94806253,SRX16500059,CTCF,481
chr1,94805776,94806254,SRX16500060,CTCF,478
chr1,94805796,94806246,SRX16500061,CTCF,450
chr1,94805928,94806123,SRX5075174,SMARCA4,195
chr1,94819976,94820514,SRX20140895,INTS13,538
chr1,94819979,94820376,SRX16500059,CTCF,397
chr1,94820024,94820581,SRX5075169,SMARCA4,557
chr1,94820047,94820505,SRX5075175,SMARCA4,458
chr1,94820053,94820416,SRX5075176,SMARCA4,363
chr1,94820078,94820481,SRX16500060,CTCF,403
chr1,94820088,94820456,SRX5075170,SMARCA4,368
chr1,94820089,94820414,SRX5716470,SMARCA4,325
chr1,94820149,94820474,SRX5075174,SMARCA4,325
chr1,94820175,94820524,SRX5075168,SMARCA4,349
chr1,94820308,94820541,SRX5716463,SMARCA4,233
chr1,94820353,94820565,SRX5716469,SMARCA4,212
chr1,94846338,94846751,SRX5075174,SMARCA4,413
chr1,94846371,94846623,SRX5716463,SMARCA4,252
chr1,94846378,94846740,SRX5075168,SMARCA4,362
chr1,94854206,94854784,SRX16500059,CTCF,578
chr1,94854333,94854749,SRX20140895,INTS13,416
chr1,94854336,94854820,SRX16500062,CTCF,484
chr1,94854348,94854784,SRX16500061,CTCF,436
chr1,94854354,94854823,SRX16500060,CTCF,469
chr1,94854356,94854788,SRX4174629,CTCF,432
chr1,94854420,94854764,SRX5075174,SMARCA4,344
chr1,94854427,94854772,SRX5716463,SMARCA4,345
chr1,94854431,94854784,SRX5075169,SMARCA4,353
chr1,94854437,94854763,SRX5075176,SMARCA4,326
chr1,94854455,94854722,SRX5075170,SMARCA4,267
chr1,94854465,94854792,SRX5075168,SMARCA4,327
chr1,94854466,94854743,SRX5716470,SMARCA4,277
chr1,94854468,94854735,SRX5716464,SMARCA4,267
chr1,94854481,94854785,SRX5716469,SMARCA4,304
chr1,94854498,94854839,SRX5075175,SMARCA4,341
chr1,94854951,94855198,SRX5075175,SMARCA4,247
chr1,94854984,94855196,SRX5716469,SMARCA4,212
chr1,94854991,94855265,SRX5075170,SMARCA4,274
chr1,94854997,94855179,SRX5075169,SMARCA4,182
chr1,94855012,94855269,SRX5075176,SMARCA4,257
chr1,94863476,94863662,SRX5075176,SMARCA4,186
chr1,94863482,94863662,SRX5054308,FOSL2,180
chr1,94863511,94863753,SRX5075169,SMARCA4,242
chr1,94863553,94863819,SRX5075170,SMARCA4,266
chr1,94863796,94864120,SRX5716460,Epitope tags,324
chr1,94863827,94864349,SRX5075168,SMARCA4,522
chr1,94863882,94864335,SRX5075174,SMARCA4,453
chr1,94863890,94864288,SRX5075169,SMARCA4,398
chr1,94863916,94864283,SRX5075176,SMARCA4,367
chr1,94863949,94864283,SRX5075175,SMARCA4,334
chr1,94863961,94864288,SRX5075170,SMARCA4,327
chr1,94863975,94864334,SRX5054309,FOSL2,359
chr1,94863980,94864277,SRX5054307,FOSL2,297
chr1,94863991,94864251,SRX5716467,SMARCA2,260
chr1,94863996,94864298,SRX5716463,SMARCA4,302
chr1,94864002,94864293,SRX5054308,FOSL2,291
chr1,94864007,94864301,SRX5716469,SMARCA4,294
chr1,94864044,94864291,SRX5020214,SMARCA2,247
chr1,94865412,94865691,SRX5075176,SMARCA4,279
chr1,94865484,94865749,SRX5075170,SMARCA4,265
chr1,94866401,94866869,SRX5075176,SMARCA4,468
chr1,94866418,94866814,SRX5075174,SMARCA4,396
chr1,94866458,94866868,SRX5075170,SMARCA4,410
chr1,94866505,94866775,SRX5716470,SMARCA4,270
chr1,94866509,94866789,SRX5075169,SMARCA4,280
chr1,94866536,94866872,SRX5075175,SMARCA4,336
chr1,94866588,94866811,SRX5054309,FOSL2,223
chr1,94872845,94873056,SRX5716470,SMARCA4,211
chr1,94876426,94876602,SRX5075174,SMARCA4,176
chr1,94883662,94883990,SRX5075170,SMARCA4,328
chr1,94883700,94883956,SRX5075176,SMARCA4,256
chr1,94883875,94884510,SRX5716470,SMARCA4,635
chr1,94884053,94884627,SRX5075170,SMARCA4,574
chr1,94884068,94884504,SRX5716467,SMARCA2,436
chr1,94884074,94884419,SRX5716469,SMARCA4,345
chr1,94884111,94884638,SRX5075176,SMARCA4,527
chr1,94884140,94884379,SRX5075168,SMARCA4,239
chr1,94884140,94884404,SRX5075174,SMARCA4,264
chr1,94884159,94884497,SRX5075169,SMARCA4,338
chr1,94884163,94884490,SRX5716468,SMARCA2,327
chr1,94884164,94884351,SRX5075175,SMARCA4,187
chr1,94917376,94917575,SRX5054308,FOSL2,199
chr1,94925544,94925848,SRX20140879,CPSF3L,304
chr1,94925572,94927644,SRX20140895,INTS13,2072
chr1,94925595,94926050,SRX5075174,SMARCA4,455
chr1,94925606,94925977,SRX5075170,SMARCA4,371
chr1,94925621,94926053,SRX5075168,SMARCA4,432
chr1,94925626,94927499,SRX20140867,INTS10,1873
chr1,94925643,94925980,SRX5075175,SMARCA4,337
chr1,94925667,94926631,SRX20140868,INTS10,964
chr1,94925681,94925924,SRX5716451,SOX2,243
chr1,94925682,94925932,SRX5716463,SMARCA4,250
chr1,94925720,94926410,SRX20140881,CPSF3L,690
chr1,94925721,94925973,SRX5075169,SMARCA4,252
chr1,94925734,94925961,SRX5054308,FOSL2,227
chr1,94925734,94926007,SRX5054309,FOSL2,273
chr1,94925745,94925940,SRX5054307,FOSL2,195
chr1,94925745,94926019,SRX5075176,SMARCA4,274
chr1,94926039,94926339,SRX20140896,INTS13,300
chr1,94926235,94926778,SRX16500059,CTCF,543
chr1,94926260,94926718,SRX16500062,CTCF,458
chr1,94926284,94926701,SRX16500061,CTCF,417
chr1,94926286,94926846,SRX16500060,CTCF,560
chr1,94926741,94927443,SRX20140868,INTS10,702
chr1,94926819,94927296,SRX20140881,CPSF3L,477
chr1,94926838,94927098,SRX20140879,CPSF3L,260
chr1,94926869,94927179,SRX20140880,CPSF3L,310
chr1,94926900,94927411,SRX20140896,INTS13,511
chr1,94926904,94927301,SRX20140897,INTS13,397
chr1,94926983,94927270,SRX20140869,INTS10,287
chr1,94927075,94927526,SRX5075168,SMARCA4,451
chr1,94927079,94927540,SRX5075170,SMARCA4,461
chr1,94927088,94927614,SRX5075176,SMARCA4,526
chr1,94927108,94927528,SRX5075174,SMARCA4,420
chr1,94927194,94927533,SRX5716470,SMARCA4,339
chr1,94927197,94927435,SRX5716464,SMARCA4,238
chr1,94927215,94927469,SRX5075175,SMARCA4,254
chr1,94927217,94927474,SRX5716469,SMARCA4,257
chr1,94927271,94927581,SRX5075169,SMARCA4,310
chr1,94936765,94937207,SRX5075174,SMARCA4,442
chr1,94936927,94937414,SRX5075168,SMARCA4,487
chr1,94938761,94938959,SRX5054308,FOSL2,198
chr1,94938780,94938975,SRX5075169,SMARCA4,195
chr1,94938792,94938978,SRX5075176,SMARCA4,186
chr1,94947450,94947740,SRX5716467,SMARCA2,290
chr1,94947477,94947702,SRX5075175,SMARCA4,225
chr1,94947491,94947817,SRX5075170,SMARCA4,326
chr1,94947496,94947833,SRX5716470,SMARCA4,337
chr1,94947515,94947765,SRX5075169,SMARCA4,250
chr1,94947520,94947788,SRX5716469,SMARCA4,268
chr1,94947583,94947806,SRX5075176,SMARCA4,223
chr1,94954546,94954719,SRX5075174,SMARCA4,173
chr1,94954668,94954915,SRX5075176,SMARCA4,247
chr1,94954670,94955017,SRX5075168,SMARCA4,347
chr1,94954675,94954909,SRX5075169,SMARCA4,234
chr1,94954708,94954910,SRX5075175,SMARCA4,202
chr1,94962735,94962965,SRX5075170,SMARCA4,230
chr1,94967394,94967599,SRX5075168,SMARCA4,205
chr1,94971493,94971691,SRX5075169,SMARCA4,198
chr1,94971503,94971727,SRX5075175,SMARCA4,224
chr1,94980730,94980948,SRX5075169,SMARCA4,218
chr1,94980731,94981018,SRX5075170,SMARCA4,287
chr1,94980758,94980995,SRX5716470,SMARCA4,237
chr1,94982419,94982762,SRX5075176,SMARCA4,343
chr1,94982450,94982859,SRX5075170,SMARCA4,409
chr1,94982488,94982755,SRX5075169,SMARCA4,267
chr1,94982501,94982751,SRX5075175,SMARCA4,250
chr1,94982549,94982777,SRX5020211,SMARCA2,228
chr1,94982551,94982802,SRX5054308,FOSL2,251
chr1,94998149,94998456,SRX5075174,SMARCA4,307
chr1,94998172,94998428,SRX5075168,SMARCA4,256
chr1,95002525,95003097,SRX5075176,SMARCA4,572
chr1,95002544,95003120,SRX5075170,SMARCA4,576
chr1,95002547,95003025,SRX5716470,SMARCA4,478
chr1,95002563,95002970,SRX5075169,SMARCA4,407
chr1,95002581,95002952,SRX5716469,SMARCA4,371
chr1,95002595,95002925,SRX5075175,SMARCA4,330
chr1,95002647,95002886,SRX5716468,SMARCA2,239
chr1,95002679,95002883,SRX5075181,SMARCA2,204
chr1,95002686,95002957,SRX5716467,SMARCA2,271
chr1,95002726,95002908,SRX5075174,SMARCA4,182
chr1,95013845,95014320,SRX5075175,SMARCA4,475
chr1,95013988,95014387,SRX5075176,SMARCA4,399
chr1,95014036,95014226,SRX5075169,SMARCA4,190
chr1,95014036,95014312,SRX5075170,SMARCA4,276
chr1,95014040,95014268,SRX5716467,SMARCA2,228
chr1,95014100,95014279,SRX5075174,SMARCA4,179
chr1,95018656,95018836,SRX5054308,FOSL2,180
chr1,95018704,95018887,SRX5054309,FOSL2,183
chr1,95021902,95022211,SRX5075170,SMARCA4,309
chr1,95023616,95024109,SRX5075175,SMARCA4,493
chr1,95023640,95024051,SRX5075176,SMARCA4,411
chr1,95023649,95024012,SRX5716467,SMARCA2,363
chr1,95023668,95024027,SRX5716469,SMARCA4,359
chr1,95023679,95024049,SRX5075170,SMARCA4,370
chr1,95023688,95024140,SRX5075169,SMARCA4,452
chr1,95023693,95024024,SRX5716470,SMARCA4,331
chr1,95023694,95024066,SRX5054308,FOSL2,372
chr1,95023698,95024065,SRX5054309,FOSL2,367
chr1,95023708,95023919,SRX5075181,SMARCA2,211
chr1,95023709,95023978,SRX5020214,SMARCA2,269
chr1,95023730,95024063,SRX5020211,SMARCA2,333
chr1,95023732,95023961,SRX5075182,SMARCA2,229
chr1,95023800,95024007,SRX5075174,SMARCA4,207
chr1,95035460,95035890,SRX5075170,SMARCA4,430
chr1,95035520,95035930,SRX5075175,SMARCA4,410
chr1,95035539,95035910,SRX5716469,SMARCA4,371
chr1,95035544,95035978,SRX5075176,SMARCA4,434
chr1,95035561,95035926,SRX5075169,SMARCA4,365
chr1,95035567,95035929,SRX5716470,SMARCA4,362
chr1,95035580,95035931,SRX5054309,FOSL2,351
chr1,95035586,95035865,SRX5054308,FOSL2,279
chr1,95035610,95035996,SRX5716467,SMARCA2,386
chr1,95041570,95041934,SRX16500059,CTCF,364
chr1,95041583,95041898,SRX16500062,CTCF,315
chr1,95041592,95041933,SRX16500061,CTCF,341
chr1,95041600,95041862,SRX5075176,SMARCA4,262
chr1,95041605,95041932,SRX16500060,CTCF,327
chr1,95041625,95041850,SRX5075175,SMARCA4,225
chr1,95041626,95041868,SRX5075174,SMARCA4,242
chr1,95041634,95041887,SRX5075168,SMARCA4,253
chr1,95041636,95041850,SRX5075170,SMARCA4,214
chr1,95041651,95041842,SRX5075169,SMARCA4,191
chr1,95043205,95043820,SRX4174629,CTCF,615
chr1,95043326,95043823,SRX16500060,CTCF,497
chr1,95043346,95043825,SRX16500059,CTCF,479
chr1,95043347,95043814,SRX16500061,CTCF,467
chr1,95043357,95043806,SRX16500062,CTCF,449
chr1,95043403,95043647,SRX5075169,SMARCA4,244
chr1,95043403,95043705,SRX5075168,SMARCA4,302
chr1,95043405,95043654,SRX5075175,SMARCA4,249
chr1,95043410,95043675,SRX5075176,SMARCA4,265
chr1,95043411,95043702,SRX5075170,SMARCA4,291
chr1,95043412,95043718,SRX5075174,SMARCA4,306
chr1,95043417,95043687,SRX5716463,SMARCA4,270
chr1,95043419,95043639,SRX5716469,SMARCA4,220
chr1,95043422,95043628,SRX5716464,SMARCA4,206
chr1,95072536,95073318,SRX5075174,SMARCA4,782
chr1,95072538,95073209,SRX20140895,INTS13,671
chr1,95072737,95073370,SRX5075168,SMARCA4,633
chr1,95072945,95073428,SRX5075170,SMARCA4,483
chr1,95072967,95073154,SRX5075175,SMARCA4,187
chr1,95072989,95073366,SRX5075176,SMARCA4,377
chr1,95073032,95073315,SRX5075169,SMARCA4,283
chr1,95073066,95073336,SRX5716470,SMARCA4,270
chr1,95084458,95084956,SRX16500060,CTCF,498
chr1,95084515,95085016,SRX16500059,CTCF,501
chr1,95084553,95085004,SRX16500062,CTCF,451
chr1,95084609,95085051,SRX16500061,CTCF,442
chr1,95086976,95087585,SRX5075175,SMARCA4,609
chr1,95086998,95087585,SRX5075176,SMARCA4,587
chr1,95087002,95087611,SRX5075168,SMARCA4,609
chr1,95087013,95087549,SRX5075169,SMARCA4,536
chr1,95087069,95087573,SRX5075174,SMARCA4,504
chr1,95087084,95087503,SRX5716460,Epitope tags,419
chr1,95087084,95087573,SRX5075170,SMARCA4,489
chr1,95087112,95087535,SRX5716469,SMARCA4,423
chr1,95087120,95087487,SRX5075181,SMARCA2,367
chr1,95087124,95087577,SRX5716467,SMARCA2,453
chr1,95087129,95087453,SRX5716464,SMARCA4,324
chr1,95087139,95087552,SRX5716470,SMARCA4,413
chr1,95087143,95087569,SRX5054309,FOSL2,426
chr1,95087150,95087480,SRX5716468,SMARCA2,330
chr1,95087185,95087491,SRX5716463,SMARCA4,306
chr1,95087194,95087567,SRX5054308,FOSL2,373
chr1,95087197,95087577,SRX5020211,SMARCA2,380
chr1,95087212,95087482,SRX5020214,SMARCA2,270
chr1,95087237,95087535,SRX5054307,FOSL2,298
chr1,95087250,95087429,SRX5075182,SMARCA2,179
chr1,95116585,95117186,SRX16500061,CTCF,601
chr1,95116603,95117168,SRX16500060,CTCF,565
chr1,95116608,95117194,SRX16500059,CTCF,586
chr1,95116663,95117032,SRX4174629,CTCF,369
chr1,95116690,95117103,SRX16500062,CTCF,413
chr1,95116722,95117037,SRX5075168,SMARCA4,315
chr1,95116724,95117017,SRX5075174,SMARCA4,293
chr1,95117163,95117701,SRX20140895,INTS13,538
chr1,95117185,95117492,SRX5075168,SMARCA4,307
chr1,95117208,95117471,SRX5075174,SMARCA4,263
chr1,95117279,95117561,SRX5075176,SMARCA4,282
chr1,95117318,95117732,SRX5075170,SMARCA4,414
chr1,95117324,95117504,SRX5075169,SMARCA4,180
chr1,95117832,95118019,SRX5075174,SMARCA4,187
chr1,95197842,95198255,SRX5075176,SMARCA4,413
chr1,95197852,95198251,SRX5054309,FOSL2,399
chr1,95197883,95198252,SRX5716469,SMARCA4,369
chr1,95197888,95198229,SRX5716470,SMARCA4,341
chr1,95197890,95198197,SRX5075170,SMARCA4,307
chr1,95197893,95198239,SRX5075169,SMARCA4,346
chr1,95197927,95198237,SRX5054308,FOSL2,310
chr1,95197945,95198148,SRX5075175,SMARCA4,203
chr1,95233801,95234423,SRX5075176,SMARCA4,622
chr1,95233816,95234293,SRX5075170,SMARCA4,477
chr1,95233824,95234186,SRX5075175,SMARCA4,362
chr1,95233849,95234391,SRX16500060,CTCF,542
chr1,95233854,95234327,SRX5716470,SMARCA4,473
chr1,95233857,95234408,SRX5075168,SMARCA4,551
chr1,95233860,95234392,SRX5075174,SMARCA4,532
chr1,95233886,95234334,SRX16500062,CTCF,448
chr1,95233898,95234289,SRX5716463,SMARCA4,391
chr1,95233898,95234507,SRX5716469,SMARCA4,609
chr1,95233900,95234423,SRX16500059,CTCF,523
chr1,95233933,95234412,SRX16500061,CTCF,479
chr1,95233962,95234230,SRX5716464,SMARCA4,268
chr1,95233970,95234495,SRX20140868,INTS10,525
chr1,95233985,95234416,SRX5075169,SMARCA4,431
chr1,95233986,95234197,SRX5716468,SMARCA2,211
chr1,95233987,95234577,SRX20140895,INTS13,590
chr1,95234033,95234438,SRX20140867,INTS10,405
chr1,95234077,95234426,SRX20140879,CPSF3L,349
chr1,95234134,95234407,SRX20140894,INTS13,273
chr1,95246585,95246823,SRX5075168,SMARCA4,238
chr1,95246661,95246881,SRX5075174,SMARCA4,220
chr1,95287116,95287378,SRX16500059,CTCF,262
chr1,95287143,95287398,SRX16500062,CTCF,255
chr1,95287153,95287428,SRX16500061,CTCF,275
chr1,95287202,95287460,SRX16500060,CTCF,258
chr1,95308852,95309425,SRX16500059,CTCF,573
chr1,95308871,95309402,SRX16500060,CTCF,531
chr1,95308908,95309389,SRX16500061,CTCF,481
chr1,95308918,95309291,SRX5716463,SMARCA4,373
chr1,95308927,95309378,SRX16500062,CTCF,451
chr1,95308931,95309363,SRX5075174,SMARCA4,432
chr1,95308943,95309333,SRX5075168,SMARCA4,390
chr1,95309073,95309318,SRX5075176,SMARCA4,245
chr1,95309080,95309327,SRX4174629,CTCF,247
chr1,95323021,95323610,SRX5075174,SMARCA4,589
chr1,95323075,95323578,SRX5075168,SMARCA4,503
chr1,95323114,95323484,SRX5716463,SMARCA4,370
chr1,95323136,95323480,SRX5075176,SMARCA4,344
chr1,95323154,95323366,SRX5716451,SOX2,212
chr1,95323161,95323465,SRX5054309,FOSL2,304
chr1,95323163,95323482,SRX5054307,FOSL2,319
chr1,95323178,95323487,SRX5054308,FOSL2,309
chr1,95323189,95323526,SRX5075170,SMARCA4,337
chr1,95323198,95323479,SRX5716469,SMARCA4,281
chr1,95323202,95323382,SRX5075169,SMARCA4,180
chr1,95407920,95408356,SRX5075174,SMARCA4,436
chr1,95407999,95408354,SRX5075168,SMARCA4,355
chr1,95415188,95415500,SRX5075170,SMARCA4,312
chr1,95415213,95415516,SRX5075176,SMARCA4,303
chr1,95415234,95415423,SRX5075169,SMARCA4,189
chr1,95415252,95415435,SRX5054309,FOSL2,183
chr1,95423085,95423459,SRX5075170,SMARCA4,374
chr1,95423165,95423352,SRX5075175,SMARCA4,187
chr1,95423175,95423527,SRX5716470,SMARCA4,352
chr1,95423234,95423409,SRX5075176,SMARCA4,175
chr1,95467063,95467284,SRX16500060,CTCF,221
chr1,95467158,95467400,SRX16500061,CTCF,242
chr1,95650684,95650869,SRX5054309,FOSL2,185
chr1,95655316,95655611,SRX5075168,SMARCA4,295
chr1,95655394,95655680,SRX5075174,SMARCA4,286
chr1,95742796,95743071,SRX5054308,FOSL2,275
chr1,95742819,95743125,SRX5054309,FOSL2,306
chr1,95746368,95746676,SRX5075174,SMARCA4,308
chr1,95780849,95781221,SRX5075174,SMARCA4,372
chr1,95780860,95781280,SRX5075168,SMARCA4,420
chr1,95780951,95781155,SRX5716463,SMARCA4,204
chr1,95780953,95781158,SRX5716454,SOX3,205
chr1,95832441,95832707,SRX5075168,SMARCA4,266
chr1,95916616,95916912,SRX16500061,CTCF,296
chr1,95916674,95916985,SRX16500059,CTCF,311
chr1,95916675,95916935,SRX16500060,CTCF,260
chr1,95916695,95916968,SRX16500062,CTCF,273
chr1,96009902,96010358,SRX5075170,SMARCA4,456
chr1,96009931,96010361,SRX5075176,SMARCA4,430
chr1,96010026,96010241,SRX5716467,SMARCA2,215
chr1,96116698,96117123,SRX5075170,SMARCA4,425
chr1,96116703,96117093,SRX5075168,SMARCA4,390
chr1,96116727,96117114,SRX5075176,SMARCA4,387
chr1,96116744,96117134,SRX5075175,SMARCA4,390
chr1,96116755,96117128,SRX5716469,SMARCA4,373
chr1,96116764,96117085,SRX5054309,FOSL2,321
chr1,96116774,96117062,SRX5054308,FOSL2,288
chr1,96116775,96117109,SRX5075169,SMARCA4,334
chr1,96116795,96117058,SRX5716470,SMARCA4,263
chr1,96116825,96117043,SRX5075174,SMARCA4,218
chr1,96234246,96234714,SRX5075175,SMARCA4,468
chr1,96234307,96234663,SRX5075176,SMARCA4,356
chr1,96234339,96234707,SRX5075170,SMARCA4,368
chr1,96234345,96234634,SRX5075169,SMARCA4,289
chr1,96234350,96234686,SRX5075174,SMARCA4,336
chr1,96234351,96234690,SRX5054309,FOSL2,339
chr1,96234369,96234709,SRX5075168,SMARCA4,340
chr1,96234378,96234682,SRX5054308,FOSL2,304
chr1,96234388,96234659,SRX5716469,SMARCA4,271
chr1,96236062,96236578,SRX16500059,CTCF,516
chr1,96236090,96236576,SRX16500062,CTCF,486
chr1,96236097,96236615,SRX16500061,CTCF,518
chr1,96236123,96236576,SRX16500060,CTCF,453
chr1,96236276,96236452,SRX5075174,SMARCA4,176
chr1,96236276,96236507,SRX5075168,SMARCA4,231
chr1,96290164,96290385,SRX5075168,SMARCA4,221
chr1,96290811,96291022,SRX5716468,SMARCA2,211
chr1,96306805,96307019,SRX5054309,FOSL2,214
chr1,96313222,96313593,SRX5075175,SMARCA4,371
chr1,96313231,96313447,SRX5020211,SMARCA2,216
chr1,96313235,96313594,SRX5075169,SMARCA4,359
chr1,96313241,96313524,SRX5716467,SMARCA2,283
chr1,96313258,96313463,SRX5020214,SMARCA2,205
chr1,96313263,96313551,SRX5054309,FOSL2,288
chr1,96313263,96313567,SRX5716470,SMARCA4,304
chr1,96313276,96313554,SRX5054308,FOSL2,278
chr1,96313276,96313593,SRX5075170,SMARCA4,317
chr1,96313293,96313561,SRX5716469,SMARCA4,268
chr1,96313305,96313560,SRX5075176,SMARCA4,255
chr1,96329112,96329449,SRX5075169,SMARCA4,337
chr1,96329112,96329494,SRX5054308,FOSL2,382
chr1,96329137,96329467,SRX5054309,FOSL2,330
chr1,96329150,96329480,SRX5075175,SMARCA4,330
chr1,96329153,96329571,SRX5716470,SMARCA4,418
chr1,96329157,96329522,SRX5075170,SMARCA4,365
chr1,96329158,96329483,SRX5075176,SMARCA4,325
chr1,96329164,96329537,SRX5716469,SMARCA4,373
chr1,96329201,96329447,SRX5020211,SMARCA2,246
chr1,96357174,96357555,SRX5054309,FOSL2,381
chr1,96357243,96357528,SRX5054308,FOSL2,285
chr1,96362541,96363039,SRX5075169,SMARCA4,498
chr1,96362550,96363042,SRX5075175,SMARCA4,492
chr1,96362566,96362979,SRX5054309,FOSL2,413
chr1,96362580,96362915,SRX5716469,SMARCA4,335
chr1,96362580,96362958,SRX5075170,SMARCA4,378
chr1,96362588,96362937,SRX5075176,SMARCA4,349
chr1,96362617,96362932,SRX5054308,FOSL2,315
chr1,96362619,96362937,SRX5716470,SMARCA4,318
chr1,96362643,96362972,SRX5075182,SMARCA2,329
chr1,96362645,96362942,SRX5020214,SMARCA2,297
chr1,96362663,96362897,SRX5716467,SMARCA2,234
chr1,96362667,96362910,SRX5075174,SMARCA4,243
chr1,96365123,96365338,SRX5020211,SMARCA2,215
chr1,96365123,96365446,SRX5075170,SMARCA4,323
chr1,96365136,96365421,SRX5075176,SMARCA4,285
chr1,96365138,96365386,SRX5075169,SMARCA4,248
chr1,96365141,96365414,SRX5716470,SMARCA4,273
chr1,96365146,96365455,SRX5716467,SMARCA2,309
chr1,96365151,96365401,SRX5716469,SMARCA4,250
chr1,96365174,96365364,SRX5075175,SMARCA4,190
chr1,96370739,96371126,SRX5075175,SMARCA4,387
chr1,96370821,96371133,SRX5075169,SMARCA4,312
chr1,96370841,96371124,SRX5075170,SMARCA4,283
chr1,96370842,96371141,SRX5075176,SMARCA4,299
chr1,96370861,96371160,SRX5054309,FOSL2,299
chr1,96370863,96371118,SRX5716470,SMARCA4,255
chr1,96370878,96371122,SRX5054308,FOSL2,244
chr1,96370880,96371094,SRX5020214,SMARCA2,214
chr1,96370885,96371100,SRX5716467,SMARCA2,215
chr1,96374421,96374618,SRX5054309,FOSL2,197
chr1,96388976,96389170,SRX5075170,SMARCA4,194
chr1,96389023,96389284,SRX5075169,SMARCA4,261
chr1,96389026,96389254,SRX5075175,SMARCA4,228
chr1,96415982,96416502,SRX5716469,SMARCA4,520
chr1,96415990,96416563,SRX5054309,FOSL2,573
chr1,96415991,96416628,SRX5075175,SMARCA4,637
chr1,96415997,96416520,SRX5054308,FOSL2,523
chr1,96416004,96416561,SRX5075169,SMARCA4,557
chr1,96416005,96416415,SRX5716470,SMARCA4,410
chr1,96416012,96416603,SRX5075170,SMARCA4,591
chr1,96416018,96416247,SRX5020211,SMARCA2,229
chr1,96416033,96416585,SRX5075176,SMARCA4,552
chr1,96416055,96416319,SRX5716467,SMARCA2,264
chr1,96416063,96416294,SRX5716468,SMARCA2,231
chr1,96416084,96416442,SRX5020214,SMARCA2,358
chr1,96425401,96425650,SRX5075168,SMARCA4,249
chr1,96425410,96425579,SRX5075170,SMARCA4,169
chr1,96427662,96427837,SRX5075176,SMARCA4,175
chr1,96464255,96464496,SRX5075174,SMARCA4,241
chr1,96473804,96474168,SRX5075176,SMARCA4,364
chr1,96473853,96474127,SRX5075168,SMARCA4,274
chr1,96473863,96474205,SRX5075174,SMARCA4,342
chr1,96473883,96474258,SRX5075170,SMARCA4,375
chr1,96473913,96474101,SRX5054308,FOSL2,188
chr1,96473938,96474133,SRX5075169,SMARCA4,195
chr1,96482597,96482916,SRX5075168,SMARCA4,319
chr1,96482704,96482960,SRX5075174,SMARCA4,256
chr1,96487276,96487748,SRX5075174,SMARCA4,472
chr1,96487396,96487663,SRX5075169,SMARCA4,267
chr1,96487430,96487877,SRX5075168,SMARCA4,447
chr1,96487562,96487797,SRX5716463,SMARCA4,235
chr1,96487565,96487740,SRX5075176,SMARCA4,175
chr1,96513248,96513628,SRX5075169,SMARCA4,380
chr1,96513304,96513550,SRX5075176,SMARCA4,246
chr1,96513316,96513688,SRX5054309,FOSL2,372
chr1,96513372,96513651,SRX5075170,SMARCA4,279
chr1,96519989,96520316,SRX5075174,SMARCA4,327
chr1,96519991,96520338,SRX5716463,SMARCA4,347
chr1,96520064,96520309,SRX5075168,SMARCA4,245
chr1,96520616,96520875,SRX5075176,SMARCA4,259
chr1,96520630,96520925,SRX5075170,SMARCA4,295
chr1,96520650,96520976,SRX5716470,SMARCA4,326
chr1,96520658,96520862,SRX5075175,SMARCA4,204
chr1,96522060,96522326,SRX5054309,FOSL2,266
chr1,96522123,96522298,SRX5075176,SMARCA4,175
chr1,96538205,96538751,SRX5075176,SMARCA4,546
chr1,96538275,96538730,SRX5075174,SMARCA4,455
chr1,96538299,96538549,SRX5075175,SMARCA4,250
chr1,96538313,96538610,SRX5716470,SMARCA4,297
chr1,96538313,96538634,SRX5075170,SMARCA4,321
chr1,96538370,96538716,SRX5075168,SMARCA4,346
chr1,96538792,96539320,SRX5075175,SMARCA4,528
chr1,96538822,96539374,SRX5075176,SMARCA4,552
chr1,96538843,96539342,SRX5716470,SMARCA4,499
chr1,96538846,96539354,SRX5075170,SMARCA4,508
chr1,96538907,96539097,SRX5075168,SMARCA4,190
chr1,96538910,96539240,SRX5054308,FOSL2,330
chr1,96538911,96539268,SRX5716469,SMARCA4,357
chr1,96538916,96539338,SRX5075169,SMARCA4,422
chr1,96538916,96539339,SRX5716467,SMARCA2,423
chr1,96538927,96539252,SRX5054309,FOSL2,325
chr1,96538928,96539178,SRX5075174,SMARCA4,250
chr1,96538945,96539313,SRX5716468,SMARCA2,368
chr1,96538984,96539229,SRX5020214,SMARCA2,245
chr1,96538993,96539195,SRX5020211,SMARCA2,202
chr1,96539038,96539299,SRX5075181,SMARCA2,261
chr1,96560057,96560528,SRX5716470,SMARCA4,471
chr1,96560083,96560589,SRX5075170,SMARCA4,506
chr1,96560096,96560642,SRX5075176,SMARCA4,546
chr1,96560100,96560645,SRX5075169,SMARCA4,545
chr1,96560136,96560700,SRX5075175,SMARCA4,564
chr1,96560157,96560552,SRX5054309,FOSL2,395
chr1,96560229,96560532,SRX5054308,FOSL2,303
chr1,96560241,96560555,SRX5716469,SMARCA4,314
chr1,96560303,96560637,SRX5716467,SMARCA2,334
chr1,96596166,96596519,SRX16500061,CTCF,353
chr1,96596263,96596582,SRX16500059,CTCF,319
chr1,96596269,96596709,SRX16500060,CTCF,440
chr1,96596281,96596552,SRX16500062,CTCF,271
chr1,96598166,96599090,SRX5075168,SMARCA4,924
chr1,96598241,96598992,SRX5716463,SMARCA4,751
chr1,96598245,96598798,SRX20140895,INTS13,553
chr1,96598259,96599056,SRX5075174,SMARCA4,797
chr1,96598288,96598802,SRX5716464,SMARCA4,514
chr1,96598302,96598805,SRX5075169,SMARCA4,503
chr1,96598358,96598904,SRX5075176,SMARCA4,546
chr1,96598368,96598786,SRX5075170,SMARCA4,418
chr1,96598409,96598819,SRX20140868,INTS10,410
chr1,96598415,96598790,SRX5075175,SMARCA4,375
chr1,96598452,96598829,SRX5716454,SOX3,377
chr1,96598477,96598733,SRX5716469,SMARCA4,256
chr1,96598506,96598884,SRX5716470,SMARCA4,378
chr1,96598521,96598920,SRX5716451,SOX2,399
chr1,96624990,96625384,SRX5075168,SMARCA4,394
chr1,96625046,96625379,SRX5075174,SMARCA4,333
chr1,96625192,96625397,SRX5716464,SMARCA4,205
chr1,96641032,96641364,SRX5075174,SMARCA4,332
chr1,96641066,96641287,SRX5716464,SMARCA4,221
chr1,96641066,96641353,SRX5075168,SMARCA4,287
chr1,96660630,96660803,SRX5075174,SMARCA4,173
chr1,96685395,96685605,SRX5075170,SMARCA4,210
chr1,96721366,96721676,SRX5075175,SMARCA4,310
chr1,96721372,96722599,SRX20140895,INTS13,1227
chr1,96721394,96721740,SRX5075169,SMARCA4,346
chr1,96721395,96721760,SRX5075176,SMARCA4,365
chr1,96721413,96721772,SRX5075168,SMARCA4,359
chr1,96721445,96721844,SRX5075174,SMARCA4,399
chr1,96721454,96721779,SRX5075170,SMARCA4,325
chr1,96721468,96721754,SRX5716469,SMARCA4,286
chr1,96721504,96721717,SRX5716470,SMARCA4,213
chr1,96721624,96722087,SRX20140868,INTS10,463
chr1,96721788,96722060,SRX20140897,INTS13,272
chr1,96722288,96722575,SRX5716470,SMARCA4,287
chr1,96722494,96722675,SRX5075174,SMARCA4,181
chr1,96836854,96837138,SRX5075170,SMARCA4,284
chr1,96865647,96866305,SRX5075170,SMARCA4,658
chr1,96865651,96866407,SRX5075176,SMARCA4,756
chr1,96865677,96866228,SRX5054309,FOSL2,551
chr1,96865686,96866302,SRX5716469,SMARCA4,616
chr1,96865691,96866186,SRX5716470,SMARCA4,495
chr1,96865726,96866185,SRX5054308,FOSL2,459
chr1,96865754,96866234,SRX5075175,SMARCA4,480
chr1,96865774,96866277,SRX5075169,SMARCA4,503
chr1,96865788,96866109,SRX5716467,SMARCA2,321
chr1,96865793,96866099,SRX5716468,SMARCA2,306
chr1,96865845,96866098,SRX5020211,SMARCA2,253
chr1,96918458,96918735,SRX5075175,SMARCA4,277
chr1,96918473,96918774,SRX5075169,SMARCA4,301
chr1,96918479,96918754,SRX5716469,SMARCA4,275
chr1,96918516,96918734,SRX5075170,SMARCA4,218
chr1,96927135,96927401,SRX5075168,SMARCA4,266
chr1,96962680,96963055,SRX5716470,SMARCA4,375
chr1,96962764,96963419,SRX5075170,SMARCA4,655
chr1,96962847,96963272,SRX5716469,SMARCA4,425
chr1,96962849,96963292,SRX5075169,SMARCA4,443
chr1,96962878,96963345,SRX5716467,SMARCA2,467
chr1,96962881,96963115,SRX5075181,SMARCA2,234
chr1,96962882,96963346,SRX5075176,SMARCA4,464
chr1,96962893,96963319,SRX5054308,FOSL2,426
chr1,96962904,96963354,SRX5020211,SMARCA2,450
chr1,96962928,96963235,SRX5054309,FOSL2,307
chr1,96962944,96963316,SRX5075175,SMARCA4,372
chr1,96963120,96963408,SRX5716470,SMARCA4,288
chr1,96966494,96966974,SRX16500060,CTCF,480
chr1,96966504,96967018,SRX16500059,CTCF,514
chr1,96966505,96966941,SRX16500062,CTCF,436
chr1,96966506,96967005,SRX16500061,CTCF,499
chr1,96966594,96966812,SRX5075168,SMARCA4,218
chr1,96966617,96966865,SRX5075174,SMARCA4,248
chr1,96966633,96966865,SRX4174629,CTCF,232
chr1,96973695,96973972,SRX5075176,SMARCA4,277
chr1,96979247,96979568,SRX5716468,SMARCA2,321
chr1,96979252,96979741,SRX5075169,SMARCA4,489
chr1,96979272,96979790,SRX5075176,SMARCA4,518
chr1,96979284,96979611,SRX5075175,SMARCA4,327
chr1,96979302,96979819,SRX5075170,SMARCA4,517
chr1,96979321,96979585,SRX5020211,SMARCA2,264
chr1,96979325,96979725,SRX5716469,SMARCA4,400
chr1,96979335,96979853,SRX5716470,SMARCA4,518
chr1,96979360,96979656,SRX5075181,SMARCA2,296
chr1,96979371,96979763,SRX5054308,FOSL2,392
chr1,96979392,96979678,SRX5716467,SMARCA2,286
chr1,96979451,96979719,SRX5054309,FOSL2,268
chr1,96980435,96980877,SRX5075170,SMARCA4,442
chr1,96980550,96980884,SRX5075176,SMARCA4,334
chr1,96995333,96995802,SRX5075176,SMARCA4,469
chr1,96995398,96995900,SRX5716470,SMARCA4,502
chr1,96995412,96995837,SRX5075170,SMARCA4,425
chr1,96995425,96995876,SRX5716469,SMARCA4,451
chr1,96995427,96995824,SRX5075169,SMARCA4,397
chr1,96995467,96995652,SRX5054309,FOSL2,185
chr1,96995476,96995806,SRX5075175,SMARCA4,330
chr1,96995486,96995850,SRX5716467,SMARCA2,364
chr1,96995496,96995875,SRX5020211,SMARCA2,379
chr1,96995512,96995723,SRX5716468,SMARCA2,211
chr1,97001395,97001439,SRX1424894,POU3F2,44
chr1,97001395,97001440,SRX1424891,POU3F2,45
chr1,97001397,97001440,SRX1424893,POU3F2,43
chr1,97005957,97006523,SRX5075169,SMARCA4,566
chr1,97006037,97006518,SRX5075170,SMARCA4,481
chr1,97006042,97006364,SRX5075175,SMARCA4,322
chr1,97006044,97006490,SRX5075176,SMARCA4,446
chr1,97006068,97006452,SRX5716469,SMARCA4,384
chr1,97006080,97006331,SRX5716467,SMARCA2,251
chr1,97006101,97006395,SRX5716470,SMARCA4,294
chr1,97006168,97006356,SRX5054309,FOSL2,188
chr1,97013877,97014272,SRX5075175,SMARCA4,395
chr1,97013922,97014327,SRX5054309,FOSL2,405
chr1,97013934,97014346,SRX5075176,SMARCA4,412
chr1,97013939,97014416,SRX5075170,SMARCA4,477
chr1,97013943,97014227,SRX5054308,FOSL2,284
chr1,97013944,97014278,SRX5075169,SMARCA4,334
chr1,97014024,97014321,SRX5020211,SMARCA2,297
chr1,97042477,97042795,SRX5054309,FOSL2,318
chr1,97094380,97094559,SRX5075168,SMARCA4,179
chr1,97101532,97101862,SRX5075174,SMARCA4,330
chr1,97101555,97101823,SRX5075168,SMARCA4,268
chr1,97138075,97138627,SRX5075170,SMARCA4,552
chr1,97138199,97138706,SRX5075176,SMARCA4,507
chr1,97138214,97138591,SRX5075169,SMARCA4,377
chr1,97138240,97138730,SRX16500060,CTCF,490
chr1,97138248,97138629,SRX5716470,SMARCA4,381
chr1,97138266,97138685,SRX16500059,CTCF,419
chr1,97138306,97138630,SRX16500061,CTCF,324
chr1,97138318,97138687,SRX16500062,CTCF,369
chr1,97138332,97138593,SRX5075175,SMARCA4,261
chr1,97138337,97138593,SRX5075168,SMARCA4,256
chr1,97138337,97138638,SRX5075174,SMARCA4,301
chr1,97138355,97138627,SRX5716469,SMARCA4,272
chr1,97144530,97144826,SRX5075169,SMARCA4,296
chr1,97144531,97144757,SRX5075170,SMARCA4,226
chr1,97144532,97144774,SRX5075168,SMARCA4,242
chr1,97144551,97144795,SRX5075176,SMARCA4,244
chr1,97144559,97144787,SRX5054308,FOSL2,228
chr1,97144559,97144847,SRX5054309,FOSL2,288
chr1,97144617,97144845,SRX5075175,SMARCA4,228
chr1,97145206,97145936,SRX5075168,SMARCA4,730
chr1,97145227,97145829,SRX5075174,SMARCA4,602
chr1,97145326,97145661,SRX20140895,INTS13,335
chr1,97145345,97145867,SRX5075176,SMARCA4,522
chr1,97145348,97145875,SRX5716469,SMARCA4,527
chr1,97145351,97145850,SRX5716470,SMARCA4,499
chr1,97145418,97145815,SRX5075175,SMARCA4,397
chr1,97145418,97145914,SRX5075169,SMARCA4,496
chr1,97145541,97145854,SRX5716468,SMARCA2,313
chr1,97145567,97145900,SRX5716467,SMARCA2,333
chr1,97145716,97145995,SRX5075170,SMARCA4,279
chr1,97167235,97167627,SRX5075170,SMARCA4,392
chr1,97167258,97167616,SRX5075176,SMARCA4,358
chr1,97167282,97167634,SRX5716470,SMARCA4,352
chr1,97167309,97167545,SRX5716468,SMARCA2,236
chr1,97167309,97167567,SRX5716469,SMARCA4,258
chr1,97167325,97167674,SRX5075169,SMARCA4,349
chr1,97167326,97167619,SRX5716467,SMARCA2,293
chr1,97167335,97167562,SRX5020211,SMARCA2,227
chr1,97167357,97167590,SRX5075175,SMARCA4,233
chr1,97192670,97193290,SRX5075176,SMARCA4,620
chr1,97192725,97193284,SRX5075170,SMARCA4,559
chr1,97192774,97193298,SRX5075169,SMARCA4,524
chr1,97192806,97193187,SRX5716470,SMARCA4,381
chr1,97192818,97193264,SRX5716467,SMARCA2,446
chr1,97192843,97193367,SRX5075175,SMARCA4,524
chr1,97192855,97193128,SRX5020211,SMARCA2,273
chr1,97192860,97193279,SRX5054309,FOSL2,419
chr1,97192896,97193259,SRX5020214,SMARCA2,363
chr1,97192914,97193293,SRX5054308,FOSL2,379
chr1,97192957,97193263,SRX5716469,SMARCA4,306
chr1,97243887,97244315,SRX16500059,CTCF,428
chr1,97243939,97244354,SRX16500061,CTCF,415
chr1,97243947,97244362,SRX16500060,CTCF,415
chr1,97244063,97244385,SRX16500062,CTCF,322
chr1,97277914,97278206,SRX5075176,SMARCA4,292
chr1,97277952,97278124,SRX5075170,SMARCA4,172
chr1,97277960,97278223,SRX5054309,FOSL2,263
chr1,97277984,97278349,SRX5075169,SMARCA4,365
chr1,97332705,97333011,SRX5075169,SMARCA4,306
chr1,97332731,97333036,SRX5075175,SMARCA4,305
chr1,97332739,97333062,SRX5075176,SMARCA4,323
chr1,97332740,97333040,SRX5075170,SMARCA4,300
chr1,97332743,97333070,SRX5054309,FOSL2,327
chr1,97332774,97333056,SRX5054308,FOSL2,282
chr1,97332787,97332992,SRX5020214,SMARCA2,205
chr1,97332899,97333096,SRX5075174,SMARCA4,197
chr1,97334501,97334803,SRX5020214,SMARCA2,302
chr1,97334511,97334759,SRX5716459,Epitope tags,248
chr1,97334524,97334806,SRX5054309,FOSL2,282
chr1,97334525,97334780,SRX5716469,SMARCA4,255
chr1,97334527,97334801,SRX5075169,SMARCA4,274
chr1,97334528,97334873,SRX5716470,SMARCA4,345
chr1,97334531,97334825,SRX5075170,SMARCA4,294
chr1,97334559,97334853,SRX5020211,SMARCA2,294
chr1,97334588,97334830,SRX5054308,FOSL2,242
chr1,97334593,97334806,SRX5075181,SMARCA2,213
chr1,97334604,97334835,SRX5075176,SMARCA4,231
chr1,97341023,97341258,SRX5075169,SMARCA4,235
chr1,97341031,97341319,SRX5075176,SMARCA4,288
chr1,97341103,97341365,SRX5075170,SMARCA4,262
chr1,97350371,97350705,SRX5054309,FOSL2,334
chr1,97352793,97353369,SRX5075174,SMARCA4,576
chr1,97352814,97353405,SRX5075168,SMARCA4,591
chr1,97352942,97353213,SRX5716463,SMARCA4,271
chr1,97364183,97364449,SRX5054309,FOSL2,266
chr1,97384248,97384917,SRX5054309,FOSL2,669
chr1,97384296,97384506,SRX5075175,SMARCA4,210
chr1,97423197,97423862,SRX5716463,SMARCA4,665
chr1,97423205,97423901,SRX5075174,SMARCA4,696
chr1,97423266,97423913,SRX5075168,SMARCA4,647
chr1,97423293,97423781,SRX20140895,INTS13,488
chr1,97423385,97423618,SRX20140867,INTS10,233
chr1,97423387,97423722,SRX20140868,INTS10,335
chr1,97423387,97423757,SRX5716464,SMARCA4,370
chr1,97423402,97423686,SRX20140880,CPSF3L,284
chr1,97423434,97423719,SRX5716451,SOX2,285
chr1,97423514,97423745,SRX5716454,SOX3,231
chr1,97433403,97433707,SRX5716460,Epitope tags,304
chr1,97433412,97433942,SRX5075176,SMARCA4,530
chr1,97433486,97433888,SRX5716467,SMARCA2,402
chr1,97433523,97433934,SRX5075169,SMARCA4,411
chr1,97433527,97433918,SRX5075170,SMARCA4,391
chr1,97433545,97433926,SRX5716469,SMARCA4,381
chr1,97433546,97433964,SRX5054309,FOSL2,418
chr1,97433547,97433826,SRX5716468,SMARCA2,279
chr1,97433573,97433976,SRX5075175,SMARCA4,403
chr1,97433576,97433847,SRX5716470,SMARCA4,271
chr1,97433594,97433924,SRX5054308,FOSL2,330
chr1,97433604,97433908,SRX5020211,SMARCA2,304
chr1,97433622,97433885,SRX5020214,SMARCA2,263
chr1,97488666,97488859,SRX5075168,SMARCA4,193
chr1,97504759,97504954,SRX5075174,SMARCA4,195
chr1,97525432,97525872,SRX16500060,CTCF,440
chr1,97525525,97525870,SRX16500062,CTCF,345
chr1,97525583,97525789,SRX5075174,SMARCA4,206
chr1,97525589,97525934,SRX16500059,CTCF,345
chr1,97525596,97525874,SRX16500061,CTCF,278
chr1,97525646,97525944,SRX4174629,CTCF,298
chr1,97536743,97536979,SRX5075170,SMARCA4,236
chr1,97536774,97537028,SRX5075176,SMARCA4,254
chr1,97603830,97604220,SRX5075174,SMARCA4,390
chr1,97603853,97604146,SRX5075176,SMARCA4,293
chr1,97603881,97604106,SRX5075169,SMARCA4,225
chr1,97603891,97604098,SRX5075170,SMARCA4,207
chr1,97603896,97604161,SRX5075168,SMARCA4,265
chr1,97609251,97609431,SRX5075174,SMARCA4,180
chr1,97622921,97623094,SRX5075174,SMARCA4,173
chr1,97631901,97632398,SRX5075170,SMARCA4,497
chr1,97631975,97632375,SRX5075176,SMARCA4,400
chr1,97631976,97632504,SRX5075169,SMARCA4,528
chr1,97632024,97632428,SRX5716470,SMARCA4,404
chr1,97632034,97632443,SRX5075175,SMARCA4,409
chr1,97632040,97632432,SRX5716469,SMARCA4,392
chr1,97632043,97632456,SRX5054309,FOSL2,413
chr1,97632044,97632277,SRX5020211,SMARCA2,233
chr1,97632053,97632286,SRX5716468,SMARCA2,233
chr1,97632082,97632387,SRX5716467,SMARCA2,305
chr1,97632146,97632386,SRX5054308,FOSL2,240
chr1,97647769,97648064,SRX5054308,FOSL2,295
chr1,97647796,97648125,SRX5075176,SMARCA4,329
chr1,97647802,97648105,SRX5054309,FOSL2,303
chr1,97647810,97648060,SRX5075175,SMARCA4,250
chr1,97647814,97648200,SRX5075170,SMARCA4,386
chr1,97647832,97648155,SRX5075169,SMARCA4,323
chr1,97647868,97648101,SRX5716467,SMARCA2,233
chr1,97668991,97669202,SRX5075170,SMARCA4,211
chr1,97669017,97669228,SRX5716470,SMARCA4,211
chr1,97669040,97669274,SRX5075176,SMARCA4,234
chr1,97669052,97669278,SRX5075169,SMARCA4,226
chr1,97669052,97669298,SRX5075175,SMARCA4,246
chr1,97680897,97681081,SRX5075174,SMARCA4,184
chr1,97691483,97691687,SRX5716463,SMARCA4,204
chr1,97720485,97720660,SRX5075176,SMARCA4,175
chr1,97739820,97740027,SRX5054309,FOSL2,207
chr1,97758534,97758714,SRX5054308,FOSL2,180
chr1,97758536,97758886,SRX5075170,SMARCA4,350
chr1,97758668,97758917,SRX5075176,SMARCA4,249
chr1,97796755,97797065,SRX5075168,SMARCA4,310
chr1,97796825,97797092,SRX5075174,SMARCA4,267
chr1,97820458,97820800,SRX16500061,CTCF,342
chr1,97820471,97820830,SRX16500060,CTCF,359
chr1,97820476,97820868,SRX16500059,CTCF,392
chr1,97820484,97820836,SRX16500062,CTCF,352
chr1,97820520,97820722,SRX5075170,SMARCA4,202
chr1,97820521,97820727,SRX5075169,SMARCA4,206
chr1,97827837,97828280,SRX5075174,SMARCA4,443
chr1,97827838,97828308,SRX5075168,SMARCA4,470
chr1,97827840,97828260,SRX5716464,SMARCA4,420
chr1,97827868,97828223,SRX5716463,SMARCA4,355
chr1,97827920,97828125,SRX5716454,SOX3,205
chr1,97827959,97828190,SRX5716451,SOX2,231
chr1,97832479,97832827,SRX5075176,SMARCA4,348
chr1,97832497,97832761,SRX5075170,SMARCA4,264
chr1,97832542,97832806,SRX5716470,SMARCA4,264
chr1,97832553,97832740,SRX5075175,SMARCA4,187
chr1,97832553,97832760,SRX5075169,SMARCA4,207
chr1,97832568,97832779,SRX5054308,FOSL2,211
chr1,97849846,97850341,SRX5075176,SMARCA4,495
chr1,97849919,97850201,SRX5716460,Epitope tags,282
chr1,97849921,97850331,SRX5075170,SMARCA4,410
chr1,97849924,97850286,SRX5020211,SMARCA2,362
chr1,97849932,97850299,SRX5716470,SMARCA4,367
chr1,97849938,97850289,SRX5716469,SMARCA4,351
chr1,97849944,97850360,SRX5075169,SMARCA4,416
chr1,97849946,97850315,SRX5054309,FOSL2,369
chr1,97849962,97850324,SRX5075174,SMARCA4,362
chr1,97849979,97850310,SRX5054308,FOSL2,331
chr1,97849983,97850353,SRX5075175,SMARCA4,370
chr1,97849989,97850243,SRX5716459,Epitope tags,254
chr1,97849996,97850230,SRX5716468,SMARCA2,234
chr1,97849999,97850317,SRX5075168,SMARCA4,318
chr1,97850006,97850289,SRX5716467,SMARCA2,283
chr1,97850031,97850263,SRX5020214,SMARCA2,232
chr1,97850046,97850225,SRX5054307,FOSL2,179
chr1,97903753,97904003,SRX5075176,SMARCA4,250
chr1,97905440,97905761,SRX5075168,SMARCA4,321
chr1,97905451,97905841,SRX5075174,SMARCA4,390
chr1,97905482,97905718,SRX5716464,SMARCA4,236
chr1,97906730,97907285,SRX5075168,SMARCA4,555
chr1,97906792,97907252,SRX5075174,SMARCA4,460
chr1,97906825,97907122,SRX5716460,Epitope tags,297
chr1,97906827,97907260,SRX5075176,SMARCA4,433
chr1,97906844,97907229,SRX5075169,SMARCA4,385
chr1,97906853,97907256,SRX5075170,SMARCA4,403
chr1,97906863,97907270,SRX5054309,FOSL2,407
chr1,97906879,97907246,SRX5075175,SMARCA4,367
chr1,97906883,97907206,SRX5716470,SMARCA4,323
chr1,97906888,97907245,SRX5054308,FOSL2,357
chr1,97906912,97907240,SRX5716469,SMARCA4,328
chr1,97906918,97907203,SRX5054307,FOSL2,285
chr1,97906982,97907248,SRX5716463,SMARCA4,266
chr1,97907005,97907206,SRX5020211,SMARCA2,201
chr1,97920855,97921658,SRX5075174,SMARCA4,803
chr1,97920867,97921682,SRX5075168,SMARCA4,815
chr1,97920895,97921171,SRX20140867,INTS10,276
chr1,97920905,97921420,SRX20140895,INTS13,515
chr1,97920942,97921338,SRX5075175,SMARCA4,396
chr1,97920959,97921236,SRX5075176,SMARCA4,277
chr1,97920994,97921303,SRX5075169,SMARCA4,309
chr1,97921027,97921604,SRX5075170,SMARCA4,577
chr1,97921208,97921559,SRX5716463,SMARCA4,351
chr1,97921388,97921679,SRX5075176,SMARCA4,291
chr1,97937863,97938400,SRX5075175,SMARCA4,537
chr1,97937867,97938288,SRX5716469,SMARCA4,421
chr1,97937890,97938440,SRX5075169,SMARCA4,550
chr1,97937905,97938310,SRX5054309,FOSL2,405
chr1,97937915,97938295,SRX5075170,SMARCA4,380
chr1,97937920,97938331,SRX5054308,FOSL2,411
chr1,97937921,97938397,SRX5075176,SMARCA4,476
chr1,97937935,97938235,SRX5075168,SMARCA4,300
chr1,97937976,97938298,SRX5020214,SMARCA2,322
chr1,97938035,97938344,SRX5075174,SMARCA4,309
chr1,97938036,97938226,SRX5075182,SMARCA2,190
chr1,97943388,97943636,SRX5075170,SMARCA4,248
chr1,97943394,97943728,SRX5075176,SMARCA4,334
chr1,97943417,97943618,SRX5075169,SMARCA4,201
chr1,98001888,98002190,SRX16500059,CTCF,302
chr1,98030500,98030790,SRX5054308,FOSL2,290
chr1,98030519,98030853,SRX5054309,FOSL2,334
chr1,98030522,98030796,SRX5075169,SMARCA4,274
chr1,98030538,98030818,SRX5020214,SMARCA2,280
chr1,98030544,98030845,SRX5075175,SMARCA4,301
chr1,98048263,98048580,SRX5075170,SMARCA4,317
chr1,98048263,98048599,SRX5075176,SMARCA4,336
chr1,98048264,98048569,SRX5075174,SMARCA4,305
chr1,98048264,98048617,SRX5716470,SMARCA4,353
chr1,98048272,98048588,SRX5075169,SMARCA4,316
chr1,98048276,98048586,SRX5075175,SMARCA4,310
chr1,98048279,98048547,SRX5716463,SMARCA4,268
chr1,98048279,98048580,SRX5716469,SMARCA4,301
chr1,98048284,98048575,SRX5075168,SMARCA4,291
chr1,98048300,98048580,SRX5716464,SMARCA4,280
chr1,98051050,98051453,SRX16500059,CTCF,403
chr1,98051051,98051455,SRX16500062,CTCF,404
chr1,98051062,98051432,SRX16500061,CTCF,370
chr1,98051077,98051451,SRX16500060,CTCF,374
chr1,98051150,98051383,SRX4174629,CTCF,233
chr1,98052921,98053248,SRX5054309,FOSL2,327
chr1,98052922,98053234,SRX5054308,FOSL2,312
chr1,98052994,98053185,SRX5075170,SMARCA4,191
chr1,98053027,98053233,SRX5075175,SMARCA4,206
chr1,98054052,98054528,SRX16500059,CTCF,476
chr1,98054065,98054518,SRX16500060,CTCF,453
chr1,98054077,98054459,SRX5075169,SMARCA4,382
chr1,98054085,98054542,SRX16500061,CTCF,457
chr1,98054128,98054529,SRX16500062,CTCF,401
chr1,98054136,98054436,SRX5716470,SMARCA4,300
chr1,98054139,98054424,SRX5075176,SMARCA4,285
chr1,98054160,98054448,SRX5075168,SMARCA4,288
chr1,98054179,98054482,SRX5075170,SMARCA4,303
chr1,98054188,98054490,SRX5075174,SMARCA4,302
chr1,98054189,98054460,SRX5716469,SMARCA4,271
chr1,98054193,98054469,SRX5075175,SMARCA4,276
chr1,98059695,98059876,SRX5075168,SMARCA4,181
chr1,98059702,98059990,SRX5075174,SMARCA4,288
chr1,98077837,98078146,SRX5075168,SMARCA4,309
chr1,98078648,98078862,SRX5075175,SMARCA4,214
chr1,98086709,98087452,SRX5075174,SMARCA4,743
chr1,98086712,98087209,SRX5075169,SMARCA4,497
chr1,98086713,98087161,SRX5075176,SMARCA4,448
chr1,98086713,98087462,SRX5075168,SMARCA4,749
chr1,98086723,98087254,SRX5075170,SMARCA4,531
chr1,98086730,98087200,SRX5075175,SMARCA4,470
chr1,98086733,98087103,SRX5020214,SMARCA2,370
chr1,98086735,98087081,SRX5716470,SMARCA4,346
chr1,98086735,98087127,SRX5054308,FOSL2,392
chr1,98086738,98087162,SRX5054309,FOSL2,424
chr1,98086770,98087118,SRX5020211,SMARCA2,348
chr1,98086770,98087134,SRX5716469,SMARCA4,364
chr1,98086771,98087148,SRX5716467,SMARCA2,377
chr1,98086777,98087518,SRX5716463,SMARCA4,741
chr1,98086787,98087143,SRX5054307,FOSL2,356
chr1,98086833,98087064,SRX5075182,SMARCA2,231
chr1,98086851,98087051,SRX5075181,SMARCA2,200
chr1,98086942,98087180,SRX5716451,SOX2,238
chr1,98102749,98102935,SRX5054309,FOSL2,186
chr1,98104201,98104767,SRX5075176,SMARCA4,566
chr1,98104277,98104674,SRX5075175,SMARCA4,397
chr1,98104300,98104732,SRX5075170,SMARCA4,432
chr1,98104320,98104714,SRX5716469,SMARCA4,394
chr1,98104406,98104736,SRX5075169,SMARCA4,330
chr1,98104422,98104681,SRX5716470,SMARCA4,259
chr1,98119883,98120096,SRX5075169,SMARCA4,213
chr1,98119934,98120103,SRX5075170,SMARCA4,169
chr1,98130412,98130728,SRX5075168,SMARCA4,316
chr1,98130444,98130766,SRX5075174,SMARCA4,322
chr1,98158012,98158273,SRX5075176,SMARCA4,261
chr1,98158019,98158243,SRX5075170,SMARCA4,224
chr1,98177014,98177257,SRX5075170,SMARCA4,243
chr1,98197375,98197637,SRX5054309,FOSL2,262
chr1,98201708,98202097,SRX5075169,SMARCA4,389
chr1,98201711,98202025,SRX5075170,SMARCA4,314
chr1,98201715,98202146,SRX5716470,SMARCA4,431
chr1,98201718,98202132,SRX5716469,SMARCA4,414
chr1,98201731,98201940,SRX5075176,SMARCA4,209
chr1,98201735,98201987,SRX5716467,SMARCA2,252
chr1,98201769,98202085,SRX5075175,SMARCA4,316
chr1,98201798,98201995,SRX5075174,SMARCA4,197
chr1,98203587,98203816,SRX5054309,FOSL2,229
chr1,98205394,98205589,SRX5075174,SMARCA4,195
chr1,98210043,98210400,SRX5054309,FOSL2,357
chr1,98210071,98210390,SRX5054308,FOSL2,319
chr1,98210115,98210426,SRX5716470,SMARCA4,311
chr1,98210116,98210492,SRX5075174,SMARCA4,376
chr1,98210147,98210596,SRX5075168,SMARCA4,449
chr1,98210151,98210528,SRX5716464,SMARCA4,377
chr1,98210176,98210402,SRX5075170,SMARCA4,226
chr1,98210177,98210492,SRX5716463,SMARCA4,315
chr1,98210180,98210395,SRX5075169,SMARCA4,215
chr1,98210197,98210450,SRX5075176,SMARCA4,253
chr1,98210208,98210409,SRX5020211,SMARCA2,201
chr1,98210218,98210453,SRX5075175,SMARCA4,235
chr1,98221944,98222213,SRX5075174,SMARCA4,269
chr1,98222049,98222233,SRX5075168,SMARCA4,184
chr1,98263712,98263961,SRX5075174,SMARCA4,249
chr1,98264039,98264295,SRX5054309,FOSL2,256
chr1,98277060,98277315,SRX5075169,SMARCA4,255
chr1,98277105,98277444,SRX5075175,SMARCA4,339
chr1,98277114,98277417,SRX5075176,SMARCA4,303
chr1,98277125,98277394,SRX5054308,FOSL2,269
chr1,98277136,98277400,SRX5054309,FOSL2,264
chr1,98277173,98277422,SRX5075170,SMARCA4,249
chr1,98277186,98277397,SRX5716470,SMARCA4,211
chr1,98300076,98300278,SRX5075168,SMARCA4,202
chr1,98315372,98315603,SRX5054309,FOSL2,231
chr1,98315409,98315637,SRX5075170,SMARCA4,228
chr1,98315409,98315649,SRX5054308,FOSL2,240
chr1,98315420,98315651,SRX5075176,SMARCA4,231
chr1,98316295,98316598,SRX5075175,SMARCA4,303
chr1,98316362,98316645,SRX5075169,SMARCA4,283
chr1,98316372,98316646,SRX5075170,SMARCA4,274
chr1,98316396,98316627,SRX5075176,SMARCA4,231
chr1,98316417,98316604,SRX5054309,FOSL2,187
chr1,98323824,98324337,SRX5075174,SMARCA4,513
chr1,98323839,98324261,SRX5075168,SMARCA4,422
chr1,98323851,98324257,SRX5075169,SMARCA4,406
chr1,98323875,98324236,SRX5054308,FOSL2,361
chr1,98323878,98324071,SRX5075170,SMARCA4,193
chr1,98323886,98324252,SRX5054309,FOSL2,366
chr1,98323907,98324186,SRX5716470,SMARCA4,279
chr1,98323919,98324219,SRX5075175,SMARCA4,300
chr1,98323949,98324239,SRX5075176,SMARCA4,290
chr1,98324015,98324249,SRX5054307,FOSL2,234
chr1,98326010,98326317,SRX5075170,SMARCA4,307
chr1,98326016,98326382,SRX5075169,SMARCA4,366
chr1,98326020,98326356,SRX5054309,FOSL2,336
chr1,98326021,98326369,SRX5075175,SMARCA4,348
chr1,98326023,98326357,SRX5075176,SMARCA4,334
chr1,98326026,98326276,SRX5054308,FOSL2,250
chr1,98331193,98331701,SRX5716469,SMARCA4,508
chr1,98331202,98331514,SRX5075174,SMARCA4,312
chr1,98331218,98331434,SRX5054309,FOSL2,216
chr1,98331222,98331492,SRX5075168,SMARCA4,270
chr1,98331228,98331959,SRX5075170,SMARCA4,731
chr1,98331229,98331655,SRX5075176,SMARCA4,426
chr1,98331249,98331738,SRX5075175,SMARCA4,489
chr1,98331254,98331714,SRX5075169,SMARCA4,460
chr1,98331263,98331759,SRX5716470,SMARCA4,496
chr1,98331285,98331574,SRX5054308,FOSL2,289
chr1,98331292,98331615,SRX5716467,SMARCA2,323
chr1,98331741,98332189,SRX5075176,SMARCA4,448
chr1,98331946,98332187,SRX5716470,SMARCA4,241
chr1,98332024,98332194,SRX5075170,SMARCA4,170
chr1,98340562,98340835,SRX5054308,FOSL2,273
chr1,98340630,98340885,SRX5054309,FOSL2,255
chr1,98344780,98345145,SRX5075168,SMARCA4,365
chr1,98344795,98345136,SRX5075174,SMARCA4,341
chr1,98344816,98345126,SRX5075176,SMARCA4,310
chr1,98344824,98345199,SRX5075170,SMARCA4,375
chr1,98344826,98345096,SRX5054309,FOSL2,270
chr1,98344837,98345039,SRX5075169,SMARCA4,202
chr1,98344839,98345072,SRX5054308,FOSL2,233
chr1,98344841,98345020,SRX5054307,FOSL2,179
chr1,98385720,98385970,SRX5075170,SMARCA4,250
chr1,98388403,98388896,SRX5075176,SMARCA4,493
chr1,98388439,98388899,SRX5075170,SMARCA4,460
chr1,98388463,98388807,SRX5716470,SMARCA4,344
chr1,98388471,98388817,SRX5054308,FOSL2,346
chr1,98388475,98388927,SRX5075169,SMARCA4,452
chr1,98388482,98388892,SRX5075175,SMARCA4,410
chr1,98388508,98388852,SRX5054309,FOSL2,344
chr1,98388539,98388833,SRX5716469,SMARCA4,294
chr1,98388547,98388808,SRX5020214,SMARCA2,261
chr1,98388578,98388799,SRX5716467,SMARCA2,221
chr1,98389864,98390108,SRX5054309,FOSL2,244
chr1,98398673,98398853,SRX5075169,SMARCA4,180
chr1,98398687,98398991,SRX5075170,SMARCA4,304
chr1,98398690,98399070,SRX5075176,SMARCA4,380
chr1,98398760,98399000,SRX5075175,SMARCA4,240
chr1,98426156,98426499,SRX5054308,FOSL2,343
chr1,98426172,98426391,SRX5020211,SMARCA2,219
chr1,98426203,98426474,SRX5054309,FOSL2,271
chr1,98426208,98426411,SRX5075175,SMARCA4,203
chr1,98452109,98452471,SRX5075176,SMARCA4,362
chr1,98452113,98452458,SRX5075170,SMARCA4,345
chr1,98458616,98458819,SRX5075174,SMARCA4,203
chr1,98468071,98468552,SRX16500059,CTCF,481
chr1,98468088,98468558,SRX16500061,CTCF,470
chr1,98468092,98468515,SRX16500060,CTCF,423
chr1,98468103,98468491,SRX16500062,CTCF,388
chr1,98468194,98468372,SRX5075176,SMARCA4,178
chr1,98468195,98468385,SRX5075169,SMARCA4,190
chr1,98468245,98468452,SRX5075174,SMARCA4,207
chr1,98538042,98538543,SRX5075176,SMARCA4,501
chr1,98538164,98538493,SRX5716467,SMARCA2,329
chr1,98538167,98538502,SRX5075170,SMARCA4,335
chr1,98546443,98546625,SRX5075168,SMARCA4,182
chr1,98556499,98556906,SRX16500060,CTCF,407
chr1,98556524,98556933,SRX16500059,CTCF,409
chr1,98556586,98556894,SRX16500061,CTCF,308
chr1,98556615,98556868,SRX5075168,SMARCA4,253
chr1,98556633,98556846,SRX16500062,CTCF,213
chr1,98556669,98556877,SRX5075174,SMARCA4,208
chr1,98661441,98661864,SRX5075174,SMARCA4,423
chr1,98661447,98661912,SRX5075170,SMARCA4,465
chr1,98661459,98662022,SRX20140895,INTS13,563
chr1,98661487,98661910,SRX5075176,SMARCA4,423
chr1,98661553,98662041,SRX5075168,SMARCA4,488
chr1,98661582,98661838,SRX20140867,INTS10,256
chr1,98661647,98661872,SRX5716469,SMARCA4,225
chr1,98661686,98661988,SRX16500060,CTCF,302
chr1,98661694,98661933,SRX5716470,SMARCA4,239
chr1,98661733,98662031,SRX16500059,CTCF,298
chr1,98661743,98661926,SRX5075169,SMARCA4,183
chr1,98662067,98662357,SRX5075175,SMARCA4,290
chr1,98662104,98662560,SRX5075170,SMARCA4,456
chr1,98662164,98662418,SRX5075174,SMARCA4,254
chr1,98662242,98662627,SRX5075176,SMARCA4,385
chr1,98662254,98662555,SRX5716470,SMARCA4,301
chr1,98662491,98662671,SRX5075169,SMARCA4,180
chr1,98669684,98669899,SRX5075176,SMARCA4,215
chr1,98677455,98677662,SRX5054309,FOSL2,207
chr1,98700270,98700530,SRX5054308,FOSL2,260
chr1,98700316,98700549,SRX5054309,FOSL2,233
chr1,98704389,98704988,SRX5075174,SMARCA4,599
chr1,98704396,98704982,SRX5075168,SMARCA4,586
chr1,98704448,98704889,SRX5716464,SMARCA4,441
chr1,98704456,98704872,SRX5716463,SMARCA4,416
chr1,98704495,98704766,SRX5716454,SOX3,271
chr1,98704517,98704795,SRX5716451,SOX2,278
chr1,98730549,98730813,SRX5075174,SMARCA4,264
chr1,98749091,98749525,SRX16500061,CTCF,434
chr1,98749111,98749508,SRX16500062,CTCF,397
chr1,98749180,98749591,SRX16500059,CTCF,411
chr1,98749196,98749611,SRX16500060,CTCF,415
chr1,98792234,98792525,SRX5020211,SMARCA2,291
chr1,98794254,98794503,SRX4174629,CTCF,249
chr1,98794278,98794663,SRX16500061,CTCF,385
chr1,98794281,98794682,SRX16500062,CTCF,401
chr1,98794292,98794775,SRX16500059,CTCF,483
chr1,98794307,98794708,SRX16500060,CTCF,401
chr1,98794316,98794619,SRX5075168,SMARCA4,303
chr1,98794345,98794618,SRX5075174,SMARCA4,273
chr1,98794354,98794567,SRX5716464,SMARCA4,213
chr1,98794364,98794630,SRX5075170,SMARCA4,266
chr1,98794368,98794557,SRX5075175,SMARCA4,189
chr1,98794373,98794578,SRX5075169,SMARCA4,205
chr1,98794373,98794604,SRX5075176,SMARCA4,231
chr1,98794392,98794610,SRX5716463,SMARCA4,218
chr1,98903236,98903660,SRX5075176,SMARCA4,424
chr1,98903241,98903652,SRX5075175,SMARCA4,411
chr1,98903256,98903619,SRX5716467,SMARCA2,363
chr1,98903259,98903592,SRX5054309,FOSL2,333
chr1,98903262,98903657,SRX5716470,SMARCA4,395
chr1,98903269,98903644,SRX5075169,SMARCA4,375
chr1,98903270,98903562,SRX5020211,SMARCA2,292
chr1,98903272,98903563,SRX5054308,FOSL2,291
chr1,98903283,98903633,SRX5075170,SMARCA4,350
chr1,98903293,98903565,SRX5075181,SMARCA2,272
chr1,98903300,98903658,SRX5716469,SMARCA4,358
chr1,98903307,98903575,SRX5716468,SMARCA2,268
chr1,98903355,98903568,SRX5020214,SMARCA2,213
chr1,98903708,98904031,SRX5716463,SMARCA4,323
chr1,98903741,98904013,SRX5075174,SMARCA4,272
chr1,98903845,98904057,SRX5716470,SMARCA4,212
chr1,98903848,98904080,SRX5075169,SMARCA4,232
chr1,98906857,98907040,SRX5054309,FOSL2,183
chr1,98920386,98920792,SRX5054309,FOSL2,406
chr1,98920422,98920783,SRX5075170,SMARCA4,361
chr1,98920444,98920834,SRX5075176,SMARCA4,390
chr1,98920477,98920728,SRX5054308,FOSL2,251
chr1,98920480,98920797,SRX5075175,SMARCA4,317
chr1,98920499,98920717,SRX5020211,SMARCA2,218
chr1,98920502,98920794,SRX5075169,SMARCA4,292
chr1,98920545,98920765,SRX5716469,SMARCA4,220
chr1,98940808,98940988,SRX5054308,FOSL2,180
chr1,98949502,98949887,SRX5075176,SMARCA4,385
chr1,98949668,98950064,SRX5075174,SMARCA4,396
chr1,98949683,98949895,SRX5716464,SMARCA4,212
chr1,98949688,98950035,SRX5075168,SMARCA4,347
chr1,98949714,98949991,SRX5716463,SMARCA4,277
chr1,98975040,98975517,SRX5075168,SMARCA4,477
chr1,98975126,98975496,SRX5075174,SMARCA4,370
chr1,98975208,98975550,SRX5075176,SMARCA4,342
chr1,98975222,98975547,SRX5075170,SMARCA4,325
chr1,98981936,98982289,SRX5054309,FOSL2,353
chr1,98981939,98982258,SRX5075169,SMARCA4,319
chr1,98981971,98982277,SRX5054308,FOSL2,306
chr1,98981982,98982281,SRX5075170,SMARCA4,299
chr1,98981985,98982237,SRX5075176,SMARCA4,252
chr1,98982035,98982228,SRX5075175,SMARCA4,193
chr1,98991117,98991462,SRX16500061,CTCF,345
chr1,98991172,98991481,SRX16500060,CTCF,309
chr1,98991213,98991475,SRX16500059,CTCF,262
chr1,98991237,98991597,SRX16500062,CTCF,360
chr1,98991506,98992104,SRX5075176,SMARCA4,598
chr1,98991539,98992081,SRX5075169,SMARCA4,542
chr1,98991565,98992029,SRX5075170,SMARCA4,464
chr1,98991570,98991885,SRX5020211,SMARCA2,315
chr1,98991586,98992127,SRX5054309,FOSL2,541
chr1,98991612,98992098,SRX5054308,FOSL2,486
chr1,98991644,98992051,SRX5716469,SMARCA4,407
chr1,98991711,98992032,SRX5075175,SMARCA4,321
chr1,99004471,99004720,SRX5075170,SMARCA4,249
chr1,99004551,99004905,SRX5075169,SMARCA4,354
chr1,99004586,99005240,SRX20140895,INTS13,654
chr1,99004647,99005116,SRX5075168,SMARCA4,469
chr1,99004755,99005095,SRX5716470,SMARCA4,340
chr1,99004764,99005110,SRX5075175,SMARCA4,346
chr1,99004878,99005280,SRX5075174,SMARCA4,402
chr1,99004913,99005239,SRX5075170,SMARCA4,326
chr1,99004933,99005127,SRX5075176,SMARCA4,194
chr1,99005183,99005364,SRX5075168,SMARCA4,181
chr1,99005414,99005649,SRX16500059,CTCF,235
chr1,99119198,99119498,SRX5075170,SMARCA4,300
chr1,99119271,99119505,SRX5075176,SMARCA4,234
chr1,99133787,99134018,SRX5075170,SMARCA4,231
chr1,99133806,99134056,SRX5075176,SMARCA4,250
chr1,99170544,99170924,SRX5054308,FOSL2,380
chr1,99170563,99170924,SRX5054309,FOSL2,361
chr1,99170592,99170900,SRX5075175,SMARCA4,308
chr1,99170603,99170864,SRX5075169,SMARCA4,261
chr1,99170634,99170865,SRX5075170,SMARCA4,231
chr1,99180085,99180768,SRX16500059,CTCF,683
chr1,99180156,99180773,SRX16500060,CTCF,617
chr1,99180214,99180702,SRX16500062,CTCF,488
chr1,99180224,99180700,SRX16500061,CTCF,476
chr1,99180315,99180797,SRX5075174,SMARCA4,482
chr1,99180336,99180764,SRX4174629,CTCF,428
chr1,99180341,99180855,SRX5075168,SMARCA4,514
chr1,99180351,99180641,SRX5075170,SMARCA4,290
chr1,99180359,99180689,SRX5075176,SMARCA4,330
chr1,99180372,99180797,SRX5716463,SMARCA4,425
chr1,99180375,99180657,SRX5716469,SMARCA4,282
chr1,99180408,99180686,SRX5716464,SMARCA4,278
chr1,99180415,99180731,SRX20140895,INTS13,316
chr1,99180471,99180737,SRX20140869,INTS10,266
chr1,99180565,99180755,SRX5716451,SOX2,190
chr1,99252541,99252797,SRX5075174,SMARCA4,256
chr1,99252613,99252805,SRX5075168,SMARCA4,192
chr1,99264234,99264703,SRX5075174,SMARCA4,469
chr1,99264280,99264651,SRX5075168,SMARCA4,371
chr1,99264422,99264597,SRX5075176,SMARCA4,175
chr1,99266742,99267009,SRX5054308,FOSL2,267
chr1,99266752,99267044,SRX5716467,SMARCA2,292
chr1,99266776,99267065,SRX5075169,SMARCA4,289
chr1,99266779,99266966,SRX5054309,FOSL2,187
chr1,99283105,99283413,SRX5075174,SMARCA4,308
chr1,99283137,99283354,SRX5075168,SMARCA4,217
chr1,99283154,99283358,SRX5716463,SMARCA4,204
chr1,99293133,99293359,SRX5054308,FOSL2,226
chr1,99326258,99326683,SRX16500060,CTCF,425
chr1,99326264,99326552,SRX16500061,CTCF,288
chr1,99326281,99326583,SRX16500062,CTCF,302
chr1,99326298,99326583,SRX16500059,CTCF,285
chr1,99441709,99442030,SRX5054308,FOSL2,321
chr1,99441725,99442023,SRX5054309,FOSL2,298
chr1,99441758,99442077,SRX5075169,SMARCA4,319
chr1,99441778,99441965,SRX5075175,SMARCA4,187
chr1,99445368,99445774,SRX5075170,SMARCA4,406
chr1,99445408,99445865,SRX5075176,SMARCA4,457
chr1,99445457,99445814,SRX5075169,SMARCA4,357
chr1,99445478,99445742,SRX5716468,SMARCA2,264
chr1,99445483,99445783,SRX5716470,SMARCA4,300
chr1,99445564,99445777,SRX5716469,SMARCA4,213
chr1,99445586,99445862,SRX5075175,SMARCA4,276
chr1,99447792,99448045,SRX5075169,SMARCA4,253
chr1,99447800,99448020,SRX5075176,SMARCA4,220
chr1,99447801,99447994,SRX5054309,FOSL2,193
chr1,99447805,99448109,SRX5054308,FOSL2,304
chr1,99447868,99448069,SRX5075175,SMARCA4,201
chr1,99465464,99465786,SRX5075169,SMARCA4,322
chr1,99465576,99465802,SRX5075176,SMARCA4,226
chr1,99465628,99465848,SRX5054309,FOSL2,220
chr1,99469528,99469856,SRX5075169,SMARCA4,328
chr1,99469578,99469797,SRX5075176,SMARCA4,219
chr1,99469618,99469841,SRX5716470,SMARCA4,223
chr1,99469636,99469844,SRX5075175,SMARCA4,208
chr1,99469664,99469850,SRX5075170,SMARCA4,186
chr1,99469665,99469849,SRX5075168,SMARCA4,184
chr1,99469686,99469859,SRX5075174,SMARCA4,173
chr1,99481313,99481953,SRX16500059,CTCF,640
chr1,99481335,99481853,SRX16500061,CTCF,518
chr1,99481369,99481854,SRX16500062,CTCF,485
chr1,99481393,99481701,SRX5075168,SMARCA4,308
chr1,99481409,99481918,SRX16500060,CTCF,509
chr1,99481412,99481700,SRX5075170,SMARCA4,288
chr1,99481447,99481726,SRX5075174,SMARCA4,279
chr1,99481460,99481706,SRX5075176,SMARCA4,246
chr1,99481494,99481696,SRX5075169,SMARCA4,202
chr1,99503281,99503687,SRX5075170,SMARCA4,406
chr1,99503316,99503666,SRX5075176,SMARCA4,350
chr1,99503329,99503671,SRX5716467,SMARCA2,342
chr1,99503394,99503612,SRX5075169,SMARCA4,218
chr1,99503447,99503742,SRX5054308,FOSL2,295
chr1,99503469,99503684,SRX5716469,SMARCA4,215
chr1,99527138,99527440,SRX5075176,SMARCA4,302
chr1,99527162,99527417,SRX16500060,CTCF,255
chr1,99527175,99527413,SRX5075170,SMARCA4,238
chr1,99534343,99534755,SRX5075170,SMARCA4,412
chr1,99534403,99534809,SRX5716470,SMARCA4,406
chr1,99534404,99534784,SRX5075169,SMARCA4,380
chr1,99534475,99534854,SRX5075176,SMARCA4,379
chr1,99534477,99534825,SRX5075175,SMARCA4,348
chr1,99534546,99534818,SRX5716469,SMARCA4,272
chr1,99534557,99534783,SRX5716468,SMARCA2,226
chr1,99544348,99544759,SRX5054308,FOSL2,411
chr1,99544459,99544735,SRX5075170,SMARCA4,276
chr1,99544473,99544763,SRX5075176,SMARCA4,290
chr1,99547083,99547311,SRX5054309,FOSL2,228
chr1,99547110,99547314,SRX5075176,SMARCA4,204
chr1,99547110,99547328,SRX5054308,FOSL2,218
chr1,99548923,99549272,SRX5075170,SMARCA4,349
chr1,99549030,99549265,SRX5075176,SMARCA4,235
chr1,99557739,99558340,SRX5075176,SMARCA4,601
chr1,99557773,99558232,SRX5054309,FOSL2,459
chr1,99557782,99558262,SRX5075170,SMARCA4,480
chr1,99557806,99558233,SRX5075175,SMARCA4,427
chr1,99557892,99558264,SRX5075169,SMARCA4,372
chr1,99557895,99558227,SRX5054308,FOSL2,332
chr1,99557914,99558220,SRX5020214,SMARCA2,306
chr1,99557920,99558173,SRX5020211,SMARCA2,253
chr1,99557932,99558118,SRX5075182,SMARCA2,186
chr1,99557939,99558207,SRX5716469,SMARCA4,268
chr1,99557946,99558157,SRX5716470,SMARCA4,211
chr1,99557978,99558193,SRX5716467,SMARCA2,215
chr1,99573910,99574206,SRX5075176,SMARCA4,296
chr1,99574038,99574319,SRX5020211,SMARCA2,281
chr1,99574042,99574222,SRX5075169,SMARCA4,180
chr1,99590642,99591263,SRX5075170,SMARCA4,621
chr1,99590716,99591298,SRX5075169,SMARCA4,582
chr1,99590730,99591176,SRX5716469,SMARCA4,446
chr1,99590763,99591228,SRX5075176,SMARCA4,465
chr1,99590790,99591040,SRX5020214,SMARCA2,250
chr1,99590795,99591212,SRX5075175,SMARCA4,417
chr1,99590829,99591171,SRX5054309,FOSL2,342
chr1,99590849,99591153,SRX5716470,SMARCA4,304
chr1,99590851,99591112,SRX5716468,SMARCA2,261
chr1,99590857,99591171,SRX5054308,FOSL2,314
chr1,99590937,99591201,SRX5020211,SMARCA2,264
chr1,99590990,99591249,SRX5716467,SMARCA2,259
chr1,99594308,99594517,SRX5075176,SMARCA4,209
chr1,99599487,99599996,SRX5075175,SMARCA4,509
chr1,99599535,99600092,SRX5075169,SMARCA4,557
chr1,99599538,99599992,SRX5020211,SMARCA2,454
chr1,99599580,99600064,SRX5075176,SMARCA4,484
chr1,99599588,99600036,SRX5054309,FOSL2,448
chr1,99599601,99599995,SRX5054308,FOSL2,394
chr1,99599608,99600039,SRX5716469,SMARCA4,431
chr1,99599614,99600035,SRX5716470,SMARCA4,421
chr1,99599621,99600099,SRX5075170,SMARCA4,478
chr1,99599691,99600033,SRX5020214,SMARCA2,342
chr1,99599693,99600012,SRX5075168,SMARCA4,319
chr1,99599774,99599992,SRX5075174,SMARCA4,218
chr1,99600678,99601078,SRX20140895,INTS13,400
chr1,99600692,99601197,SRX5075168,SMARCA4,505
chr1,99600727,99601219,SRX5075174,SMARCA4,492
chr1,99600792,99601082,SRX5716451,SOX2,290
chr1,99600809,99601148,SRX5716463,SMARCA4,339
chr1,99600823,99601119,SRX5716464,SMARCA4,296
chr1,99600939,99601146,SRX5075176,SMARCA4,207
chr1,99621527,99621824,SRX5054309,FOSL2,297
chr1,99621575,99621822,SRX5054308,FOSL2,247
chr1,99623435,99623889,SRX5716469,SMARCA4,454
chr1,99623468,99623813,SRX5075175,SMARCA4,345
chr1,99623492,99623884,SRX5075176,SMARCA4,392
chr1,99623515,99623858,SRX5716470,SMARCA4,343
chr1,99623515,99623888,SRX5075169,SMARCA4,373
chr1,99623524,99623907,SRX5716467,SMARCA2,383
chr1,99623542,99623887,SRX5075170,SMARCA4,345
chr1,99623560,99623873,SRX5716468,SMARCA2,313
chr1,99623597,99623842,SRX5020211,SMARCA2,245
chr1,99635022,99635399,SRX5716470,SMARCA4,377
chr1,99635096,99635494,SRX5075170,SMARCA4,398
chr1,99635132,99635458,SRX5075176,SMARCA4,326
chr1,99635221,99635446,SRX5075175,SMARCA4,225
chr1,99635248,99635549,SRX5075169,SMARCA4,301
chr1,99643377,99643612,SRX5075170,SMARCA4,235
chr1,99645294,99645495,SRX5075168,SMARCA4,201
chr1,99646253,99646463,SRX5075168,SMARCA4,210
chr1,99646380,99646603,SRX5075174,SMARCA4,223
chr1,99652951,99653305,SRX5075174,SMARCA4,354
chr1,99652986,99653242,SRX20140895,INTS13,256
chr1,99653015,99653327,SRX5075168,SMARCA4,312
chr1,99653065,99653306,SRX5716451,SOX2,241
chr1,99653066,99653322,SRX5716463,SMARCA4,256
chr1,99672463,99672864,SRX5075169,SMARCA4,401
chr1,99672579,99672996,SRX5075176,SMARCA4,417
chr1,99672616,99672851,SRX5075175,SMARCA4,235
chr1,99672633,99672954,SRX5075170,SMARCA4,321
chr1,99672833,99673044,SRX5716470,SMARCA4,211
chr1,99682349,99682724,SRX5054308,FOSL2,375
chr1,99682407,99682743,SRX5054309,FOSL2,336
chr1,99682418,99682770,SRX5075175,SMARCA4,352
chr1,99682472,99682754,SRX5075170,SMARCA4,282
chr1,99682512,99682725,SRX5075176,SMARCA4,213
chr1,99682530,99682758,SRX5075169,SMARCA4,228
chr1,99685651,99686075,SRX16500062,CTCF,424
chr1,99685660,99686089,SRX16500059,CTCF,429
chr1,99685682,99686096,SRX16500060,CTCF,414
chr1,99685685,99686050,SRX5075170,SMARCA4,365
chr1,99685690,99686024,SRX5075168,SMARCA4,334
chr1,99685693,99686047,SRX16500061,CTCF,354
chr1,99685723,99686025,SRX5075176,SMARCA4,302
chr1,99685758,99686075,SRX5075174,SMARCA4,317
chr1,99685766,99686007,SRX4174629,CTCF,241
chr1,99685790,99686018,SRX5716464,SMARCA4,228
chr1,99685797,99685998,SRX5075169,SMARCA4,201
chr1,99691174,99691526,SRX5075176,SMARCA4,352
chr1,99691198,99691578,SRX5075170,SMARCA4,380
chr1,99691223,99691546,SRX5054309,FOSL2,323
chr1,99691250,99691518,SRX5075169,SMARCA4,268
chr1,99691252,99691517,SRX5020214,SMARCA2,265
chr1,99691264,99691495,SRX5054308,FOSL2,231
chr1,99691279,99691477,SRX5075175,SMARCA4,198
chr1,99707490,99707995,SRX16500059,CTCF,505
chr1,99707504,99707992,SRX16500061,CTCF,488
chr1,99707514,99708024,SRX16500060,CTCF,510
chr1,99707543,99708018,SRX16500062,CTCF,475
chr1,99707552,99707835,SRX5075174,SMARCA4,283
chr1,99707560,99707839,SRX5716463,SMARCA4,279
chr1,99707572,99707828,SRX5075168,SMARCA4,256
chr1,99707580,99707809,SRX5075176,SMARCA4,229
chr1,99719022,99719260,SRX5075175,SMARCA4,238
chr1,99719091,99719281,SRX5075169,SMARCA4,190
chr1,99719117,99719297,SRX5075170,SMARCA4,180
chr1,99727814,99728021,SRX5054309,FOSL2,207
chr1,99727815,99728169,SRX5075175,SMARCA4,354
chr1,99727822,99728138,SRX5075170,SMARCA4,316
chr1,99727824,99728135,SRX5075169,SMARCA4,311
chr1,99727840,99728201,SRX5075174,SMARCA4,361
chr1,99727854,99728180,SRX5075176,SMARCA4,326
chr1,99727906,99728150,SRX5075168,SMARCA4,244
chr1,99728593,99728783,SRX5075176,SMARCA4,190
chr1,99728786,99729005,SRX5075170,SMARCA4,219
chr1,99728802,99729167,SRX16500061,CTCF,365
chr1,99728825,99729117,SRX16500059,CTCF,292
chr1,99728841,99729139,SRX16500060,CTCF,298
chr1,99728854,99729100,SRX16500062,CTCF,246
chr1,99731452,99731724,SRX5054309,FOSL2,272
chr1,99731517,99731699,SRX5054308,FOSL2,182
chr1,99731517,99731766,SRX5075169,SMARCA4,249
chr1,99736999,99737457,SRX16500059,CTCF,458
chr1,99737023,99737363,SRX5075176,SMARCA4,340
chr1,99737036,99737333,SRX5075169,SMARCA4,297
chr1,99737038,99737365,SRX5075170,SMARCA4,327
chr1,99737046,99737382,SRX16500060,CTCF,336
chr1,99737059,99737299,SRX5075174,SMARCA4,240
chr1,99737072,99737360,SRX5716470,SMARCA4,288
chr1,99737074,99737324,SRX5075175,SMARCA4,250
chr1,99737098,99737334,SRX16500061,CTCF,236
chr1,99737104,99737389,SRX16500062,CTCF,285
chr1,99737123,99737373,SRX5075168,SMARCA4,250
chr1,99761783,99762058,SRX5075168,SMARCA4,275
chr1,99761839,99762051,SRX5075174,SMARCA4,212
chr1,99766379,99766856,SRX5075170,SMARCA4,477
chr1,99766410,99766742,SRX5075169,SMARCA4,332
chr1,99766431,99766832,SRX5075176,SMARCA4,401
chr1,99766441,99766680,SRX5716470,SMARCA4,239
chr1,99766449,99766743,SRX5075175,SMARCA4,294
chr1,99766463,99766834,SRX5075168,SMARCA4,371
chr1,99766515,99766771,SRX5075174,SMARCA4,256
chr1,99766519,99766806,SRX5716464,SMARCA4,287
chr1,99768220,99768748,SRX20140895,INTS13,528
chr1,99768233,99768570,SRX5075174,SMARCA4,337
chr1,99773840,99774101,SRX16500060,CTCF,261
chr1,99808566,99809079,SRX16500059,CTCF,513
chr1,99808582,99809037,SRX16500062,CTCF,455
chr1,99808592,99809056,SRX16500060,CTCF,464
chr1,99808593,99809113,SRX16500061,CTCF,520
chr1,99808613,99809075,SRX5075174,SMARCA4,462
chr1,99808645,99808876,SRX5716470,SMARCA4,231
chr1,99808658,99809129,SRX5075176,SMARCA4,471
chr1,99808660,99809047,SRX4174629,CTCF,387
chr1,99808674,99809195,SRX5075175,SMARCA4,521
chr1,99808715,99808988,SRX5716464,SMARCA4,273
chr1,99808728,99809107,SRX5075168,SMARCA4,379
chr1,99808743,99809032,SRX5716463,SMARCA4,289
chr1,99808746,99809058,SRX5075170,SMARCA4,312
chr1,99808768,99808989,SRX5054307,FOSL2,221
chr1,99808793,99809042,SRX5054308,FOSL2,249
chr1,99808797,99809058,SRX5075169,SMARCA4,261
chr1,99808830,99809089,SRX5054309,FOSL2,259
chr1,99849711,99850465,SRX20140895,INTS13,754
chr1,99849810,99850569,SRX5075174,SMARCA4,759
chr1,99849813,99849996,SRX5075170,SMARCA4,183
chr1,99849818,99850480,SRX20140868,INTS10,662
chr1,99849828,99850060,SRX5075168,SMARCA4,232
chr1,99849849,99850327,SRX5075169,SMARCA4,478
chr1,99849859,99850335,SRX5075176,SMARCA4,476
chr1,99849942,99850423,SRX20140867,INTS10,481
chr1,99849977,99850480,SRX5075175,SMARCA4,503
chr1,99850028,99850345,SRX20140869,INTS10,317
chr1,99850037,99850310,SRX20140897,INTS13,273
chr1,99850105,99850498,SRX5075170,SMARCA4,393
chr1,99850123,99850545,SRX5716470,SMARCA4,422
chr1,99850123,99850600,SRX5075168,SMARCA4,477
chr1,99850181,99850470,SRX5716469,SMARCA4,289
chr1,99850380,99850658,SRX5075169,SMARCA4,278
chr1,99943215,99943639,SRX5075170,SMARCA4,424
chr1,99943223,99943695,SRX5075176,SMARCA4,472
chr1,99943387,99943694,SRX5716470,SMARCA4,307
chr1,99943389,99943618,SRX5075169,SMARCA4,229
chr1,99943394,99943626,SRX5716469,SMARCA4,232
chr1,99943417,99943663,SRX5075175,SMARCA4,246
chr1,99956757,99956937,SRX5054308,FOSL2,180
chr1,99956812,99957044,SRX5075170,SMARCA4,232
chr1,99960715,99960757,SRX1424891,POU3F2,42
chr1,99962947,99963358,SRX5054309,FOSL2,411
chr1,99963013,99963294,SRX5054308,FOSL2,281
chr1,99963047,99963294,SRX5075175,SMARCA4,247
chr1,99963092,99963365,SRX5075169,SMARCA4,273
chr1,99969699,99970270,SRX20140895,INTS13,571
chr1,99969754,99970123,SRX5075170,SMARCA4,369
chr1,99969777,99970099,SRX5075174,SMARCA4,322
chr1,99969808,99970003,SRX5075168,SMARCA4,195
chr1,99969894,99970149,SRX20140867,INTS10,255
chr1,99970118,99970410,SRX5075168,SMARCA4,292
chr1,99972603,99972840,SRX5054309,FOSL2,237
chr1,100034464,100034794,SRX16500061,CTCF,330
chr1,100034475,100034858,SRX16500060,CTCF,383
chr1,100034487,100034815,SRX16500059,CTCF,328
chr1,100034542,100034808,SRX16500062,CTCF,266
chr1,100037781,100038010,SRX5075169,SMARCA4,229
chr1,100037830,100038752,SRX20140895,INTS13,922
chr1,100037834,100038216,SRX5075174,SMARCA4,382
chr1,100037846,100038149,SRX5716470,SMARCA4,303
chr1,100037860,100038074,SRX5075176,SMARCA4,214
chr1,100037860,100038159,SRX5075168,SMARCA4,299
chr1,100037869,100038362,SRX20140867,INTS10,493
chr1,100037880,100038304,SRX20140881,CPSF3L,424
chr1,100037886,100038329,SRX20140896,INTS13,443
chr1,100037889,100038461,SRX20140868,INTS10,572
chr1,100037896,100038231,SRX20140879,CPSF3L,335
chr1,100037903,100038391,SRX20140897,INTS13,488
chr1,100037910,100038124,SRX5075170,SMARCA4,214
chr1,100037959,100038206,SRX20140894,INTS13,247
chr1,100037963,100038322,SRX20140869,INTS10,359
chr1,100132624,100133168,SRX5075168,SMARCA4,544
chr1,100132685,100133261,SRX20140895,INTS13,576
chr1,100132694,100133410,SRX5075174,SMARCA4,716
chr1,100132752,100133117,SRX20140867,INTS10,365
chr1,100132825,100133238,SRX20140869,INTS10,413
chr1,100132831,100133127,SRX5716463,SMARCA4,296
chr1,100132875,100133241,SRX20140879,CPSF3L,366
chr1,100132959,100133164,SRX5716454,SOX3,205
chr1,100132973,100133169,SRX5716451,SOX2,196
chr1,100133000,100133190,SRX5075169,SMARCA4,190
chr1,100133008,100133216,SRX5075170,SMARCA4,208
chr1,100133069,100133280,SRX5716470,SMARCA4,211
chr1,100164141,100164558,SRX5075168,SMARCA4,417
chr1,100164158,100164559,SRX5075170,SMARCA4,401
chr1,100164176,100164568,SRX5020211,SMARCA2,392
chr1,100164180,100164587,SRX5075169,SMARCA4,407
chr1,100164184,100164542,SRX5075174,SMARCA4,358
chr1,100164214,100164575,SRX5716469,SMARCA4,361
chr1,100164230,100164617,SRX5716470,SMARCA4,387
chr1,100164235,100164620,SRX5716467,SMARCA2,385
chr1,100164246,100164644,SRX5075176,SMARCA4,398
chr1,100164267,100164581,SRX5054309,FOSL2,314
chr1,100164273,100164588,SRX5054308,FOSL2,315
chr1,100164275,100164541,SRX5075175,SMARCA4,266
chr1,100164298,100164558,SRX5716468,SMARCA2,260
chr1,100164314,100164588,SRX5075181,SMARCA2,274
chr1,100188573,100188843,SRX5054308,FOSL2,270
chr1,100188587,100189043,SRX5075175,SMARCA4,456
chr1,100188597,100189081,SRX5716470,SMARCA4,484
chr1,100188620,100188967,SRX5075169,SMARCA4,347
chr1,100188625,100188996,SRX5020211,SMARCA2,371
chr1,100188626,100188925,SRX5716459,Epitope tags,299
chr1,100188639,100188959,SRX5075176,SMARCA4,320
chr1,100188641,100189057,SRX5716469,SMARCA4,416
chr1,100188646,100188956,SRX5075170,SMARCA4,310
chr1,100188654,100188896,SRX5054309,FOSL2,242
chr1,100188656,100188969,SRX5075181,SMARCA2,313
chr1,100188736,100189009,SRX5716467,SMARCA2,273
chr1,100188737,100189050,SRX5716468,SMARCA2,313
chr1,100249569,100250159,SRX5075175,SMARCA4,590
chr1,100249582,100250178,SRX5075176,SMARCA4,596
chr1,100249585,100249806,SRX5716470,SMARCA4,221
chr1,100249593,100250214,SRX5075168,SMARCA4,621
chr1,100249596,100250039,SRX20140895,INTS13,443
chr1,100249606,100249908,SRX20140881,CPSF3L,302
chr1,100249627,100249868,SRX20140867,INTS10,241
chr1,100249689,100250006,SRX20140868,INTS10,317
chr1,100249713,100250114,SRX5075169,SMARCA4,401
chr1,100249713,100250231,SRX5075174,SMARCA4,518
chr1,100249718,100250124,SRX20140879,CPSF3L,406
chr1,100249732,100250184,SRX5716463,SMARCA4,452
chr1,100249818,100250018,SRX5054307,FOSL2,200
chr1,100249818,100250155,SRX5716464,SMARCA4,337
chr1,100249826,100250167,SRX5075170,SMARCA4,341
chr1,100249880,100250204,SRX5716470,SMARCA4,324
chr1,100249913,100250221,SRX5716469,SMARCA4,308
chr1,100265841,100266090,SRX5716470,SMARCA4,249
chr1,100265869,100266616,SRX5075174,SMARCA4,747
chr1,100265892,100266431,SRX5075168,SMARCA4,539
chr1,100265985,100266511,SRX5075170,SMARCA4,526
chr1,100265988,100266418,SRX5075175,SMARCA4,430
chr1,100266002,100266464,SRX20140895,INTS13,462
chr1,100266049,100266392,SRX5075176,SMARCA4,343
chr1,100266220,100266443,SRX5075169,SMARCA4,223
chr1,100266305,100266553,SRX5716470,SMARCA4,248
chr1,100308906,100309081,SRX5075176,SMARCA4,175
chr1,100322794,100323141,SRX5075175,SMARCA4,347
chr1,100323073,100323291,SRX5075169,SMARCA4,218
chr1,100351097,100351448,SRX16500061,CTCF,351
chr1,100351107,100351332,SRX5075176,SMARCA4,225
chr1,100351151,100351415,SRX5075170,SMARCA4,264
chr1,100351156,100351472,SRX16500059,CTCF,316
chr1,100351159,100351339,SRX5075169,SMARCA4,180
chr1,100351160,100351692,SRX5075168,SMARCA4,532
chr1,100351168,100351461,SRX5075174,SMARCA4,293
chr1,100351208,100351518,SRX16500060,CTCF,310
chr1,100351246,100352881,SRX20140895,INTS13,1635
chr1,100351262,100351483,SRX16500062,CTCF,221
chr1,100351292,100351559,SRX5716470,SMARCA4,267
chr1,100351329,100351690,SRX20140869,INTS10,361
chr1,100351333,100351827,SRX20140868,INTS10,494
chr1,100351360,100351708,SRX20140879,CPSF3L,348
chr1,100351394,100351734,SRX20140867,INTS10,340
chr1,100351424,100352308,SRX20140881,CPSF3L,884
chr1,100351885,100352207,SRX20140879,CPSF3L,322
chr1,100352080,100352814,SRX20140868,INTS10,734
chr1,100352129,100352751,SRX20140867,INTS10,622
chr1,100352137,100352433,SRX5075168,SMARCA4,296
chr1,100352176,100352550,SRX5075174,SMARCA4,374
chr1,100352302,100352725,SRX20140897,INTS13,423
chr1,100352352,100352738,SRX20140881,CPSF3L,386
chr1,100352583,100352770,SRX5075169,SMARCA4,187
chr1,100354078,100354266,SRX5075174,SMARCA4,188
chr1,100354928,100355206,SRX5075168,SMARCA4,278
chr1,100354978,100355216,SRX5075174,SMARCA4,238
chr1,100355007,100355209,SRX5075176,SMARCA4,202
chr1,100355130,100355335,SRX5075169,SMARCA4,205
chr1,100358141,100358576,SRX16500060,CTCF,435
chr1,100358182,100358574,SRX16500059,CTCF,392
chr1,100358190,100358433,SRX16500062,CTCF,243
chr1,100360747,100361080,SRX5075169,SMARCA4,333
chr1,100360754,100361096,SRX5075170,SMARCA4,342
chr1,100360781,100361089,SRX5075175,SMARCA4,308
chr1,100360783,100361120,SRX5716469,SMARCA4,337
chr1,100360789,100361012,SRX5054309,FOSL2,223
chr1,100360799,100361099,SRX5075174,SMARCA4,300
chr1,100360804,100361186,SRX5075176,SMARCA4,382
chr1,100360855,100361099,SRX5716467,SMARCA2,244
chr1,100360861,100361154,SRX5716470,SMARCA4,293
chr1,100387175,100387586,SRX5075170,SMARCA4,411
chr1,100387211,100387574,SRX5075169,SMARCA4,363
chr1,100387249,100387606,SRX5716469,SMARCA4,357
chr1,100387280,100387617,SRX5075176,SMARCA4,337
chr1,100387285,100387529,SRX5075175,SMARCA4,244
chr1,100387342,100387521,SRX5075168,SMARCA4,179
chr1,100387391,100387602,SRX5716470,SMARCA4,211
chr1,100400353,100400885,SRX5075168,SMARCA4,532
chr1,100400369,100400917,SRX5075174,SMARCA4,548
chr1,100400455,100400660,SRX5716464,SMARCA4,205
chr1,100400495,100400698,SRX5716451,SOX2,203
chr1,100400519,100400748,SRX5716463,SMARCA4,229
chr1,100404878,100405175,SRX5054309,FOSL2,297
chr1,100404879,100405140,SRX5054308,FOSL2,261
chr1,100404947,100405153,SRX5075169,SMARCA4,206
chr1,100443751,100444098,SRX5075176,SMARCA4,347
chr1,100443759,100444160,SRX5075169,SMARCA4,401
chr1,100443761,100444026,SRX5054308,FOSL2,265
chr1,100443797,100444024,SRX5075170,SMARCA4,227
chr1,100443806,100444219,SRX5054309,FOSL2,413
chr1,100443816,100444037,SRX5716470,SMARCA4,221
chr1,100455461,100455854,SRX16500060,CTCF,393
chr1,100455484,100455835,SRX16500061,CTCF,351
chr1,100455488,100455858,SRX16500059,CTCF,370
chr1,100455498,100455834,SRX16500062,CTCF,336
chr1,100459478,100459858,SRX16500062,CTCF,380
chr1,100459493,100459929,SRX16500059,CTCF,436
chr1,100459503,100459883,SRX16500060,CTCF,380
chr1,100459509,100459895,SRX16500061,CTCF,386
chr1,100459548,100459785,SRX5075174,SMARCA4,237
chr1,100459556,100459794,SRX5075168,SMARCA4,238
chr1,100459568,100459766,SRX5075176,SMARCA4,198
chr1,100461217,100461701,SRX5075176,SMARCA4,484
chr1,100461298,100461731,SRX5075170,SMARCA4,433
chr1,100461342,100461631,SRX5075175,SMARCA4,289
chr1,100461351,100461602,SRX5716467,SMARCA2,251
chr1,100461355,100461620,SRX5716470,SMARCA4,265
chr1,100461366,100461594,SRX5716469,SMARCA4,228
chr1,100461369,100461600,SRX5075169,SMARCA4,231
chr1,100461381,100461610,SRX5716468,SMARCA2,229
chr1,100463689,100464089,SRX16500059,CTCF,400
chr1,100463701,100464085,SRX16500060,CTCF,384
chr1,100463721,100464100,SRX16500061,CTCF,379
chr1,100463734,100464070,SRX16500062,CTCF,336
chr1,100499473,100499789,SRX5075170,SMARCA4,316
chr1,100499474,100499718,SRX5075176,SMARCA4,244
chr1,100499501,100499767,SRX5054309,FOSL2,266
chr1,100506199,100506507,SRX5716468,SMARCA2,308
chr1,100506249,100506523,SRX5716469,SMARCA4,274
chr1,100506259,100506534,SRX5075170,SMARCA4,275
chr1,100506261,100506515,SRX5716470,SMARCA4,254
chr1,100506261,100506539,SRX5075169,SMARCA4,278
chr1,100506265,100506535,SRX5075175,SMARCA4,270
chr1,100506269,100506558,SRX5075176,SMARCA4,289
chr1,100506279,100506529,SRX5054309,FOSL2,250
chr1,100506289,100506533,SRX5020211,SMARCA2,244
chr1,100506370,100506550,SRX5054308,FOSL2,180
chr1,100510593,100510764,SRX5075170,SMARCA4,171
chr1,100510602,100510806,SRX5075176,SMARCA4,204
chr1,100528835,100529199,SRX5716467,SMARCA2,364
chr1,100528883,100529187,SRX5716469,SMARCA4,304
chr1,100528902,100529287,SRX5075176,SMARCA4,385
chr1,100528910,100529282,SRX5075170,SMARCA4,372
chr1,100528911,100529289,SRX5716470,SMARCA4,378
chr1,100528945,100529160,SRX5075175,SMARCA4,215
chr1,100528946,100529149,SRX5020211,SMARCA2,203
chr1,100528946,100529153,SRX5020214,SMARCA2,207
chr1,100528979,100529223,SRX5075169,SMARCA4,244
chr1,100529012,100529232,SRX5716468,SMARCA2,220
chr1,100531298,100531501,SRX5054308,FOSL2,203
chr1,100538989,100539244,SRX16500061,CTCF,255
chr1,100584748,100584986,SRX5075176,SMARCA4,238
chr1,100596977,100597627,SRX5054309,FOSL2,650
chr1,100596996,100597465,SRX5075175,SMARCA4,469
chr1,100597041,100597492,SRX5075169,SMARCA4,451
chr1,100597047,100597431,SRX5054308,FOSL2,384
chr1,100597055,100597410,SRX5075176,SMARCA4,355
chr1,100597068,100597366,SRX5716469,SMARCA4,298
chr1,100597082,100597391,SRX5075170,SMARCA4,309
chr1,100597171,100597386,SRX5716467,SMARCA2,215
chr1,100606515,100606763,SRX16500061,CTCF,248
chr1,100606523,100606784,SRX16500059,CTCF,261
chr1,100606528,100606798,SRX16500060,CTCF,270
chr1,100606532,100606763,SRX4174629,CTCF,231
chr1,100606570,100606741,SRX5075170,SMARCA4,171
chr1,100621831,100622455,SRX5075170,SMARCA4,624
chr1,100621869,100622451,SRX5075169,SMARCA4,582
chr1,100621893,100622461,SRX5075175,SMARCA4,568
chr1,100621900,100622493,SRX5075176,SMARCA4,593
chr1,100621985,100622418,SRX5716470,SMARCA4,433
chr1,100622006,100622386,SRX5716469,SMARCA4,380
chr1,100622045,100622394,SRX5075174,SMARCA4,349
chr1,100622053,100622380,SRX5054308,FOSL2,327
chr1,100622072,100622427,SRX5054309,FOSL2,355
chr1,100622073,100622399,SRX5716467,SMARCA2,326
chr1,100622117,100622470,SRX5075168,SMARCA4,353
chr1,100630813,100631382,SRX5054308,FOSL2,569
chr1,100630821,100631432,SRX5054309,FOSL2,611
chr1,100630898,100631243,SRX5075181,SMARCA2,345
chr1,100630905,100631182,SRX5075169,SMARCA4,277
chr1,100630915,100631234,SRX5020211,SMARCA2,319
chr1,100630983,100631218,SRX5075175,SMARCA4,235
chr1,100643546,100643718,SRX5075170,SMARCA4,172
chr1,100643703,100644139,SRX5716468,SMARCA2,436
chr1,100643742,100643960,SRX5716469,SMARCA4,218
chr1,100643766,100644306,SRX5075176,SMARCA4,540
chr1,100643858,100644237,SRX5075170,SMARCA4,379
chr1,100643899,100644237,SRX5716467,SMARCA2,338
chr1,100643911,100644152,SRX5075169,SMARCA4,241
chr1,100643912,100644118,SRX5054309,FOSL2,206
chr1,100643998,100644188,SRX5075175,SMARCA4,190
chr1,100676490,100676724,SRX5075170,SMARCA4,234
chr1,100676515,100676720,SRX5020211,SMARCA2,205
chr1,100699842,100700080,SRX5075170,SMARCA4,238
chr1,100708489,100708727,SRX5075169,SMARCA4,238
chr1,100708522,100708718,SRX5075176,SMARCA4,196
chr1,100708538,100708750,SRX5075170,SMARCA4,212
chr1,100713670,100714120,SRX5075168,SMARCA4,450
chr1,100713742,100714109,SRX5075174,SMARCA4,367
chr1,100719408,100719829,SRX20140895,INTS13,421
chr1,100719496,100719797,SRX5075174,SMARCA4,301
chr1,100721501,100722131,SRX5075169,SMARCA4,630
chr1,100721562,100721870,SRX5075170,SMARCA4,308
chr1,100721572,100721950,SRX5075176,SMARCA4,378
chr1,100721586,100721821,SRX5716467,SMARCA2,235
chr1,100722003,100722197,SRX5075170,SMARCA4,194
chr1,100722027,100722261,SRX5075176,SMARCA4,234
chr1,100734529,100735241,SRX5075176,SMARCA4,712
chr1,100734560,100735183,SRX5075170,SMARCA4,623
chr1,100734565,100735169,SRX5075169,SMARCA4,604
chr1,100734644,100735111,SRX5716470,SMARCA4,467
chr1,100734656,100735217,SRX5075175,SMARCA4,561
chr1,100734663,100735066,SRX5716467,SMARCA2,403
chr1,100734674,100735036,SRX5054308,FOSL2,362
chr1,100734691,100735078,SRX5054309,FOSL2,387
chr1,100734717,100735175,SRX5716469,SMARCA4,458
chr1,100734754,100735138,SRX5020211,SMARCA2,384
chr1,100734786,100735012,SRX5075181,SMARCA2,226
chr1,100734787,100735127,SRX5716468,SMARCA2,340
chr1,100734850,100735109,SRX5075182,SMARCA2,259
chr1,100747750,100748209,SRX5075168,SMARCA4,459
chr1,100747784,100748235,SRX5075174,SMARCA4,451
chr1,100767225,100767952,SRX5075176,SMARCA4,727
chr1,100767424,100767775,SRX5054309,FOSL2,351
chr1,100767469,100767876,SRX5075175,SMARCA4,407
chr1,100767487,100767947,SRX5075170,SMARCA4,460
chr1,100767506,100767837,SRX5075169,SMARCA4,331
chr1,100767508,100767767,SRX5716469,SMARCA4,259
chr1,100767532,100767899,SRX5716470,SMARCA4,367
chr1,100767541,100767875,SRX5020211,SMARCA2,334
chr1,100785469,100786004,SRX5075168,SMARCA4,535
chr1,100785471,100785926,SRX5075174,SMARCA4,455
chr1,100785579,100785876,SRX5716463,SMARCA4,297
chr1,100785642,100785761,SRX1424891,POU3F2,119
chr1,100785652,100785950,SRX5075170,SMARCA4,298
chr1,100785663,100785785,SRX1424893,POU3F2,122
chr1,100785725,100785787,SRX1424894,POU3F2,62
chr1,100787845,100788316,SRX5075168,SMARCA4,471
chr1,100787876,100788326,SRX5075174,SMARCA4,450
chr1,100787896,100788188,SRX5716463,SMARCA4,292
chr1,100787922,100788174,SRX5716464,SMARCA4,252
chr1,100793724,100793906,SRX5054308,FOSL2,182
chr1,100793786,100793975,SRX5075176,SMARCA4,189
chr1,100794697,100795125,SRX5075175,SMARCA4,428
chr1,100794710,100795085,SRX5075169,SMARCA4,375
chr1,100794746,100795147,SRX5054309,FOSL2,401
chr1,100794755,100795213,SRX5075176,SMARCA4,458
chr1,100794780,100795024,SRX5716467,SMARCA2,244
chr1,100794780,100795517,SRX5075170,SMARCA4,737
chr1,100794796,100795075,SRX5716470,SMARCA4,279
chr1,100794802,100795191,SRX5054308,FOSL2,389
chr1,100794864,100795288,SRX5716469,SMARCA4,424
chr1,100795684,100795905,SRX5075168,SMARCA4,221
chr1,100811722,100812012,SRX5075168,SMARCA4,290
chr1,100819142,100819524,SRX5075168,SMARCA4,382
chr1,100819147,100819606,SRX5075174,SMARCA4,459
chr1,100819158,100819420,SRX5716464,SMARCA4,262
chr1,100819209,100819572,SRX5716463,SMARCA4,363
chr1,100819214,100819406,SRX5716451,SOX2,192
chr1,100834985,100835288,SRX16500062,CTCF,303
chr1,100835010,100835326,SRX16500060,CTCF,316
chr1,100847176,100848032,SRX5075174,SMARCA4,856
chr1,100847293,100848073,SRX5075168,SMARCA4,780
chr1,100847413,100847846,SRX5075176,SMARCA4,433
chr1,100847439,100847673,SRX5716451,SOX2,234
chr1,100847447,100847754,SRX5716463,SMARCA4,307
chr1,100860505,100860746,SRX5075176,SMARCA4,241
chr1,100860527,100860712,SRX5075170,SMARCA4,185
chr1,100866305,100866761,SRX16500062,CTCF,456
chr1,100866337,100866742,SRX16500060,CTCF,405
chr1,100866357,100866746,SRX16500059,CTCF,389
chr1,100866364,100866736,SRX16500061,CTCF,372
chr1,100868334,100868812,SRX16500059,CTCF,478
chr1,100868337,100868791,SRX16500060,CTCF,454
chr1,100868351,100868753,SRX16500061,CTCF,402
chr1,100868371,100868810,SRX16500062,CTCF,439
chr1,100875276,100875472,SRX5075174,SMARCA4,196
chr1,100883349,100883524,SRX5075176,SMARCA4,175
chr1,100883357,100883538,SRX5075170,SMARCA4,181
chr1,100883901,100884348,SRX5075170,SMARCA4,447
chr1,100883904,100884305,SRX5716469,SMARCA4,401
chr1,100883928,100884318,SRX5075176,SMARCA4,390
chr1,100883937,100884291,SRX5054309,FOSL2,354
chr1,100883937,100884304,SRX5075175,SMARCA4,367
chr1,100883964,100884319,SRX5075169,SMARCA4,355
chr1,100883982,100884246,SRX5716467,SMARCA2,264
chr1,100883984,100884270,SRX5716470,SMARCA4,286
chr1,100884005,100884302,SRX5054308,FOSL2,297
chr1,100894567,100894778,SRX5716470,SMARCA4,211
chr1,100894595,100895171,SRX5075174,SMARCA4,576
chr1,100894602,100894801,SRX5075168,SMARCA4,199
chr1,100894650,100894832,SRX5075176,SMARCA4,182
chr1,100894834,100895285,SRX20140895,INTS13,451
chr1,100894953,100895208,SRX20140897,INTS13,255
chr1,100895817,100896220,SRX5075176,SMARCA4,403
chr1,100895872,100896118,SRX5075170,SMARCA4,246
chr1,100895913,100896226,SRX5075174,SMARCA4,313
chr1,100895927,100896210,SRX5075168,SMARCA4,283
chr1,100921001,100921562,SRX16500060,CTCF,561
chr1,100921025,100921592,SRX16500059,CTCF,567
chr1,100921032,100921550,SRX16500061,CTCF,518
chr1,100921058,100921520,SRX16500062,CTCF,462
chr1,100921160,100921397,SRX5075168,SMARCA4,237
chr1,100921167,100921468,SRX5075174,SMARCA4,301
chr1,100950750,100951237,SRX5075170,SMARCA4,487
chr1,100950805,100951231,SRX5075176,SMARCA4,426
chr1,100950815,100951204,SRX5075175,SMARCA4,389
chr1,100950818,100951095,SRX5716470,SMARCA4,277
chr1,100950871,100951126,SRX5075169,SMARCA4,255
chr1,100950910,100951133,SRX5020211,SMARCA2,223
chr1,100955280,100955808,SRX5075170,SMARCA4,528
chr1,100955308,100955673,SRX5054309,FOSL2,365
chr1,100955321,100955666,SRX5054308,FOSL2,345
chr1,100955331,100955767,SRX5075176,SMARCA4,436
chr1,100955338,100955761,SRX5716469,SMARCA4,423
chr1,100955367,100955609,SRX5075168,SMARCA4,242
chr1,100955368,100955736,SRX5075169,SMARCA4,368
chr1,100955376,100955684,SRX5075174,SMARCA4,308
chr1,100955379,100955636,SRX5020211,SMARCA2,257
chr1,100955393,100955726,SRX5075175,SMARCA4,333
chr1,100955416,100955717,SRX5716467,SMARCA2,301
chr1,100989720,100989989,SRX5075176,SMARCA4,269
chr1,100989735,100990034,SRX5075169,SMARCA4,299
chr1,100989742,100989930,SRX5054309,FOSL2,188
chr1,100989746,100990038,SRX5075170,SMARCA4,292
chr1,100989814,100990100,SRX5716469,SMARCA4,286
chr1,101002599,101002824,SRX5075168,SMARCA4,225
chr1,101002654,101002832,SRX5075170,SMARCA4,178
chr1,101004061,101004434,SRX5075168,SMARCA4,373
chr1,101004070,101004421,SRX5075174,SMARCA4,351
chr1,101004124,101004314,SRX5716451,SOX2,190
chr1,101025236,101025565,SRX5075175,SMARCA4,329
chr1,101025651,101026006,SRX5075170,SMARCA4,355
chr1,101025672,101026192,SRX20140895,INTS13,520
chr1,101025700,101026218,SRX5075168,SMARCA4,518
chr1,101025710,101026148,SRX20140897,INTS13,438
chr1,101025711,101026299,SRX5075176,SMARCA4,588
chr1,101025720,101026092,SRX5075174,SMARCA4,372
chr1,101025775,101026080,SRX20140867,INTS10,305
chr1,101025794,101026122,SRX20140868,INTS10,328
chr1,101025830,101026072,SRX5716470,SMARCA4,242
chr1,101025839,101026078,SRX20140879,CPSF3L,239
chr1,101025871,101026197,SRX20140869,INTS10,326
chr1,101025882,101026174,SRX20140881,CPSF3L,292
chr1,101025897,101026175,SRX5075169,SMARCA4,278
chr1,101026078,101026273,SRX5075170,SMARCA4,195
chr1,101043728,101044118,SRX5075174,SMARCA4,390
chr1,101043737,101044171,SRX5075168,SMARCA4,434
chr1,101043813,101044020,SRX5075176,SMARCA4,207
chr1,101043901,101044091,SRX5075170,SMARCA4,190
chr1,101069099,101069657,SRX5716463,SMARCA4,558
chr1,101069106,101069716,SRX5075174,SMARCA4,610
chr1,101069136,101069693,SRX5075168,SMARCA4,557
chr1,101069166,101069497,SRX5716451,SOX2,331
chr1,101069212,101069602,SRX20140895,INTS13,390
chr1,101069213,101069566,SRX5716464,SMARCA4,353
chr1,101069214,101069522,SRX5716454,SOX3,308
chr1,101070402,101070625,SRX5075174,SMARCA4,223
chr1,101128178,101128351,SRX5075174,SMARCA4,173
chr1,101136910,101137152,SRX16500060,CTCF,242
chr1,101136928,101137195,SRX16500059,CTCF,267
chr1,101148790,101149287,SRX5075174,SMARCA4,497
chr1,101148801,101149015,SRX5075168,SMARCA4,214
chr1,101148926,101149301,SRX20140895,INTS13,375
chr1,101149072,101149267,SRX5075168,SMARCA4,195
chr1,101154441,101154756,SRX5716463,SMARCA4,315
chr1,101154468,101154786,SRX5075174,SMARCA4,318
chr1,101154470,101154793,SRX5716464,SMARCA4,323
chr1,101154491,101154841,SRX5075168,SMARCA4,350
chr1,101154532,101154759,SRX5716451,SOX2,227
chr1,101154625,101154800,SRX5075176,SMARCA4,175
chr1,101188347,101188592,SRX5054309,FOSL2,245
chr1,101200531,101200850,SRX5075175,SMARCA4,319
chr1,101200554,101200755,SRX5054309,FOSL2,201
chr1,101200562,101200814,SRX5716469,SMARCA4,252
chr1,101200583,101200769,SRX5075169,SMARCA4,186
chr1,101235963,101236136,SRX5075174,SMARCA4,173
chr1,101236181,101236534,SRX20140895,INTS13,353
chr1,101236614,101237264,SRX20140895,INTS13,650
chr1,101236722,101237136,SRX20140867,INTS10,414
chr1,101236754,101237095,SRX20140879,CPSF3L,341
chr1,101236760,101237072,SRX5075168,SMARCA4,312
chr1,101236814,101237144,SRX20140868,INTS10,330
chr1,101238654,101239169,SRX16500060,CTCF,515
chr1,101238681,101239212,SRX16500059,CTCF,531
chr1,101238698,101239210,SRX16500061,CTCF,512
chr1,101238738,101239192,SRX16500062,CTCF,454
chr1,101238791,101238979,SRX5075176,SMARCA4,188
chr1,101238797,101239115,SRX4174629,CTCF,318
chr1,101238805,101238978,SRX5075174,SMARCA4,173
chr1,101259710,101260081,SRX5054309,FOSL2,371
chr1,101259743,101260152,SRX5075175,SMARCA4,409
chr1,101259756,101260133,SRX5075176,SMARCA4,377
chr1,101259788,101260066,SRX5075169,SMARCA4,278
chr1,101259794,101260089,SRX5075170,SMARCA4,295
chr1,101288281,101288913,SRX16500060,CTCF,632
chr1,101288316,101288864,SRX16500061,CTCF,548
chr1,101288316,101288874,SRX16500059,CTCF,558
chr1,101288349,101288832,SRX16500062,CTCF,483
chr1,101288400,101288811,SRX4174629,CTCF,411
chr1,101288451,101288731,SRX5075174,SMARCA4,280
chr1,101288454,101288669,SRX5075168,SMARCA4,215
chr1,101288467,101288720,SRX5075176,SMARCA4,253
chr1,101288474,101288725,SRX5075175,SMARCA4,251
chr1,101288528,101288749,SRX5075169,SMARCA4,221
chr1,101288546,101288759,SRX5075170,SMARCA4,213
chr1,101293772,101294117,SRX5054308,FOSL2,345
chr1,101293780,101294109,SRX5054309,FOSL2,329
chr1,101302913,101303100,SRX5075168,SMARCA4,187
chr1,101302919,101303172,SRX5075174,SMARCA4,253
chr1,101302965,101303157,SRX5054309,FOSL2,192
chr1,101309119,101309698,SRX4174629,CTCF,579
chr1,101309141,101309761,SRX16500060,CTCF,620
chr1,101309165,101309732,SRX16500062,CTCF,567
chr1,101309186,101309741,SRX16500061,CTCF,555
chr1,101309195,101309670,SRX16500059,CTCF,475
chr1,101309281,101309834,SRX5075168,SMARCA4,553
chr1,101309288,101309603,SRX5075169,SMARCA4,315
chr1,101309292,101309600,SRX5716464,SMARCA4,308
chr1,101309293,101309619,SRX5075170,SMARCA4,326
chr1,101309294,101309834,SRX5075174,SMARCA4,540
chr1,101309299,101309661,SRX5716463,SMARCA4,362
chr1,101309309,101309696,SRX5075175,SMARCA4,387
chr1,101309313,101309599,SRX5075176,SMARCA4,286
chr1,101309328,101309605,SRX5716470,SMARCA4,277
chr1,101309399,101309633,SRX5716469,SMARCA4,234
chr1,101309545,101310225,SRX20140895,INTS13,680
chr1,101309634,101310098,SRX20140867,INTS10,464
chr1,101309815,101310057,SRX20140860,SOX2,242
chr1,101316109,101316689,SRX5075168,SMARCA4,580
chr1,101316144,101316740,SRX5075174,SMARCA4,596
chr1,101316320,101316632,SRX5716463,SMARCA4,312
chr1,101316334,101316627,SRX5716451,SOX2,293
chr1,101316359,101316615,SRX5716464,SMARCA4,256
chr1,101357240,101357769,SRX4174629,CTCF,529
chr1,101357251,101357782,SRX16500060,CTCF,531
chr1,101357283,101357752,SRX16500062,CTCF,469
chr1,101357292,101357803,SRX16500059,CTCF,511
chr1,101357337,101357751,SRX16500061,CTCF,414
chr1,101357365,101357742,SRX5075168,SMARCA4,377
chr1,101357368,101357744,SRX5716464,SMARCA4,376
chr1,101357369,101357602,SRX5716463,SMARCA4,233
chr1,101357389,101357746,SRX5075174,SMARCA4,357
chr1,101357393,101357630,SRX5075169,SMARCA4,237
chr1,101357399,101357680,SRX5075176,SMARCA4,281
chr1,101357403,101357695,SRX5075170,SMARCA4,292
chr1,101357428,101357676,SRX5075175,SMARCA4,248
chr1,101366916,101367111,SRX5075175,SMARCA4,195
chr1,101366929,101367105,SRX5075176,SMARCA4,176
chr1,101366973,101367160,SRX5075169,SMARCA4,187
chr1,101367753,101367953,SRX5075168,SMARCA4,200
chr1,101371188,101371497,SRX5054309,FOSL2,309
chr1,101371239,101371462,SRX5054308,FOSL2,223
chr1,101376761,101376930,SRX5075170,SMARCA4,169
chr1,101389346,101389533,SRX5075168,SMARCA4,187
chr1,101389391,101389581,SRX5075174,SMARCA4,190
chr1,101394076,101394388,SRX5054309,FOSL2,312
chr1,101399273,101399630,SRX5075174,SMARCA4,357
chr1,101399287,101399617,SRX5075168,SMARCA4,330
chr1,101410248,101410522,SRX5054309,FOSL2,274
chr1,101410300,101410590,SRX5054308,FOSL2,290
chr1,101438392,101438686,SRX16500059,CTCF,294
chr1,101438423,101438676,SRX16500060,CTCF,253
chr1,101474013,101474452,SRX16500060,CTCF,439
chr1,101474026,101474441,SRX16500059,CTCF,415
chr1,101474083,101474427,SRX16500061,CTCF,344
chr1,101474113,101474421,SRX16500062,CTCF,308
chr1,101474128,101474376,SRX5075168,SMARCA4,248
chr1,101474144,101474410,SRX5716463,SMARCA4,266
chr1,101498241,101498427,SRX5054309,FOSL2,186
chr1,101506418,101506926,SRX16500060,CTCF,508
chr1,101506495,101506913,SRX16500061,CTCF,418
chr1,101506510,101506910,SRX16500059,CTCF,400
chr1,101506551,101506970,SRX16500062,CTCF,419
chr1,101506566,101506771,SRX5716464,SMARCA4,205
chr1,101506584,101506929,SRX5075174,SMARCA4,345
chr1,101506644,101506860,SRX5075168,SMARCA4,216
chr1,101507684,101507889,SRX5054309,FOSL2,205
chr1,101507771,101507946,SRX5075176,SMARCA4,175
chr1,101520160,101520633,SRX16500059,CTCF,473
chr1,101520173,101520592,SRX16500062,CTCF,419
chr1,101520179,101520639,SRX16500060,CTCF,460
chr1,101520192,101520659,SRX16500061,CTCF,467
chr1,101520333,101520588,SRX5075176,SMARCA4,255
chr1,101520339,101520537,SRX5075174,SMARCA4,198
chr1,101520341,101520665,SRX4174629,CTCF,324
chr1,101520344,101520513,SRX5075170,SMARCA4,169
chr1,101548198,101548629,SRX5075174,SMARCA4,431
chr1,101567508,101568000,SRX16500061,CTCF,492
chr1,101567538,101567957,SRX16500059,CTCF,419
chr1,101567564,101567993,SRX16500060,CTCF,429
chr1,101567589,101568002,SRX16500062,CTCF,413
chr1,101567624,101567886,SRX5075168,SMARCA4,262
chr1,101567639,101567919,SRX5075174,SMARCA4,280
chr1,101567701,101567881,SRX5075170,SMARCA4,180
chr1,101587769,101587962,SRX5075169,SMARCA4,193
chr1,101587798,101588110,SRX5075170,SMARCA4,312
chr1,101587834,101588130,SRX5075176,SMARCA4,296
chr1,101592774,101593269,SRX5075170,SMARCA4,495
chr1,101592819,101593328,SRX5716469,SMARCA4,509
chr1,101592842,101593235,SRX5075176,SMARCA4,393
chr1,101592848,101593223,SRX5075175,SMARCA4,375
chr1,101592855,101593188,SRX5054309,FOSL2,333
chr1,101592856,101593120,SRX5020211,SMARCA2,264
chr1,101592867,101593186,SRX5075169,SMARCA4,319
chr1,101592868,101593183,SRX5716470,SMARCA4,315
chr1,101592884,101593243,SRX5054308,FOSL2,359
chr1,101592889,101593164,SRX5020214,SMARCA2,275
chr1,101592914,101593184,SRX5075182,SMARCA2,270
chr1,101592921,101593164,SRX5716467,SMARCA2,243
chr1,101592995,101593217,SRX5075181,SMARCA2,222
chr1,101594230,101594466,SRX5054309,FOSL2,236
chr1,101594254,101594458,SRX5054308,FOSL2,204
chr1,101613590,101613815,SRX5054308,FOSL2,225
chr1,101613610,101613934,SRX5054309,FOSL2,324
chr1,101653461,101653671,SRX4174629,CTCF,210
chr1,101738543,101738813,SRX5054308,FOSL2,270
chr1,101738553,101738835,SRX5075175,SMARCA4,282
chr1,101738559,101738847,SRX5054309,FOSL2,288
chr1,101738573,101738789,SRX5075169,SMARCA4,216
chr1,101738635,101738858,SRX5075176,SMARCA4,223
chr1,101769526,101769903,SRX16500060,CTCF,377
chr1,101769529,101769983,SRX16500061,CTCF,454
chr1,101769548,101769904,SRX16500059,CTCF,356
chr1,101769636,101769900,SRX16500062,CTCF,264
chr1,101820065,101820502,SRX16500059,CTCF,437
chr1,101820091,101820477,SRX16500060,CTCF,386
chr1,101820128,101820480,SRX16500062,CTCF,352
chr1,101820135,101820436,SRX16500061,CTCF,301
chr1,101884475,101885155,SRX5075168,SMARCA4,680
chr1,101884560,101884906,SRX5716463,SMARCA4,346
chr1,101884584,101885190,SRX5075174,SMARCA4,606
chr1,101884594,101885110,SRX20140895,INTS13,516
chr1,101884609,101884850,SRX5716454,SOX3,241
chr1,101884674,101885063,SRX20140868,INTS10,389
chr1,101884809,101885049,SRX20140880,CPSF3L,240
chr1,101905280,101905455,SRX5075170,SMARCA4,175
chr1,101905555,101905792,SRX5075176,SMARCA4,237
chr1,101915635,101915837,SRX5075170,SMARCA4,202
chr1,101971368,101971639,SRX16500059,CTCF,271
chr1,101971370,101971664,SRX16500062,CTCF,294
chr1,101981029,101981218,SRX5075174,SMARCA4,189
chr1,101993732,101994014,SRX16500061,CTCF,282
chr1,101993778,101994054,SRX16500060,CTCF,276
chr1,101993805,101994113,SRX16500059,CTCF,308
chr1,101996807,101997252,SRX5075168,SMARCA4,445
chr1,101996821,101997264,SRX5075174,SMARCA4,443
chr1,101996836,101997227,SRX5075176,SMARCA4,391
chr1,101996838,101997208,SRX5716463,SMARCA4,370
chr1,101996851,101997253,SRX5716470,SMARCA4,402
chr1,101996855,101997184,SRX5716469,SMARCA4,329
chr1,101996876,101997237,SRX5075170,SMARCA4,361
chr1,101996909,101997233,SRX5020214,SMARCA2,324
chr1,101996910,101997236,SRX5716464,SMARCA4,326
chr1,101996922,101997222,SRX5075169,SMARCA4,300
chr1,101996933,101997226,SRX5075175,SMARCA4,293
chr1,101996990,101997216,SRX5020211,SMARCA2,226
chr1,102085845,102086234,SRX5075174,SMARCA4,389
chr1,102085889,102086312,SRX5075168,SMARCA4,423
chr1,102086047,102086256,SRX5075170,SMARCA4,209
chr1,102105907,102106239,SRX5075168,SMARCA4,332
chr1,102105915,102106348,SRX5075174,SMARCA4,433
chr1,102106051,102106304,SRX5716463,SMARCA4,253
chr1,102107502,102107814,SRX5075174,SMARCA4,312
chr1,102107508,102107747,SRX5716464,SMARCA4,239
chr1,102107522,102107789,SRX5075168,SMARCA4,267
chr1,102107548,102107824,SRX5716463,SMARCA4,276
chr1,102132639,102132986,SRX5075174,SMARCA4,347
chr1,102132654,102133162,SRX5075168,SMARCA4,508
chr1,102174375,102174625,SRX16500059,CTCF,250
chr1,102191693,102192125,SRX16500060,CTCF,432
chr1,102191706,102192072,SRX16500061,CTCF,366
chr1,102191717,102192094,SRX4174629,CTCF,377
chr1,102191749,102192104,SRX16500062,CTCF,355
chr1,102191757,102192153,SRX16500059,CTCF,396
chr1,102191774,102191987,SRX5075168,SMARCA4,213
chr1,102191828,102192023,SRX5075174,SMARCA4,195
chr1,102434469,102434862,SRX16500059,CTCF,393
chr1,102434472,102434878,SRX16500060,CTCF,406
chr1,102434500,102434847,SRX16500062,CTCF,347
chr1,102434507,102434841,SRX16500061,CTCF,334
chr1,102715234,102715523,SRX5054308,FOSL2,289
chr1,102715254,102715539,SRX5716469,SMARCA4,285
chr1,102715265,102715470,SRX5054309,FOSL2,205
chr1,102724133,102724353,SRX5054309,FOSL2,220
chr1,102732880,102733313,SRX5054309,FOSL2,433
chr1,102732993,102733215,SRX5054308,FOSL2,222
chr1,102742333,102742765,SRX5054309,FOSL2,432
chr1,102742510,102742830,SRX5054308,FOSL2,320
chr1,102742538,102742772,SRX5075169,SMARCA4,234
chr1,102742570,102742782,SRX5716469,SMARCA4,212
chr1,102791001,102791320,SRX16500061,CTCF,319
chr1,102791027,102791272,SRX16500060,CTCF,245
chr1,102791040,102791300,SRX16500059,CTCF,260
chr1,102791069,102791257,SRX5075176,SMARCA4,188
chr1,102799542,102799823,SRX5075169,SMARCA4,281
chr1,102799579,102799786,SRX5054308,FOSL2,207
chr1,102821622,102822079,SRX5075168,SMARCA4,457
chr1,102821646,102822084,SRX5075174,SMARCA4,438
chr1,102821705,102821938,SRX5054307,FOSL2,233
chr1,102852649,102852855,SRX5075176,SMARCA4,206
chr1,102879661,102879902,SRX5054309,FOSL2,241
chr1,102879676,102879902,SRX5075175,SMARCA4,226
chr1,102879701,102879870,SRX5075170,SMARCA4,169
chr1,102879705,102879880,SRX5075176,SMARCA4,175
chr1,102892135,102892481,SRX5075176,SMARCA4,346
chr1,102892143,102892490,SRX5054309,FOSL2,347
chr1,102892145,102892486,SRX5054308,FOSL2,341
chr1,102892152,102892367,SRX5716467,SMARCA2,215
chr1,102892157,102892552,SRX5075169,SMARCA4,395
chr1,102892203,102892463,SRX5075175,SMARCA4,260
chr1,102892231,102892484,SRX5716469,SMARCA4,253
chr1,102892278,102892509,SRX5075170,SMARCA4,231
chr1,102897533,102897966,SRX5075169,SMARCA4,433
chr1,102897591,102897891,SRX5075175,SMARCA4,300
chr1,102897591,102897922,SRX5075170,SMARCA4,331
chr1,102897605,102897861,SRX5054308,FOSL2,256
chr1,102897605,102897945,SRX5075176,SMARCA4,340
chr1,102897651,102897931,SRX5716469,SMARCA4,280
chr1,102897666,102897878,SRX5716470,SMARCA4,212
chr1,102902143,102902323,SRX5054308,FOSL2,180
chr1,102919647,102920099,SRX5075169,SMARCA4,452
chr1,102919656,102920189,SRX5075175,SMARCA4,533
chr1,102919659,102920111,SRX5075176,SMARCA4,452
chr1,102919669,102920081,SRX5054309,FOSL2,412
chr1,102919688,102920020,SRX5075170,SMARCA4,332
chr1,102919706,102920030,SRX5054308,FOSL2,324
chr1,102942477,102942694,SRX5075169,SMARCA4,217
chr1,102970440,102970901,SRX16500060,CTCF,461
chr1,102970449,102970991,SRX16500059,CTCF,542
chr1,102970473,102970868,SRX16500062,CTCF,395
chr1,102970487,102970870,SRX16500061,CTCF,383
chr1,102970519,102970802,SRX5075168,SMARCA4,283
chr1,102970528,102970829,SRX5075174,SMARCA4,301
chr1,102970537,102970808,SRX5075170,SMARCA4,271
chr1,102970544,102970778,SRX5075176,SMARCA4,234
chr1,102970555,102970768,SRX5716470,SMARCA4,213
chr1,103002089,103002269,SRX5054308,FOSL2,180
chr1,103106160,103106827,SRX16500060,CTCF,667
chr1,103106237,103106751,SRX16500059,CTCF,514
chr1,103106267,103106791,SRX16500061,CTCF,524
chr1,103106294,103106771,SRX16500062,CTCF,477
chr1,103106414,103106698,SRX4174629,CTCF,284
chr1,103108256,103108526,SRX20140881,CPSF3L,270
chr1,103108366,103108888,SRX5075174,SMARCA4,522
chr1,103108419,103108844,SRX5075170,SMARCA4,425
chr1,103108432,103108947,SRX20140897,INTS13,515
chr1,103108453,103108723,SRX5716463,SMARCA4,270
chr1,103108475,103109033,SRX5075168,SMARCA4,558
chr1,103108612,103108964,SRX20140895,INTS13,352
chr1,103160314,103160494,SRX5075169,SMARCA4,180
chr1,103160325,103160605,SRX5054309,FOSL2,280
chr1,103180585,103180939,SRX5054308,FOSL2,354
chr1,103180587,103181019,SRX5054309,FOSL2,432
chr1,103180667,103181025,SRX5075175,SMARCA4,358
chr1,103180671,103181010,SRX5075169,SMARCA4,339
chr1,103180744,103181007,SRX5716469,SMARCA4,263
chr1,103180769,103181001,SRX5075176,SMARCA4,232
chr1,103180790,103181011,SRX5716470,SMARCA4,221
chr1,103191412,103191608,SRX5054309,FOSL2,196
chr1,103194096,103194284,SRX5075169,SMARCA4,188
chr1,103194107,103194290,SRX5054309,FOSL2,183
chr1,103197320,103197544,SRX5054308,FOSL2,224
chr1,103197361,103197552,SRX5054309,FOSL2,191
chr1,103200685,103200900,SRX5054309,FOSL2,215
chr1,103200696,103200879,SRX5054308,FOSL2,183
chr1,103211116,103211451,SRX5020211,SMARCA2,335
chr1,103211126,103211433,SRX5075176,SMARCA4,307
chr1,103211164,103211393,SRX5716470,SMARCA4,229
chr1,103211169,103211473,SRX5075169,SMARCA4,304
chr1,103211189,103211374,SRX5054309,FOSL2,185
chr1,103211194,103211424,SRX5075175,SMARCA4,230
chr1,103220630,103221199,SRX5075169,SMARCA4,569
chr1,103220640,103221242,SRX5716470,SMARCA4,602
chr1,103220644,103221114,SRX5075170,SMARCA4,470
chr1,103220648,103221130,SRX5054309,FOSL2,482
chr1,103220689,103221174,SRX5075176,SMARCA4,485
chr1,103220700,103221110,SRX5716467,SMARCA2,410
chr1,103220701,103221176,SRX5716469,SMARCA4,475
chr1,103220709,103221016,SRX5075182,SMARCA2,307
chr1,103220711,103221093,SRX5075181,SMARCA2,382
chr1,103220731,103221137,SRX5075175,SMARCA4,406
chr1,103220734,103221058,SRX5054308,FOSL2,324
chr1,103220745,103221113,SRX5020211,SMARCA2,368
chr1,103220756,103221114,SRX5716468,SMARCA2,358
chr1,103220781,103221133,SRX5020214,SMARCA2,352
chr1,103230072,103230374,SRX5054309,FOSL2,302
chr1,103250353,103250894,SRX5716470,SMARCA4,541
chr1,103250365,103250810,SRX5075168,SMARCA4,445
chr1,103250367,103250768,SRX5075170,SMARCA4,401
chr1,103250371,103250812,SRX5054309,FOSL2,441
chr1,103250372,103250810,SRX5075175,SMARCA4,438
chr1,103250406,103250956,SRX5716469,SMARCA4,550
chr1,103250410,103250964,SRX5075176,SMARCA4,554
chr1,103250413,103250866,SRX5075169,SMARCA4,453
chr1,103250437,103250907,SRX20140869,INTS10,470
chr1,103250471,103250878,SRX5075174,SMARCA4,407
chr1,103250518,103250890,SRX20140881,CPSF3L,372
chr1,103250538,103250717,SRX5075182,SMARCA2,179
chr1,103250589,103250883,SRX20140897,INTS13,294
chr1,103256542,103256826,SRX5054308,FOSL2,284
chr1,103256556,103256809,SRX5054309,FOSL2,253
chr1,103265440,103265994,SRX5075168,SMARCA4,554
chr1,103265476,103266034,SRX5075174,SMARCA4,558
chr1,103265532,103266014,SRX5716463,SMARCA4,482
chr1,103265537,103265832,SRX5075176,SMARCA4,295
chr1,103265553,103265923,SRX5075169,SMARCA4,370
chr1,103265569,103265759,SRX5054309,FOSL2,190
chr1,103265600,103265864,SRX5075175,SMARCA4,264
chr1,103265629,103265909,SRX5075170,SMARCA4,280
chr1,103265698,103265946,SRX5716454,SOX3,248
chr1,103265710,103265916,SRX5716451,SOX2,206
chr1,103265986,103266388,SRX5075170,SMARCA4,402
chr1,103266027,103266359,SRX5075176,SMARCA4,332
chr1,103266084,103266375,SRX5075169,SMARCA4,291
chr1,103266103,103266446,SRX5716467,SMARCA2,343
chr1,103266121,103266392,SRX5075175,SMARCA4,271
chr1,103266133,103266485,SRX5716470,SMARCA4,352
chr1,103266161,103266379,SRX5716469,SMARCA4,218
chr1,103266173,103266409,SRX5020211,SMARCA2,236
chr1,103271606,103271789,SRX5054309,FOSL2,183
chr1,103284142,103284743,SRX5075175,SMARCA4,601
chr1,103284163,103284674,SRX5716467,SMARCA2,511
chr1,103284172,103284816,SRX5075170,SMARCA4,644
chr1,103284179,103284704,SRX5716459,Epitope tags,525
chr1,103284186,103284545,SRX5075181,SMARCA2,359
chr1,103284192,103284842,SRX5075169,SMARCA4,650
chr1,103284197,103284823,SRX5075176,SMARCA4,626
chr1,103284209,103284489,SRX5054309,FOSL2,280
chr1,103284227,103284486,SRX5054308,FOSL2,259
chr1,103284230,103284777,SRX5716470,SMARCA4,547
chr1,103284232,103284642,SRX5020211,SMARCA2,410
chr1,103284262,103284719,SRX5716469,SMARCA4,457
chr1,103284267,103284695,SRX5716468,SMARCA2,428
chr1,103343092,103343288,SRX5075170,SMARCA4,196
chr1,103343140,103343393,SRX5075176,SMARCA4,253
chr1,103371320,103371500,SRX5075169,SMARCA4,180
chr1,103371377,103371618,SRX5054309,FOSL2,241
chr1,103416746,103416975,SRX5075176,SMARCA4,229
chr1,103448753,103448995,SRX5020211,SMARCA2,242
chr1,103448874,103449082,SRX5054309,FOSL2,208
chr1,103459549,103459724,SRX5075176,SMARCA4,175
chr1,103461057,103461575,SRX16500059,CTCF,518
chr1,103461099,103461602,SRX16500062,CTCF,503
chr1,103461103,103461567,SRX16500060,CTCF,464
chr1,103461110,103461612,SRX16500061,CTCF,502
chr1,103496176,103496665,SRX5075169,SMARCA4,489
chr1,103496190,103496846,SRX5075176,SMARCA4,656
chr1,103496262,103496709,SRX5075175,SMARCA4,447
chr1,103496267,103496659,SRX5075170,SMARCA4,392
chr1,103496272,103496610,SRX5054309,FOSL2,338
chr1,103496294,103496548,SRX5716470,SMARCA4,254
chr1,103496303,103496760,SRX5716467,SMARCA2,457
chr1,103496312,103496635,SRX5054308,FOSL2,323
chr1,103496323,103496717,SRX5716469,SMARCA4,394
chr1,103496324,103496540,SRX5075181,SMARCA2,216
chr1,103496333,103496657,SRX5020211,SMARCA2,324
chr1,103496494,103496749,SRX5716468,SMARCA2,255
chr1,103514840,103515349,SRX16500059,CTCF,509
chr1,103514847,103515356,SRX16500060,CTCF,509
chr1,103514891,103515346,SRX16500062,CTCF,455
chr1,103514907,103515323,SRX16500061,CTCF,416
chr1,103514985,103515212,SRX5075174,SMARCA4,227
chr1,103514989,103515206,SRX5075170,SMARCA4,217
chr1,103514992,103515250,SRX5075168,SMARCA4,258
chr1,103515032,103515253,SRX5075176,SMARCA4,221
chr1,103516682,103516965,SRX5054309,FOSL2,283
chr1,103516719,103516915,SRX5075169,SMARCA4,196
chr1,103525699,103526229,SRX5075174,SMARCA4,530
chr1,103525719,103526504,SRX5075168,SMARCA4,785
chr1,103525771,103526200,SRX20140867,INTS10,429
chr1,103525772,103526281,SRX20140897,INTS13,509
chr1,103525783,103526544,SRX5075176,SMARCA4,761
chr1,103525793,103526530,SRX5075169,SMARCA4,737
chr1,103525798,103526329,SRX20140895,INTS13,531
chr1,103525808,103526034,SRX5054308,FOSL2,226
chr1,103525889,103526160,SRX20140896,INTS13,271
chr1,103525918,103526261,SRX20140869,INTS10,343
chr1,103525925,103526529,SRX5075170,SMARCA4,604
chr1,103526027,103526433,SRX5716470,SMARCA4,406
chr1,103526032,103526481,SRX5075175,SMARCA4,449
chr1,103526045,103526273,SRX5716469,SMARCA4,228
chr1,103526281,103526454,SRX5075174,SMARCA4,173
chr1,103526316,103526553,SRX5054309,FOSL2,237
chr1,103526327,103526574,SRX5716469,SMARCA4,247
chr1,103622458,103622751,SRX5075174,SMARCA4,293
chr1,103716603,103716842,SRX5075174,SMARCA4,239
chr1,103716667,103716862,SRX5075168,SMARCA4,195
chr1,103788329,103788755,SRX16500060,CTCF,426
chr1,103788341,103788761,SRX16500062,CTCF,420
chr1,103788379,103788756,SRX16500061,CTCF,377
chr1,103788397,103788741,SRX16500059,CTCF,344
chr1,103828879,103829068,SRX5075168,SMARCA4,189
chr1,103948504,103948877,SRX16500060,CTCF,373
chr1,103948511,103948890,SRX16500059,CTCF,379
chr1,103948548,103948861,SRX16500062,CTCF,313
chr1,103948556,103948879,SRX16500061,CTCF,323
chr1,104120557,104120858,SRX16500060,CTCF,301
chr1,104120558,104120780,SRX16500062,CTCF,222
chr1,104120574,104120793,SRX16500061,CTCF,219
chr1,104132278,104132817,SRX16500060,CTCF,539
chr1,104132310,104132826,SRX16500059,CTCF,516
chr1,104132343,104132737,SRX16500061,CTCF,394
chr1,104132401,104132799,SRX16500062,CTCF,398
chr1,104132470,104132643,SRX5075174,SMARCA4,173
chr1,104132521,104132731,SRX4174629,CTCF,210
chr1,104195503,104195733,SRX5054309,FOSL2,230
chr1,104263246,104263485,SRX4174629,CTCF,239
chr1,104264621,104264838,SRX5054309,FOSL2,217
chr1,104463558,104463826,SRX20140867,INTS10,268
chr1,104648030,104648543,SRX16500059,CTCF,513
chr1,104648089,104648542,SRX16500062,CTCF,453
chr1,104648114,104648564,SRX16500060,CTCF,450
chr1,104648126,104648562,SRX16500061,CTCF,436
chr1,104648177,104648489,SRX5075174,SMARCA4,312
chr1,104648234,104648459,SRX5075170,SMARCA4,225
chr1,104648249,104648491,SRX5075168,SMARCA4,242
chr1,104648277,104648452,SRX5075176,SMARCA4,175
chr1,104648346,104648627,SRX4174629,CTCF,281
chr1,104780455,104780956,SRX16500060,CTCF,501
chr1,104780472,104780883,SRX16500062,CTCF,411
chr1,104780476,104780923,SRX16500061,CTCF,447
chr1,104780477,104780921,SRX16500059,CTCF,444
chr1,104780523,104780866,SRX5075168,SMARCA4,343
chr1,104780524,104780802,SRX5716470,SMARCA4,278
chr1,104780543,104780846,SRX5075174,SMARCA4,303
chr1,104780550,104780843,SRX5716463,SMARCA4,293
chr1,104780583,104780845,SRX5716464,SMARCA4,262
chr1,104780590,104780820,SRX5075170,SMARCA4,230
chr1,104780609,104780855,SRX5075176,SMARCA4,246
chr1,104780631,104780828,SRX5075175,SMARCA4,197
chr1,104807572,104807855,SRX5054309,FOSL2,283
chr1,104807628,104807857,SRX5054308,FOSL2,229
chr1,104862398,104862664,SRX5075169,SMARCA4,266
chr1,104862403,104862699,SRX5054309,FOSL2,296
chr1,104862428,104862616,SRX5054308,FOSL2,188
chr1,104885014,104885236,SRX5075169,SMARCA4,222
chr1,104885044,104885335,SRX5054309,FOSL2,291
chr1,104885052,104885242,SRX5054308,FOSL2,190
chr1,104921576,104921848,SRX5075176,SMARCA4,272
chr1,104921576,104921860,SRX5054308,FOSL2,284
chr1,104921577,104921865,SRX5075169,SMARCA4,288
chr1,104921598,104921835,SRX5020214,SMARCA2,237
chr1,104921607,104921946,SRX5054309,FOSL2,339
chr1,104921615,104921896,SRX5075170,SMARCA4,281
chr1,104921670,104921893,SRX5075175,SMARCA4,223
chr1,104927465,104927665,SRX5075174,SMARCA4,200
chr1,105137436,105137801,SRX5075174,SMARCA4,365
chr1,105137448,105137825,SRX16500060,CTCF,377
chr1,105137459,105137740,SRX16500062,CTCF,281
chr1,105137460,105137737,SRX16500059,CTCF,277
chr1,105137469,105137769,SRX5075168,SMARCA4,300
chr1,105137476,105137684,SRX5716464,SMARCA4,208
chr1,105137507,105137682,SRX5075176,SMARCA4,175
chr1,105137507,105137727,SRX16500061,CTCF,220
chr1,105137519,105137705,SRX5075170,SMARCA4,186
chr1,105362560,105362733,SRX5075174,SMARCA4,173
chr1,105462383,105462658,SRX16500061,CTCF,275
chr1,105462402,105462729,SRX16500060,CTCF,327
chr1,105462460,105462728,SRX16500062,CTCF,268
chr1,105483517,105483788,SRX5716470,SMARCA4,271
chr1,105485117,105485570,SRX5075170,SMARCA4,453
chr1,105485117,105485578,SRX5075169,SMARCA4,461
chr1,105485151,105485583,SRX5054309,FOSL2,432
chr1,105485160,105485539,SRX5075176,SMARCA4,379
chr1,105485164,105485671,SRX5075175,SMARCA4,507
chr1,105485184,105485550,SRX5054308,FOSL2,366
chr1,105485242,105485487,SRX5716469,SMARCA4,245
chr1,105485247,105485434,SRX5075182,SMARCA2,187
chr1,105485275,105485559,SRX5020214,SMARCA2,284
chr1,105785178,105785458,SRX5075176,SMARCA4,280
chr1,105793486,105793972,SRX16500060,CTCF,486
chr1,105793501,105793975,SRX16500061,CTCF,474
chr1,105793505,105794007,SRX16500059,CTCF,502
chr1,105793531,105793946,SRX16500062,CTCF,415
chr1,105793589,105793833,SRX5075168,SMARCA4,244
chr1,105793604,105793859,SRX5075174,SMARCA4,255
chr1,105793621,105793829,SRX5075176,SMARCA4,208
chr1,105864754,105865075,SRX5075168,SMARCA4,321
chr1,105864857,105865086,SRX5075174,SMARCA4,229
chr1,105865590,105865867,SRX5054309,FOSL2,277
chr1,105865595,105865793,SRX5075168,SMARCA4,198
chr1,105865620,105865873,SRX5075174,SMARCA4,253
chr1,105865633,105865842,SRX5054308,FOSL2,209
chr1,105894090,105894349,SRX5054309,FOSL2,259
chr1,105905248,105905431,SRX5054309,FOSL2,183
chr1,106022232,106022790,SRX16500059,CTCF,558
chr1,106022238,106022716,SRX16500062,CTCF,478
chr1,106022264,106022721,SRX16500060,CTCF,457
chr1,106022279,106022784,SRX16500061,CTCF,505
chr1,106038274,106038484,SRX16500062,CTCF,210
chr1,106049633,106049939,SRX5075168,SMARCA4,306
chr1,106063582,106063791,SRX5075168,SMARCA4,209
chr1,106063607,106063867,SRX5075174,SMARCA4,260
chr1,106217841,106218071,SRX16500060,CTCF,230
chr1,106217850,106218134,SRX16500061,CTCF,284
chr1,106217862,106218116,SRX16500062,CTCF,254
chr1,106222373,106222665,SRX5716470,SMARCA4,292
chr1,106222381,106222834,SRX5075169,SMARCA4,453
chr1,106222401,106222794,SRX5716469,SMARCA4,393
chr1,106222410,106222778,SRX5054308,FOSL2,368
chr1,106222431,106222740,SRX5075176,SMARCA4,309
chr1,106222440,106222776,SRX5054309,FOSL2,336
chr1,106222450,106222655,SRX5020211,SMARCA2,205
chr1,106222461,106222764,SRX5075175,SMARCA4,303
chr1,106222493,106222746,SRX5075170,SMARCA4,253
chr1,106222496,106222735,SRX5716468,SMARCA2,239
chr1,106222558,106222742,SRX5075168,SMARCA4,184
chr1,106225350,106225805,SRX5075174,SMARCA4,455
chr1,106225359,106225776,SRX5075168,SMARCA4,417
chr1,106225407,106225740,SRX5716463,SMARCA4,333
chr1,106225489,106225723,SRX5716464,SMARCA4,234
chr1,106226686,106226921,SRX5075174,SMARCA4,235
chr1,106226709,106226936,SRX5716463,SMARCA4,227
chr1,106226728,106226965,SRX5716464,SMARCA4,237
chr1,106268053,106268418,SRX16500060,CTCF,365
chr1,106268089,106268423,SRX16500059,CTCF,334
chr1,106268109,106268401,SRX16500062,CTCF,292
chr1,106268116,106268426,SRX5075174,SMARCA4,310
chr1,106268145,106268399,SRX5075168,SMARCA4,254
chr1,106268147,106268524,SRX16500061,CTCF,377
chr1,106276875,106277223,SRX5075170,SMARCA4,348
chr1,106276881,106277224,SRX5075176,SMARCA4,343
chr1,106278734,106279051,SRX5054309,FOSL2,317
chr1,106289526,106289931,SRX5075168,SMARCA4,405
chr1,106289569,106289908,SRX5716463,SMARCA4,339
chr1,106289595,106289938,SRX5075174,SMARCA4,343
chr1,106289600,106289811,SRX5716464,SMARCA4,211
chr1,106289721,106289931,SRX5716451,SOX2,210
chr1,106291215,106291590,SRX20140868,INTS10,375
chr1,106291236,106291503,SRX20140895,INTS13,267
chr1,106360243,106360640,SRX16500059,CTCF,397
chr1,106360287,106360538,SRX16500061,CTCF,251
chr1,106413256,106413613,SRX20140895,INTS13,357
chr1,106498355,106498550,SRX5054308,FOSL2,195
chr1,106523412,106523968,SRX5075174,SMARCA4,556
chr1,106523421,106523921,SRX5075168,SMARCA4,500
chr1,106523564,106523950,SRX5716463,SMARCA4,386
chr1,106526866,106527036,SRX5075170,SMARCA4,170
chr1,106571085,106571254,SRX5075170,SMARCA4,169
chr1,106571101,106571276,SRX5075176,SMARCA4,175
chr1,106699512,106699687,SRX5075176,SMARCA4,175
chr1,106699537,106699805,SRX5075170,SMARCA4,268
chr1,106700080,106700530,SRX5075176,SMARCA4,450
chr1,106700142,106700624,SRX5075170,SMARCA4,482
chr1,106700152,106700486,SRX5054309,FOSL2,334
chr1,106700156,106700442,SRX5716467,SMARCA2,286
chr1,106700160,106700545,SRX5075169,SMARCA4,385
chr1,106700168,106700476,SRX5716470,SMARCA4,308
chr1,106700178,106700589,SRX5075175,SMARCA4,411
chr1,106700180,106700472,SRX5054308,FOSL2,292
chr1,106700188,106700582,SRX5716469,SMARCA4,394
chr1,106746468,106747050,SRX5075176,SMARCA4,582
chr1,106746530,106747217,SRX5075174,SMARCA4,687
chr1,106746562,106746973,SRX5075170,SMARCA4,411
chr1,106746583,106747136,SRX5716470,SMARCA4,553
chr1,106746592,106747035,SRX5075169,SMARCA4,443
chr1,106746593,106747174,SRX5075168,SMARCA4,581
chr1,106746697,106747092,SRX5716463,SMARCA4,395
chr1,106746735,106746993,SRX5716469,SMARCA4,258
chr1,106746840,106747082,SRX5716464,SMARCA4,242
chr1,106746872,106747060,SRX5075175,SMARCA4,188
chr1,106752980,106753577,SRX5075174,SMARCA4,597
chr1,106753015,106753592,SRX5075168,SMARCA4,577
chr1,106753100,106753376,SRX5075169,SMARCA4,276
chr1,106753113,106753371,SRX5054309,FOSL2,258
chr1,106753145,106753358,SRX5075176,SMARCA4,213
chr1,106753184,106753551,SRX5716463,SMARCA4,367
chr1,106753231,106753549,SRX5716464,SMARCA4,318
chr1,106753297,106753508,SRX5716451,SOX2,211
chr1,106755748,106756057,SRX5054309,FOSL2,309
chr1,106755762,106755983,SRX5054308,FOSL2,221
chr1,106768486,106768777,SRX5054309,FOSL2,291
chr1,106780100,106780417,SRX5716470,SMARCA4,317
chr1,106780102,106780368,SRX5075170,SMARCA4,266
chr1,106780108,106780380,SRX5075176,SMARCA4,272
chr1,106780132,106780379,SRX5716467,SMARCA2,247
chr1,106785243,106785454,SRX5716470,SMARCA4,211
chr1,106785243,106785455,SRX5716469,SMARCA4,212
chr1,106785248,106785456,SRX5075176,SMARCA4,208
chr1,106817557,106817987,SRX5075170,SMARCA4,430
chr1,106817575,106817954,SRX5075176,SMARCA4,379
chr1,106924302,106924734,SRX5716464,SMARCA4,432
chr1,106924345,106924861,SRX5075168,SMARCA4,516
chr1,106924366,106924823,SRX5075174,SMARCA4,457
chr1,106924391,106924665,SRX5075170,SMARCA4,274
chr1,106924412,106924660,SRX5054309,FOSL2,248
chr1,106924429,106924781,SRX5716463,SMARCA4,352
chr1,106924444,106924647,SRX5075175,SMARCA4,203
chr1,106924454,106924640,SRX5075176,SMARCA4,186
chr1,106924463,106924647,SRX5054307,FOSL2,184
chr1,106926714,106927134,SRX5075174,SMARCA4,420
chr1,106926749,106926977,SRX5075168,SMARCA4,228
chr1,106926788,106926975,SRX5075176,SMARCA4,187
chr1,106937087,106937482,SRX5075175,SMARCA4,395
chr1,106937108,106937450,SRX5075169,SMARCA4,342
chr1,106937113,106937440,SRX5054308,FOSL2,327
chr1,106937118,106937479,SRX5075168,SMARCA4,361
chr1,106937125,106937477,SRX5075170,SMARCA4,352
chr1,106937127,106937463,SRX5054309,FOSL2,336
chr1,106937142,106937487,SRX5075174,SMARCA4,345
chr1,106937147,106937494,SRX5075176,SMARCA4,347
chr1,106937148,106937394,SRX5716469,SMARCA4,246
chr1,106937189,106937439,SRX5020214,SMARCA2,250
chr1,106937200,106937407,SRX5075182,SMARCA2,207
chr1,106944684,106945087,SRX5075176,SMARCA4,403
chr1,106944701,106945086,SRX5075170,SMARCA4,385
chr1,106944712,106944935,SRX5075175,SMARCA4,223
chr1,106953620,106953823,SRX5075168,SMARCA4,203
chr1,106956684,106957130,SRX5075176,SMARCA4,446
chr1,106956688,106957134,SRX5075170,SMARCA4,446
chr1,106956725,106957029,SRX5075169,SMARCA4,304
chr1,106956732,106957036,SRX5716469,SMARCA4,304
chr1,106956741,106956975,SRX5054308,FOSL2,234
chr1,106956776,106957044,SRX5075175,SMARCA4,268
chr1,106956780,106957022,SRX5716467,SMARCA2,242
chr1,106956794,106956977,SRX5054309,FOSL2,183
chr1,106956808,106957019,SRX5716470,SMARCA4,211
chr1,106978418,106978785,SRX5075170,SMARCA4,367
chr1,106978433,106978773,SRX5075176,SMARCA4,340
chr1,106978450,106978828,SRX5716470,SMARCA4,378
chr1,106978456,106978701,SRX5075175,SMARCA4,245
chr1,106978510,106978796,SRX5054308,FOSL2,286
chr1,106978533,106978760,SRX5054309,FOSL2,227
chr1,107019322,107019491,SRX5075170,SMARCA4,169
chr1,107056420,107056858,SRX5075174,SMARCA4,438
chr1,107056431,107056779,SRX5075176,SMARCA4,348
chr1,107056446,107057243,SRX20140895,INTS13,797
chr1,107056450,107056999,SRX5075168,SMARCA4,549
chr1,107056476,107056692,SRX5716470,SMARCA4,216
chr1,107056501,107056724,SRX5075169,SMARCA4,223
chr1,107056527,107056821,SRX5075175,SMARCA4,294
chr1,107056539,107056898,SRX20140867,INTS10,359
chr1,107056543,107056962,SRX20140868,INTS10,419
chr1,107056555,107056919,SRX5075170,SMARCA4,364
chr1,107056629,107056901,SRX20140879,CPSF3L,272
chr1,107056722,107057021,SRX20140881,CPSF3L,299
chr1,107057380,107057649,SRX5075176,SMARCA4,269
chr1,107057540,107057759,SRX5075170,SMARCA4,219
chr1,107076926,107077217,SRX5054309,FOSL2,291
chr1,107076981,107077225,SRX5716469,SMARCA4,244
chr1,107093409,107093655,SRX5054309,FOSL2,246
chr1,107100316,107101014,SRX5075170,SMARCA4,698
chr1,107100319,107100642,SRX5075175,SMARCA4,323
chr1,107100326,107100696,SRX5716467,SMARCA2,370
chr1,107100333,107100847,SRX5075169,SMARCA4,514
chr1,107100359,107100654,SRX5716470,SMARCA4,295
chr1,107100384,107100871,SRX5716469,SMARCA4,487
chr1,107100392,107101073,SRX5075176,SMARCA4,681
chr1,107100393,107100671,SRX5716468,SMARCA2,278
chr1,107100640,107100851,SRX5054309,FOSL2,211
chr1,107110174,107110633,SRX5075174,SMARCA4,459
chr1,107110236,107110439,SRX5075168,SMARCA4,203
chr1,107110300,107110681,SRX5075176,SMARCA4,381
chr1,107110318,107110701,SRX5075170,SMARCA4,383
chr1,107110351,107110582,SRX5716467,SMARCA2,231
chr1,107116432,107116898,SRX5075170,SMARCA4,466
chr1,107116438,107116700,SRX5075176,SMARCA4,262
chr1,107135481,107135816,SRX5075169,SMARCA4,335
chr1,107135511,107135810,SRX5075176,SMARCA4,299
chr1,107135516,107135809,SRX5716469,SMARCA4,293
chr1,107135516,107135819,SRX5075170,SMARCA4,303
chr1,107135543,107135767,SRX5075168,SMARCA4,224
chr1,107135549,107135820,SRX5716470,SMARCA4,271
chr1,107135550,107135785,SRX5075175,SMARCA4,235
chr1,107135555,107135817,SRX5075174,SMARCA4,262
chr1,107135565,107135767,SRX5075181,SMARCA2,202
chr1,107135576,107135810,SRX5020211,SMARCA2,234
chr1,107139939,107140151,SRX5075176,SMARCA4,212
chr1,107141949,107142488,SRX16500059,CTCF,539
chr1,107141980,107142477,SRX16500060,CTCF,497
chr1,107142008,107142483,SRX16500062,CTCF,475
chr1,107142015,107142481,SRX16500061,CTCF,466
chr1,107142064,107142285,SRX5054308,FOSL2,221
chr1,107142131,107142372,SRX5075176,SMARCA4,241
chr1,107175345,107175908,SRX5075174,SMARCA4,563
chr1,107175360,107175976,SRX5075168,SMARCA4,616
chr1,107175429,107175852,SRX5716463,SMARCA4,423
chr1,107175544,107175745,SRX5716451,SOX2,201
chr1,107196926,107197360,SRX16500059,CTCF,434
chr1,107196993,107197226,SRX16500060,CTCF,233
chr1,107197000,107197279,SRX16500061,CTCF,279
chr1,107197060,107197285,SRX16500062,CTCF,225
chr1,107198663,107198840,SRX5075170,SMARCA4,177
chr1,107226098,107226375,SRX5075176,SMARCA4,277
chr1,107226107,107226380,SRX5075170,SMARCA4,273
chr1,107229788,107230006,SRX5075176,SMARCA4,218
chr1,107229848,107230029,SRX5075170,SMARCA4,181
chr1,107246955,107247208,SRX5075174,SMARCA4,253
chr1,107247043,107247287,SRX5075168,SMARCA4,244
chr1,107262888,107263065,SRX5075170,SMARCA4,177
chr1,107262911,107263182,SRX5054309,FOSL2,271
chr1,107262923,107263201,SRX5075169,SMARCA4,278
chr1,107264588,107264822,SRX5075170,SMARCA4,234
chr1,107264606,107264871,SRX5075176,SMARCA4,265
chr1,107264630,107264843,SRX5075175,SMARCA4,213
chr1,107264663,107264856,SRX5075169,SMARCA4,193
chr1,107276848,107277322,SRX16500062,CTCF,474
chr1,107276885,107277314,SRX16500059,CTCF,429
chr1,107276933,107277354,SRX16500060,CTCF,421
chr1,107276957,107277336,SRX16500061,CTCF,379
chr1,107277030,107277377,SRX4174629,CTCF,347
chr1,107277086,107277264,SRX5075174,SMARCA4,178
chr1,107323746,107324049,SRX5075174,SMARCA4,303
chr1,107323840,107324025,SRX5075168,SMARCA4,185
chr1,107389797,107390179,SRX5075174,SMARCA4,382
chr1,107389961,107390296,SRX5075168,SMARCA4,335
chr1,107404871,107405077,SRX5075169,SMARCA4,206
chr1,107404972,107405564,SRX5075176,SMARCA4,592
chr1,107405178,107405638,SRX5075170,SMARCA4,460
chr1,107405229,107405503,SRX5054308,FOSL2,274
chr1,107405233,107405498,SRX5054309,FOSL2,265
chr1,107405237,107405479,SRX5075175,SMARCA4,242
chr1,107405267,107405467,SRX5075169,SMARCA4,200
chr1,107430599,107431052,SRX16500059,CTCF,453
chr1,107430621,107431025,SRX16500062,CTCF,404
chr1,107430630,107431079,SRX4174629,CTCF,449
chr1,107430645,107431075,SRX16500060,CTCF,430
chr1,107430660,107430952,SRX16500061,CTCF,292
chr1,107430723,107431014,SRX5075168,SMARCA4,291
chr1,107430737,107431002,SRX5075174,SMARCA4,265
chr1,107430771,107431003,SRX5716464,SMARCA4,232
chr1,107430777,107430981,SRX5716463,SMARCA4,204
chr1,107453414,107453631,SRX5075170,SMARCA4,217
chr1,107455600,107456003,SRX5075174,SMARCA4,403
chr1,107455638,107455872,SRX5075168,SMARCA4,234
chr1,107455666,107455871,SRX5716464,SMARCA4,205
chr1,107455767,107455971,SRX5716463,SMARCA4,204
chr1,107477274,107477520,SRX16500059,CTCF,246
chr1,107477280,107477628,SRX16500061,CTCF,348
chr1,107477310,107477553,SRX16500060,CTCF,243
chr1,107529480,107529955,SRX16500060,CTCF,475
chr1,107529501,107529960,SRX16500059,CTCF,459
chr1,107529508,107529947,SRX16500061,CTCF,439
chr1,107529517,107529957,SRX16500062,CTCF,440
chr1,107529580,107529878,SRX5075174,SMARCA4,298
chr1,107529591,107529815,SRX4174629,CTCF,224
chr1,107529604,107529836,SRX5075168,SMARCA4,232
chr1,107529636,107529836,SRX5075170,SMARCA4,200
chr1,107559970,107560207,SRX5054309,FOSL2,237
chr1,107559993,107560221,SRX5054308,FOSL2,228
chr1,107572568,107573097,SRX5075170,SMARCA4,529
chr1,107572648,107573008,SRX5075176,SMARCA4,360
chr1,107572655,107572964,SRX5716469,SMARCA4,309
chr1,107572664,107572983,SRX5054309,FOSL2,319
chr1,107572674,107573076,SRX5075175,SMARCA4,402
chr1,107572675,107572924,SRX5054308,FOSL2,249
chr1,107572692,107572967,SRX5075169,SMARCA4,275
chr1,107572698,107572984,SRX5716467,SMARCA2,286
chr1,107626182,107626437,SRX5075176,SMARCA4,255
chr1,107626427,107626729,SRX5075170,SMARCA4,302
chr1,107647972,107648406,SRX5075169,SMARCA4,434
chr1,107648047,107648394,SRX5054309,FOSL2,347
chr1,107648064,107648367,SRX5075170,SMARCA4,303
chr1,107648072,107648339,SRX5075175,SMARCA4,267
chr1,107648129,107648402,SRX5075176,SMARCA4,273
chr1,107648175,107648364,SRX5054308,FOSL2,189
chr1,107688487,107688720,SRX5054308,FOSL2,233
chr1,107688507,107688708,SRX5054309,FOSL2,201
chr1,107700733,107700971,SRX5075176,SMARCA4,238
chr1,107700753,107700934,SRX5075169,SMARCA4,181
chr1,107748541,107748833,SRX16500062,CTCF,292
chr1,107748556,107748859,SRX16500060,CTCF,303
chr1,107748579,107748870,SRX16500059,CTCF,291
chr1,107750346,107750858,SRX16500059,CTCF,512
chr1,107750367,107750792,SRX16500061,CTCF,425
chr1,107750383,107750769,SRX16500060,CTCF,386
chr1,107750392,107750609,SRX5716470,SMARCA4,217
chr1,107750400,107750786,SRX16500062,CTCF,386
chr1,107750411,107750689,SRX4174629,CTCF,278
chr1,107750414,107750661,SRX5075176,SMARCA4,247
chr1,107750429,107750732,SRX5075168,SMARCA4,303
chr1,107750452,107750702,SRX5075174,SMARCA4,250
chr1,107750471,107750684,SRX5716463,SMARCA4,213
chr1,107782062,107782621,SRX16500061,CTCF,559
chr1,107782124,107782700,SRX16500060,CTCF,576
chr1,107782125,107782632,SRX16500059,CTCF,507
chr1,107782201,107782673,SRX16500062,CTCF,472
chr1,107782274,107782499,SRX5075174,SMARCA4,225
chr1,107782339,107782518,SRX5075168,SMARCA4,179
chr1,107877171,107877391,SRX5075170,SMARCA4,220
chr1,107877197,107877507,SRX5075176,SMARCA4,310
chr1,107877212,107877471,SRX5054308,FOSL2,259
chr1,107936444,107936765,SRX5075169,SMARCA4,321
chr1,107936470,107936854,SRX5075168,SMARCA4,384
chr1,107936478,107936754,SRX5054309,FOSL2,276
chr1,107936479,107936875,SRX5075174,SMARCA4,396
chr1,107936500,107936712,SRX5716469,SMARCA4,212
chr1,107936501,107936864,SRX5075170,SMARCA4,363
chr1,107936506,107936834,SRX5075176,SMARCA4,328
chr1,107936524,107936785,SRX5054308,FOSL2,261
chr1,107936535,107936853,SRX5075175,SMARCA4,318
chr1,107937277,107937481,SRX5075174,SMARCA4,204
chr1,107965165,107965436,SRX20140895,INTS13,271
chr1,107965370,107965922,SRX16500059,CTCF,552
chr1,107965549,107965833,SRX16500060,CTCF,284
chr1,107965569,107965792,SRX16500062,CTCF,223
chr1,107965712,107966033,SRX5075174,SMARCA4,321
chr1,107965780,107966086,SRX5075168,SMARCA4,306
chr1,107976765,107977252,SRX5054309,FOSL2,487
chr1,107976772,107977331,SRX5075176,SMARCA4,559
chr1,107976807,107977237,SRX5075175,SMARCA4,430
chr1,107976844,107977325,SRX5075170,SMARCA4,481
chr1,107976852,107977213,SRX5054308,FOSL2,361
chr1,107976852,107977274,SRX5075169,SMARCA4,422
chr1,107976922,107977252,SRX5716470,SMARCA4,330
chr1,107976971,107977236,SRX5716469,SMARCA4,265
chr1,107993958,107994318,SRX5075168,SMARCA4,360
chr1,108000627,108001165,SRX5075176,SMARCA4,538
chr1,108000646,108001158,SRX5075170,SMARCA4,512
chr1,108000679,108001148,SRX5075169,SMARCA4,469
chr1,108000681,108000994,SRX5054309,FOSL2,313
chr1,108000729,108001155,SRX5716469,SMARCA4,426
chr1,108000735,108000978,SRX5716470,SMARCA4,243
chr1,108000759,108000994,SRX5054308,FOSL2,235
chr1,108000793,108001059,SRX5075175,SMARCA4,266
chr1,108009833,108010068,SRX5054309,FOSL2,235
chr1,108016387,108016903,SRX5075170,SMARCA4,516
chr1,108016431,108016982,SRX5075174,SMARCA4,551
chr1,108016470,108016886,SRX5075168,SMARCA4,416
chr1,108016472,108016727,SRX5054308,FOSL2,255
chr1,108016489,108016930,SRX5075169,SMARCA4,441
chr1,108016495,108016974,SRX5075176,SMARCA4,479
chr1,108016507,108016768,SRX5054309,FOSL2,261
chr1,108016509,108016843,SRX5075175,SMARCA4,334
chr1,108016542,108016897,SRX5716469,SMARCA4,355
chr1,108034422,108034613,SRX5075170,SMARCA4,191
chr1,108041308,108041715,SRX5075176,SMARCA4,407
chr1,108041409,108041892,SRX5075170,SMARCA4,483
chr1,108049630,108049851,SRX16500062,CTCF,221
chr1,108049642,108049942,SRX16500060,CTCF,300
chr1,108051821,108052325,SRX5075174,SMARCA4,504
chr1,108051951,108052229,SRX5716464,SMARCA4,278
chr1,108051965,108052343,SRX5075168,SMARCA4,378
chr1,108057608,108057862,SRX5075168,SMARCA4,254
chr1,108057629,108057911,SRX5075174,SMARCA4,282
chr1,108057709,108057898,SRX5075176,SMARCA4,189
chr1,108089386,108089845,SRX5075170,SMARCA4,459
chr1,108089400,108089709,SRX5075176,SMARCA4,309
chr1,108118528,108118771,SRX5054309,FOSL2,243
chr1,108118578,108118772,SRX5054308,FOSL2,194
chr1,108125431,108125949,SRX16500059,CTCF,518
chr1,108125443,108125955,SRX16500060,CTCF,512
chr1,108125454,108125909,SRX16500062,CTCF,455
chr1,108125484,108125936,SRX16500061,CTCF,452
chr1,108125497,108125831,SRX5075174,SMARCA4,334
chr1,108125509,108125714,SRX5716464,SMARCA4,205
chr1,108125522,108125912,SRX4174629,CTCF,390
chr1,108125559,108125776,SRX5075176,SMARCA4,217
chr1,108125562,108125849,SRX5075168,SMARCA4,287
chr1,108125607,108125793,SRX5075170,SMARCA4,186
chr1,108199237,108199527,SRX5075174,SMARCA4,290
chr1,108199284,108199583,SRX5075175,SMARCA4,299
chr1,108199308,108199585,SRX5075168,SMARCA4,277
chr1,108199820,108200681,SRX20140895,INTS13,861
chr1,108199953,108200179,SRX5716470,SMARCA4,226
chr1,108199997,108200229,SRX20140867,INTS10,232
chr1,108200136,108200728,SRX5075169,SMARCA4,592
chr1,108200183,108200570,SRX5075174,SMARCA4,387
chr1,108200210,108200661,SRX5075168,SMARCA4,451
chr1,108200229,108200705,SRX5075170,SMARCA4,476
chr1,108200242,108200827,SRX5075176,SMARCA4,585
chr1,108214571,108215150,SRX16500060,CTCF,579
chr1,108214596,108215126,SRX16500059,CTCF,530
chr1,108214640,108215151,SRX16500061,CTCF,511
chr1,108214672,108215078,SRX16500062,CTCF,406
chr1,108214717,108214987,SRX5075174,SMARCA4,270
chr1,108214734,108215026,SRX5075168,SMARCA4,292
chr1,108214757,108214992,SRX5716463,SMARCA4,235
chr1,108214775,108214990,SRX5075170,SMARCA4,215
chr1,108214776,108215010,SRX5075176,SMARCA4,234
chr1,108502994,108503441,SRX5716470,SMARCA4,447
chr1,108503078,108503486,SRX5075169,SMARCA4,408
chr1,108503079,108503404,SRX5075168,SMARCA4,325
chr1,108503090,108503475,SRX5075175,SMARCA4,385
chr1,108503092,108503357,SRX5020211,SMARCA2,265
chr1,108503102,108503343,SRX5716469,SMARCA4,241
chr1,108503103,108503576,SRX5716464,SMARCA4,473
chr1,108503109,108503311,SRX5075181,SMARCA2,202
chr1,108503111,108503449,SRX5075170,SMARCA4,338
chr1,108503115,108503393,SRX5075182,SMARCA2,278
chr1,108503119,108503512,SRX5075176,SMARCA4,393
chr1,108503159,108503393,SRX5716468,SMARCA2,234
chr1,108512393,108512903,SRX16500061,CTCF,510
chr1,108512425,108512936,SRX16500060,CTCF,511
chr1,108512432,108512974,SRX16500059,CTCF,542
chr1,108512462,108512936,SRX16500062,CTCF,474
chr1,108512598,108512786,SRX5075168,SMARCA4,188
chr1,108537919,108538394,SRX5075176,SMARCA4,475
chr1,108537948,108538324,SRX5075170,SMARCA4,376
chr1,108538085,108538265,SRX5075169,SMARCA4,180
chr1,108559701,108560163,SRX5075176,SMARCA4,462
chr1,108559719,108560136,SRX16500061,CTCF,417
chr1,108559736,108560162,SRX20140895,INTS13,426
chr1,108559737,108560144,SRX5075168,SMARCA4,407
chr1,108559740,108560161,SRX5716463,SMARCA4,421
chr1,108559746,108560160,SRX5075170,SMARCA4,414
chr1,108559759,108560161,SRX5075174,SMARCA4,402
chr1,108559775,108560045,SRX5716469,SMARCA4,270
chr1,108559792,108560144,SRX5716470,SMARCA4,352
chr1,108559813,108560169,SRX5075169,SMARCA4,356
chr1,108559819,108560189,SRX16500059,CTCF,370
chr1,108559823,108560163,SRX16500062,CTCF,340
chr1,108559835,108560184,SRX5075175,SMARCA4,349
chr1,108559837,108560020,SRX5054309,FOSL2,183
chr1,108559838,108560087,SRX5716464,SMARCA4,249
chr1,108559845,108560195,SRX16500060,CTCF,350
chr1,108561090,108561292,SRX5075176,SMARCA4,202
chr1,108561772,108562071,SRX16500060,CTCF,299
chr1,108561785,108562119,SRX16500061,CTCF,334
chr1,108561802,108562086,SRX16500059,CTCF,284
chr1,108575338,108575587,SRX5075169,SMARCA4,249
chr1,108575369,108575563,SRX5054309,FOSL2,194
chr1,108575392,108575714,SRX5075176,SMARCA4,322
chr1,108590931,108591384,SRX5716470,SMARCA4,453
chr1,108590937,108591355,SRX5075175,SMARCA4,418
chr1,108590950,108591329,SRX5075174,SMARCA4,379
chr1,108590954,108591361,SRX5075176,SMARCA4,407
chr1,108590959,108591338,SRX5075169,SMARCA4,379
chr1,108590967,108591323,SRX5075168,SMARCA4,356
chr1,108590968,108591249,SRX5054309,FOSL2,281
chr1,108590969,108591316,SRX5054308,FOSL2,347
chr1,108590980,108591378,SRX5075170,SMARCA4,398
chr1,108590988,108591305,SRX5716469,SMARCA4,317
chr1,108591007,108591329,SRX5716467,SMARCA2,322
chr1,108591033,108591237,SRX5716463,SMARCA4,204
chr1,108591036,108591308,SRX5020214,SMARCA2,272
chr1,108591038,108591257,SRX5716468,SMARCA2,219
chr1,108591078,108591283,SRX5716464,SMARCA4,205
chr1,108591134,108591345,SRX5075181,SMARCA2,211
chr1,108595618,108595787,SRX5075170,SMARCA4,169
chr1,108595643,108595826,SRX5075176,SMARCA4,183
chr1,108608172,108608359,SRX5075170,SMARCA4,187
chr1,108608189,108608364,SRX5075176,SMARCA4,175
chr1,108609594,108609903,SRX5075176,SMARCA4,309
chr1,108609751,108609925,SRX5075170,SMARCA4,174
chr1,108627294,108627654,SRX5075170,SMARCA4,360
chr1,108627338,108627712,SRX5075176,SMARCA4,374
chr1,108627364,108627640,SRX5075169,SMARCA4,276
chr1,108627372,108627587,SRX5716467,SMARCA2,215
chr1,108627394,108627629,SRX5075175,SMARCA4,235
chr1,108627414,108627656,SRX5716470,SMARCA4,242
chr1,108643475,108643924,SRX16500059,CTCF,449
chr1,108643520,108643938,SRX16500062,CTCF,418
chr1,108643539,108643919,SRX16500060,CTCF,380
chr1,108643545,108643920,SRX16500061,CTCF,375
chr1,108643608,108643777,SRX5075170,SMARCA4,169
chr1,108657750,108657950,SRX5054309,FOSL2,200
chr1,108661006,108661281,SRX5075176,SMARCA4,275
chr1,108661016,108661321,SRX20140881,CPSF3L,305
chr1,108661034,108661228,SRX5075169,SMARCA4,194
chr1,108661038,108661263,SRX5716470,SMARCA4,225
chr1,108661056,108661454,SRX20140867,INTS10,398
chr1,108661082,108661425,SRX20140869,INTS10,343
chr1,108691910,108692300,SRX5716470,SMARCA4,390
chr1,108691989,108692243,SRX5716469,SMARCA4,254
chr1,108691995,108692177,SRX5075176,SMARCA4,182
chr1,108691995,108692442,SRX5075174,SMARCA4,447
chr1,108691999,108692294,SRX5075168,SMARCA4,295
chr1,108692010,108692249,SRX5075175,SMARCA4,239
chr1,108692015,108692567,SRX20140869,INTS10,552
chr1,108692027,108692307,SRX5075170,SMARCA4,280
chr1,108692070,108692859,SRX20140895,INTS13,789
chr1,108692094,108692660,SRX20140881,CPSF3L,566
chr1,108692128,108692517,SRX20140867,INTS10,389
chr1,108692131,108692460,SRX20140897,INTS13,329
chr1,108692666,108693086,SRX16500060,CTCF,420
chr1,108692681,108692962,SRX16500062,CTCF,281
chr1,108692685,108693034,SRX16500059,CTCF,349
chr1,108692719,108693029,SRX16500061,CTCF,310
chr1,108704622,108704809,SRX5075175,SMARCA4,187
chr1,108708674,108709041,SRX5075170,SMARCA4,367
chr1,108708692,108709071,SRX5075176,SMARCA4,379
chr1,108708708,108709067,SRX5075169,SMARCA4,359
chr1,108708744,108709053,SRX5716467,SMARCA2,309
chr1,108708745,108709023,SRX5716470,SMARCA4,278
chr1,108708757,108709071,SRX5716469,SMARCA4,314
chr1,108708774,108709045,SRX5020211,SMARCA2,271
chr1,108708781,108709010,SRX5075175,SMARCA4,229
chr1,108708826,108709064,SRX5716468,SMARCA2,238
chr1,108715922,108716246,SRX5075174,SMARCA4,324
chr1,108715939,108716287,SRX5075168,SMARCA4,348
chr1,108718906,108719113,SRX5075176,SMARCA4,207
chr1,108718929,108719348,SRX5075170,SMARCA4,419
chr1,108719876,108720231,SRX5075169,SMARCA4,355
chr1,108719905,108720249,SRX5054309,FOSL2,344
chr1,108719942,108720248,SRX5075175,SMARCA4,306
chr1,108719944,108720203,SRX5054308,FOSL2,259
chr1,108719957,108720220,SRX5075176,SMARCA4,263
chr1,108719979,108720223,SRX5075170,SMARCA4,244
chr1,108746117,108746908,SRX16500060,CTCF,791
chr1,108746136,108746931,SRX16500059,CTCF,795
chr1,108746186,108746968,SRX20140881,CPSF3L,782
chr1,108746187,108746894,SRX16500061,CTCF,707
chr1,108746246,108746908,SRX20140879,CPSF3L,662
chr1,108746285,108746678,SRX4174629,CTCF,393
chr1,108746298,108746843,SRX16500062,CTCF,545
chr1,108746326,108746806,SRX5075168,SMARCA4,480
chr1,108746353,108746682,SRX5075169,SMARCA4,329
chr1,108746355,108746772,SRX5075174,SMARCA4,417
chr1,108746367,108746650,SRX5716463,SMARCA4,283
chr1,108746383,108746868,SRX5075170,SMARCA4,485
chr1,108746385,108746762,SRX5075176,SMARCA4,377
chr1,108746394,108746850,SRX5716464,SMARCA4,456
chr1,108746450,108747192,SRX20140895,INTS13,742
chr1,108746461,108746709,SRX5054307,FOSL2,248
chr1,108746471,108747257,SRX20140869,INTS10,786
chr1,108746501,108746975,SRX20140868,INTS10,474
chr1,108746508,108746975,SRX20140897,INTS13,467
chr1,108746514,108746990,SRX20140896,INTS13,476
chr1,108746520,108746970,SRX20140867,INTS10,450
chr1,108746552,108746869,SRX5716470,SMARCA4,317
chr1,108746637,108746894,SRX5075175,SMARCA4,257
chr1,108746640,108746901,SRX20140894,INTS13,261
chr1,108746646,108746858,SRX5716469,SMARCA4,212
chr1,108746944,108747135,SRX5075170,SMARCA4,191
chr1,108746961,108747303,SRX5716470,SMARCA4,342
chr1,108747037,108747225,SRX5075175,SMARCA4,188
chr1,108747269,108747659,SRX5075168,SMARCA4,390
chr1,108747289,108747573,SRX5075174,SMARCA4,284
chr1,108747333,108747581,SRX5075176,SMARCA4,248
chr1,108747343,108747598,SRX5075170,SMARCA4,255
chr1,108801129,108801446,SRX5054309,FOSL2,317
chr1,108801142,108801449,SRX5054308,FOSL2,307
chr1,108801157,108801402,SRX5075170,SMARCA4,245
chr1,108814698,108815146,SRX5075170,SMARCA4,448
chr1,108814733,108815197,SRX5075176,SMARCA4,464
chr1,108814784,108815061,SRX5075169,SMARCA4,277
chr1,108814797,108815137,SRX5716470,SMARCA4,340
chr1,108814802,108815115,SRX5075175,SMARCA4,313
chr1,108814806,108815140,SRX5716467,SMARCA2,334
chr1,108814828,108815056,SRX5075168,SMARCA4,228
chr1,108814838,108815082,SRX5716469,SMARCA4,244
chr1,108814874,108815111,SRX5716468,SMARCA2,237
chr1,108814907,108815110,SRX5075174,SMARCA4,203
chr1,108816143,108816804,SRX5075168,SMARCA4,661
chr1,108816156,108816828,SRX5075169,SMARCA4,672
chr1,108816202,108816953,SRX5075174,SMARCA4,751
chr1,108816213,108816753,SRX5716470,SMARCA4,540
chr1,108816238,108816935,SRX20140895,INTS13,697
chr1,108816274,108816712,SRX5716463,SMARCA4,438
chr1,108816274,108816875,SRX5075170,SMARCA4,601
chr1,108816296,108816735,SRX20140897,INTS13,439
chr1,108816313,108816853,SRX5075176,SMARCA4,540
chr1,108816322,108816705,SRX5716467,SMARCA2,383
chr1,108816322,108816706,SRX5054308,FOSL2,384
chr1,108816324,108816644,SRX20140867,INTS10,320
chr1,108816333,108816835,SRX5716469,SMARCA4,502
chr1,108816348,108816709,SRX5716451,SOX2,361
chr1,108816359,108816635,SRX5716464,SMARCA4,276
chr1,108816360,108816668,SRX5020211,SMARCA2,308
chr1,108816365,108816721,SRX5054309,FOSL2,356
chr1,108816369,108816766,SRX5075175,SMARCA4,397
chr1,108816386,108816744,SRX5716468,SMARCA2,358
chr1,108816387,108816628,SRX5075181,SMARCA2,241
chr1,108816388,108816705,SRX5054307,FOSL2,317
chr1,108816395,108816693,SRX5716454,SOX3,298
chr1,108817213,108817404,SRX5075176,SMARCA4,191
chr1,108827930,108828550,SRX16500059,CTCF,620
chr1,108827942,108828557,SRX16500062,CTCF,615
chr1,108827960,108828549,SRX16500061,CTCF,589
chr1,108828034,108828540,SRX16500060,CTCF,506
chr1,108828164,108828410,SRX5075168,SMARCA4,246
chr1,108828210,108828452,SRX4174629,CTCF,242
chr1,108828258,108828489,SRX5075174,SMARCA4,231
chr1,108828260,108828933,SRX5075170,SMARCA4,673
chr1,108828263,108828959,SRX5075176,SMARCA4,696
chr1,108828406,108828830,SRX5716469,SMARCA4,424
chr1,108828517,108828826,SRX5716470,SMARCA4,309
chr1,108828566,108828917,SRX5075169,SMARCA4,351
chr1,108828594,108828919,SRX5075175,SMARCA4,325
chr1,108828605,108828840,SRX5716467,SMARCA2,235
chr1,108830576,108830782,SRX5075169,SMARCA4,206
chr1,108830580,108830816,SRX5075175,SMARCA4,236
chr1,108831208,108831454,SRX5075170,SMARCA4,246
chr1,108831251,108831489,SRX5075176,SMARCA4,238
chr1,108852275,108852627,SRX5075176,SMARCA4,352
chr1,108852310,108852645,SRX5075170,SMARCA4,335
chr1,108852560,108852893,SRX5075174,SMARCA4,333
chr1,108852633,108852888,SRX5075168,SMARCA4,255
chr1,108852708,108852911,SRX5075170,SMARCA4,203
chr1,108876767,108877323,SRX5075174,SMARCA4,556
chr1,108876770,108877175,SRX5075168,SMARCA4,405
chr1,108876787,108877393,SRX20140895,INTS13,606
chr1,108876845,108877085,SRX5075176,SMARCA4,240
chr1,108876876,108877114,SRX5075175,SMARCA4,238
chr1,108876890,108877274,SRX5716463,SMARCA4,384
chr1,108876921,108877131,SRX16500062,CTCF,210
chr1,108876990,108877185,SRX5075169,SMARCA4,195
chr1,108877173,108877360,SRX5075176,SMARCA4,187
chr1,108881491,108881674,SRX5054308,FOSL2,183
chr1,108881493,108881698,SRX5075170,SMARCA4,205
chr1,108881493,108881731,SRX5054309,FOSL2,238
chr1,108889100,108889424,SRX5075170,SMARCA4,324
chr1,108889157,108889408,SRX5075176,SMARCA4,251
chr1,108897896,108898334,SRX4174629,CTCF,438
chr1,108898025,108898542,SRX16500059,CTCF,517
chr1,108898053,108898490,SRX16500062,CTCF,437
chr1,108898068,108898529,SRX16500060,CTCF,461
chr1,108898075,108898464,SRX5075168,SMARCA4,389
chr1,108898090,108898405,SRX5075170,SMARCA4,315
chr1,108898093,108898632,SRX16500061,CTCF,539
chr1,108898100,108898408,SRX5075174,SMARCA4,308
chr1,108898116,108898371,SRX5716464,SMARCA4,255
chr1,108898131,108898441,SRX5075176,SMARCA4,310
chr1,108898134,108898360,SRX5075169,SMARCA4,226
chr1,108898154,108898393,SRX5716463,SMARCA4,239
chr1,108898162,108898414,SRX5716470,SMARCA4,252
chr1,108898194,108898381,SRX5075175,SMARCA4,187
chr1,108913069,108913513,SRX5075170,SMARCA4,444
chr1,108913075,108913525,SRX5716470,SMARCA4,450
chr1,108913112,108913478,SRX5075169,SMARCA4,366
chr1,108913146,108913520,SRX5075176,SMARCA4,374
chr1,108948305,108948512,SRX5075169,SMARCA4,207
chr1,108963001,108963639,SRX20140895,INTS13,638
chr1,108963031,108963755,SRX5075168,SMARCA4,724
chr1,108963038,108963483,SRX5716470,SMARCA4,445
chr1,108963062,108963488,SRX5075175,SMARCA4,426
chr1,108963078,108963638,SRX5075169,SMARCA4,560
chr1,108963104,108963670,SRX5075176,SMARCA4,566
chr1,108963154,108963742,SRX5075174,SMARCA4,588
chr1,108963179,108963520,SRX20140897,INTS13,341
chr1,108963210,108963553,SRX20140867,INTS10,343
chr1,108963228,108963542,SRX20140868,INTS10,314
chr1,108963246,108963725,SRX5075170,SMARCA4,479
chr1,108963302,108963482,SRX5054308,FOSL2,180
chr1,108963407,108963694,SRX5716463,SMARCA4,287
chr1,109027929,109028150,SRX16500060,CTCF,221
chr1,109041521,109042269,SRX20140895,INTS13,748
chr1,109041688,109042198,SRX20140897,INTS13,510
chr1,109041747,109042217,SRX20140868,INTS10,470
chr1,109041758,109042140,SRX20140881,CPSF3L,382
chr1,109041811,109042262,SRX20140867,INTS10,451
chr1,109041863,109042187,SRX20140879,CPSF3L,324
chr1,109041868,109042252,SRX5075168,SMARCA4,384
chr1,109041934,109042226,SRX20140896,INTS13,292
chr1,109041978,109042254,SRX5075174,SMARCA4,276
chr1,109042027,109042202,SRX5075170,SMARCA4,175
chr1,109042048,109042246,SRX5075176,SMARCA4,198
chr1,109042074,109042283,SRX5054307,FOSL2,209
chr1,109075355,109075675,SRX5716469,SMARCA4,320
chr1,109075679,109076286,SRX5716470,SMARCA4,607
chr1,109075743,109076369,SRX5075174,SMARCA4,626
chr1,109075745,109076333,SRX5716463,SMARCA4,588
chr1,109075768,109076301,SRX5075169,SMARCA4,533
chr1,109075785,109076502,SRX20140869,INTS10,717
chr1,109075786,109076341,SRX20140897,INTS13,555
chr1,109075802,109076267,SRX5716464,SMARCA4,465
chr1,109075818,109076312,SRX5075170,SMARCA4,494
chr1,109075828,109076336,SRX5075176,SMARCA4,508
chr1,109075839,109076396,SRX5075168,SMARCA4,557
chr1,109075875,109076432,SRX20140867,INTS10,557
chr1,109075880,109076477,SRX20140895,INTS13,597
chr1,109075909,109076142,SRX16500062,CTCF,233
chr1,109075909,109076243,SRX20140881,CPSF3L,334
chr1,109075919,109076325,SRX20140868,INTS10,406
chr1,109075943,109076242,SRX20140882,CPSF3L,299
chr1,109075971,109076274,SRX5054309,FOSL2,303
chr1,109075983,109076218,SRX5716467,SMARCA2,235
chr1,109075990,109076288,SRX5716454,SOX3,298
chr1,109075991,109076343,SRX5716451,SOX2,352
chr1,109075995,109076189,SRX5054308,FOSL2,194
chr1,109076044,109076328,SRX20140879,CPSF3L,284
chr1,109076058,109076318,SRX5075175,SMARCA4,260
chr1,109083438,109084195,SRX20140895,INTS13,757
chr1,109083544,109083789,SRX5075174,SMARCA4,245
chr1,109083582,109084316,SRX5075168,SMARCA4,734
chr1,109083837,109084217,SRX20140868,INTS10,380
chr1,109083847,109084345,SRX5075174,SMARCA4,498
chr1,109083912,109084253,SRX5716454,SOX3,341
chr1,109083913,109084257,SRX5716451,SOX2,344
chr1,109083931,109084165,SRX5716463,SMARCA4,234
chr1,109084616,109084939,SRX5054309,FOSL2,323
chr1,109084641,109084825,SRX5054308,FOSL2,184
chr1,109089165,109089511,SRX16500061,CTCF,346
chr1,109089260,109089574,SRX16500059,CTCF,314
chr1,109089283,109089596,SRX16500060,CTCF,313
chr1,109089328,109089602,SRX16500062,CTCF,274
chr1,109090470,109090937,SRX5075174,SMARCA4,467
chr1,109090475,109090852,SRX5075175,SMARCA4,377
chr1,109090489,109090865,SRX5075170,SMARCA4,376
chr1,109090489,109090953,SRX20140897,INTS13,464
chr1,109090496,109090899,SRX5075168,SMARCA4,403
chr1,109090502,109090713,SRX5716463,SMARCA4,211
chr1,109090505,109090752,SRX5075176,SMARCA4,247
chr1,109090559,109090982,SRX20140895,INTS13,423
chr1,109090629,109090930,SRX20140867,INTS10,301
chr1,109090663,109090911,SRX20140879,CPSF3L,248
chr1,109090734,109091123,SRX5716470,SMARCA4,389
chr1,109099789,109100242,SRX16500062,CTCF,453
chr1,109099795,109100259,SRX16500060,CTCF,464
chr1,109099795,109100394,SRX16500059,CTCF,599
chr1,109099800,109100302,SRX16500061,CTCF,502
chr1,109099809,109100235,SRX4174629,CTCF,426
chr1,109099809,109100302,SRX5075174,SMARCA4,493
chr1,109099884,109100351,SRX5716470,SMARCA4,467
chr1,109099915,109100498,SRX5075168,SMARCA4,583
chr1,109099927,109100254,SRX5716464,SMARCA4,327
chr1,109099947,109100325,SRX5075170,SMARCA4,378
chr1,109099957,109100274,SRX5716463,SMARCA4,317
chr1,109099967,109100182,SRX5716467,SMARCA2,215
chr1,109099970,109100710,SRX20140895,INTS13,740
chr1,109099983,109100485,SRX20140869,INTS10,502
chr1,109099987,109100296,SRX5075169,SMARCA4,309
chr1,109099989,109100289,SRX5075176,SMARCA4,300
chr1,109100004,109100525,SRX20140879,CPSF3L,521
chr1,109100029,109100222,SRX5054308,FOSL2,193
chr1,109100036,109100624,SRX20140868,INTS10,588
chr1,109100040,109100578,SRX20140867,INTS10,538
chr1,109100055,109100587,SRX20140881,CPSF3L,532
chr1,109100060,109100523,SRX20140894,INTS13,463
chr1,109100079,109100573,SRX20140897,INTS13,494
chr1,109100128,109100616,SRX20140896,INTS13,488
chr1,109112516,109113030,SRX5075174,SMARCA4,514
chr1,109112535,109113036,SRX5075168,SMARCA4,501
chr1,109112541,109112961,SRX5716463,SMARCA4,420
chr1,109112567,109112912,SRX20140895,INTS13,345
chr1,109112578,109112928,SRX5075170,SMARCA4,350
chr1,109112581,109113076,SRX16500061,CTCF,495
chr1,109112598,109112948,SRX5716464,SMARCA4,350
chr1,109112610,109113095,SRX16500059,CTCF,485
chr1,109112616,109113111,SRX16500062,CTCF,495
chr1,109112621,109113112,SRX16500060,CTCF,491
chr1,109112624,109112972,SRX20140868,INTS10,348
chr1,109112642,109112959,SRX5716470,SMARCA4,317
chr1,109112648,109112994,SRX5075176,SMARCA4,346
chr1,109112649,109113031,SRX5075169,SMARCA4,382
chr1,109112650,109112929,SRX5716451,SOX2,279
chr1,109112671,109112883,SRX5716454,SOX3,212
chr1,109112673,109112888,SRX5716467,SMARCA2,215
chr1,109112687,109113000,SRX4174629,CTCF,313
chr1,109112705,109112926,SRX5716469,SMARCA4,221
chr1,109151213,109151393,SRX5075169,SMARCA4,180
chr1,109151215,109151516,SRX5075168,SMARCA4,301
chr1,109151232,109151449,SRX5075170,SMARCA4,217
chr1,109151252,109151531,SRX5075174,SMARCA4,279
chr1,109162045,109162373,SRX5075176,SMARCA4,328
chr1,109162081,109162265,SRX5075170,SMARCA4,184
chr1,109162134,109162552,SRX5075169,SMARCA4,418
chr1,109162148,109162468,SRX5716470,SMARCA4,320
chr1,109162190,109162551,SRX5075175,SMARCA4,361
chr1,109162364,109162570,SRX5075170,SMARCA4,206
chr1,109166926,109167163,SRX5075168,SMARCA4,237
chr1,109167051,109167260,SRX5075174,SMARCA4,209
chr1,109167120,109167383,SRX5716469,SMARCA4,263
chr1,109167124,109167501,SRX5075175,SMARCA4,377
chr1,109167131,109167586,SRX5075176,SMARCA4,455
chr1,109167147,109167533,SRX5054308,FOSL2,386
chr1,109167154,109167553,SRX5020211,SMARCA2,399
chr1,109167156,109167576,SRX5075169,SMARCA4,420
chr1,109167158,109167537,SRX5716470,SMARCA4,379
chr1,109167160,109167632,SRX5075170,SMARCA4,472
chr1,109167173,109167505,SRX5716467,SMARCA2,332
chr1,109181277,109181604,SRX5075176,SMARCA4,327
chr1,109181312,109181833,SRX5075170,SMARCA4,521
chr1,109181335,109181724,SRX5716469,SMARCA4,389
chr1,109193674,109193951,SRX16500061,CTCF,277
chr1,109193681,109193990,SRX16500060,CTCF,309
chr1,109193705,109193983,SRX16500059,CTCF,278
chr1,109197196,109197761,SRX5054309,FOSL2,565
chr1,109197203,109197522,SRX5020211,SMARCA2,319
chr1,109197211,109197797,SRX5075169,SMARCA4,586
chr1,109197215,109197722,SRX5716467,SMARCA2,507
chr1,109197235,109197735,SRX5020214,SMARCA2,500
chr1,109197238,109197703,SRX5054308,FOSL2,465
chr1,109197239,109197776,SRX5075174,SMARCA4,537
chr1,109197243,109197717,SRX5716469,SMARCA4,474
chr1,109197252,109197706,SRX5075176,SMARCA4,454
chr1,109197256,109197693,SRX5075175,SMARCA4,437
chr1,109197282,109197827,SRX5075168,SMARCA4,545
chr1,109197295,109197722,SRX5075170,SMARCA4,427
chr1,109197317,109197659,SRX5716470,SMARCA4,342
chr1,109197322,109197585,SRX5075182,SMARCA2,263
chr1,109197413,109197593,SRX5054307,FOSL2,180
chr1,109197418,109197636,SRX5716463,SMARCA4,218
chr1,109201064,109201460,SRX16500062,CTCF,396
chr1,109201087,109201451,SRX16500060,CTCF,364
chr1,109201088,109201500,SRX16500059,CTCF,412
chr1,109201115,109201470,SRX16500061,CTCF,355
chr1,109201179,109201497,SRX4174629,CTCF,318
chr1,109201241,109201475,SRX5075175,SMARCA4,234
chr1,109201244,109201413,SRX5075170,SMARCA4,169
chr1,109201285,109201464,SRX5075176,SMARCA4,179
chr1,109201287,109201469,SRX5075168,SMARCA4,182
chr1,109208861,109209399,SRX5075169,SMARCA4,538
chr1,109208863,109209431,SRX5075176,SMARCA4,568
chr1,109208873,109209264,SRX5716467,SMARCA2,391
chr1,109208902,109209285,SRX5716469,SMARCA4,383
chr1,109208936,109209264,SRX5716468,SMARCA2,328
chr1,109208943,109209254,SRX5020211,SMARCA2,311
chr1,109208971,109209429,SRX5075170,SMARCA4,458
chr1,109209006,109209430,SRX5716470,SMARCA4,424
chr1,109209020,109209371,SRX5054308,FOSL2,351
chr1,109209029,109209412,SRX5075175,SMARCA4,383
chr1,109209130,109209361,SRX5054309,FOSL2,231
chr1,109213639,109213979,SRX5075174,SMARCA4,340
chr1,109213661,109214047,SRX5075168,SMARCA4,386
chr1,109213725,109213971,SRX5716463,SMARCA4,246
chr1,109213748,109213996,SRX5716464,SMARCA4,248
chr1,109214044,109214423,SRX20140895,INTS13,379
chr1,109214704,109215003,SRX20140895,INTS13,299
chr1,109214908,109215146,SRX5075170,SMARCA4,238
chr1,109214918,109215093,SRX5075176,SMARCA4,175
chr1,109229611,109230280,SRX5075174,SMARCA4,669
chr1,109229686,109230306,SRX20140895,INTS13,620
chr1,109229693,109230149,SRX5716463,SMARCA4,456
chr1,109229737,109230302,SRX5075168,SMARCA4,565
chr1,109229767,109230155,SRX5716451,SOX2,388
chr1,109229773,109230166,SRX20140894,INTS13,393
chr1,109229774,109230235,SRX20140868,INTS10,461
chr1,109229777,109230169,SRX20140867,INTS10,392
chr1,109229803,109230112,SRX20140879,CPSF3L,309
chr1,109229808,109230143,SRX5716454,SOX3,335
chr1,109229835,109230077,SRX20140860,SOX2,242
chr1,109229861,109230141,SRX20140861,SOX2,280
chr1,109229928,109230138,SRX5716464,SMARCA4,210
chr1,109229951,109229996,SRX1424894,POU3F2,45
chr1,109239426,109239788,SRX16500060,CTCF,362
chr1,109239455,109239757,SRX16500062,CTCF,302
chr1,109239461,109239740,SRX16500059,CTCF,279
chr1,109239464,109239843,SRX16500061,CTCF,379
chr1,109249294,109249528,SRX5075168,SMARCA4,234
chr1,109249322,109249556,SRX5075174,SMARCA4,234
chr1,109249354,109249524,SRX5075170,SMARCA4,170
chr1,109249532,109249760,SRX20140867,INTS10,228
chr1,109253756,109254063,SRX20140895,INTS13,307
chr1,109253765,109254073,SRX5075168,SMARCA4,308
chr1,109253904,109254127,SRX5075174,SMARCA4,223
chr1,109253908,109254099,SRX5075169,SMARCA4,191
chr1,109253931,109254141,SRX5075170,SMARCA4,210
chr1,109253979,109254154,SRX5075176,SMARCA4,175
chr1,109255053,109255341,SRX5075168,SMARCA4,288
chr1,109255104,109255447,SRX20140867,INTS10,343
chr1,109255128,109255317,SRX5075174,SMARCA4,189
chr1,109255230,109255636,SRX20140868,INTS10,406
chr1,109263495,109264047,SRX16500062,CTCF,552
chr1,109263527,109264125,SRX16500060,CTCF,598
chr1,109263545,109264123,SRX16500059,CTCF,578
chr1,109263546,109264107,SRX16500061,CTCF,561
chr1,109263576,109264094,SRX4174629,CTCF,518
chr1,109263623,109263945,SRX5075174,SMARCA4,322
chr1,109263646,109263932,SRX5716470,SMARCA4,286
chr1,109263651,109263940,SRX20140895,INTS13,289
chr1,109263664,109263937,SRX5075170,SMARCA4,273
chr1,109263672,109263912,SRX5075169,SMARCA4,240
chr1,109263677,109263916,SRX5716463,SMARCA4,239
chr1,109263685,109263977,SRX5075168,SMARCA4,292
chr1,109263705,109263959,SRX5716469,SMARCA4,254
chr1,109263733,109263928,SRX5075176,SMARCA4,195
chr1,109275345,109275525,SRX5054308,FOSL2,180
chr1,109275350,109275550,SRX5054309,FOSL2,200
chr1,109275961,109276206,SRX5075175,SMARCA4,245
chr1,109276072,109276299,SRX5054309,FOSL2,227
chr1,109277329,109277867,SRX16500062,CTCF,538
chr1,109277365,109277869,SRX16500060,CTCF,504
chr1,109277375,109277908,SRX16500061,CTCF,533
chr1,109277399,109277901,SRX16500059,CTCF,502
chr1,109277437,109277751,SRX5075174,SMARCA4,314
chr1,109277439,109277742,SRX4174629,CTCF,303
chr1,109277516,109277749,SRX5075168,SMARCA4,233
chr1,109277565,109277760,SRX5075170,SMARCA4,195
chr1,109282966,109283585,SRX5075168,SMARCA4,619
chr1,109282989,109283169,SRX5075169,SMARCA4,180
chr1,109282989,109283562,SRX5075174,SMARCA4,573
chr1,109283030,109283401,SRX5716463,SMARCA4,371
chr1,109283036,109283591,SRX5075176,SMARCA4,555
chr1,109283085,109283605,SRX20140895,INTS13,520
chr1,109283134,109283601,SRX5716469,SMARCA4,467
chr1,109283163,109283643,SRX5075170,SMARCA4,480
chr1,109283193,109283438,SRX5716464,SMARCA4,245
chr1,109283193,109283670,SRX5716470,SMARCA4,477
chr1,109283238,109283595,SRX5075169,SMARCA4,357
chr1,109283254,109283522,SRX20140867,INTS10,268
chr1,109283287,109283558,SRX5075175,SMARCA4,271
chr1,109283298,109283602,SRX20140869,INTS10,304
chr1,109285077,109285312,SRX5075174,SMARCA4,235
chr1,109299018,109299374,SRX5075170,SMARCA4,356
chr1,109299029,109299472,SRX5716469,SMARCA4,443
chr1,109299050,109299561,SRX5716470,SMARCA4,511
chr1,109299060,109299438,SRX5075176,SMARCA4,378
chr1,109299066,109299510,SRX5075169,SMARCA4,444
chr1,109299081,109299429,SRX5075175,SMARCA4,348
chr1,109299100,109299358,SRX5020211,SMARCA2,258
chr1,109299221,109299478,SRX5054309,FOSL2,257
chr1,109299465,109299738,SRX5716467,SMARCA2,273
chr1,109299711,109300147,SRX5075170,SMARCA4,436
chr1,109299717,109300117,SRX5075176,SMARCA4,400
chr1,109299803,109300104,SRX5075169,SMARCA4,301
chr1,109299816,109300063,SRX5075175,SMARCA4,247
chr1,109370601,109370951,SRX5075175,SMARCA4,350
chr1,109370657,109370958,SRX5075170,SMARCA4,301
chr1,109370681,109371184,SRX5716470,SMARCA4,503
chr1,109370688,109371110,SRX5075169,SMARCA4,422
chr1,109370708,109370978,SRX5075176,SMARCA4,270
chr1,109370714,109370955,SRX5054309,FOSL2,241
chr1,109370723,109371033,SRX5716469,SMARCA4,310
chr1,109383101,109383367,SRX5075174,SMARCA4,266
chr1,109383168,109383461,SRX5075168,SMARCA4,293
chr1,109383175,109383427,SRX5716463,SMARCA4,252
chr1,109384063,109384236,SRX5075174,SMARCA4,173
chr1,109391225,109391521,SRX5075169,SMARCA4,296
chr1,109391254,109391517,SRX5054308,FOSL2,263
chr1,109391255,109391564,SRX5075170,SMARCA4,309
chr1,109391288,109391535,SRX5054309,FOSL2,247
chr1,109391314,109391507,SRX5075175,SMARCA4,193
chr1,109397778,109398323,SRX20140895,INTS13,545
chr1,109397940,109398109,SRX5075170,SMARCA4,169
chr1,109397967,109398190,SRX5054307,FOSL2,223
chr1,109397973,109398261,SRX5075174,SMARCA4,288
chr1,109399284,109399777,SRX16500059,CTCF,493
chr1,109399304,109399629,SRX5075176,SMARCA4,325
chr1,109399313,109399810,SRX16500061,CTCF,497
chr1,109399318,109399860,SRX16500060,CTCF,542
chr1,109399326,109399539,SRX5716454,SOX3,213
chr1,109399330,109399630,SRX5075174,SMARCA4,300
chr1,109399348,109399664,SRX5075168,SMARCA4,316
chr1,109399352,109399624,SRX5716451,SOX2,272
chr1,109399353,109399800,SRX16500062,CTCF,447
chr1,109399377,109399595,SRX5075170,SMARCA4,218
chr1,109399382,109399616,SRX5716463,SMARCA4,234
chr1,109412583,109412862,SRX5075170,SMARCA4,279
chr1,109412612,109413026,SRX5075176,SMARCA4,414
chr1,109426284,109427037,SRX20140895,INTS13,753
chr1,109426429,109426699,SRX5054307,FOSL2,270
chr1,109426451,109426923,SRX5075174,SMARCA4,472
chr1,109426467,109426836,SRX5075168,SMARCA4,369
chr1,109426694,109426952,SRX5075176,SMARCA4,258
chr1,109432361,109432709,SRX5075176,SMARCA4,348
chr1,109432392,109432713,SRX5075170,SMARCA4,321
chr1,109432413,109432621,SRX5054308,FOSL2,208
chr1,109432443,109432639,SRX5054309,FOSL2,196
chr1,109438667,109439220,SRX5075175,SMARCA4,553
chr1,109438778,109439282,SRX5075170,SMARCA4,504
chr1,109438783,109439261,SRX5075176,SMARCA4,478
chr1,109438830,109439214,SRX5075169,SMARCA4,384
chr1,109438830,109439237,SRX5054309,FOSL2,407
chr1,109438832,109439201,SRX5716469,SMARCA4,369
chr1,109438838,109439164,SRX5716467,SMARCA2,326
chr1,109438866,109439229,SRX5054308,FOSL2,363
chr1,109438898,109439169,SRX5716470,SMARCA4,271
chr1,109438904,109439215,SRX5020211,SMARCA2,311
chr1,109438912,109439121,SRX5020214,SMARCA2,209
chr1,109438975,109439148,SRX5075174,SMARCA4,173
chr1,109466288,109466740,SRX20140895,INTS13,452
chr1,109466328,109466667,SRX5075175,SMARCA4,339
chr1,109466333,109466852,SRX5075174,SMARCA4,519
chr1,109466337,109466654,SRX5075168,SMARCA4,317
chr1,109466507,109466698,SRX5075170,SMARCA4,191
chr1,109483422,109483634,SRX5075175,SMARCA4,212
chr1,109483455,109483713,SRX5075168,SMARCA4,258
chr1,109483470,109483680,SRX5075170,SMARCA4,210
chr1,109483763,109484330,SRX20140895,INTS13,567
chr1,109483791,109484248,SRX20140896,INTS13,457
chr1,109483804,109484269,SRX20140868,INTS10,465
chr1,109483805,109484302,SRX20140897,INTS13,497
chr1,109483811,109484112,SRX5075170,SMARCA4,301
chr1,109483814,109484328,SRX5075174,SMARCA4,514
chr1,109483826,109484338,SRX20140867,INTS10,512
chr1,109483845,109484293,SRX20140881,CPSF3L,448
chr1,109483858,109484166,SRX5075168,SMARCA4,308
chr1,109483883,109484174,SRX5716470,SMARCA4,291
chr1,109483896,109484292,SRX20140869,INTS10,396
chr1,109483901,109484231,SRX5075176,SMARCA4,330
chr1,109483934,109484192,SRX20140880,CPSF3L,258
chr1,109483939,109484195,SRX5075169,SMARCA4,256
chr1,109483990,109484301,SRX20140879,CPSF3L,311
chr1,109490620,109490960,SRX16500060,CTCF,340
chr1,109490623,109490928,SRX16500061,CTCF,305
chr1,109490646,109490857,SRX16500062,CTCF,211
chr1,109490669,109490966,SRX16500059,CTCF,297
chr1,109493751,109494207,SRX16500060,CTCF,456
chr1,109493791,109494184,SRX16500062,CTCF,393
chr1,109493793,109494230,SRX16500059,CTCF,437
chr1,109493820,109494205,SRX16500061,CTCF,385
chr1,109493827,109494231,SRX5075174,SMARCA4,404
chr1,109493844,109494249,SRX5075168,SMARCA4,405
chr1,109493849,109494154,SRX5716463,SMARCA4,305
chr1,109493850,109494234,SRX5075176,SMARCA4,384
chr1,109493867,109494203,SRX5075170,SMARCA4,336
chr1,109493896,109494215,SRX5075169,SMARCA4,319
chr1,109493929,109494155,SRX5716464,SMARCA4,226
chr1,109493934,109494263,SRX5716469,SMARCA4,329
chr1,109493938,109494163,SRX5716470,SMARCA4,225
chr1,109493983,109494308,SRX20140895,INTS13,325
chr1,109493995,109494253,SRX5075175,SMARCA4,258
chr1,109494034,109494313,SRX20140897,INTS13,279
chr1,109498278,109498694,SRX16500059,CTCF,416
chr1,109498289,109498677,SRX16500060,CTCF,388
chr1,109498327,109498658,SRX16500062,CTCF,331
chr1,109498348,109498649,SRX16500061,CTCF,301
chr1,109498490,109498659,SRX5075170,SMARCA4,169
chr1,109500989,109501201,SRX5716470,SMARCA4,212
chr1,109501018,109501247,SRX5075170,SMARCA4,229
chr1,109509416,109509942,SRX20140895,INTS13,526
chr1,109509537,109509927,SRX5075168,SMARCA4,390
chr1,109509550,109510026,SRX5075174,SMARCA4,476
chr1,109509594,109509907,SRX5075169,SMARCA4,313
chr1,109509601,109509859,SRX5075175,SMARCA4,258
chr1,109509625,109510028,SRX5075170,SMARCA4,403
chr1,109509708,109510021,SRX5075176,SMARCA4,313
chr1,109509739,109509970,SRX5716470,SMARCA4,231
chr1,109516891,109517174,SRX5075175,SMARCA4,283
chr1,109516894,109517290,SRX5075176,SMARCA4,396
chr1,109516912,109517333,SRX5075170,SMARCA4,421
chr1,109516935,109517254,SRX5075169,SMARCA4,319
chr1,109517044,109517349,SRX5716470,SMARCA4,305
chr1,109532226,109533185,SRX16500060,CTCF,959
chr1,109532234,109533160,SRX16500061,CTCF,926
chr1,109532239,109533219,SRX16500059,CTCF,980
chr1,109532243,109533124,SRX16500062,CTCF,881
chr1,109532291,109532610,SRX5075168,SMARCA4,319
chr1,109532315,109532665,SRX4174629,CTCF,350
chr1,109532326,109532632,SRX5075174,SMARCA4,306
chr1,109532334,109532532,SRX5075170,SMARCA4,198
chr1,109532440,109532672,SRX5716464,SMARCA4,232
chr1,109532718,109533102,SRX4174629,CTCF,384
chr1,109532782,109533072,SRX5075170,SMARCA4,290
chr1,109532802,109533054,SRX5716470,SMARCA4,252
chr1,109532876,109533081,SRX5075176,SMARCA4,205
chr1,109532940,109533135,SRX5075174,SMARCA4,195
chr1,109546038,109546707,SRX16500060,CTCF,669
chr1,109546116,109546695,SRX16500059,CTCF,579
chr1,109546117,109546679,SRX16500061,CTCF,562
chr1,109546158,109546654,SRX16500062,CTCF,496
chr1,109546279,109546647,SRX4174629,CTCF,368
chr1,109546304,109546708,SRX5075174,SMARCA4,404
chr1,109546324,109546603,SRX5075168,SMARCA4,279
chr1,109546329,109546639,SRX5075176,SMARCA4,310
chr1,109546363,109546574,SRX5716470,SMARCA4,211
chr1,109546396,109546600,SRX5716463,SMARCA4,204
chr1,109546409,109546615,SRX5075170,SMARCA4,206
chr1,109548276,109548889,SRX20140895,INTS13,613
chr1,109548309,109548520,SRX5075176,SMARCA4,211
chr1,109548342,109548629,SRX5075170,SMARCA4,287
chr1,109548354,109548823,SRX20140897,INTS13,469
chr1,109548431,109548851,SRX20140867,INTS10,420
chr1,109548451,109548630,SRX5075168,SMARCA4,179
chr1,109548471,109548761,SRX20140868,INTS10,290
chr1,109598661,109599001,SRX16500060,CTCF,340
chr1,109617304,109617711,SRX5075174,SMARCA4,407
chr1,109617317,109617767,SRX5075168,SMARCA4,450
chr1,109617319,109617658,SRX5054309,FOSL2,339
chr1,109617323,109617638,SRX5054308,FOSL2,315
chr1,109617340,109617585,SRX5054307,FOSL2,245
chr1,109617364,109617642,SRX5075176,SMARCA4,278
chr1,109617365,109617629,SRX5075169,SMARCA4,264
chr1,109617399,109617637,SRX5075170,SMARCA4,238
chr1,109617410,109617661,SRX5716451,SOX2,251
chr1,109617431,109617664,SRX5075175,SMARCA4,233
chr1,109617432,109617657,SRX5716469,SMARCA4,225
chr1,109619531,109620087,SRX20140895,INTS13,556
chr1,109619572,109619863,SRX20140868,INTS10,291
chr1,109619574,109619883,SRX5075174,SMARCA4,309
chr1,109619581,109619962,SRX20140897,INTS13,381
chr1,109619603,109619821,SRX5075168,SMARCA4,218
chr1,109619611,109619788,SRX5075170,SMARCA4,177
chr1,109619614,109619946,SRX20140867,INTS10,332
chr1,109620877,109621146,SRX5075170,SMARCA4,269
chr1,109620881,109621131,SRX5075168,SMARCA4,250
chr1,109620888,109621107,SRX5716463,SMARCA4,219
chr1,109620906,109621210,SRX5075174,SMARCA4,304
chr1,109620910,109621147,SRX5716464,SMARCA4,237
chr1,109620911,109621105,SRX5075176,SMARCA4,194
chr1,109630302,109630573,SRX16500060,CTCF,271
chr1,109630308,109630561,SRX16500059,CTCF,253
chr1,109630321,109630542,SRX16500061,CTCF,221
chr1,109630345,109630565,SRX16500062,CTCF,220
chr1,109632610,109632821,SRX5716470,SMARCA4,211
chr1,109632663,109632915,SRX5075170,SMARCA4,252
chr1,109632697,109633061,SRX5075176,SMARCA4,364
chr1,109636316,109636752,SRX5075170,SMARCA4,436
chr1,109636317,109636720,SRX5075176,SMARCA4,403
chr1,109636382,109636712,SRX5054309,FOSL2,330
chr1,109636410,109636725,SRX5075169,SMARCA4,315
chr1,109636422,109636720,SRX5054308,FOSL2,298
chr1,109636423,109636635,SRX5716469,SMARCA4,212
chr1,109636469,109636713,SRX5075175,SMARCA4,244
chr1,109640146,109640643,SRX16500061,CTCF,497
chr1,109640171,109640617,SRX16500060,CTCF,446
chr1,109640189,109640699,SRX16500059,CTCF,510
chr1,109640218,109640722,SRX16500062,CTCF,504
chr1,109640281,109640513,SRX5075168,SMARCA4,232
chr1,109640303,109640543,SRX5075174,SMARCA4,240
chr1,109643261,109643748,SRX16500059,CTCF,487
chr1,109643293,109643715,SRX16500062,CTCF,422
chr1,109643317,109643723,SRX16500060,CTCF,406
chr1,109643320,109643620,SRX4174629,CTCF,300
chr1,109643333,109643689,SRX16500061,CTCF,356
chr1,109643350,109643617,SRX5075174,SMARCA4,267
chr1,109643388,109643642,SRX5075168,SMARCA4,254
chr1,109643475,109643697,SRX5075169,SMARCA4,222
chr1,109649576,109649848,SRX5075170,SMARCA4,272
chr1,109650599,109650945,SRX5054309,FOSL2,346
chr1,109650654,109650891,SRX5075175,SMARCA4,237
chr1,109650657,109650973,SRX5075169,SMARCA4,316
chr1,109650705,109650929,SRX5075176,SMARCA4,224
chr1,109650749,109650929,SRX5054308,FOSL2,180
chr1,109655783,109656093,SRX5075174,SMARCA4,310
chr1,109655856,109656204,SRX5716469,SMARCA4,348
chr1,109655863,109656203,SRX5075170,SMARCA4,340
chr1,109655874,109656304,SRX5075168,SMARCA4,430
chr1,109655880,109656228,SRX5075175,SMARCA4,348
chr1,109655917,109656273,SRX5075176,SMARCA4,356
chr1,109655947,109656298,SRX5716470,SMARCA4,351
chr1,109664083,109664266,SRX5054309,FOSL2,183
chr1,109667756,109668211,SRX5075168,SMARCA4,455
chr1,109667757,109667986,SRX5075175,SMARCA4,229
chr1,109667763,109668159,SRX5716463,SMARCA4,396
chr1,109667768,109668218,SRX5075170,SMARCA4,450
chr1,109667787,109668171,SRX5075176,SMARCA4,384
chr1,109667814,109668116,SRX5716470,SMARCA4,302
chr1,109667826,109668149,SRX5075174,SMARCA4,323
chr1,109667831,109668238,SRX5075169,SMARCA4,407
chr1,109667835,109668216,SRX20140895,INTS13,381
chr1,109667869,109668164,SRX5716464,SMARCA4,295
chr1,109719370,109719644,SRX5075176,SMARCA4,274
chr1,109719494,109719669,SRX5075170,SMARCA4,175
chr1,109730593,109730976,SRX5075168,SMARCA4,383
chr1,109730651,109730959,SRX5075174,SMARCA4,308
chr1,109739792,109740639,SRX5075176,SMARCA4,847
chr1,109739804,109740259,SRX5075169,SMARCA4,455
chr1,109739821,109740533,SRX5075174,SMARCA4,712
chr1,109739835,109740306,SRX5716469,SMARCA4,471
chr1,109739891,109740643,SRX20140895,INTS13,752
chr1,109739921,109740362,SRX5716470,SMARCA4,441
chr1,109740047,109740452,SRX20140881,CPSF3L,405
chr1,109740096,109740498,SRX20140879,CPSF3L,402
chr1,109740104,109740437,SRX20140897,INTS13,333
chr1,109740132,109740445,SRX20140868,INTS10,313
chr1,109740140,109740614,SRX5075168,SMARCA4,474
chr1,109740149,109740586,SRX20140867,INTS10,437
chr1,109740160,109740568,SRX5075175,SMARCA4,408
chr1,109740253,109740552,SRX5716463,SMARCA4,299
chr1,109740316,109740647,SRX5075170,SMARCA4,331
chr1,109763007,109763293,SRX5075170,SMARCA4,286
chr1,109763046,109763226,SRX5054308,FOSL2,180
chr1,109763055,109763270,SRX5054309,FOSL2,215
chr1,109763073,109763278,SRX5075176,SMARCA4,205
chr1,109769353,109769639,SRX5075170,SMARCA4,286
chr1,109769370,109769647,SRX5054309,FOSL2,277
chr1,109769407,109769631,SRX5075169,SMARCA4,224
chr1,109769408,109769609,SRX5054308,FOSL2,201
chr1,109769448,109769625,SRX5075176,SMARCA4,177
chr1,109773619,109774036,SRX16500059,CTCF,417
chr1,109773677,109774011,SRX16500061,CTCF,334
chr1,109773691,109774007,SRX4174629,CTCF,316
chr1,109773693,109774028,SRX16500060,CTCF,335
chr1,109773696,109774051,SRX16500062,CTCF,355
chr1,109773705,109773932,SRX5075174,SMARCA4,227
chr1,109773715,109773937,SRX5075168,SMARCA4,222
chr1,109773748,109773923,SRX5075176,SMARCA4,175
chr1,109776773,109777305,SRX16500059,CTCF,532
chr1,109776796,109777259,SRX16500061,CTCF,463
chr1,109776811,109777240,SRX16500060,CTCF,429
chr1,109776820,109777241,SRX16500062,CTCF,421
chr1,109776920,109777134,SRX5075168,SMARCA4,214
chr1,109776938,109777231,SRX5075174,SMARCA4,293
chr1,109776957,109777254,SRX4174629,CTCF,297
chr1,109776981,109777177,SRX5075170,SMARCA4,196
chr1,109777020,109777198,SRX5075176,SMARCA4,178
chr1,109782469,109782706,SRX5716467,SMARCA2,237
chr1,109782504,109782754,SRX5716470,SMARCA4,250
chr1,109782506,109782807,SRX5075170,SMARCA4,301
chr1,109782509,109782699,SRX5075176,SMARCA4,190
chr1,109782550,109782758,SRX5075169,SMARCA4,208
chr1,109783477,109783657,SRX5075169,SMARCA4,180
chr1,109789029,109789363,SRX16500060,CTCF,334
chr1,109789038,109789385,SRX16500059,CTCF,347
chr1,109789126,109789417,SRX16500061,CTCF,291
chr1,109792123,109792445,SRX5075174,SMARCA4,322
chr1,109792130,109792543,SRX5075176,SMARCA4,413
chr1,109792142,109792497,SRX5075170,SMARCA4,355
chr1,109792160,109792540,SRX5075169,SMARCA4,380
chr1,109792166,109792479,SRX5075175,SMARCA4,313
chr1,109792176,109792497,SRX5716469,SMARCA4,321
chr1,109792181,109792544,SRX5075168,SMARCA4,363
chr1,109792186,109792506,SRX5716470,SMARCA4,320
chr1,109792222,109792460,SRX5054308,FOSL2,238
chr1,109792245,109792473,SRX5716467,SMARCA2,228
chr1,109792247,109792516,SRX5054309,FOSL2,269
chr1,109793826,109794189,SRX5075170,SMARCA4,363
chr1,109793858,109794173,SRX5075176,SMARCA4,315
chr1,109793892,109794088,SRX5075169,SMARCA4,196
chr1,109793895,109794137,SRX5075175,SMARCA4,242
chr1,109793910,109794197,SRX5716469,SMARCA4,287
chr1,109793988,109794192,SRX5054308,FOSL2,204
chr1,109816106,109816428,SRX20140867,INTS10,322
chr1,109816295,109816563,SRX5075168,SMARCA4,268
chr1,109816316,109816597,SRX5075174,SMARCA4,281
chr1,109816388,109816658,SRX5716470,SMARCA4,270
chr1,109816431,109816604,SRX5075170,SMARCA4,173
chr1,109816467,109816661,SRX5075176,SMARCA4,194
chr1,109821329,109821572,SRX5075169,SMARCA4,243
chr1,109821346,109821577,SRX5075175,SMARCA4,231
chr1,109821371,109821546,SRX5075176,SMARCA4,175
chr1,109838834,109839045,SRX5054309,FOSL2,211
chr1,109852350,109852715,SRX5075176,SMARCA4,365
chr1,109852418,109852608,SRX5054309,FOSL2,190
chr1,109852420,109852650,SRX5075170,SMARCA4,230
chr1,109852492,109852693,SRX5075175,SMARCA4,201
chr1,109857334,109857605,SRX5075170,SMARCA4,271
chr1,109863699,109863933,SRX5716468,SMARCA2,234
chr1,109863707,109863924,SRX5716467,SMARCA2,217
chr1,109863721,109864144,SRX5716469,SMARCA4,423
chr1,109863722,109864111,SRX5075175,SMARCA4,389
chr1,109863733,109863980,SRX5075169,SMARCA4,247
chr1,109863736,109863916,SRX5054308,FOSL2,180
chr1,109863742,109863943,SRX5054309,FOSL2,201
chr1,109863743,109864373,SRX5075170,SMARCA4,630
chr1,109863756,109864135,SRX5716470,SMARCA4,379
chr1,109863762,109863988,SRX5075176,SMARCA4,226
chr1,109864124,109864630,SRX5075176,SMARCA4,506
chr1,109864191,109864568,SRX5020211,SMARCA2,377
chr1,109864235,109864556,SRX5716469,SMARCA4,321
chr1,109864349,109864642,SRX5716470,SMARCA4,293
chr1,109864460,109864688,SRX5075169,SMARCA4,228
chr1,109872236,109872560,SRX5075169,SMARCA4,324
chr1,109872246,109872586,SRX5075170,SMARCA4,340
chr1,109872261,109872555,SRX5054309,FOSL2,294
chr1,109872271,109872578,SRX5075176,SMARCA4,307
chr1,109872273,109872531,SRX5075175,SMARCA4,258
chr1,109872299,109872573,SRX5054308,FOSL2,274
chr1,109877162,109877730,SRX5075175,SMARCA4,568
chr1,109877199,109877635,SRX5716469,SMARCA4,436
chr1,109877215,109877757,SRX5716470,SMARCA4,542
chr1,109877223,109877701,SRX5075176,SMARCA4,478
chr1,109877241,109877746,SRX5075170,SMARCA4,505
chr1,109877243,109877726,SRX5075169,SMARCA4,483
chr1,109877258,109877712,SRX5075168,SMARCA4,454
chr1,109877279,109877672,SRX5716468,SMARCA2,393
chr1,109877284,109877626,SRX5020214,SMARCA2,342
chr1,109877327,109877716,SRX5716467,SMARCA2,389
chr1,109877329,109877644,SRX5075181,SMARCA2,315
chr1,109877349,109877657,SRX5020211,SMARCA2,308
chr1,109877353,109877700,SRX5075174,SMARCA4,347
chr1,109877367,109877548,SRX5075182,SMARCA2,181
chr1,109877370,109877626,SRX5054308,FOSL2,256
chr1,109877378,109877676,SRX16500061,CTCF,298
chr1,109877389,109877631,SRX5054309,FOSL2,242
chr1,109877440,109877669,SRX5716464,SMARCA4,229
chr1,109895819,109896237,SRX5075168,SMARCA4,418
chr1,109895822,109896107,SRX5075170,SMARCA4,285
chr1,109895834,109896230,SRX5075174,SMARCA4,396
chr1,109895854,109896132,SRX5075169,SMARCA4,278
chr1,109895865,109896119,SRX5054309,FOSL2,254
chr1,109895873,109896135,SRX5054308,FOSL2,262
chr1,109895879,109896176,SRX5075176,SMARCA4,297
chr1,109895889,109896167,SRX5075175,SMARCA4,278
chr1,109910402,109910634,SRX5716469,SMARCA4,232
chr1,109910414,109910973,SRX5075169,SMARCA4,559
chr1,109910490,109910682,SRX5075168,SMARCA4,192
chr1,109910499,109911342,SRX20140895,INTS13,843
chr1,109910500,109910909,SRX5716470,SMARCA4,409
chr1,109910501,109910939,SRX5075174,SMARCA4,438
chr1,109910538,109910937,SRX5075176,SMARCA4,399
chr1,109910561,109910807,SRX5054309,FOSL2,246
chr1,109910564,109910761,SRX5075175,SMARCA4,197
chr1,109910584,109910922,SRX5075170,SMARCA4,338
chr1,109910612,109911010,SRX20140897,INTS13,398
chr1,109910695,109910952,SRX5716469,SMARCA4,257
chr1,109910708,109910922,SRX20140867,INTS10,214
chr1,109923403,109923762,SRX16500060,CTCF,359
chr1,109923450,109923740,SRX16500062,CTCF,290
chr1,109923452,109923782,SRX16500061,CTCF,330
chr1,109923475,109923739,SRX16500059,CTCF,264
chr1,109931034,109931529,SRX5075168,SMARCA4,495
chr1,109931053,109931480,SRX5716469,SMARCA4,427
chr1,109931055,109931514,SRX5075176,SMARCA4,459
chr1,109931057,109931512,SRX5075174,SMARCA4,455
chr1,109931070,109931449,SRX5716464,SMARCA4,379
chr1,109931075,109931491,SRX5716470,SMARCA4,416
chr1,109931079,109931482,SRX5075170,SMARCA4,403
chr1,109931079,109931492,SRX5075169,SMARCA4,413
chr1,109931088,109931477,SRX5075175,SMARCA4,389
chr1,109931096,109931449,SRX5716468,SMARCA2,353
chr1,109931099,109931443,SRX5075181,SMARCA2,344
chr1,109931101,109931506,SRX5716463,SMARCA4,405
chr1,109931103,109931395,SRX5020214,SMARCA2,292
chr1,109931109,109931419,SRX5075182,SMARCA2,310
chr1,109931111,109931450,SRX5020211,SMARCA2,339
chr1,109931136,109931460,SRX5716467,SMARCA2,324
chr1,109931248,109931514,SRX20140881,CPSF3L,266
chr1,109931274,109931500,SRX20140867,INTS10,226
chr1,109934346,109934529,SRX5054309,FOSL2,183
chr1,109951072,109951292,SRX5020211,SMARCA2,220
chr1,109951088,109951308,SRX5075181,SMARCA2,220
chr1,109953796,109954130,SRX5054309,FOSL2,334
chr1,109953864,109954123,SRX5075169,SMARCA4,259
chr1,109959717,109960328,SRX5716463,SMARCA4,611
chr1,109959807,109960384,SRX5075174,SMARCA4,577
chr1,109959890,109960321,SRX5075168,SMARCA4,431
chr1,109959930,109960227,SRX5716464,SMARCA4,297
chr1,109959932,109960203,SRX5716470,SMARCA4,271
chr1,109959954,109960256,SRX5075176,SMARCA4,302
chr1,109959962,109960312,SRX5075169,SMARCA4,350
chr1,109959965,109960229,SRX5075175,SMARCA4,264
chr1,109959972,109960247,SRX5716469,SMARCA4,275
chr1,109960058,109960268,SRX5716454,SOX3,210
chr1,109960078,109960305,SRX5075170,SMARCA4,227
chr1,109962898,109963081,SRX5054309,FOSL2,183
chr1,109962925,109963100,SRX5075170,SMARCA4,175
chr1,109969281,109969648,SRX5075175,SMARCA4,367
chr1,109969293,109969761,SRX5075176,SMARCA4,468
chr1,109969313,109969800,SRX5075169,SMARCA4,487
chr1,109969316,109969740,SRX5075170,SMARCA4,424
chr1,109969318,109969711,SRX5054309,FOSL2,393
chr1,109969321,109969602,SRX5054308,FOSL2,281
chr1,109969354,109969613,SRX5716470,SMARCA4,259
chr1,109969381,109969691,SRX5020214,SMARCA2,310
chr1,109969397,109969616,SRX5020211,SMARCA2,219
chr1,109975744,109975977,SRX5716467,SMARCA2,233
chr1,109975766,109976001,SRX5716470,SMARCA4,235
chr1,109975780,109976086,SRX5075169,SMARCA4,306
chr1,109975799,109976090,SRX5075175,SMARCA4,291
chr1,109975861,109976045,SRX5054309,FOSL2,184
chr1,109984224,109984864,SRX16500061,CTCF,640
chr1,109984285,109985050,SRX5075170,SMARCA4,765
chr1,109984290,109984886,SRX5075176,SMARCA4,596
chr1,109984293,109984873,SRX16500060,CTCF,580
chr1,109984299,109984955,SRX16500062,CTCF,656
chr1,109984313,109984916,SRX16500059,CTCF,603
chr1,109984344,109984923,SRX5075174,SMARCA4,579
chr1,109984349,109984798,SRX4174629,CTCF,449
chr1,109984400,109984604,SRX5075175,SMARCA4,204
chr1,109984405,109984750,SRX5716464,SMARCA4,345
chr1,109984431,109985020,SRX5075168,SMARCA4,589
chr1,109984446,109984938,SRX5075169,SMARCA4,492
chr1,109984469,109985276,SRX20140895,INTS13,807
chr1,109984482,109984812,SRX5716463,SMARCA4,330
chr1,109984569,109985125,SRX20140868,INTS10,556
chr1,109984587,109985087,SRX20140897,INTS13,500
chr1,109984603,109985021,SRX20140879,CPSF3L,418
chr1,109984613,109985121,SRX20140867,INTS10,508
chr1,109984618,109984818,SRX5054309,FOSL2,200
chr1,109984650,109984995,SRX5716470,SMARCA4,345
chr1,109984677,109985043,SRX20140896,INTS13,366
chr1,109984710,109985098,SRX20140881,CPSF3L,388
chr1,109984727,109985006,SRX5716469,SMARCA4,279
chr1,109984728,109984999,SRX20140869,INTS10,271
chr1,110003797,110004518,SRX5075169,SMARCA4,721
chr1,110003801,110004456,SRX5075170,SMARCA4,655
chr1,110003810,110004417,SRX5054309,FOSL2,607
chr1,110003810,110004495,SRX5075176,SMARCA4,685
chr1,110003829,110004416,SRX5054308,FOSL2,587
chr1,110003879,110004410,SRX5075175,SMARCA4,531
chr1,110003893,110004416,SRX5716467,SMARCA2,523
chr1,110003896,110004081,SRX5075174,SMARCA4,185
chr1,110003904,110004381,SRX5020214,SMARCA2,477
chr1,110003932,110004393,SRX5716470,SMARCA4,461
chr1,110003963,110004337,SRX5716468,SMARCA2,374
chr1,110004029,110004455,SRX5716469,SMARCA4,426
chr1,110004115,110004350,SRX5075168,SMARCA4,235
chr1,110004140,110004430,SRX5020211,SMARCA2,290
chr1,110011586,110011929,SRX5075169,SMARCA4,343
chr1,110011622,110011959,SRX16500061,CTCF,337
chr1,110011629,110011944,SRX16500062,CTCF,315
chr1,110011635,110012000,SRX16500059,CTCF,365
chr1,110011645,110011814,SRX5075170,SMARCA4,169
chr1,110011653,110011965,SRX16500060,CTCF,312
chr1,110011666,110011880,SRX5075176,SMARCA4,214
chr1,110011672,110011882,SRX4174629,CTCF,210
chr1,110029463,110029994,SRX4174629,CTCF,531
chr1,110029534,110030098,SRX16500060,CTCF,564
chr1,110029546,110030034,SRX16500059,CTCF,488
chr1,110029555,110030109,SRX16500062,CTCF,554
chr1,110029561,110029892,SRX5716463,SMARCA4,331
chr1,110029569,110030006,SRX16500061,CTCF,437
chr1,110029621,110029924,SRX5716464,SMARCA4,303
chr1,110029630,110029947,SRX5075174,SMARCA4,317
chr1,110029639,110029911,SRX5075176,SMARCA4,272
chr1,110029647,110029923,SRX5075170,SMARCA4,276
chr1,110029650,110029975,SRX5075168,SMARCA4,325
chr1,110029688,110029906,SRX5716470,SMARCA4,218
chr1,110029690,110029906,SRX5075169,SMARCA4,216
chr1,110034261,110034543,SRX5075170,SMARCA4,282
chr1,110034297,110034532,SRX5075176,SMARCA4,235
chr1,110034322,110034639,SRX5075174,SMARCA4,317
chr1,110034332,110034583,SRX5075168,SMARCA4,251
chr1,110034395,110035223,SRX20140895,INTS13,828
chr1,110034449,110034821,SRX20140867,INTS10,372
chr1,110034466,110034845,SRX20140896,INTS13,379
chr1,110034494,110034739,SRX20140879,CPSF3L,245
chr1,110034554,110034832,SRX20140869,INTS10,278
chr1,110034564,110035084,SRX20140897,INTS13,520
chr1,110034600,110035014,SRX20140868,INTS10,414
chr1,110053770,110054285,SRX16500059,CTCF,515
chr1,110053774,110054230,SRX16500060,CTCF,456
chr1,110053786,110054224,SRX16500061,CTCF,438
chr1,110053807,110054245,SRX16500062,CTCF,438
chr1,110053822,110054166,SRX4174629,CTCF,344
chr1,110053974,110054143,SRX5075170,SMARCA4,169
chr1,110053988,110054210,SRX5716463,SMARCA4,222
chr1,110055577,110055865,SRX5054309,FOSL2,288
chr1,110059997,110060484,SRX16500061,CTCF,487
chr1,110060041,110060417,SRX16500062,CTCF,376
chr1,110060079,110060469,SRX16500059,CTCF,390
chr1,110060079,110060469,SRX16500060,CTCF,390
chr1,110084630,110084885,SRX5075175,SMARCA4,255
chr1,110084710,110084928,SRX5716470,SMARCA4,218
chr1,110088026,110088511,SRX16500060,CTCF,485
chr1,110088044,110088511,SRX16500062,CTCF,467
chr1,110088046,110088430,SRX16500061,CTCF,384
chr1,110088084,110088537,SRX16500059,CTCF,453
chr1,110088170,110088344,SRX5075174,SMARCA4,174
chr1,110106019,110106545,SRX16500060,CTCF,526
chr1,110106032,110106503,SRX16500061,CTCF,471
chr1,110106050,110106580,SRX16500059,CTCF,530
chr1,110106097,110106549,SRX16500062,CTCF,452
chr1,110106138,110106398,SRX5075174,SMARCA4,260
chr1,110106142,110106435,SRX4174629,CTCF,293
chr1,110106162,110106398,SRX5075168,SMARCA4,236
chr1,110106183,110106394,SRX5075176,SMARCA4,211
chr1,110116385,110116815,SRX16500061,CTCF,430
chr1,110116405,110116847,SRX16500059,CTCF,442
chr1,110116423,110116823,SRX16500062,CTCF,400
chr1,110116446,110116815,SRX16500060,CTCF,369
chr1,110136842,110137310,SRX20140895,INTS13,468
chr1,110136896,110137329,SRX5075174,SMARCA4,433
chr1,110136901,110137198,SRX5075168,SMARCA4,297
chr1,110136946,110137203,SRX5716463,SMARCA4,257
chr1,110149024,110149323,SRX16500062,CTCF,299
chr1,110155892,110156276,SRX5716470,SMARCA4,384
chr1,110155904,110156263,SRX5075170,SMARCA4,359
chr1,110155907,110156276,SRX5716469,SMARCA4,369
chr1,110155914,110156243,SRX5075168,SMARCA4,329
chr1,110155930,110156258,SRX5075176,SMARCA4,328
chr1,110155934,110156232,SRX5075175,SMARCA4,298
chr1,110155936,110156259,SRX5075169,SMARCA4,323
chr1,110155955,110156249,SRX5075174,SMARCA4,294
chr1,110155960,110156191,SRX5075181,SMARCA2,231
chr1,110155987,110156213,SRX5716464,SMARCA4,226
chr1,110155990,110156208,SRX5716468,SMARCA2,218
chr1,110187524,110187841,SRX5075170,SMARCA4,317
chr1,110187528,110187868,SRX5716470,SMARCA4,340
chr1,110187529,110187887,SRX5075169,SMARCA4,358
chr1,110187542,110187820,SRX5075175,SMARCA4,278
chr1,110187542,110187896,SRX5075176,SMARCA4,354
chr1,110187557,110187826,SRX5716469,SMARCA4,269
chr1,110187610,110187827,SRX5716467,SMARCA2,217
chr1,110196821,110197338,SRX16500060,CTCF,517
chr1,110196825,110197425,SRX16500059,CTCF,600
chr1,110196828,110197356,SRX16500061,CTCF,528
chr1,110196886,110197284,SRX16500062,CTCF,398
chr1,110196920,110197242,SRX5075174,SMARCA4,322
chr1,110196968,110197223,SRX5075168,SMARCA4,255
chr1,110196993,110197267,SRX4174629,CTCF,274
chr1,110202900,110203407,SRX16500059,CTCF,507
chr1,110202934,110203406,SRX16500060,CTCF,472
chr1,110202962,110203364,SRX16500061,CTCF,402
chr1,110202998,110203369,SRX16500062,CTCF,371
chr1,110203038,110203316,SRX5075174,SMARCA4,278
chr1,110203041,110203237,SRX5075168,SMARCA4,196
chr1,110203119,110203288,SRX5075170,SMARCA4,169
chr1,110207714,110208187,SRX16500059,CTCF,473
chr1,110207742,110208170,SRX16500060,CTCF,428
chr1,110207750,110208153,SRX16500061,CTCF,403
chr1,110207753,110208146,SRX16500062,CTCF,393
chr1,110207795,110208118,SRX4174629,CTCF,323
chr1,110210140,110210420,SRX5075168,SMARCA4,280
chr1,110210268,110210594,SRX20140895,INTS13,326
chr1,110236033,110236250,SRX5054309,FOSL2,217
chr1,110239664,110239835,SRX5075170,SMARCA4,171
chr1,110255418,110255844,SRX5075168,SMARCA4,426
chr1,110255431,110255814,SRX5075174,SMARCA4,383
chr1,110312512,110313060,SRX16500060,CTCF,548
chr1,110312530,110313041,SRX16500059,CTCF,511
chr1,110312534,110313111,SRX16500061,CTCF,577
chr1,110312562,110313004,SRX16500062,CTCF,442
chr1,110312603,110312951,SRX4174629,CTCF,348
chr1,110312618,110312855,SRX5075174,SMARCA4,237
chr1,110312631,110312885,SRX5075168,SMARCA4,254
chr1,110312670,110312889,SRX5075170,SMARCA4,219
chr1,110338139,110339674,SRX20140895,INTS13,1535
chr1,110338215,110338746,SRX20140867,INTS10,531
chr1,110338231,110338739,SRX20140868,INTS10,508
chr1,110338243,110338802,SRX16500061,CTCF,559
chr1,110338249,110338814,SRX16500060,CTCF,565
chr1,110338251,110338466,SRX5075168,SMARCA4,215
chr1,110338263,110338771,SRX20140879,CPSF3L,508
chr1,110338269,110338517,SRX5716470,SMARCA4,248
chr1,110338284,110338777,SRX5075170,SMARCA4,493
chr1,110338305,110338809,SRX16500059,CTCF,504
chr1,110338310,110338695,SRX20140897,INTS13,385
chr1,110338317,110338774,SRX16500062,CTCF,457
chr1,110338326,110338725,SRX20140881,CPSF3L,399
chr1,110338345,110338541,SRX5075176,SMARCA4,196
chr1,110338346,110338639,SRX5075174,SMARCA4,293
chr1,110338521,110338835,SRX5075168,SMARCA4,314
chr1,110338648,110338831,SRX5054309,FOSL2,183
chr1,110338744,110339130,SRX5716451,SOX2,386
chr1,110338850,110339475,SRX5054307,FOSL2,625
chr1,110338853,110339071,SRX5716454,SOX3,218
chr1,110339042,110339329,SRX5054308,FOSL2,287
chr1,110339075,110339649,SRX20140897,INTS13,574
chr1,110339373,110339593,SRX20140867,INTS10,220
chr1,110348820,110349260,SRX5716469,SMARCA4,440
chr1,110348828,110349090,SRX5716467,SMARCA2,262
chr1,110348833,110349098,SRX5075175,SMARCA4,265
chr1,110348878,110349248,SRX5716470,SMARCA4,370
chr1,110348887,110349062,SRX5075176,SMARCA4,175
chr1,110370831,110371126,SRX5075169,SMARCA4,295
chr1,110370873,110371080,SRX5075175,SMARCA4,207
chr1,110370921,110371153,SRX5054309,FOSL2,232
chr1,110370930,110371099,SRX5075170,SMARCA4,169
chr1,110380643,110380969,SRX5716470,SMARCA4,326
chr1,110380648,110380969,SRX5075176,SMARCA4,321
chr1,110380665,110380959,SRX5075175,SMARCA4,294
chr1,110380671,110380980,SRX5075169,SMARCA4,309
chr1,110380673,110380929,SRX5716469,SMARCA4,256
chr1,110380696,110380972,SRX5075170,SMARCA4,276
chr1,110380705,110380975,SRX5716468,SMARCA2,270
chr1,110380713,110380960,SRX5716467,SMARCA2,247
chr1,110390672,110391029,SRX5716469,SMARCA4,357
chr1,110390802,110391096,SRX5075176,SMARCA4,294
chr1,110390808,110391204,SRX5075169,SMARCA4,396
chr1,110390835,110391281,SRX5716470,SMARCA4,446
chr1,110390926,110391260,SRX5075170,SMARCA4,334
chr1,110393942,110394262,SRX5075175,SMARCA4,320
chr1,110393972,110394280,SRX5054309,FOSL2,308
chr1,110394015,110394286,SRX5075176,SMARCA4,271
chr1,110394031,110394308,SRX5075170,SMARCA4,277
chr1,110394058,110394305,SRX5054308,FOSL2,247
chr1,110407262,110408040,SRX20140895,INTS13,778
chr1,110407387,110407879,SRX20140868,INTS10,492
chr1,110407428,110407937,SRX20140881,CPSF3L,509
chr1,110407504,110407925,SRX20140867,INTS10,421
chr1,110407511,110407726,SRX5075174,SMARCA4,215
chr1,110407513,110407984,SRX20140897,INTS13,471
chr1,110407520,110407852,SRX20140879,CPSF3L,332
chr1,110407618,110407845,SRX5075168,SMARCA4,227
chr1,110407646,110408034,SRX20140869,INTS10,388
chr1,110407666,110407896,SRX5075169,SMARCA4,230
chr1,110412429,110412927,SRX16500062,CTCF,498
chr1,110412450,110412907,SRX16500060,CTCF,457
chr1,110412471,110412920,SRX16500059,CTCF,449
chr1,110412503,110412917,SRX16500061,CTCF,414
chr1,110412573,110412823,SRX5075168,SMARCA4,250
chr1,110412588,110412904,SRX4174629,CTCF,316
chr1,110412590,110412816,SRX5075174,SMARCA4,226
chr1,110433861,110434155,SRX5075168,SMARCA4,294
chr1,110460205,110460699,SRX16500060,CTCF,494
chr1,110460211,110460666,SRX16500062,CTCF,455
chr1,110460216,110460677,SRX16500059,CTCF,461
chr1,110460224,110460694,SRX16500061,CTCF,470
chr1,110460287,110460472,SRX5075176,SMARCA4,185
chr1,110460311,110460517,SRX5075174,SMARCA4,206
chr1,110460324,110460511,SRX5075168,SMARCA4,187
chr1,110460347,110460630,SRX4174629,CTCF,283
chr1,110494719,110495212,SRX5075174,SMARCA4,493
chr1,110494728,110495261,SRX5075168,SMARCA4,533
chr1,110494790,110495145,SRX5716463,SMARCA4,355
chr1,110494866,110495111,SRX5716454,SOX3,245
chr1,110494867,110495111,SRX5716451,SOX2,244
chr1,110494871,110495181,SRX5716464,SMARCA4,310
chr1,110494927,110495109,SRX5075176,SMARCA4,182
chr1,110495107,110495366,SRX20140895,INTS13,259
chr1,110495916,110496425,SRX16500060,CTCF,509
chr1,110495927,110496305,SRX4174629,CTCF,378
chr1,110495947,110496397,SRX16500062,CTCF,450
chr1,110495947,110496433,SRX16500059,CTCF,486
chr1,110495956,110496392,SRX16500061,CTCF,436
chr1,110495999,110496289,SRX5075174,SMARCA4,290
chr1,110496058,110496253,SRX5075168,SMARCA4,195
chr1,110496061,110496321,SRX5075176,SMARCA4,260
chr1,110496063,110496312,SRX5075170,SMARCA4,249
chr1,110513453,110513814,SRX5075168,SMARCA4,361
chr1,110513523,110513832,SRX5075174,SMARCA4,309
chr1,110524411,110524906,SRX16500059,CTCF,495
chr1,110524425,110524874,SRX16500060,CTCF,449
chr1,110524443,110524901,SRX4174629,CTCF,458
chr1,110524451,110524886,SRX16500061,CTCF,435
chr1,110524451,110524895,SRX16500062,CTCF,444
chr1,110542801,110542996,SRX5075176,SMARCA4,195
chr1,110548443,110548742,SRX16500062,CTCF,299
chr1,110548468,110548778,SRX16500059,CTCF,310
chr1,110555138,110555640,SRX16500059,CTCF,502
chr1,110555206,110555694,SRX16500060,CTCF,488
chr1,110555230,110555485,SRX4174629,CTCF,255
chr1,110555242,110555671,SRX16500062,CTCF,429
chr1,110555244,110555577,SRX5075174,SMARCA4,333
chr1,110555257,110555733,SRX16500061,CTCF,476
chr1,110555350,110555809,SRX5075168,SMARCA4,459
chr1,110555363,110555585,SRX5716464,SMARCA4,222
chr1,110581730,110582050,SRX5075168,SMARCA4,320
chr1,110581810,110582075,SRX5075174,SMARCA4,265
chr1,110606282,110606569,SRX5075170,SMARCA4,287
chr1,110606308,110606746,SRX5075168,SMARCA4,438
chr1,110606328,110606592,SRX5075176,SMARCA4,264
chr1,110606341,110606768,SRX5075175,SMARCA4,427
chr1,110606350,110606656,SRX5075174,SMARCA4,306
chr1,110615742,110616051,SRX4174629,CTCF,309
chr1,110615760,110616110,SRX16500059,CTCF,350
chr1,110615784,110616073,SRX16500061,CTCF,289
chr1,110615829,110616106,SRX16500062,CTCF,277
chr1,110615829,110616122,SRX16500060,CTCF,293
chr1,110615880,110616071,SRX5075168,SMARCA4,191
chr1,110615896,110616069,SRX5075174,SMARCA4,173
chr1,110619273,110619551,SRX4174629,CTCF,278
chr1,110619275,110619705,SRX16500062,CTCF,430
chr1,110619290,110619745,SRX16500060,CTCF,455
chr1,110619294,110619773,SRX16500059,CTCF,479
chr1,110619303,110619768,SRX16500061,CTCF,465
chr1,110619343,110619701,SRX5075174,SMARCA4,358
chr1,110619351,110619700,SRX5716463,SMARCA4,349
chr1,110619407,110619722,SRX5075168,SMARCA4,315
chr1,110619413,110619658,SRX5716464,SMARCA4,245
chr1,110619467,110619648,SRX5075176,SMARCA4,181
chr1,110630583,110631161,SRX16500060,CTCF,578
chr1,110630659,110631167,SRX16500062,CTCF,508
chr1,110630700,110631162,SRX16500059,CTCF,462
chr1,110630747,110631152,SRX16500061,CTCF,405
chr1,110630781,110631135,SRX4174629,CTCF,354
chr1,110643880,110644208,SRX5075174,SMARCA4,328
chr1,110643963,110644245,SRX5075168,SMARCA4,282
chr1,110671973,110672338,SRX5075168,SMARCA4,365
chr1,110671997,110672321,SRX5716464,SMARCA4,324
chr1,110672001,110672317,SRX5075174,SMARCA4,316
chr1,110672055,110672276,SRX5716463,SMARCA4,221
chr1,110674534,110674856,SRX20140895,INTS13,322
chr1,110674544,110674812,SRX20140867,INTS10,268
chr1,110674964,110675154,SRX5075174,SMARCA4,190
chr1,110689895,110690174,SRX5075174,SMARCA4,279
chr1,110689940,110690230,SRX5716464,SMARCA4,290
chr1,110689981,110690289,SRX5716463,SMARCA4,308
chr1,110746686,110746995,SRX5075168,SMARCA4,309
chr1,110746714,110747026,SRX5075174,SMARCA4,312
chr1,110746724,110746961,SRX5716464,SMARCA4,237
chr1,110746748,110747023,SRX5075170,SMARCA4,275
chr1,110746759,110746976,SRX5075176,SMARCA4,217
chr1,110746773,110746968,SRX5075175,SMARCA4,195
chr1,110765934,110766461,SRX16500061,CTCF,527
chr1,110765947,110766487,SRX16500059,CTCF,540
chr1,110765959,110766429,SRX16500062,CTCF,470
chr1,110765959,110766531,SRX16500060,CTCF,572
chr1,110765960,110766302,SRX4174629,CTCF,342
chr1,110766061,110766370,SRX5075168,SMARCA4,309
chr1,110766064,110766376,SRX5075174,SMARCA4,312
chr1,110766099,110766352,SRX5075170,SMARCA4,253
chr1,110766106,110766388,SRX5716464,SMARCA4,282
chr1,110766111,110766349,SRX5716463,SMARCA4,238
chr1,110766149,110766332,SRX5075176,SMARCA4,183
chr1,110780808,110781282,SRX16500059,CTCF,474
chr1,110780833,110781265,SRX16500060,CTCF,432
chr1,110780858,110781270,SRX16500062,CTCF,412
chr1,110780860,110781250,SRX16500061,CTCF,390
chr1,110780882,110781145,SRX5716464,SMARCA4,263
chr1,110780924,110781148,SRX4174629,CTCF,224
chr1,110780931,110781166,SRX5075174,SMARCA4,235
chr1,110780948,110781135,SRX5075168,SMARCA4,187
chr1,110783285,110783725,SRX16500061,CTCF,440
chr1,110783298,110783697,SRX16500059,CTCF,399
chr1,110783304,110783709,SRX16500062,CTCF,405
chr1,110783316,110783627,SRX5075174,SMARCA4,311
chr1,110783317,110783707,SRX16500060,CTCF,390
chr1,110783327,110783581,SRX4174629,CTCF,254
chr1,110783333,110783635,SRX5075168,SMARCA4,302
chr1,110783354,110783576,SRX5075169,SMARCA4,222
chr1,110783360,110783590,SRX5075170,SMARCA4,230
chr1,110783376,110783580,SRX5716463,SMARCA4,204
chr1,110783392,110783603,SRX5716470,SMARCA4,211
chr1,110783393,110783629,SRX5075176,SMARCA4,236
chr1,110829946,110830454,SRX16500059,CTCF,508
chr1,110829964,110830462,SRX16500060,CTCF,498
chr1,110829999,110830353,SRX16500061,CTCF,354
chr1,110830004,110830335,SRX16500062,CTCF,331
chr1,110830034,110830278,SRX5075168,SMARCA4,244
chr1,110830077,110830286,SRX5075174,SMARCA4,209
chr1,110963164,110964137,SRX20140895,INTS13,973
chr1,110963212,110963681,SRX20140868,INTS10,469
chr1,110963222,110963752,SRX20140894,INTS13,530
chr1,110963269,110964012,SRX20140897,INTS13,743
chr1,110963440,110963949,SRX20140869,INTS10,509
chr1,110963643,110963991,SRX20140867,INTS10,348
chr1,110963646,110963962,SRX20140879,CPSF3L,316
chr1,110963656,110964053,SRX16500060,CTCF,397
chr1,110963675,110963955,SRX16500061,CTCF,280
chr1,110963742,110964117,SRX20140868,INTS10,375
chr1,110963857,110964036,SRX5075174,SMARCA4,179
chr1,110963874,110964113,SRX5075170,SMARCA4,239
chr1,110963922,110964287,SRX5075168,SMARCA4,365
chr1,110963962,110964261,SRX5716463,SMARCA4,299
chr1,110992355,110992576,SRX16500060,CTCF,221
chr1,110992403,110992622,SRX16500061,CTCF,219
chr1,111030509,111030744,SRX16500061,CTCF,235
chr1,111030537,111030774,SRX16500062,CTCF,237
chr1,111030551,111030823,SRX16500060,CTCF,272
chr1,111030554,111030835,SRX16500059,CTCF,281
chr1,111030627,111030806,SRX5075168,SMARCA4,179
chr1,111032186,111032692,SRX16500059,CTCF,506
chr1,111032251,111032674,SRX16500060,CTCF,423
chr1,111032277,111032686,SRX16500062,CTCF,409
chr1,111032298,111032681,SRX16500061,CTCF,383
chr1,111032343,111032584,SRX5716463,SMARCA4,241
chr1,111032368,111032607,SRX5075174,SMARCA4,239
chr1,111052318,111052570,SRX5054309,FOSL2,252
chr1,111139374,111139700,SRX5075169,SMARCA4,326
chr1,111139441,111139685,SRX5075174,SMARCA4,244
chr1,111139449,111139628,SRX5075168,SMARCA4,179
chr1,111139625,111140447,SRX20140895,INTS13,822
chr1,111139861,111140159,SRX20140867,INTS10,298
chr1,111139879,111140092,SRX5716470,SMARCA4,213
chr1,111139890,111140380,SRX5075170,SMARCA4,490
chr1,111139961,111140410,SRX5075174,SMARCA4,449
chr1,111139969,111140204,SRX20140879,CPSF3L,235
chr1,111140003,111140327,SRX5075168,SMARCA4,324
chr1,111140027,111140260,SRX5075169,SMARCA4,233
chr1,111140038,111140419,SRX5075176,SMARCA4,381
chr1,111140088,111140309,SRX5054309,FOSL2,221
chr1,111140337,111140591,SRX5716470,SMARCA4,254
chr1,111197551,111197788,SRX16500061,CTCF,237
chr1,111197617,111197866,SRX16500062,CTCF,249
chr1,111222826,111223258,SRX16500061,CTCF,432
chr1,111222838,111223251,SRX16500060,CTCF,413
chr1,111222839,111223298,SRX16500059,CTCF,459
chr1,111222855,111223260,SRX16500062,CTCF,405
chr1,111222886,111223141,SRX4174629,CTCF,255
chr1,111222959,111223171,SRX5075174,SMARCA4,212
chr1,111228337,111228852,SRX5075169,SMARCA4,515
chr1,111228379,111228985,SRX5075176,SMARCA4,606
chr1,111228387,111228862,SRX5054308,FOSL2,475
chr1,111228411,111228879,SRX5075175,SMARCA4,468
chr1,111228420,111228824,SRX5716467,SMARCA2,404
chr1,111228420,111228949,SRX5075170,SMARCA4,529
chr1,111228421,111228854,SRX5716469,SMARCA4,433
chr1,111228449,111228760,SRX5020211,SMARCA2,311
chr1,111228457,111228708,SRX5075174,SMARCA4,251
chr1,111228479,111228732,SRX5075168,SMARCA4,253
chr1,111228480,111228884,SRX5716470,SMARCA4,404
chr1,111228484,111228835,SRX5054309,FOSL2,351
chr1,111228496,111228810,SRX5020214,SMARCA2,314
chr1,111228521,111228771,SRX5716468,SMARCA2,250
chr1,111228572,111228754,SRX5075182,SMARCA2,182
chr1,111272093,111272416,SRX5075174,SMARCA4,323
chr1,111295994,111296249,SRX5075168,SMARCA4,255
chr1,111334193,111334526,SRX16500060,CTCF,333
chr1,111334204,111334468,SRX16500062,CTCF,264
chr1,111334222,111334502,SRX16500059,CTCF,280
chr1,111334260,111334482,SRX16500061,CTCF,222
chr1,111345995,111346258,SRX16500061,CTCF,263
chr1,111346046,111346369,SRX16500062,CTCF,323
chr1,111346060,111346310,SRX16500059,CTCF,250
chr1,111346071,111346342,SRX16500060,CTCF,271
chr1,111346071,111346562,SRX5716463,SMARCA4,491
chr1,111346100,111346808,SRX5075174,SMARCA4,708
chr1,111346136,111346502,SRX5075175,SMARCA4,366
chr1,111346152,111346756,SRX5075168,SMARCA4,604
chr1,111346167,111346769,SRX5716470,SMARCA4,602
chr1,111346185,111346757,SRX5075170,SMARCA4,572
chr1,111346239,111346709,SRX20140895,INTS13,470
chr1,111346337,111346768,SRX5716469,SMARCA4,431
chr1,111346367,111346604,SRX5716464,SMARCA4,237
chr1,111346395,111346751,SRX5075169,SMARCA4,356
chr1,111346517,111346792,SRX5075176,SMARCA4,275
chr1,111399771,111400230,SRX16500059,CTCF,459
chr1,111399779,111400214,SRX16500061,CTCF,435
chr1,111399784,111400201,SRX16500062,CTCF,417
chr1,111399789,111400239,SRX16500060,CTCF,450
chr1,111441527,111441913,SRX16500060,CTCF,386
chr1,111441588,111441956,SRX16500061,CTCF,368
chr1,111441593,111441942,SRX16500059,CTCF,349
chr1,111441640,111441945,SRX16500062,CTCF,305
chr1,111449000,111449572,SRX20140895,INTS13,572
chr1,111449011,111449522,SRX20140897,INTS13,511
chr1,111449059,111449624,SRX5075174,SMARCA4,565
chr1,111449086,111449403,SRX5075176,SMARCA4,317
chr1,111449086,111449485,SRX5075168,SMARCA4,399
chr1,111449119,111449689,SRX5075170,SMARCA4,570
chr1,111449130,111449351,SRX16500060,CTCF,221
chr1,111449151,111449357,SRX5075169,SMARCA4,206
chr1,111449230,111449464,SRX5716454,SOX3,234
chr1,111449390,111449639,SRX5716470,SMARCA4,249
chr1,111449511,111449687,SRX5075176,SMARCA4,176
chr1,111463389,111463569,SRX5054308,FOSL2,180
chr1,111463427,111463614,SRX5075175,SMARCA4,187
chr1,111474257,111474499,SRX5716470,SMARCA4,242
chr1,111481622,111482039,SRX16500059,CTCF,417
chr1,111481629,111481974,SRX16500060,CTCF,345
chr1,111481637,111481980,SRX16500061,CTCF,343
chr1,111481686,111482009,SRX16500062,CTCF,323
chr1,111507587,111507925,SRX5075170,SMARCA4,338
chr1,111507675,111507955,SRX5075174,SMARCA4,280
chr1,111507870,111508330,SRX5716469,SMARCA4,460
chr1,111507888,111508369,SRX20140895,INTS13,481
chr1,111507915,111508237,SRX5716470,SMARCA4,322
chr1,111507993,111508609,SRX5075176,SMARCA4,616
chr1,111508035,111508677,SRX16500060,CTCF,642
chr1,111508044,111508617,SRX16500059,CTCF,573
chr1,111508075,111508595,SRX16500061,CTCF,520
chr1,111508118,111508591,SRX5075170,SMARCA4,473
chr1,111508123,111508604,SRX4174629,CTCF,481
chr1,111508129,111508616,SRX16500062,CTCF,487
chr1,111508182,111508623,SRX5075174,SMARCA4,441
chr1,111508197,111508470,SRX5075169,SMARCA4,273
chr1,111508215,111508607,SRX5075168,SMARCA4,392
chr1,111508248,111508525,SRX5716464,SMARCA4,277
chr1,111508285,111508547,SRX5075175,SMARCA4,262
chr1,111538275,111538995,SRX5075176,SMARCA4,720
chr1,111538294,111538692,SRX5075169,SMARCA4,398
chr1,111538296,111539029,SRX5075170,SMARCA4,733
chr1,111538332,111538680,SRX5075174,SMARCA4,348
chr1,111538339,111538630,SRX5054308,FOSL2,291
chr1,111538394,111538684,SRX5054309,FOSL2,290
chr1,111538408,111538658,SRX5075168,SMARCA4,250
chr1,111538430,111538811,SRX5075175,SMARCA4,381
chr1,111538498,111538920,SRX5716470,SMARCA4,422
chr1,111538788,111538982,SRX5075169,SMARCA4,194
chr1,111541872,111542066,SRX5075174,SMARCA4,194
chr1,111541886,111542087,SRX5075168,SMARCA4,201
chr1,111553209,111553462,SRX5075169,SMARCA4,253
chr1,111553277,111553514,SRX5054309,FOSL2,237
chr1,111553307,111553494,SRX5075175,SMARCA4,187
chr1,111553325,111553494,SRX5075170,SMARCA4,169
chr1,111553333,111553543,SRX5075176,SMARCA4,210
chr1,111563628,111563945,SRX5075170,SMARCA4,317
chr1,111563689,111563951,SRX5075169,SMARCA4,262
chr1,111563696,111564025,SRX5075176,SMARCA4,329
chr1,111563700,111564005,SRX5054309,FOSL2,305
chr1,111563703,111564000,SRX5054308,FOSL2,297
chr1,111563708,111563987,SRX5075175,SMARCA4,279
chr1,111563714,111563952,SRX5716469,SMARCA4,238
chr1,111570839,111571059,SRX16500061,CTCF,220
chr1,111571957,111572256,SRX5075175,SMARCA4,299
chr1,111571985,111572310,SRX5075170,SMARCA4,325
chr1,111571987,111572308,SRX5075169,SMARCA4,321
chr1,111572010,111572321,SRX5716470,SMARCA4,311
chr1,111572011,111572363,SRX5075176,SMARCA4,352
chr1,111592607,111593305,SRX5075169,SMARCA4,698
chr1,111592662,111593259,SRX5075170,SMARCA4,597
chr1,111592686,111593267,SRX5075175,SMARCA4,581
chr1,111592756,111593243,SRX5075176,SMARCA4,487
chr1,111592761,111593237,SRX5716469,SMARCA4,476
chr1,111592764,111592992,SRX5020211,SMARCA2,228
chr1,111592768,111593166,SRX5054308,FOSL2,398
chr1,111592785,111593057,SRX5716470,SMARCA4,272
chr1,111592793,111593043,SRX5054309,FOSL2,250
chr1,111592823,111593128,SRX5716467,SMARCA2,305
chr1,111605045,111605321,SRX5075175,SMARCA4,276
chr1,111605068,111605314,SRX5054309,FOSL2,246
chr1,111605096,111605350,SRX5075170,SMARCA4,254
chr1,111605134,111605410,SRX5716469,SMARCA4,276
chr1,111605134,111605508,SRX5075169,SMARCA4,374
chr1,111605696,111605888,SRX5075176,SMARCA4,192
chr1,111619463,111619960,SRX5075174,SMARCA4,497
chr1,111619502,111619826,SRX5716464,SMARCA4,324
chr1,111619521,111619936,SRX5075168,SMARCA4,415
chr1,111619557,111620026,SRX5075175,SMARCA4,469
chr1,111619562,111619893,SRX5075170,SMARCA4,331
chr1,111619576,111619795,SRX5075176,SMARCA4,219
chr1,111619600,111619896,SRX5716463,SMARCA4,296
chr1,111619649,111619836,SRX5054307,FOSL2,187
chr1,111619867,111620289,SRX20140895,INTS13,422
chr1,111656317,111656834,SRX16500059,CTCF,517
chr1,111656358,111656783,SRX16500061,CTCF,425
chr1,111656364,111656801,SRX16500060,CTCF,437
chr1,111656392,111656821,SRX16500062,CTCF,429
chr1,111656395,111656669,SRX5075174,SMARCA4,274
chr1,111656429,111656687,SRX5075170,SMARCA4,258
chr1,111656488,111656686,SRX5075168,SMARCA4,198
chr1,111690217,111690682,SRX5075170,SMARCA4,465
chr1,111690229,111690675,SRX5075176,SMARCA4,446
chr1,111690247,111690694,SRX5075175,SMARCA4,447
chr1,111690251,111690718,SRX5075169,SMARCA4,467
chr1,111690270,111690593,SRX5716460,Epitope tags,323
chr1,111690271,111690679,SRX5716470,SMARCA4,408
chr1,111690297,111690674,SRX5716467,SMARCA2,377
chr1,111690300,111690551,SRX5075181,SMARCA2,251
chr1,111690301,111690585,SRX5716468,SMARCA2,284
chr1,111690324,111690549,SRX5075182,SMARCA2,225
chr1,111690331,111690629,SRX5716469,SMARCA4,298
chr1,111690338,111690665,SRX5020211,SMARCA2,327
chr1,111690384,111690635,SRX5020214,SMARCA2,251
chr1,111714763,111715255,SRX16500060,CTCF,492
chr1,111714800,111715287,SRX16500059,CTCF,487
chr1,111714836,111715282,SRX16500061,CTCF,446
chr1,111714843,111715275,SRX16500062,CTCF,432
chr1,111714958,111715291,SRX4174629,CTCF,333
chr1,111714984,111715172,SRX5075174,SMARCA4,188
chr1,111716194,111716725,SRX5075176,SMARCA4,531
chr1,111716377,111716690,SRX5075170,SMARCA4,313
chr1,111716401,111716690,SRX5716467,SMARCA2,289
chr1,111716431,111716643,SRX5716469,SMARCA4,212
chr1,111716436,111716649,SRX5075169,SMARCA4,213
chr1,111733257,111734108,SRX5075176,SMARCA4,851
chr1,111733283,111734117,SRX5075170,SMARCA4,834
chr1,111733328,111733542,SRX5716470,SMARCA4,214
chr1,111733345,111733590,SRX5075168,SMARCA4,245
chr1,111733358,111733643,SRX5075174,SMARCA4,285
chr1,111733372,111734123,SRX5075169,SMARCA4,751
chr1,111733375,111734077,SRX5075175,SMARCA4,702
chr1,111733381,111733660,SRX5054309,FOSL2,279
chr1,111733397,111733667,SRX5716469,SMARCA4,270
chr1,111733438,111733635,SRX5054308,FOSL2,197
chr1,111733644,111733876,SRX5716470,SMARCA4,232
chr1,111739169,111740486,SRX20140895,INTS13,1317
chr1,111739419,111739695,SRX20140897,INTS13,276
chr1,111740233,111740447,SRX20140867,INTS10,214
chr1,111740282,111740580,SRX5075174,SMARCA4,298
chr1,111747178,111747614,SRX16500062,CTCF,436
chr1,111747204,111747692,SRX16500059,CTCF,488
chr1,111747250,111747661,SRX16500060,CTCF,411
chr1,111747251,111747609,SRX20140869,INTS10,358
chr1,111747251,111747626,SRX16500061,CTCF,375
chr1,111747284,111747697,SRX20140868,INTS10,413
chr1,111747309,111747609,SRX20140867,INTS10,300
chr1,111754948,111755161,SRX5075169,SMARCA4,213
chr1,111754951,111755909,SRX5075170,SMARCA4,958
chr1,111754986,111755271,SRX5075176,SMARCA4,285
chr1,111755014,111755205,SRX5075174,SMARCA4,191
chr1,111755036,111755233,SRX5075175,SMARCA4,197
chr1,111755313,111756213,SRX20140895,INTS13,900
chr1,111755349,111755855,SRX5075169,SMARCA4,506
chr1,111755396,111755664,SRX5075175,SMARCA4,268
chr1,111755408,111755878,SRX5075176,SMARCA4,470
chr1,111755422,111755916,SRX16500062,CTCF,494
chr1,111755422,111756023,SRX5075168,SMARCA4,601
chr1,111755444,111755925,SRX16500061,CTCF,481
chr1,111755450,111755923,SRX16500060,CTCF,473
chr1,111755453,111755928,SRX16500059,CTCF,475
chr1,111755462,111756102,SRX20140868,INTS10,640
chr1,111755489,111755896,SRX5716463,SMARCA4,407
chr1,111755502,111756146,SRX20140867,INTS10,644
chr1,111755504,111755771,SRX4174629,CTCF,267
chr1,111755516,111755842,SRX5054309,FOSL2,326
chr1,111755520,111755813,SRX5716469,SMARCA4,293
chr1,111755526,111755745,SRX5716451,SOX2,219
chr1,111755526,111755839,SRX5716470,SMARCA4,313
chr1,111755526,111756057,SRX5075174,SMARCA4,531
chr1,111755625,111756014,SRX20140869,INTS10,389
chr1,111755706,111756098,SRX20140881,CPSF3L,392
chr1,111755707,111756145,SRX20140897,INTS13,438
chr1,111755721,111755916,SRX5075175,SMARCA4,195
chr1,111755729,111756053,SRX20140879,CPSF3L,324
chr1,111755757,111756157,SRX20140896,INTS13,400
chr1,111769489,111769965,SRX16500059,CTCF,476
chr1,111769520,111769986,SRX16500062,CTCF,466
chr1,111769526,111769940,SRX16500061,CTCF,414
chr1,111769526,111769974,SRX16500060,CTCF,448
chr1,111769551,111769828,SRX5075168,SMARCA4,277
chr1,111769582,111769839,SRX5075170,SMARCA4,257
chr1,111769586,111769828,SRX5075174,SMARCA4,242
chr1,111769606,111769807,SRX5075169,SMARCA4,201
chr1,111769615,111769797,SRX5075176,SMARCA4,182
chr1,111775990,111776219,SRX20140867,INTS10,229
chr1,111801469,111801704,SRX16500059,CTCF,235
chr1,111856797,111857089,SRX5075174,SMARCA4,292
chr1,111856836,111857146,SRX5075168,SMARCA4,310
chr1,111856894,111857039,SRX1424893,POU3F2,145
chr1,111856942,111856998,SRX1424894,POU3F2,56
chr1,111895457,111895887,SRX5075174,SMARCA4,430
chr1,111895498,111895808,SRX5075168,SMARCA4,310
chr1,111904396,111904677,SRX20140895,INTS13,281
chr1,111908979,111909438,SRX5075168,SMARCA4,459
chr1,111909000,111909401,SRX5716451,SOX2,401
chr1,111909022,111909451,SRX5075174,SMARCA4,429
chr1,111909035,111909428,SRX5716463,SMARCA4,393
chr1,111909082,111909363,SRX5716454,SOX3,281
chr1,111911031,111911461,SRX5075174,SMARCA4,430
chr1,111911033,111911390,SRX5075168,SMARCA4,357
chr1,111920240,111920506,SRX5075174,SMARCA4,266
chr1,111920264,111920520,SRX5075168,SMARCA4,256
chr1,111921998,111922291,SRX5075168,SMARCA4,293
chr1,111921999,111922252,SRX5075174,SMARCA4,253
chr1,111943844,111944181,SRX5075174,SMARCA4,337
chr1,111943856,111944077,SRX5075168,SMARCA4,221
chr1,111961191,111961364,SRX5075174,SMARCA4,173
chr1,111991345,111991792,SRX16500059,CTCF,447
chr1,111991386,111991698,SRX16500061,CTCF,312
chr1,111991408,111991655,SRX16500062,CTCF,247
chr1,111991408,111991789,SRX16500060,CTCF,381
chr1,111991445,111991728,SRX5075168,SMARCA4,283
chr1,111991476,111991725,SRX5075174,SMARCA4,249
chr1,111991505,111991715,SRX4174629,CTCF,210
chr1,112064712,112065058,SRX5075174,SMARCA4,346
chr1,112172411,112172690,SRX5075174,SMARCA4,279
chr1,112172414,112172610,SRX5075176,SMARCA4,196
chr1,112172427,112172630,SRX5075170,SMARCA4,203
chr1,112172449,112172653,SRX5716463,SMARCA4,204
chr1,112298554,112298904,SRX16500062,CTCF,350
chr1,112298608,112298899,SRX16500059,CTCF,291
chr1,112298635,112298910,SRX16500060,CTCF,275
chr1,112298653,112298929,SRX16500061,CTCF,276
chr1,112336920,112337257,SRX16500061,CTCF,337
chr1,112336957,112337273,SRX16500059,CTCF,316
chr1,112336968,112337325,SRX16500060,CTCF,357
chr1,112337034,112337311,SRX16500062,CTCF,277
chr1,112358730,112359265,SRX16500059,CTCF,535
chr1,112358789,112359183,SRX16500062,CTCF,394
chr1,112358793,112359126,SRX16500061,CTCF,333
chr1,112358804,112359147,SRX16500060,CTCF,343
chr1,112360118,112360293,SRX5075176,SMARCA4,175
chr1,112360240,112360457,SRX5716470,SMARCA4,217
chr1,112369519,112370018,SRX4174629,CTCF,499
chr1,112369596,112370108,SRX16500062,CTCF,512
chr1,112369603,112370108,SRX16500060,CTCF,505
chr1,112369603,112370175,SRX16500059,CTCF,572
chr1,112369626,112370081,SRX16500061,CTCF,455
chr1,112369640,112369980,SRX5716464,SMARCA4,340
chr1,112369643,112370031,SRX5075168,SMARCA4,388
chr1,112369651,112369992,SRX5075170,SMARCA4,341
chr1,112369663,112370002,SRX5075174,SMARCA4,339
chr1,112369672,112369901,SRX5716469,SMARCA4,229
chr1,112369676,112369993,SRX5075169,SMARCA4,317
chr1,112369682,112369960,SRX5075176,SMARCA4,278
chr1,112369686,112369986,SRX5716470,SMARCA4,300
chr1,112369694,112369994,SRX5075175,SMARCA4,300
chr1,112369713,112369966,SRX5716463,SMARCA4,253
chr1,112388474,112388914,SRX5075170,SMARCA4,440
chr1,112388486,112388917,SRX5075176,SMARCA4,431
chr1,112388502,112388747,SRX5075175,SMARCA4,245
chr1,112388512,112388845,SRX5075169,SMARCA4,333
chr1,112390737,112391312,SRX16500060,CTCF,575
chr1,112390772,112391328,SRX16500059,CTCF,556
chr1,112390773,112391329,SRX16500062,CTCF,556
chr1,112390775,112391274,SRX16500061,CTCF,499
chr1,112390821,112391172,SRX5075174,SMARCA4,351
chr1,112390838,112391178,SRX5075170,SMARCA4,340
chr1,112390865,112391242,SRX5075168,SMARCA4,377
chr1,112390867,112391199,SRX5075176,SMARCA4,332
chr1,112390897,112391308,SRX4174629,CTCF,411
chr1,112390903,112391161,SRX5075169,SMARCA4,258
chr1,112394100,112394491,SRX5054309,FOSL2,391
chr1,112394123,112394463,SRX5054308,FOSL2,340
chr1,112394124,112394701,SRX5075170,SMARCA4,577
chr1,112394147,112394392,SRX5075174,SMARCA4,245
chr1,112394148,112394480,SRX5075175,SMARCA4,332
chr1,112394154,112394489,SRX5075176,SMARCA4,335
chr1,112394156,112394387,SRX5716467,SMARCA2,231
chr1,112394158,112394519,SRX5075169,SMARCA4,361
chr1,112394165,112394475,SRX5716469,SMARCA4,310
chr1,112394173,112394432,SRX5020214,SMARCA2,259
chr1,112395767,112396279,SRX20140895,INTS13,512
chr1,112395844,112396214,SRX5075168,SMARCA4,370
chr1,112395912,112396253,SRX5716464,SMARCA4,341
chr1,112395922,112396190,SRX20140867,INTS10,268
chr1,112395941,112396224,SRX5716451,SOX2,283
chr1,112395994,112396181,SRX5054307,FOSL2,187
chr1,112396021,112396231,SRX5716454,SOX3,210
chr1,112396021,112396292,SRX5075174,SMARCA4,271
chr1,112404242,112404969,SRX5075168,SMARCA4,727
chr1,112404270,112404805,SRX5075169,SMARCA4,535
chr1,112404291,112404744,SRX5716469,SMARCA4,453
chr1,112404307,112404661,SRX5075170,SMARCA4,354
chr1,112404309,112404742,SRX5716470,SMARCA4,433
chr1,112404311,112404860,SRX5075174,SMARCA4,549
chr1,112404324,112404719,SRX5075175,SMARCA4,395
chr1,112404337,112404771,SRX5075176,SMARCA4,434
chr1,112404342,112404796,SRX5054309,FOSL2,454
chr1,112404356,112404678,SRX5020214,SMARCA2,322
chr1,112404360,112404700,SRX5054308,FOSL2,340
chr1,112404365,112404672,SRX5716463,SMARCA4,307
chr1,112404365,112404731,SRX5716467,SMARCA2,366
chr1,112404370,112404696,SRX5020211,SMARCA2,326
chr1,112404428,112404656,SRX5716468,SMARCA2,228
chr1,112404429,112404626,SRX5075181,SMARCA2,197
chr1,112404460,112404657,SRX5716451,SOX2,197
chr1,112404468,112404667,SRX5054307,FOSL2,199
chr1,112444281,112444637,SRX5075175,SMARCA4,356
chr1,112444306,112444514,SRX5075170,SMARCA4,208
chr1,112444308,112444563,SRX5075169,SMARCA4,255
chr1,112444429,112444612,SRX5054309,FOSL2,183
chr1,112466079,112466589,SRX16500059,CTCF,510
chr1,112466090,112466450,SRX5716463,SMARCA4,360
chr1,112466091,112466552,SRX5075176,SMARCA4,461
chr1,112466092,112466533,SRX16500061,CTCF,441
chr1,112466093,112466587,SRX16500060,CTCF,494
chr1,112466102,112466546,SRX5075170,SMARCA4,444
chr1,112466106,112466497,SRX5075168,SMARCA4,391
chr1,112466109,112466441,SRX16500062,CTCF,332
chr1,112466117,112466480,SRX5075174,SMARCA4,363
chr1,112466155,112466423,SRX5716464,SMARCA4,268
chr1,112466164,112466486,SRX5716470,SMARCA4,322
chr1,112466168,112466569,SRX5075175,SMARCA4,401
chr1,112466217,112466602,SRX5075169,SMARCA4,385
chr1,112466220,112466534,SRX5716469,SMARCA4,314
chr1,112466221,112466581,SRX4174629,CTCF,360
chr1,112466254,112466481,SRX5716468,SMARCA2,227
chr1,112501796,112502166,SRX16500060,CTCF,370
chr1,112501806,112502210,SRX16500059,CTCF,404
chr1,112501820,112502146,SRX16500061,CTCF,326
chr1,112501826,112502231,SRX5075168,SMARCA4,405
chr1,112501835,112502176,SRX16500062,CTCF,341
chr1,112501864,112502413,SRX5075174,SMARCA4,549
chr1,112501903,112502278,SRX5075170,SMARCA4,375
chr1,112501908,112502437,SRX5075176,SMARCA4,529
chr1,112501925,112502420,SRX5716470,SMARCA4,495
chr1,112501939,112502335,SRX5075175,SMARCA4,396
chr1,112501963,112502389,SRX5716469,SMARCA4,426
chr1,112501970,112502295,SRX20140895,INTS13,325
chr1,112501975,112502451,SRX5075169,SMARCA4,476
chr1,112515503,112516150,SRX5075174,SMARCA4,647
chr1,112515514,112516219,SRX5075168,SMARCA4,705
chr1,112515545,112516088,SRX5716463,SMARCA4,543
chr1,112515595,112516009,SRX5716470,SMARCA4,414
chr1,112515595,112516040,SRX5075175,SMARCA4,445
chr1,112515595,112516043,SRX5075169,SMARCA4,448
chr1,112515607,112516016,SRX5716469,SMARCA4,409
chr1,112515628,112516072,SRX5075170,SMARCA4,444
chr1,112515634,112515931,SRX5716464,SMARCA4,297
chr1,112515639,112516036,SRX5075176,SMARCA4,397
chr1,112515656,112515976,SRX5716467,SMARCA2,320
chr1,112515657,112515980,SRX20140867,INTS10,323
chr1,112515667,112516017,SRX5054309,FOSL2,350
chr1,112515672,112516043,SRX20140894,INTS13,371
chr1,112515682,112516079,SRX20140895,INTS13,397
chr1,112515694,112515982,SRX20140879,CPSF3L,288
chr1,112515710,112515976,SRX20140860,SOX2,266
chr1,112515716,112515914,SRX5054307,FOSL2,198
chr1,112515718,112515974,SRX5054308,FOSL2,256
chr1,112515731,112516028,SRX5716451,SOX2,297
chr1,112515799,112516036,SRX5716454,SOX3,237
chr1,112522499,112522982,SRX5075170,SMARCA4,483
chr1,112522514,112522984,SRX5075169,SMARCA4,470
chr1,112522559,112522980,SRX5054309,FOSL2,421
chr1,112522572,112523018,SRX5054308,FOSL2,446
chr1,112522576,112522921,SRX5020211,SMARCA2,345
chr1,112522579,112522999,SRX5075175,SMARCA4,420
chr1,112522594,112522984,SRX5075176,SMARCA4,390
chr1,112522601,112523010,SRX5716467,SMARCA2,409
chr1,112522610,112522849,SRX5075181,SMARCA2,239
chr1,112522621,112522936,SRX5020214,SMARCA2,315
chr1,112522624,112522976,SRX5716469,SMARCA4,352
chr1,112522631,112522928,SRX5716468,SMARCA2,297
chr1,112522636,112522934,SRX5716470,SMARCA4,298
chr1,112522639,112522929,SRX5075182,SMARCA2,290
chr1,112522675,112522971,SRX5075174,SMARCA4,296
chr1,112522686,112522931,SRX5075168,SMARCA4,245
chr1,112522709,112522911,SRX5054307,FOSL2,202
chr1,112528140,112528344,SRX5075169,SMARCA4,204
chr1,112532178,112532218,SRX1424891,POU3F2,40
chr1,112533072,112533334,SRX5075169,SMARCA4,262
chr1,112533099,112533347,SRX5075175,SMARCA4,248
chr1,112533126,112533388,SRX5054309,FOSL2,262
chr1,112533139,112533319,SRX5054308,FOSL2,180
chr1,112544031,112544492,SRX5075170,SMARCA4,461
chr1,112544036,112544443,SRX5075175,SMARCA4,407
chr1,112544038,112544489,SRX5054309,FOSL2,451
chr1,112544046,112544415,SRX5054308,FOSL2,369
chr1,112544046,112544529,SRX5075169,SMARCA4,483
chr1,112544047,112544384,SRX5020211,SMARCA2,337
chr1,112544047,112544550,SRX5716469,SMARCA4,503
chr1,112544055,112544399,SRX5075176,SMARCA4,344
chr1,112544071,112544423,SRX5716470,SMARCA4,352
chr1,112544093,112544421,SRX5716467,SMARCA2,328
chr1,112544228,112544518,SRX5716460,Epitope tags,290
chr1,112544833,112545079,SRX5075169,SMARCA4,246
chr1,112544862,112545049,SRX5075175,SMARCA4,187
chr1,112557420,112557748,SRX5075176,SMARCA4,328
chr1,112557479,112557742,SRX5075170,SMARCA4,263
chr1,112575442,112575814,SRX5054309,FOSL2,372
chr1,112575452,112575768,SRX5075175,SMARCA4,316
chr1,112575453,112575776,SRX5054308,FOSL2,323
chr1,112575456,112575729,SRX5075176,SMARCA4,273
chr1,112575479,112575815,SRX5075169,SMARCA4,336
chr1,112575499,112575711,SRX5075170,SMARCA4,212
chr1,112575513,112575725,SRX5716469,SMARCA4,212
chr1,112614418,112614890,SRX16500059,CTCF,472
chr1,112614421,112614874,SRX16500060,CTCF,453
chr1,112614437,112614838,SRX16500061,CTCF,401
chr1,112614452,112614815,SRX16500062,CTCF,363
chr1,112618907,112619353,SRX20140895,INTS13,446
chr1,112618945,112619320,SRX20140868,INTS10,375
chr1,112619487,112620115,SRX20140895,INTS13,628
chr1,112619513,112619702,SRX5075175,SMARCA4,189
chr1,112619527,112619889,SRX5075170,SMARCA4,362
chr1,112619539,112619967,SRX5075174,SMARCA4,428
chr1,112619569,112620009,SRX20140897,INTS13,440
chr1,112619570,112619906,SRX5075168,SMARCA4,336
chr1,112619589,112619820,SRX5075176,SMARCA4,231
chr1,112619626,112619920,SRX20140868,INTS10,294
chr1,112619633,112619945,SRX20140867,INTS10,312
chr1,112619656,112619895,SRX5054308,FOSL2,239
chr1,112619724,112619995,SRX20140896,INTS13,271
chr1,112636767,112636962,SRX5075170,SMARCA4,195
chr1,112672138,112672314,SRX5075174,SMARCA4,176
chr1,112673636,112673907,SRX5075176,SMARCA4,271
chr1,112674842,112675052,SRX5075169,SMARCA4,210
chr1,112674862,112675605,SRX20140895,INTS13,743
chr1,112675003,112675531,SRX20140868,INTS10,528
chr1,112675171,112675452,SRX5716469,SMARCA4,281
chr1,112675213,112675437,SRX5716470,SMARCA4,224
chr1,112675223,112675540,SRX5075175,SMARCA4,317
chr1,112675265,112675530,SRX5075174,SMARCA4,265
chr1,112686515,112686698,SRX5054309,FOSL2,183
chr1,112700489,112701168,SRX5075169,SMARCA4,679
chr1,112700512,112701179,SRX5075176,SMARCA4,667
chr1,112700582,112701171,SRX5075170,SMARCA4,589
chr1,112700610,112700954,SRX5075175,SMARCA4,344
chr1,112700682,112701041,SRX5075168,SMARCA4,359
chr1,112700725,112701129,SRX5716470,SMARCA4,404
chr1,112700889,112701070,SRX5075174,SMARCA4,181
chr1,112704829,112705440,SRX5716469,SMARCA4,611
chr1,112704841,112705333,SRX5075170,SMARCA4,492
chr1,112704872,112705328,SRX5075176,SMARCA4,456
chr1,112704918,112705334,SRX5075169,SMARCA4,416
chr1,112704962,112705186,SRX5075175,SMARCA4,224
chr1,112704989,112705548,SRX5075174,SMARCA4,559
chr1,112705081,112705405,SRX5075168,SMARCA4,324
chr1,112705111,112705375,SRX5716464,SMARCA4,264
chr1,112705393,112705579,SRX5054309,FOSL2,186
chr1,112706839,112707511,SRX20140895,INTS13,672
chr1,112706934,112707218,SRX20140868,INTS10,284
chr1,112707004,112707634,SRX5075168,SMARCA4,630
chr1,112707059,112707560,SRX5075174,SMARCA4,501
chr1,112707082,112707493,SRX5075169,SMARCA4,411
chr1,112707092,112707554,SRX5075176,SMARCA4,462
chr1,112707127,112707491,SRX5075175,SMARCA4,364
chr1,112707237,112707482,SRX5716470,SMARCA4,245
chr1,112707247,112707541,SRX5716463,SMARCA4,294
chr1,112707264,112707759,SRX16500060,CTCF,495
chr1,112707266,112707691,SRX16500059,CTCF,425
chr1,112707279,112707593,SRX5075170,SMARCA4,314
chr1,112707289,112707755,SRX16500062,CTCF,466
chr1,112707310,112707694,SRX16500061,CTCF,384
chr1,112707337,112707684,SRX4174629,CTCF,347
chr1,112715107,112715621,SRX5075174,SMARCA4,514
chr1,112715109,112715605,SRX5075168,SMARCA4,496
chr1,112715125,112715611,SRX5716463,SMARCA4,486
chr1,112715145,112715518,SRX5075175,SMARCA4,373
chr1,112715175,112715566,SRX5075170,SMARCA4,391
chr1,112715214,112715613,SRX5075176,SMARCA4,399
chr1,112715308,112715500,SRX5054307,FOSL2,192
chr1,112716209,112716690,SRX16500061,CTCF,481
chr1,112716210,112716627,SRX4174629,CTCF,417
chr1,112716214,112716685,SRX16500059,CTCF,471
chr1,112716217,112716663,SRX16500062,CTCF,446
chr1,112716219,112716675,SRX16500060,CTCF,456
chr1,112716273,112716534,SRX5075170,SMARCA4,261
chr1,112716295,112716513,SRX5075176,SMARCA4,218
chr1,112716323,112716597,SRX5075174,SMARCA4,274
chr1,112716366,112716602,SRX5075168,SMARCA4,236
chr1,112716368,112716611,SRX5716470,SMARCA4,243
chr1,112718642,112719030,SRX16500060,CTCF,388
chr1,112718652,112719024,SRX16500061,CTCF,372
chr1,112718698,112719076,SRX16500059,CTCF,378
chr1,112718722,112719009,SRX16500062,CTCF,287
chr1,112718789,112718987,SRX5075170,SMARCA4,198
chr1,112718818,112718998,SRX5075169,SMARCA4,180
chr1,112722753,112723270,SRX20140895,INTS13,517
chr1,112735718,112736105,SRX5075175,SMARCA4,387
chr1,112735743,112736106,SRX5075170,SMARCA4,363
chr1,112735766,112736063,SRX5054309,FOSL2,297
chr1,112735783,112736090,SRX5075176,SMARCA4,307
chr1,112735802,112736110,SRX5075169,SMARCA4,308
chr1,112735806,112736162,SRX5716469,SMARCA4,356
chr1,112735847,112736133,SRX5054308,FOSL2,286
chr1,112762892,112763167,SRX5716469,SMARCA4,275
chr1,112762927,112763233,SRX5716470,SMARCA4,306
chr1,112763013,112763285,SRX5075169,SMARCA4,272
chr1,112763027,112763281,SRX5716467,SMARCA2,254
chr1,112792190,112792427,SRX5054309,FOSL2,237
chr1,112804154,112804561,SRX16500059,CTCF,407
chr1,112804158,112804569,SRX16500060,CTCF,411
chr1,112804159,112804495,SRX4174629,CTCF,336
chr1,112804161,112804511,SRX16500062,CTCF,350
chr1,112804176,112804387,SRX5716470,SMARCA4,211
chr1,112804198,112804402,SRX5716463,SMARCA4,204
chr1,112804201,112804523,SRX16500061,CTCF,322
chr1,112804209,112804454,SRX5075174,SMARCA4,245
chr1,112804229,112804477,SRX5075168,SMARCA4,248
chr1,112804288,112804467,SRX5075170,SMARCA4,179
chr1,112804289,112804476,SRX5075175,SMARCA4,187
chr1,112809132,112809593,SRX16500061,CTCF,461
chr1,112809194,112809673,SRX16500060,CTCF,479
chr1,112809197,112809635,SRX16500062,CTCF,438
chr1,112809218,112809653,SRX16500059,CTCF,435
chr1,112809273,112809537,SRX5075176,SMARCA4,264
chr1,112809325,112809532,SRX5075174,SMARCA4,207
chr1,112809340,112809549,SRX5075168,SMARCA4,209
chr1,112809409,112809578,SRX5075170,SMARCA4,169
chr1,112821808,112822043,SRX5075174,SMARCA4,235
chr1,112866095,112866521,SRX5075169,SMARCA4,426
chr1,112866144,112866463,SRX5054309,FOSL2,319
chr1,112866158,112866477,SRX5075175,SMARCA4,319
chr1,112866175,112866497,SRX5075170,SMARCA4,322
chr1,112866193,112866438,SRX5054308,FOSL2,245
chr1,112866198,112866462,SRX5075176,SMARCA4,264
chr1,112866201,112866413,SRX5716469,SMARCA4,212
chr1,112866237,112866483,SRX5716470,SMARCA4,246
chr1,112880853,112881338,SRX16500060,CTCF,485
chr1,112880868,112881344,SRX16500059,CTCF,476
chr1,112880912,112881226,SRX5075170,SMARCA4,314
chr1,112880928,112881286,SRX16500061,CTCF,358
chr1,112880930,112881190,SRX4174629,CTCF,260
chr1,112880930,112881328,SRX16500062,CTCF,398
chr1,112880967,112881217,SRX5075175,SMARCA4,250
chr1,112880970,112881271,SRX5075174,SMARCA4,301
chr1,112880990,112881242,SRX5075168,SMARCA4,252
chr1,112881073,112881271,SRX5075176,SMARCA4,198
chr1,112904043,112904300,SRX5075170,SMARCA4,257
chr1,112904044,112904231,SRX5075175,SMARCA4,187
chr1,112904060,112904316,SRX5054308,FOSL2,256
chr1,112904066,112904322,SRX5054309,FOSL2,256
chr1,112904101,112904299,SRX5075169,SMARCA4,198
chr1,112904146,112904323,SRX5075176,SMARCA4,177
chr1,112905859,112906076,SRX5075176,SMARCA4,217
chr1,112905888,112906115,SRX5075170,SMARCA4,227
chr1,112915641,112916044,SRX5054309,FOSL2,403
chr1,112915702,112915995,SRX5054308,FOSL2,293
chr1,112915777,112915968,SRX5075169,SMARCA4,191
chr1,112935524,112935972,SRX5054309,FOSL2,448
chr1,112935619,112935875,SRX5054308,FOSL2,256
chr1,112935642,112935998,SRX5075170,SMARCA4,356
chr1,112955214,112955507,SRX5075174,SMARCA4,293
chr1,112955662,112956668,SRX20140895,INTS13,1006
chr1,112955756,112956463,SRX20140868,INTS10,707
chr1,112955819,112956085,SRX16500059,CTCF,266
chr1,112955848,112956259,SRX20140881,CPSF3L,411
chr1,112955886,112956338,SRX20140879,CPSF3L,452
chr1,112955890,112956584,SRX20140897,INTS13,694
chr1,112955928,112956419,SRX20140867,INTS10,491
chr1,112955987,112956561,SRX5075174,SMARCA4,574
chr1,112956166,112956578,SRX5075168,SMARCA4,412
chr1,112956184,112956502,SRX5075176,SMARCA4,318
chr1,112956186,112956503,SRX5075170,SMARCA4,317
chr1,112956214,112956576,SRX5075169,SMARCA4,362
chr1,112956261,112956520,SRX16500060,CTCF,259
chr1,113021701,113022006,SRX5716470,SMARCA4,305
chr1,113021732,113022109,SRX5716469,SMARCA4,377
chr1,113021734,113021930,SRX5075176,SMARCA4,196
chr1,113021757,113022032,SRX5075175,SMARCA4,275
chr1,113021778,113022009,SRX5075170,SMARCA4,231
chr1,113042161,113042568,SRX5716469,SMARCA4,407
chr1,113042185,113042928,SRX5716470,SMARCA4,743
chr1,113042271,113042998,SRX5075176,SMARCA4,727
chr1,113042329,113042961,SRX5075169,SMARCA4,632
chr1,113042364,113042956,SRX5075174,SMARCA4,592
chr1,113042366,113042914,SRX5075170,SMARCA4,548
chr1,113042377,113042660,SRX5716460,Epitope tags,283
chr1,113042381,113042984,SRX5075175,SMARCA4,603
chr1,113042411,113042946,SRX5075168,SMARCA4,535
chr1,113042459,113042819,SRX5020211,SMARCA2,360
chr1,113042516,113043066,SRX16500060,CTCF,550
chr1,113042527,113042825,SRX5716464,SMARCA4,298
chr1,113042548,113043005,SRX4174629,CTCF,457
chr1,113042554,113042961,SRX5716463,SMARCA4,407
chr1,113042566,113043116,SRX16500059,CTCF,550
chr1,113042589,113042789,SRX5716451,SOX2,200
chr1,113042596,113043011,SRX16500061,CTCF,415
chr1,113042642,113043080,SRX16500062,CTCF,438
chr1,113042695,113042974,SRX5054309,FOSL2,279
chr1,113057032,113057309,SRX5075176,SMARCA4,277
chr1,113057049,113057369,SRX5075170,SMARCA4,320
chr1,113072547,113073267,SRX4174629,CTCF,720
chr1,113072594,113073298,SRX16500059,CTCF,704
chr1,113072599,113073679,SRX16500060,CTCF,1080
chr1,113072600,113073192,SRX16500061,CTCF,592
chr1,113072606,113073215,SRX5075168,SMARCA4,609
chr1,113072660,113073201,SRX16500062,CTCF,541
chr1,113072663,113073104,SRX5075170,SMARCA4,441
chr1,113072667,113073738,SRX5075174,SMARCA4,1071
chr1,113072690,113073168,SRX5075176,SMARCA4,478
chr1,113072729,113073014,SRX5716470,SMARCA4,285
chr1,113072742,113073080,SRX5716469,SMARCA4,338
chr1,113072767,113073018,SRX5716464,SMARCA4,251
chr1,113072771,113073033,SRX5075169,SMARCA4,262
chr1,113072781,113073672,SRX20140895,INTS13,891
chr1,113072824,113073066,SRX5075175,SMARCA4,242
chr1,113072833,113073305,SRX5716463,SMARCA4,472
chr1,113073064,113073400,SRX20140897,INTS13,336
chr1,113073108,113073664,SRX20140868,INTS10,556
chr1,113073408,113073757,SRX5716469,SMARCA4,349
chr1,113073432,113073781,SRX5075170,SMARCA4,349
chr1,113073444,113073716,SRX16500059,CTCF,272
chr1,113073444,113073784,SRX5075169,SMARCA4,340
chr1,113073452,113073734,SRX5075176,SMARCA4,282
chr1,113073459,113073852,SRX5075168,SMARCA4,393
chr1,113073469,113073773,SRX5716470,SMARCA4,304
chr1,113073473,113073696,SRX16500062,CTCF,223
chr1,113073476,113073841,SRX5075175,SMARCA4,365
chr1,113073576,113073790,SRX5716464,SMARCA4,214
chr1,113074331,113074511,SRX5054308,FOSL2,180
chr1,113074334,113074613,SRX5054309,FOSL2,279
chr1,113123862,113124050,SRX5054308,FOSL2,188
chr1,113140425,113140938,SRX16500060,CTCF,513
chr1,113140430,113140887,SRX16500062,CTCF,457
chr1,113140466,113140934,SRX16500061,CTCF,468
chr1,113140469,113140968,SRX16500059,CTCF,499
chr1,113140556,113140899,SRX4174629,CTCF,343
chr1,113140606,113140842,SRX5075174,SMARCA4,236
chr1,113140616,113140795,SRX5075168,SMARCA4,179
chr1,113141738,113141927,SRX5075170,SMARCA4,189
chr1,113141769,113142018,SRX5054309,FOSL2,249
chr1,113142903,113143087,SRX5075170,SMARCA4,184
chr1,113166588,113166980,SRX20140869,INTS10,392
chr1,113178614,113178794,SRX5075174,SMARCA4,180
chr1,113389900,113390628,SRX5075174,SMARCA4,728
chr1,113389937,113390826,SRX20140895,INTS13,889
chr1,113389946,113390514,SRX5075168,SMARCA4,568
chr1,113389972,113390459,SRX5075170,SMARCA4,487
chr1,113389980,113390470,SRX5075176,SMARCA4,490
chr1,113390022,113390410,SRX5716464,SMARCA4,388
chr1,113390053,113390481,SRX5054307,FOSL2,428
chr1,113390198,113390415,SRX5716463,SMARCA4,217
chr1,113390226,113390446,SRX5716454,SOX3,220
chr1,113390242,113390437,SRX5716451,SOX2,195
chr1,113390268,113390466,SRX5054308,FOSL2,198
chr1,113390406,113390797,SRX20140868,INTS10,391
chr1,113390431,113390645,SRX20140867,INTS10,214
chr1,113390453,113390709,SRX20140879,CPSF3L,256
chr1,113396645,113396896,SRX5075176,SMARCA4,251
chr1,113396678,113396868,SRX5075175,SMARCA4,190
chr1,113396718,113396926,SRX5075169,SMARCA4,208
chr1,113452934,113453288,SRX16500060,CTCF,354
chr1,113452978,113453336,SRX16500059,CTCF,358
chr1,113456814,113457355,SRX5075175,SMARCA4,541
chr1,113456841,113457388,SRX5075170,SMARCA4,547
chr1,113456863,113457416,SRX5075169,SMARCA4,553
chr1,113456889,113457410,SRX5054309,FOSL2,521
chr1,113456893,113457407,SRX5075176,SMARCA4,514
chr1,113456898,113457354,SRX5054308,FOSL2,456
chr1,113456912,113457339,SRX5020214,SMARCA2,427
chr1,113456919,113457318,SRX5716469,SMARCA4,399
chr1,113456958,113457222,SRX5716467,SMARCA2,264
chr1,113456983,113457281,SRX5716470,SMARCA4,298
chr1,113456984,113457257,SRX5020211,SMARCA2,273
chr1,113456989,113457264,SRX5075168,SMARCA4,275
chr1,113457006,113457271,SRX5075174,SMARCA4,265
chr1,113529964,113530213,SRX5716470,SMARCA4,249
chr1,113530106,113530317,SRX5075176,SMARCA4,211
chr1,113534136,113534385,SRX5716470,SMARCA4,249
chr1,113534140,113534393,SRX5075169,SMARCA4,253
chr1,113534151,113534445,SRX5054309,FOSL2,294
chr1,113534190,113534384,SRX5075175,SMARCA4,194
chr1,113534212,113534385,SRX5075170,SMARCA4,173
chr1,113535014,113535183,SRX5075170,SMARCA4,169
chr1,113536189,113536491,SRX5054308,FOSL2,302
chr1,113536199,113536495,SRX5054309,FOSL2,296
chr1,113536246,113536492,SRX5075170,SMARCA4,246
chr1,113536260,113536585,SRX5075169,SMARCA4,325
chr1,113536269,113536500,SRX5075176,SMARCA4,231
chr1,113542090,113542496,SRX5075175,SMARCA4,406
chr1,113542098,113542576,SRX5075169,SMARCA4,478
chr1,113542102,113542542,SRX5075170,SMARCA4,440
chr1,113542108,113542424,SRX5075174,SMARCA4,316
chr1,113542112,113542505,SRX5716467,SMARCA2,393
chr1,113542114,113542468,SRX5054309,FOSL2,354
chr1,113542118,113542479,SRX5054308,FOSL2,361
chr1,113542123,113542519,SRX5075176,SMARCA4,396
chr1,113542153,113542448,SRX5716469,SMARCA4,295
chr1,113542203,113542537,SRX5716468,SMARCA2,334
chr1,113542205,113542495,SRX5716470,SMARCA4,290
chr1,113542223,113542459,SRX5075168,SMARCA4,236
chr1,113605161,113605379,SRX5075170,SMARCA4,218
chr1,113608392,113608635,SRX20140867,INTS10,243
chr1,113615536,113615729,SRX5054309,FOSL2,193
chr1,113617542,113617741,SRX5054308,FOSL2,199
chr1,113677737,113678334,SRX16500059,CTCF,597
chr1,113677813,113678370,SRX16500060,CTCF,557
chr1,113677827,113678316,SRX16500062,CTCF,489
chr1,113677855,113678320,SRX16500061,CTCF,465
chr1,113677949,113678159,SRX4174629,CTCF,210
chr1,113677975,113678218,SRX5075174,SMARCA4,243
chr1,113677983,113678183,SRX5075168,SMARCA4,200
chr1,113677988,113678175,SRX5075176,SMARCA4,187
chr1,113701530,113701797,SRX5075168,SMARCA4,267
chr1,113701573,113701753,SRX5075174,SMARCA4,180
chr1,113747338,113747708,SRX5054309,FOSL2,370
chr1,113747423,113747775,SRX5716469,SMARCA4,352
chr1,113747426,113747639,SRX5075176,SMARCA4,213
chr1,113747443,113747662,SRX5716470,SMARCA4,219
chr1,113747448,113747723,SRX5075169,SMARCA4,275
chr1,113747456,113747663,SRX5075175,SMARCA4,207
chr1,113747464,113747687,SRX5075170,SMARCA4,223
chr1,113747486,113747734,SRX5054308,FOSL2,248
chr1,113758064,113758314,SRX5075174,SMARCA4,250
chr1,113758872,113759903,SRX20140895,INTS13,1031
chr1,113758928,113759314,SRX5716464,SMARCA4,386
chr1,113759008,113759761,SRX20140867,INTS10,753
chr1,113759047,113759795,SRX20140868,INTS10,748
chr1,113759049,113759537,SRX5075168,SMARCA4,488
chr1,113759065,113759619,SRX5075174,SMARCA4,554
chr1,113759123,113759446,SRX5716463,SMARCA4,323
chr1,113759170,113759489,SRX20140879,CPSF3L,319
chr1,113759180,113759431,SRX20140894,INTS13,251
chr1,113759226,113759793,SRX20140881,CPSF3L,567
chr1,113759251,113759598,SRX20140896,INTS13,347
chr1,113759253,113759647,SRX5054308,FOSL2,394
chr1,113759310,113759630,SRX5054309,FOSL2,320
chr1,113759315,113759795,SRX20140897,INTS13,480
chr1,113759336,113759617,SRX5075169,SMARCA4,281
chr1,113759355,113759851,SRX5075175,SMARCA4,496
chr1,113759371,113759631,SRX5075176,SMARCA4,260
chr1,113759378,113759590,SRX5054307,FOSL2,212
chr1,113759394,113759637,SRX5075170,SMARCA4,243
chr1,113759567,113759832,SRX20140879,CPSF3L,265
chr1,113759718,113759981,SRX5075170,SMARCA4,263
chr1,113759746,113760017,SRX5716469,SMARCA4,271
chr1,113765243,113765616,SRX5716469,SMARCA4,373
chr1,113765292,113765667,SRX5716470,SMARCA4,375
chr1,113765459,113765641,SRX5075176,SMARCA4,182
chr1,113768898,113769296,SRX5075174,SMARCA4,398
chr1,113768942,113769251,SRX5716451,SOX2,309
chr1,113768958,113769247,SRX5716463,SMARCA4,289
chr1,113768971,113769307,SRX5075168,SMARCA4,336
chr1,113804795,113805090,SRX5054308,FOSL2,295
chr1,113804823,113805093,SRX5054309,FOSL2,270
chr1,113811900,113812814,SRX20140895,INTS13,914
chr1,113812058,113812589,SRX20140896,INTS13,531
chr1,113812078,113812785,SRX20140867,INTS10,707
chr1,113812126,113812693,SRX20140881,CPSF3L,567
chr1,113812133,113812442,SRX20140879,CPSF3L,309
chr1,113812133,113812693,SRX20140897,INTS13,560
chr1,113812167,113812822,SRX20140868,INTS10,655
chr1,113812183,113812859,SRX5075174,SMARCA4,676
chr1,113812214,113812937,SRX5075168,SMARCA4,723
chr1,113812267,113812667,SRX5716451,SOX2,400
chr1,113812301,113812759,SRX5075169,SMARCA4,458
chr1,113812309,113812758,SRX5075170,SMARCA4,449
chr1,113812314,113812795,SRX5075176,SMARCA4,481
chr1,113812316,113812744,SRX5716464,SMARCA4,428
chr1,113812319,113812790,SRX5716463,SMARCA4,471
chr1,113812335,113812658,SRX5716454,SOX3,323
chr1,113812364,113812598,SRX5054308,FOSL2,234
chr1,113812372,113812555,SRX5054307,FOSL2,183
chr1,113812451,113812803,SRX5716470,SMARCA4,352
chr1,113812454,113812693,SRX5075175,SMARCA4,239
chr1,113812541,113812854,SRX20140879,CPSF3L,313
chr1,113830028,113830388,SRX5075175,SMARCA4,360
chr1,113830044,113830381,SRX5075169,SMARCA4,337
chr1,113830080,113830292,SRX5716469,SMARCA4,212
chr1,113830080,113830306,SRX5054309,FOSL2,226
chr1,113830102,113830333,SRX5054308,FOSL2,231
chr1,113835602,113836197,SRX16500059,CTCF,595
chr1,113835603,113836262,SRX16500062,CTCF,659
chr1,113835618,113836231,SRX16500060,CTCF,613
chr1,113835640,113836159,SRX16500061,CTCF,519
chr1,113835835,113836013,SRX5075170,SMARCA4,178
chr1,113860914,113861230,SRX5075169,SMARCA4,316
chr1,113860920,113861240,SRX5075175,SMARCA4,320
chr1,113860973,113861271,SRX5054308,FOSL2,298
chr1,113860978,113861286,SRX5054309,FOSL2,308
chr1,113860987,113861221,SRX5075176,SMARCA4,234
chr1,113860998,113861263,SRX5075170,SMARCA4,265
chr1,113871656,113871843,SRX5075175,SMARCA4,187
chr1,113871692,113871891,SRX5054308,FOSL2,199
chr1,113904518,113905497,SRX5075176,SMARCA4,979
chr1,113904632,113905525,SRX20140895,INTS13,893
chr1,113904642,113905457,SRX5075170,SMARCA4,815
chr1,113904644,113905023,SRX5075175,SMARCA4,379
chr1,113904710,113904909,SRX5054308,FOSL2,199
chr1,113904768,113905409,SRX5075169,SMARCA4,641
chr1,113904771,113905403,SRX5716470,SMARCA4,632
chr1,113904780,113905480,SRX5075168,SMARCA4,700
chr1,113904794,113905501,SRX5075174,SMARCA4,707
chr1,113904839,113905292,SRX20140868,INTS10,453
chr1,113904842,113905405,SRX5054309,FOSL2,563
chr1,113904904,113905161,SRX5716469,SMARCA4,257
chr1,113904947,113905257,SRX5716451,SOX2,310
chr1,113905021,113905272,SRX5716463,SMARCA4,251
chr1,113905049,113905502,SRX16500061,CTCF,453
chr1,113905056,113905497,SRX16500059,CTCF,441
chr1,113905065,113905307,SRX5716454,SOX3,242
chr1,113905066,113905443,SRX16500060,CTCF,377
chr1,113905071,113905354,SRX5716464,SMARCA4,283
chr1,113905078,113905390,SRX16500062,CTCF,312
chr1,113905089,113905289,SRX5020211,SMARCA2,200
chr1,113905123,113905468,SRX5075175,SMARCA4,345
chr1,113929263,113930124,SRX20140895,INTS13,861
chr1,113929342,113929759,SRX20140867,INTS10,417
chr1,113929378,113929694,SRX20140868,INTS10,316
chr1,113929411,113929782,SRX5075174,SMARCA4,371
chr1,113929461,113929661,SRX5075168,SMARCA4,200
chr1,113929531,113929777,SRX5716464,SMARCA4,246
chr1,113929555,113929779,SRX5075170,SMARCA4,224
chr1,113929673,113929965,SRX16500059,CTCF,292
chr1,113931623,113931814,SRX5054308,FOSL2,191
chr1,113949103,113949421,SRX16500060,CTCF,318
chr1,113949184,113949430,SRX5075170,SMARCA4,246
chr1,113949184,113949515,SRX16500059,CTCF,331
chr1,113966065,113966355,SRX5075174,SMARCA4,290
chr1,113976698,113977046,SRX20140895,INTS13,348
chr1,113976805,113977229,SRX5075174,SMARCA4,424
chr1,113976831,113977231,SRX5075168,SMARCA4,400
chr1,113976902,113977268,SRX16500060,CTCF,366
chr1,113976930,113977196,SRX16500062,CTCF,266
chr1,113976945,113977252,SRX16500059,CTCF,307
chr1,113976982,113977220,SRX16500061,CTCF,238
chr1,113978670,113979177,SRX16500059,CTCF,507
chr1,113978735,113979139,SRX16500062,CTCF,404
chr1,113978735,113979184,SRX16500060,CTCF,449
chr1,113978746,113979158,SRX16500061,CTCF,412
chr1,113978826,113979518,SRX5075170,SMARCA4,692
chr1,113978849,113979589,SRX5075169,SMARCA4,740
chr1,113978851,113979143,SRX5075174,SMARCA4,292
chr1,113978852,113979148,SRX4174629,CTCF,296
chr1,113978861,113979156,SRX5075168,SMARCA4,295
chr1,113978865,113979566,SRX5075175,SMARCA4,701
chr1,113978875,113979424,SRX5716470,SMARCA4,549
chr1,113978897,113979566,SRX5075176,SMARCA4,669
chr1,113978927,113979461,SRX5716469,SMARCA4,534
chr1,113979237,113979452,SRX5716467,SMARCA2,215
chr1,113979248,113979450,SRX5054308,FOSL2,202
chr1,113979260,113979554,SRX5054309,FOSL2,294
chr1,113979270,113979477,SRX5020214,SMARCA2,207
chr1,113998390,113998728,SRX5075170,SMARCA4,338
chr1,113998461,113998713,SRX5075176,SMARCA4,252
chr1,114008631,114008817,SRX5054309,FOSL2,186
chr1,114009483,114009713,SRX5716469,SMARCA4,230
chr1,114009485,114009728,SRX5054308,FOSL2,243
chr1,114014987,114015504,SRX5075176,SMARCA4,517
chr1,114015011,114015468,SRX5075169,SMARCA4,457
chr1,114015025,114015509,SRX5075170,SMARCA4,484
chr1,114015037,114015502,SRX5054309,FOSL2,465
chr1,114015042,114015542,SRX5075175,SMARCA4,500
chr1,114015073,114015429,SRX5716470,SMARCA4,356
chr1,114015086,114015481,SRX5054308,FOSL2,395
chr1,114015092,114015443,SRX5716469,SMARCA4,351
chr1,114015092,114015477,SRX5075168,SMARCA4,385
chr1,114015108,114015329,SRX5716467,SMARCA2,221
chr1,114015152,114015504,SRX5075174,SMARCA4,352
chr1,114015181,114015428,SRX5020214,SMARCA2,247
chr1,114015212,114015396,SRX5075182,SMARCA2,184
chr1,114024045,114024428,SRX5716469,SMARCA4,383
chr1,114024061,114024473,SRX5075176,SMARCA4,412
chr1,114024102,114024475,SRX5075170,SMARCA4,373
chr1,114024114,114024383,SRX5716468,SMARCA2,269
chr1,114024117,114024427,SRX5716467,SMARCA2,310
chr1,114024118,114024453,SRX5716470,SMARCA4,335
chr1,114024126,114024380,SRX5054309,FOSL2,254
chr1,114024128,114024374,SRX5075169,SMARCA4,246
chr1,114024137,114024337,SRX5020211,SMARCA2,200
chr1,114024142,114024424,SRX5075175,SMARCA4,282
chr1,114024165,114024370,SRX5020214,SMARCA2,205
chr1,114026040,114026289,SRX5054308,FOSL2,249
chr1,114026049,114026299,SRX5075175,SMARCA4,250
chr1,114026075,114026301,SRX5054309,FOSL2,226
chr1,114026084,114026329,SRX5075169,SMARCA4,245
chr1,114026103,114026312,SRX5020211,SMARCA2,209
chr1,114032831,114033176,SRX5054309,FOSL2,345
chr1,114032836,114033113,SRX5075169,SMARCA4,277
chr1,114032940,114033273,SRX5075176,SMARCA4,333
chr1,114032953,114033340,SRX5075170,SMARCA4,387
chr1,114033253,114033642,SRX16500062,CTCF,389
chr1,114033253,114033654,SRX16500060,CTCF,401
chr1,114033264,114033678,SRX16500059,CTCF,414
chr1,114033280,114033702,SRX16500061,CTCF,422
chr1,114037969,114038327,SRX5075174,SMARCA4,358
chr1,114038020,114038227,SRX5075168,SMARCA4,207
chr1,114061445,114061680,SRX5054309,FOSL2,235
chr1,114062732,114062976,SRX5075170,SMARCA4,244
chr1,114075846,114076061,SRX5075176,SMARCA4,215
chr1,114075849,114076061,SRX5075170,SMARCA4,212
chr1,114094289,114094546,SRX5075170,SMARCA4,257
chr1,114094318,114094522,SRX5075169,SMARCA4,204
chr1,114094333,114094559,SRX5075176,SMARCA4,226
chr1,114094348,114094538,SRX5054308,FOSL2,190
chr1,114099840,114100098,SRX5075170,SMARCA4,258
chr1,114099864,114100122,SRX5075176,SMARCA4,258
chr1,114108658,114109121,SRX5716460,Epitope tags,463
chr1,114108727,114109308,SRX5054309,FOSL2,581
chr1,114108727,114109336,SRX5075176,SMARCA4,609
chr1,114108742,114109357,SRX5075170,SMARCA4,615
chr1,114108800,114109261,SRX5075169,SMARCA4,461
chr1,114108804,114109124,SRX5716470,SMARCA4,320
chr1,114108806,114109283,SRX5054308,FOSL2,477
chr1,114108826,114109288,SRX5075175,SMARCA4,462
chr1,114108849,114109202,SRX5716467,SMARCA2,353
chr1,114108870,114109254,SRX5020214,SMARCA2,384
chr1,114108887,114109232,SRX5716469,SMARCA4,345
chr1,114112329,114112604,SRX5075170,SMARCA4,275
chr1,114112330,114112603,SRX5075176,SMARCA4,273
chr1,114122866,114123400,SRX5075170,SMARCA4,534
chr1,114122887,114123233,SRX5075176,SMARCA4,346
chr1,114122956,114123283,SRX5054309,FOSL2,327
chr1,114122960,114123200,SRX5075174,SMARCA4,240
chr1,114123065,114123347,SRX5075168,SMARCA4,282
chr1,114123390,114123571,SRX5075176,SMARCA4,181
chr1,114145550,114145876,SRX5075170,SMARCA4,326
chr1,114145560,114145812,SRX5075176,SMARCA4,252
chr1,114145560,114145816,SRX5075168,SMARCA4,256
chr1,114145577,114145908,SRX5054309,FOSL2,331
chr1,114145612,114145792,SRX5054308,FOSL2,180
chr1,114145622,114145862,SRX5054307,FOSL2,240
chr1,114152653,114152833,SRX5075174,SMARCA4,180
chr1,114152706,114152923,SRX5075170,SMARCA4,217
chr1,114203578,114204125,SRX5075174,SMARCA4,547
chr1,114203660,114204225,SRX5075168,SMARCA4,565
chr1,114203833,114204038,SRX5716463,SMARCA4,205
chr1,114224323,114224675,SRX5075176,SMARCA4,352
chr1,114224345,114224624,SRX5075170,SMARCA4,279
chr1,114282735,114283194,SRX16500061,CTCF,459
chr1,114282771,114283238,SRX16500059,CTCF,467
chr1,114282771,114283248,SRX16500060,CTCF,477
chr1,114282796,114283139,SRX4174629,CTCF,343
chr1,114282802,114283239,SRX16500062,CTCF,437
chr1,114282828,114283146,SRX5075174,SMARCA4,318
chr1,114282839,114283131,SRX5075170,SMARCA4,292
chr1,114282842,114283055,SRX5716464,SMARCA4,213
chr1,114282849,114283131,SRX5075168,SMARCA4,282
chr1,114282859,114283178,SRX5075176,SMARCA4,319
chr1,114282884,114283112,SRX5075175,SMARCA4,228
chr1,114286255,114286587,SRX5054309,FOSL2,332
chr1,114286259,114286458,SRX5075168,SMARCA4,199
chr1,114286265,114286600,SRX5075175,SMARCA4,335
chr1,114286296,114286576,SRX5075176,SMARCA4,280
chr1,114286299,114286585,SRX5075170,SMARCA4,286
chr1,114286305,114286522,SRX5716469,SMARCA4,217
chr1,114286335,114286531,SRX5075174,SMARCA4,196
chr1,114286340,114286590,SRX5054308,FOSL2,250
chr1,114286341,114286529,SRX5075169,SMARCA4,188
chr1,114310725,114311309,SRX5075169,SMARCA4,584
chr1,114310743,114311316,SRX5075175,SMARCA4,573
chr1,114310773,114311459,SRX5075176,SMARCA4,686
chr1,114310779,114311346,SRX5716470,SMARCA4,567
chr1,114310787,114311354,SRX5075170,SMARCA4,567
chr1,114310921,114311317,SRX5716469,SMARCA4,396
chr1,114310953,114311298,SRX5020211,SMARCA2,345
chr1,114310991,114311263,SRX5075181,SMARCA2,272
chr1,114311002,114311329,SRX5716467,SMARCA2,327
chr1,114311075,114311349,SRX5054308,FOSL2,274
chr1,114311092,114311339,SRX5716468,SMARCA2,247
chr1,114311102,114311355,SRX5054309,FOSL2,253
chr1,114319334,114319765,SRX5716469,SMARCA4,431
chr1,114319466,114319772,SRX5075169,SMARCA4,306
chr1,114320547,114320987,SRX5054309,FOSL2,440
chr1,114320595,114320888,SRX5020214,SMARCA2,293
chr1,114320596,114320948,SRX5075175,SMARCA4,352
chr1,114320597,114320923,SRX5075169,SMARCA4,326
chr1,114320605,114320882,SRX5054308,FOSL2,277
chr1,114320630,114320895,SRX5075176,SMARCA4,265
chr1,114320641,114320843,SRX5075170,SMARCA4,202
chr1,114320663,114320912,SRX5716469,SMARCA4,249
chr1,114320706,114320924,SRX5075168,SMARCA4,218
chr1,114322699,114322889,SRX5054309,FOSL2,190
chr1,114346332,114347092,SRX4174629,CTCF,760
chr1,114346353,114346993,SRX16500060,CTCF,640
chr1,114346380,114346964,SRX16500059,CTCF,584
chr1,114346382,114346949,SRX16500062,CTCF,567
chr1,114346390,114346972,SRX16500061,CTCF,582
chr1,114346424,114346794,SRX5716469,SMARCA4,370
chr1,114346432,114346852,SRX5716470,SMARCA4,420
chr1,114346457,114346914,SRX5716463,SMARCA4,457
chr1,114346457,114346926,SRX5075174,SMARCA4,469
chr1,114346462,114346880,SRX5075170,SMARCA4,418
chr1,114346463,114346903,SRX5075176,SMARCA4,440
chr1,114346472,114346890,SRX5075169,SMARCA4,418
chr1,114346473,114346870,SRX5075175,SMARCA4,397
chr1,114346486,114346908,SRX5075168,SMARCA4,422
chr1,114346491,114346864,SRX5716464,SMARCA4,373
chr1,114346504,114346856,SRX20140895,INTS13,352
chr1,114346537,114346752,SRX5716467,SMARCA2,215
chr1,114353292,114353665,SRX5075176,SMARCA4,373
chr1,114353313,114353747,SRX5075170,SMARCA4,434
chr1,114353340,114353575,SRX5716470,SMARCA4,235
chr1,114353385,114353673,SRX5054309,FOSL2,288
chr1,114353405,114353585,SRX5075169,SMARCA4,180
chr1,114353445,114353658,SRX5054308,FOSL2,213
chr1,114428012,114428429,SRX16500059,CTCF,417
chr1,114428053,114428413,SRX16500060,CTCF,360
chr1,114428079,114428408,SRX16500061,CTCF,329
chr1,114428109,114428367,SRX16500062,CTCF,258
chr1,114473482,114473700,SRX5054309,FOSL2,218
chr1,114510788,114511665,SRX20140895,INTS13,877
chr1,114510852,114511396,SRX20140868,INTS10,544
chr1,114510882,114511456,SRX20140867,INTS10,574
chr1,114510931,114511442,SRX20140897,INTS13,511
chr1,114510992,114511343,SRX20140869,INTS10,351
chr1,114511009,114511469,SRX5075174,SMARCA4,460
chr1,114511018,114511457,SRX5075176,SMARCA4,439
chr1,114511056,114511327,SRX5716463,SMARCA4,271
chr1,114511066,114511526,SRX5075170,SMARCA4,460
chr1,114511093,114511364,SRX5716470,SMARCA4,271
chr1,114511139,114511371,SRX5716469,SMARCA4,232
chr1,114511175,114511613,SRX5075168,SMARCA4,438
chr1,114511328,114511637,SRX5075169,SMARCA4,309
chr1,114551384,114551633,SRX5716463,SMARCA4,249
chr1,114551390,114551649,SRX5075174,SMARCA4,259
chr1,114558491,114558946,SRX16500060,CTCF,455
chr1,114558494,114558971,SRX16500059,CTCF,477
chr1,114558524,114558881,SRX16500062,CTCF,357
chr1,114558536,114558890,SRX16500061,CTCF,354
chr1,114558653,114558826,SRX5075174,SMARCA4,173
chr1,114581356,114581654,SRX20140867,INTS10,298
chr1,114581366,114581939,SRX5075174,SMARCA4,573
chr1,114581376,114581762,SRX5716463,SMARCA4,386
chr1,114581396,114581890,SRX20140895,INTS13,494
chr1,114581422,114581935,SRX5075168,SMARCA4,513
chr1,114581423,114581801,SRX20140897,INTS13,378
chr1,114581464,114581798,SRX20140896,INTS13,334
chr1,114581468,114581822,SRX20140868,INTS10,354
chr1,114581472,114581773,SRX20140881,CPSF3L,301
chr1,114581613,114581871,SRX5716464,SMARCA4,258
chr1,114581643,114581849,SRX5716454,SOX3,206
chr1,114585299,114585580,SRX5075170,SMARCA4,281
chr1,114585315,114585611,SRX5075169,SMARCA4,296
chr1,114585323,114585604,SRX5075176,SMARCA4,281
chr1,114585351,114585579,SRX5716470,SMARCA4,228
chr1,114585417,114585609,SRX5075175,SMARCA4,192
chr1,114585432,114585647,SRX5716467,SMARCA2,215
chr1,114610623,114610965,SRX5054308,FOSL2,342
chr1,114610630,114610914,SRX5054309,FOSL2,284
chr1,114610643,114611011,SRX5075176,SMARCA4,368
chr1,114610649,114611037,SRX5075170,SMARCA4,388
chr1,114669547,114669919,SRX5716469,SMARCA4,372
chr1,114669623,114670060,SRX5075169,SMARCA4,437
chr1,114669668,114670084,SRX5075175,SMARCA4,416
chr1,114669790,114670102,SRX5716470,SMARCA4,312
chr1,114669843,114670355,SRX5075170,SMARCA4,512
chr1,114669865,114670254,SRX5075176,SMARCA4,389
chr1,114669880,114670291,SRX5075174,SMARCA4,411
chr1,114670005,114670411,SRX16500059,CTCF,406
chr1,114670015,114670363,SRX16500062,CTCF,348
chr1,114670104,114670314,SRX5716463,SMARCA4,210
chr1,114670106,114670418,SRX5075168,SMARCA4,312
chr1,114671391,114671705,SRX16500060,CTCF,314
chr1,114671433,114671657,SRX16500062,CTCF,224
chr1,114700158,114700433,SRX5075176,SMARCA4,275
chr1,114716488,114716834,SRX20140869,INTS10,346
chr1,114716524,114717134,SRX20140895,INTS13,610
chr1,114716551,114717015,SRX20140897,INTS13,464
chr1,114716552,114717005,SRX5075170,SMARCA4,453
chr1,114716611,114717136,SRX5075174,SMARCA4,525
chr1,114716641,114716902,SRX20140868,INTS10,261
chr1,114716646,114717081,SRX5075168,SMARCA4,435
chr1,114716695,114716984,SRX5716464,SMARCA4,289
chr1,114716709,114716892,SRX5054308,FOSL2,183
chr1,114716747,114716951,SRX5054309,FOSL2,204
chr1,114716792,114717075,SRX5075176,SMARCA4,283
chr1,114716825,114717153,SRX5716463,SMARCA4,328
chr1,114757577,114758270,SRX20140895,INTS13,693
chr1,114757585,114758158,SRX20140867,INTS10,573
chr1,114757636,114758199,SRX20140868,INTS10,563
chr1,114757637,114758141,SRX20140894,INTS13,504
chr1,114757638,114757993,SRX20140869,INTS10,355
chr1,114757641,114758183,SRX20140896,INTS13,542
chr1,114757655,114758127,SRX20140881,CPSF3L,472
chr1,114757656,114758290,SRX20140897,INTS13,634
chr1,114757668,114758115,SRX20140879,CPSF3L,447
chr1,114757785,114758400,SRX16500062,CTCF,615
chr1,114757916,114758488,SRX16500060,CTCF,572
chr1,114757961,114758333,SRX5716464,SMARCA4,372
chr1,114757981,114758407,SRX5075174,SMARCA4,426
chr1,114757988,114758352,SRX5075170,SMARCA4,364
chr1,114757990,114758483,SRX16500059,CTCF,493
chr1,114757993,114758368,SRX5075168,SMARCA4,375
chr1,114758012,114758349,SRX5075176,SMARCA4,337
chr1,114758057,114758319,SRX4174629,CTCF,262
chr1,114758068,114758143,SRX1424893,POU3F2,75
chr1,114758070,114758110,SRX1424894,POU3F2,40
chr1,114758072,114758350,SRX5075169,SMARCA4,278
chr1,114758072,114758448,SRX5075175,SMARCA4,376
chr1,114758076,114758401,SRX16500061,CTCF,325
chr1,114758113,114758361,SRX5716470,SMARCA4,248
chr1,114780236,114781014,SRX5716470,SMARCA4,778
chr1,114780246,114780983,SRX5075174,SMARCA4,737
chr1,114780252,114780883,SRX5075169,SMARCA4,631
chr1,114780288,114780957,SRX5075170,SMARCA4,669
chr1,114780310,114780862,SRX20140869,INTS10,552
chr1,114780324,114780686,SRX5716469,SMARCA4,362
chr1,114780329,114780994,SRX20140895,INTS13,665
chr1,114780383,114780914,SRX5075175,SMARCA4,531
chr1,114780409,114780742,SRX20140881,CPSF3L,333
chr1,114780419,114780969,SRX5075176,SMARCA4,550
chr1,114780424,114780933,SRX5075168,SMARCA4,509
chr1,114780443,114780754,SRX20140879,CPSF3L,311
chr1,114780456,114780805,SRX20140867,INTS10,349
chr1,114780464,114780888,SRX20140868,INTS10,424
chr1,114780478,114780779,SRX5716463,SMARCA4,301
chr1,114780507,114780849,SRX20140897,INTS13,342
chr1,114956642,114956883,SRX16500059,CTCF,241
chr1,114979125,114979724,SRX16500059,CTCF,599
chr1,114979192,114979736,SRX16500060,CTCF,544
chr1,114979283,114979779,SRX16500061,CTCF,496
chr1,114979298,114979735,SRX16500062,CTCF,437
chr1,114979415,114979625,SRX4174629,CTCF,210
chr1,115041690,115041914,SRX16500062,CTCF,224
chr1,115041717,115041955,SRX16500059,CTCF,238
chr1,115041718,115041960,SRX16500061,CTCF,242
chr1,115041728,115041964,SRX16500060,CTCF,236
chr1,115052411,115052856,SRX16500062,CTCF,445
chr1,115052436,115052916,SRX16500060,CTCF,480
chr1,115052438,115052979,SRX16500059,CTCF,541
chr1,115052458,115052898,SRX16500061,CTCF,440
chr1,115052517,115052821,SRX4174629,CTCF,304
chr1,115056333,115056885,SRX5075168,SMARCA4,552
chr1,115056341,115056869,SRX5075174,SMARCA4,528
chr1,115056412,115056905,SRX5716464,SMARCA4,493
chr1,115056428,115056746,SRX5716470,SMARCA4,318
chr1,115056462,115056674,SRX5075175,SMARCA4,212
chr1,115056471,115056791,SRX5075169,SMARCA4,320
chr1,115056508,115056742,SRX5716469,SMARCA4,234
chr1,115056512,115056876,SRX5716463,SMARCA4,364
chr1,115056540,115056764,SRX5075176,SMARCA4,224
chr1,115062614,115062800,SRX5054309,FOSL2,186
chr1,115089203,115090016,SRX20140895,INTS13,813
chr1,115089313,115089669,SRX5075168,SMARCA4,356
chr1,115089316,115089492,SRX5075174,SMARCA4,176
chr1,115089390,115089610,SRX5075176,SMARCA4,220
chr1,115089816,115090148,SRX16500060,CTCF,332
chr1,115089983,115090218,SRX16500062,CTCF,235
chr1,115110771,115111036,SRX5075174,SMARCA4,265
chr1,115110813,115111040,SRX5075168,SMARCA4,227
chr1,115112733,115113227,SRX16500060,CTCF,494
chr1,115112746,115113229,SRX16500061,CTCF,483
chr1,115112764,115113224,SRX16500059,CTCF,460
chr1,115112778,115113183,SRX16500062,CTCF,405
chr1,115112795,115113247,SRX4174629,CTCF,452
chr1,115112825,115113026,SRX5075174,SMARCA4,201
chr1,115112844,115113065,SRX5075168,SMARCA4,221
chr1,115114372,115114559,SRX5075175,SMARCA4,187
chr1,115114392,115114679,SRX5075176,SMARCA4,287
chr1,115114442,115114658,SRX5075169,SMARCA4,216
chr1,115133491,115133698,SRX5054309,FOSL2,207
chr1,115135115,115135411,SRX5075169,SMARCA4,296
chr1,115135161,115135337,SRX5075170,SMARCA4,176
chr1,115135254,115135445,SRX5054308,FOSL2,191
chr1,115135263,115135450,SRX5075175,SMARCA4,187
chr1,115138789,115139376,SRX16500060,CTCF,587
chr1,115138813,115139348,SRX16500059,CTCF,535
chr1,115138825,115139344,SRX16500061,CTCF,519
chr1,115138826,115139349,SRX16500062,CTCF,523
chr1,115138893,115139295,SRX4174629,CTCF,402
chr1,115138971,115139262,SRX5075168,SMARCA4,291
chr1,115138978,115139262,SRX5075176,SMARCA4,284
chr1,115139015,115139280,SRX5075170,SMARCA4,265
chr1,115139041,115139225,SRX5075174,SMARCA4,184
chr1,115139067,115139279,SRX5716470,SMARCA4,212
chr1,115158235,115158465,SRX5075176,SMARCA4,230
chr1,115166749,115167083,SRX5075168,SMARCA4,334
chr1,115166784,115167085,SRX5075176,SMARCA4,301
chr1,115166787,115167142,SRX5075174,SMARCA4,355
chr1,115166915,115167099,SRX5075170,SMARCA4,184
chr1,115168714,115169173,SRX5075176,SMARCA4,459
chr1,115168723,115169150,SRX5075175,SMARCA4,427
chr1,115168730,115169162,SRX5075170,SMARCA4,432
chr1,115168746,115169171,SRX5054309,FOSL2,425
chr1,115168751,115169143,SRX5075169,SMARCA4,392
chr1,115168767,115169135,SRX5054308,FOSL2,368
chr1,115179478,115179795,SRX5075169,SMARCA4,317
chr1,115179489,115179818,SRX5054309,FOSL2,329
chr1,115179502,115179821,SRX5054308,FOSL2,319
chr1,115183716,115184124,SRX5075170,SMARCA4,408
chr1,115183752,115184494,SRX5075176,SMARCA4,742
chr1,115184106,115184385,SRX5716468,SMARCA2,279
chr1,115184231,115184437,SRX5075170,SMARCA4,206
chr1,115184242,115184473,SRX5716470,SMARCA4,231
chr1,115190012,115190571,SRX5075169,SMARCA4,559
chr1,115190024,115190592,SRX5075176,SMARCA4,568
chr1,115190037,115190596,SRX5075170,SMARCA4,559
chr1,115190054,115190543,SRX5054309,FOSL2,489
chr1,115190083,115190599,SRX5075175,SMARCA4,516
chr1,115190098,115190460,SRX5716467,SMARCA2,362
chr1,115190116,115190521,SRX5054308,FOSL2,405
chr1,115190124,115190389,SRX5020214,SMARCA2,265
chr1,115190153,115190359,SRX5075181,SMARCA2,206
chr1,115190163,115190485,SRX5716469,SMARCA4,322
chr1,115190210,115190476,SRX5716470,SMARCA4,266
chr1,115190223,115190515,SRX5020211,SMARCA2,292
chr1,115199539,115199795,SRX5075174,SMARCA4,256
chr1,115199579,115199821,SRX5075168,SMARCA4,242
chr1,115218182,115218357,SRX5075176,SMARCA4,175
chr1,115227614,115228102,SRX5054309,FOSL2,488
chr1,115227714,115227941,SRX5075169,SMARCA4,227
chr1,115227722,115228063,SRX5054308,FOSL2,341
chr1,115227726,115227992,SRX5075175,SMARCA4,266
chr1,115237575,115237798,SRX5054308,FOSL2,223
chr1,115237589,115237840,SRX5075170,SMARCA4,251
chr1,115237590,115237884,SRX5054309,FOSL2,294
chr1,115237590,115237899,SRX5075175,SMARCA4,309
chr1,115237592,115237871,SRX5075176,SMARCA4,279
chr1,115251679,115252301,SRX5075175,SMARCA4,622
chr1,115251775,115252276,SRX5716469,SMARCA4,501
chr1,115251779,115252277,SRX5054308,FOSL2,498
chr1,115251791,115252367,SRX5075169,SMARCA4,576
chr1,115251814,115252334,SRX5716470,SMARCA4,520
chr1,115251818,115252288,SRX5054309,FOSL2,470
chr1,115251824,115252521,SRX5075176,SMARCA4,697
chr1,115251839,115252286,SRX5716467,SMARCA2,447
chr1,115251844,115252367,SRX5075170,SMARCA4,523
chr1,115251887,115252289,SRX5020211,SMARCA2,402
chr1,115251912,115252214,SRX5716468,SMARCA2,302
chr1,115251981,115252202,SRX5075181,SMARCA2,221
chr1,115258400,115258594,SRX5054309,FOSL2,194
chr1,115258418,115258670,SRX5054308,FOSL2,252
chr1,115265174,115265409,SRX5020211,SMARCA2,235
chr1,115265198,115265452,SRX5075169,SMARCA4,254
chr1,115265206,115265421,SRX5716467,SMARCA2,215
chr1,115265238,115265473,SRX5075170,SMARCA4,235
chr1,115275224,115275566,SRX16500060,CTCF,342
chr1,115277216,115277665,SRX5054309,FOSL2,449
chr1,115277305,115277617,SRX5020214,SMARCA2,312
chr1,115277307,115277563,SRX5054308,FOSL2,256
chr1,115277349,115277550,SRX5075169,SMARCA4,201
chr1,115280031,115280296,SRX5075170,SMARCA4,265
chr1,115280036,115280367,SRX5075176,SMARCA4,331
chr1,115280067,115280279,SRX5716469,SMARCA4,212
chr1,115280087,115280298,SRX5716470,SMARCA4,211
chr1,115280106,115280324,SRX5075169,SMARCA4,218
chr1,115285246,115285529,SRX5075170,SMARCA4,283
chr1,115285261,115285615,SRX5075176,SMARCA4,354
chr1,115285294,115285496,SRX5075169,SMARCA4,202
chr1,115285324,115285536,SRX5716469,SMARCA4,212
chr1,115300063,115300403,SRX5075170,SMARCA4,340
chr1,115300108,115300470,SRX5075176,SMARCA4,362
chr1,115300175,115300396,SRX5075175,SMARCA4,221
chr1,115300195,115300500,SRX5054308,FOSL2,305
chr1,115300211,115300539,SRX5075169,SMARCA4,328
chr1,115300212,115300468,SRX5054309,FOSL2,256
chr1,115300510,115301035,SRX5075168,SMARCA4,525
chr1,115300612,115300995,SRX5075174,SMARCA4,383
chr1,115302399,115302800,SRX5075170,SMARCA4,401
chr1,115302405,115302824,SRX5075176,SMARCA4,419
chr1,115314787,115315118,SRX5075169,SMARCA4,331
chr1,115314801,115315041,SRX5054308,FOSL2,240
chr1,115314821,115315076,SRX5054309,FOSL2,255
chr1,115314827,115315053,SRX5020211,SMARCA2,226
chr1,115314836,115315071,SRX5075175,SMARCA4,235
chr1,115314855,115315072,SRX5075170,SMARCA4,217
chr1,115314861,115315086,SRX5075176,SMARCA4,225
chr1,115314874,115315107,SRX5075181,SMARCA2,233
chr1,115322760,115322945,SRX5054309,FOSL2,185
chr1,115325955,115326142,SRX5075175,SMARCA4,187
chr1,115325956,115326142,SRX5075176,SMARCA4,186
chr1,115325957,115326196,SRX5075170,SMARCA4,239
chr1,115330605,115330895,SRX5054309,FOSL2,290
chr1,115330616,115330890,SRX5075169,SMARCA4,274
chr1,115330620,115330944,SRX5075170,SMARCA4,324
chr1,115330649,115330896,SRX5716470,SMARCA4,247
chr1,115330657,115330953,SRX5075175,SMARCA4,296
chr1,115338046,115338392,SRX5075170,SMARCA4,346
chr1,115338096,115338344,SRX5054308,FOSL2,248
chr1,115338098,115338383,SRX5716469,SMARCA4,285
chr1,115338107,115338442,SRX5075175,SMARCA4,335
chr1,115338111,115338449,SRX5054309,FOSL2,338
chr1,115338117,115338347,SRX5075176,SMARCA4,230
chr1,115338138,115338377,SRX5075169,SMARCA4,239
chr1,115338149,115338444,SRX5075174,SMARCA4,295
chr1,115338281,115338563,SRX16500059,CTCF,282
chr1,115364467,115364723,SRX5716469,SMARCA4,256
chr1,115364544,115364755,SRX5716470,SMARCA4,211
chr1,115364547,115364895,SRX5075169,SMARCA4,348
chr1,115364550,115364739,SRX5075170,SMARCA4,189
chr1,115364551,115364749,SRX5075175,SMARCA4,198
chr1,115364565,115364752,SRX5054308,FOSL2,187
chr1,115364565,115364843,SRX5020211,SMARCA2,278
chr1,115364576,115364751,SRX5075176,SMARCA4,175
chr1,115409768,115410078,SRX5075176,SMARCA4,310
chr1,115409778,115410065,SRX5075170,SMARCA4,287
chr1,115409829,115410040,SRX5075169,SMARCA4,211
chr1,115426361,115426553,SRX5075169,SMARCA4,192
chr1,115426375,115426562,SRX5075175,SMARCA4,187
chr1,115430811,115431058,SRX5054309,FOSL2,247
chr1,115430820,115431039,SRX5054308,FOSL2,219
chr1,115469577,115470073,SRX16500060,CTCF,496
chr1,115469628,115470044,SRX16500061,CTCF,416
chr1,115469630,115470098,SRX16500059,CTCF,468
chr1,115469657,115470047,SRX16500062,CTCF,390
chr1,115469735,115469958,SRX4174629,CTCF,223
chr1,115470229,115470412,SRX5054309,FOSL2,183
chr1,115505059,115505448,SRX5716470,SMARCA4,389
chr1,115505067,115505469,SRX5716468,SMARCA2,402
chr1,115505077,115505599,SRX5075176,SMARCA4,522
chr1,115505088,115505533,SRX5075170,SMARCA4,445
chr1,115505096,115505454,SRX5716467,SMARCA2,358
chr1,115505123,115505459,SRX5075169,SMARCA4,336
chr1,115505137,115505482,SRX5716469,SMARCA4,345
chr1,115505173,115505387,SRX5075175,SMARCA4,214
chr1,115507157,115507532,SRX16500061,CTCF,375
chr1,115507163,115507504,SRX16500059,CTCF,341
chr1,115507206,115507500,SRX16500060,CTCF,294
chr1,115507217,115507553,SRX16500062,CTCF,336
chr1,115507234,115507457,SRX5075174,SMARCA4,223
chr1,115507255,115507439,SRX5075168,SMARCA4,184
chr1,115530214,115530814,SRX5075170,SMARCA4,600
chr1,115530276,115530817,SRX5075176,SMARCA4,541
chr1,115530334,115530571,SRX5716468,SMARCA2,237
chr1,115530340,115530678,SRX5716469,SMARCA4,338
chr1,115530373,115530760,SRX5075175,SMARCA4,387
chr1,115530387,115530715,SRX5716470,SMARCA4,328
chr1,115530398,115530712,SRX5075169,SMARCA4,314
chr1,115530405,115530589,SRX5054308,FOSL2,184
chr1,115531777,115532120,SRX5075176,SMARCA4,343
chr1,115531919,115532110,SRX5075170,SMARCA4,191
chr1,115531923,115532173,SRX5716467,SMARCA2,250
chr1,115531932,115532283,SRX5716470,SMARCA4,351
chr1,115539077,115539366,SRX5075170,SMARCA4,289
chr1,115539115,115539415,SRX5075176,SMARCA4,300
chr1,115539125,115539376,SRX5075169,SMARCA4,251
chr1,115545562,115546254,SRX20140869,INTS10,692
chr1,115545679,115546558,SRX5075176,SMARCA4,879
chr1,115545687,115546447,SRX5716469,SMARCA4,760
chr1,115545697,115546218,SRX5054309,FOSL2,521
chr1,115545705,115546609,SRX5075175,SMARCA4,904
chr1,115545709,115546116,SRX5054308,FOSL2,407
chr1,115545722,115546096,SRX5716467,SMARCA2,374
chr1,115545725,115546123,SRX5020214,SMARCA2,398
chr1,115545727,115546552,SRX5075170,SMARCA4,825
chr1,115545737,115546585,SRX5075169,SMARCA4,848
chr1,115545739,115546033,SRX5075174,SMARCA4,294
chr1,115545758,115546624,SRX5716470,SMARCA4,866
chr1,115545772,115546226,SRX5020211,SMARCA2,454
chr1,115545779,115546082,SRX5075168,SMARCA4,303
chr1,115545802,115546141,SRX5716468,SMARCA2,339
chr1,115545815,115546175,SRX5075181,SMARCA2,360
chr1,115545872,115546051,SRX5075182,SMARCA2,179
chr1,115545913,115546387,SRX20140897,INTS13,474
chr1,115546175,115546485,SRX5075174,SMARCA4,310
chr1,115546184,115546479,SRX5075168,SMARCA4,295
chr1,115546193,115546497,SRX16500059,CTCF,304
chr1,115546202,115546440,SRX16500060,CTCF,238
chr1,115546239,115546479,SRX16500061,CTCF,240
chr1,115555542,115555759,SRX5075170,SMARCA4,217
chr1,115555570,115555815,SRX5075176,SMARCA4,245
chr1,115595693,115596089,SRX5716469,SMARCA4,396
chr1,115595708,115596135,SRX5075170,SMARCA4,427
chr1,115595721,115596110,SRX5075176,SMARCA4,389
chr1,115595727,115596068,SRX5075169,SMARCA4,341
chr1,115595731,115596235,SRX16500060,CTCF,504
chr1,115595735,115596051,SRX5075175,SMARCA4,316
chr1,115595739,115596278,SRX16500059,CTCF,539
chr1,115595752,115596001,SRX5716467,SMARCA2,249
chr1,115595765,115596088,SRX5716470,SMARCA4,323
chr1,115595778,115595996,SRX5054309,FOSL2,218
chr1,115595781,115596007,SRX5075181,SMARCA2,226
chr1,115595797,115596226,SRX16500061,CTCF,429
chr1,115595801,115596218,SRX16500062,CTCF,417
chr1,115595810,115596056,SRX5054308,FOSL2,246
chr1,115595817,115596168,SRX4174629,CTCF,351
chr1,115595861,115596178,SRX5075168,SMARCA4,317
chr1,115595882,115596151,SRX5075174,SMARCA4,269
chr1,115608126,115608545,SRX16500059,CTCF,419
chr1,115608138,115608570,SRX16500060,CTCF,432
chr1,115608166,115608492,SRX16500061,CTCF,326
chr1,115608207,115608523,SRX16500062,CTCF,316
chr1,115608216,115608453,SRX5075170,SMARCA4,237
chr1,115608241,115608428,SRX5075175,SMARCA4,187
chr1,115608295,115608528,SRX5075174,SMARCA4,233
chr1,115641731,115642018,SRX5716469,SMARCA4,287
chr1,115641753,115642032,SRX5075170,SMARCA4,279
chr1,115641796,115642100,SRX5075176,SMARCA4,304
chr1,115641822,115642204,SRX5075169,SMARCA4,382
chr1,115642287,115642591,SRX5075176,SMARCA4,304
chr1,115642814,115642994,SRX5075169,SMARCA4,180
chr1,115649039,115649223,SRX5054308,FOSL2,184
chr1,115649086,115649284,SRX5054309,FOSL2,198
chr1,115649135,115649304,SRX5075170,SMARCA4,169
chr1,115650237,115650480,SRX5716467,SMARCA2,243
chr1,115654812,115655310,SRX5075170,SMARCA4,498
chr1,115654815,115655133,SRX20140895,INTS13,318
chr1,115654841,115655177,SRX5054309,FOSL2,336
chr1,115654858,115655212,SRX5075168,SMARCA4,354
chr1,115654868,115655169,SRX5716469,SMARCA4,301
chr1,115654869,115655226,SRX5075174,SMARCA4,357
chr1,115654880,115655222,SRX5054308,FOSL2,342
chr1,115654882,115655225,SRX5716470,SMARCA4,343
chr1,115654887,115655140,SRX5075175,SMARCA4,253
chr1,115654890,115655187,SRX5075176,SMARCA4,297
chr1,115654897,115655207,SRX5075169,SMARCA4,310
chr1,115668642,115669384,SRX5054309,FOSL2,742
chr1,115668706,115669384,SRX5020214,SMARCA2,678
chr1,115669050,115669368,SRX5075176,SMARCA4,318
chr1,115669065,115669368,SRX5075175,SMARCA4,303
chr1,115669068,115669364,SRX5075169,SMARCA4,296
chr1,115669071,115669344,SRX5054308,FOSL2,273
chr1,115669083,115669342,SRX5075170,SMARCA4,259
chr1,115670910,115671134,SRX5716470,SMARCA4,224
chr1,115677084,115677537,SRX5716463,SMARCA4,453
chr1,115677084,115677542,SRX20140895,INTS13,458
chr1,115677117,115677749,SRX5075174,SMARCA4,632
chr1,115677131,115677768,SRX5075168,SMARCA4,637
chr1,115677153,115677528,SRX5716470,SMARCA4,375
chr1,115677164,115677485,SRX5716464,SMARCA4,321
chr1,115677188,115677463,SRX5716451,SOX2,275
chr1,115677236,115677523,SRX5716469,SMARCA4,287
chr1,115677251,115677471,SRX5716454,SOX3,220
chr1,115677286,115677485,SRX5075169,SMARCA4,199
chr1,115677577,115677839,SRX16500062,CTCF,262
chr1,115677649,115677882,SRX16500060,CTCF,233
chr1,115677653,115677902,SRX16500061,CTCF,249
chr1,115677656,115677911,SRX16500059,CTCF,255
chr1,115679065,115679358,SRX5054308,FOSL2,293
chr1,115679093,115679346,SRX5075176,SMARCA4,253
chr1,115679096,115679286,SRX5075169,SMARCA4,190
chr1,115679098,115679390,SRX5054309,FOSL2,292
chr1,115679102,115679334,SRX5075175,SMARCA4,232
chr1,115679102,115679468,SRX5075170,SMARCA4,366
chr1,115706715,115707146,SRX5075174,SMARCA4,431
chr1,115706716,115707276,SRX16500060,CTCF,560
chr1,115706756,115707129,SRX5075168,SMARCA4,373
chr1,115706761,115707256,SRX16500059,CTCF,495
chr1,115706787,115707024,SRX5716464,SMARCA4,237
chr1,115706808,115707035,SRX5716463,SMARCA4,227
chr1,115706815,115707257,SRX16500061,CTCF,442
chr1,115706820,115707222,SRX16500062,CTCF,402
chr1,115717547,115717854,SRX16500059,CTCF,307
chr1,115717557,115717857,SRX16500061,CTCF,300
chr1,115717581,115717948,SRX16500062,CTCF,367
chr1,115717593,115717900,SRX16500060,CTCF,307
chr1,115727717,115728116,SRX5075176,SMARCA4,399
chr1,115727769,115728197,SRX5075168,SMARCA4,428
chr1,115727769,115728233,SRX5075170,SMARCA4,464
chr1,115727781,115728238,SRX5075174,SMARCA4,457
chr1,115727814,115728103,SRX5075175,SMARCA4,289
chr1,115727824,115728203,SRX5075169,SMARCA4,379
chr1,115727853,115728174,SRX20140869,INTS10,321
chr1,115727878,115728269,SRX5716470,SMARCA4,391
chr1,115727889,115728192,SRX5054309,FOSL2,303
chr1,115727900,115728144,SRX5054308,FOSL2,244
chr1,115728007,115728259,SRX5716469,SMARCA4,252
chr1,115748404,115748757,SRX5075170,SMARCA4,353
chr1,115748431,115748819,SRX5075174,SMARCA4,388
chr1,115748432,115748699,SRX5716469,SMARCA4,267
chr1,115748433,115748818,SRX5075176,SMARCA4,385
chr1,115748438,115748739,SRX5054308,FOSL2,301
chr1,115748471,115748727,SRX5054309,FOSL2,256
chr1,115748476,115748702,SRX5075169,SMARCA4,226
chr1,115748479,115748866,SRX5075168,SMARCA4,387
chr1,115757396,115757695,SRX5075169,SMARCA4,299
chr1,115757439,115757666,SRX5020211,SMARCA2,227
chr1,115757467,115757688,SRX5075176,SMARCA4,221
chr1,115757487,115757708,SRX5716467,SMARCA2,221
chr1,115757536,115757709,SRX5075170,SMARCA4,173
chr1,115761765,115761974,SRX5054309,FOSL2,209
chr1,115764591,115764950,SRX16500059,CTCF,359
chr1,115764593,115764933,SRX16500062,CTCF,340
chr1,115764599,115764940,SRX16500060,CTCF,341
chr1,115764622,115764890,SRX16500061,CTCF,268
chr1,115771792,115772257,SRX16500059,CTCF,465
chr1,115771812,115772269,SRX16500060,CTCF,457
chr1,115771818,115772210,SRX5075168,SMARCA4,392
chr1,115771821,115772090,SRX4174629,CTCF,269
chr1,115771823,115772299,SRX16500061,CTCF,476
chr1,115771831,115772207,SRX5075174,SMARCA4,376
chr1,115771871,115772182,SRX5075170,SMARCA4,311
chr1,115771871,115772242,SRX16500062,CTCF,371
chr1,115771884,115772118,SRX5075169,SMARCA4,234
chr1,115771884,115772148,SRX5075176,SMARCA4,264
chr1,115783088,115783304,SRX5054309,FOSL2,216
chr1,115807614,115808161,SRX16500060,CTCF,547
chr1,115807684,115808192,SRX16500059,CTCF,508
chr1,115807687,115808128,SRX16500062,CTCF,441
chr1,115807728,115808025,SRX4174629,CTCF,297
chr1,115807737,115808138,SRX16500061,CTCF,401
chr1,115807764,115807995,SRX5075168,SMARCA4,231
chr1,115807916,115808108,SRX5075174,SMARCA4,192
chr1,115827747,115827953,SRX5075168,SMARCA4,206
chr1,115827778,115827956,SRX5075174,SMARCA4,178
chr1,115828522,115828789,SRX5075174,SMARCA4,267
chr1,115829350,115829605,SRX5054309,FOSL2,255
chr1,115829354,115829554,SRX5054308,FOSL2,200
chr1,115877562,115877758,SRX5075174,SMARCA4,196
chr1,115877574,115877786,SRX5075168,SMARCA4,212
chr1,115929821,115930198,SRX5054309,FOSL2,377
chr1,115929850,115930066,SRX5054308,FOSL2,216
chr1,115929869,115930218,SRX5075170,SMARCA4,349
chr1,115929872,115930219,SRX5075169,SMARCA4,347
chr1,115929881,115930289,SRX5075176,SMARCA4,408
chr1,115969518,115969790,SRX5075168,SMARCA4,272
chr1,115969527,115969771,SRX5075174,SMARCA4,244
chr1,115975954,115976166,SRX5716469,SMARCA4,212
chr1,115975996,115976386,SRX5075170,SMARCA4,390
chr1,115976006,115976286,SRX5075169,SMARCA4,280
chr1,115976112,115976301,SRX5075175,SMARCA4,189
chr1,115976122,115976357,SRX5075168,SMARCA4,235
chr1,115976135,115976309,SRX5075174,SMARCA4,174
chr1,115976182,115976382,SRX5075176,SMARCA4,200
chr1,115976583,115976836,SRX5075175,SMARCA4,253
chr1,115981329,115981772,SRX16500061,CTCF,443
chr1,115981333,115981788,SRX16500062,CTCF,455
chr1,115981358,115981786,SRX16500059,CTCF,428
chr1,115981373,115981795,SRX16500060,CTCF,422
chr1,115981474,115981666,SRX5075168,SMARCA4,192
chr1,116020644,116021078,SRX16500059,CTCF,434
chr1,116020656,116020963,SRX16500060,CTCF,307
chr1,116020708,116021029,SRX16500061,CTCF,321
chr1,116020714,116021056,SRX16500062,CTCF,342
chr1,116020717,116020962,SRX5075168,SMARCA4,245
chr1,116020736,116020959,SRX5075174,SMARCA4,223
chr1,116033287,116033754,SRX5075168,SMARCA4,467
chr1,116033365,116033753,SRX5075174,SMARCA4,388
chr1,116033390,116033614,SRX5716464,SMARCA4,224
chr1,116033393,116033657,SRX5716451,SOX2,264
chr1,116033419,116033685,SRX5716463,SMARCA4,266
chr1,116067268,116067930,SRX5075170,SMARCA4,662
chr1,116067343,116067955,SRX5075169,SMARCA4,612
chr1,116067381,116067933,SRX5075176,SMARCA4,552
chr1,116067625,116067902,SRX5054308,FOSL2,277
chr1,116067626,116067880,SRX5054309,FOSL2,254
chr1,116067662,116067924,SRX5075175,SMARCA4,262
chr1,116067715,116067944,SRX5716469,SMARCA4,229
chr1,116115538,116115837,SRX5054309,FOSL2,299
chr1,116115542,116115874,SRX5716470,SMARCA4,332
chr1,116115608,116115801,SRX5054308,FOSL2,193
chr1,116115649,116115850,SRX5075175,SMARCA4,201
chr1,116122838,116123229,SRX5075175,SMARCA4,391
chr1,116122876,116123266,SRX5075169,SMARCA4,390
chr1,116122892,116123223,SRX5075170,SMARCA4,331
chr1,116122908,116123265,SRX5054309,FOSL2,357
chr1,116122938,116123204,SRX5075176,SMARCA4,266
chr1,116138920,116139468,SRX16500059,CTCF,548
chr1,116138959,116139251,SRX5075169,SMARCA4,292
chr1,116138965,116139468,SRX16500060,CTCF,503
chr1,116138967,116139439,SRX16500061,CTCF,472
chr1,116138984,116139335,SRX5075174,SMARCA4,351
chr1,116138986,116139437,SRX16500062,CTCF,451
chr1,116138996,116139379,SRX5075176,SMARCA4,383
chr1,116138997,116139432,SRX5075170,SMARCA4,435
chr1,116139027,116139408,SRX5075168,SMARCA4,381
chr1,116139044,116139531,SRX4174629,CTCF,487
chr1,116139065,116139306,SRX5075175,SMARCA4,241
chr1,116139076,116139302,SRX5716469,SMARCA4,226
chr1,116151842,116152414,SRX16500059,CTCF,572
chr1,116151896,116152378,SRX16500061,CTCF,482
chr1,116151896,116152464,SRX16500060,CTCF,568
chr1,116151909,116152388,SRX16500062,CTCF,479
chr1,116152000,116152453,SRX5716470,SMARCA4,453
chr1,116152012,116152400,SRX5075168,SMARCA4,388
chr1,116152021,116152412,SRX5075176,SMARCA4,391
chr1,116152032,116152409,SRX5075175,SMARCA4,377
chr1,116152050,116152475,SRX5075174,SMARCA4,425
chr1,116152051,116152460,SRX4174629,CTCF,409
chr1,116152059,116152433,SRX5075170,SMARCA4,374
chr1,116152077,116152439,SRX5075169,SMARCA4,362
chr1,116152104,116152321,SRX5716464,SMARCA4,217
chr1,116152133,116152455,SRX20140895,INTS13,322
chr1,116152146,116152400,SRX5716463,SMARCA4,254
chr1,116152148,116152417,SRX5716469,SMARCA4,269
chr1,116152161,116152361,SRX5020211,SMARCA2,200
chr1,116168225,116168796,SRX16500059,CTCF,571
chr1,116168260,116168767,SRX16500061,CTCF,507
chr1,116168288,116168749,SRX16500060,CTCF,461
chr1,116168328,116168746,SRX16500062,CTCF,418
chr1,116168334,116168690,SRX5716470,SMARCA4,356
chr1,116168341,116168624,SRX5075169,SMARCA4,283
chr1,116168351,116168677,SRX5075170,SMARCA4,326
chr1,116168359,116168683,SRX5075175,SMARCA4,324
chr1,116168390,116168721,SRX5075176,SMARCA4,331
chr1,116168404,116168715,SRX5075174,SMARCA4,311
chr1,116168409,116168746,SRX5075168,SMARCA4,337
chr1,116261238,116261528,SRX5075174,SMARCA4,290
chr1,116311731,116312110,SRX20140895,INTS13,379
chr1,116311831,116312101,SRX5075174,SMARCA4,270
chr1,116312775,116312965,SRX5075168,SMARCA4,190
chr1,116334104,116334370,SRX5075169,SMARCA4,266
chr1,116334158,116334380,SRX5075170,SMARCA4,222
chr1,116334159,116334450,SRX5075176,SMARCA4,291
chr1,116334162,116334371,SRX5075175,SMARCA4,209
chr1,116334174,116334504,SRX5054309,FOSL2,330
chr1,116334176,116334370,SRX5054308,FOSL2,194
chr1,116345891,116346302,SRX5075168,SMARCA4,411
chr1,116345898,116346214,SRX5075174,SMARCA4,316
chr1,116356654,116356983,SRX5075176,SMARCA4,329
chr1,116356670,116356907,SRX5716467,SMARCA2,237
chr1,116356693,116356964,SRX5716470,SMARCA4,271
chr1,116356701,116356946,SRX5054309,FOSL2,245
chr1,116356701,116357017,SRX5075170,SMARCA4,316
chr1,116356707,116357017,SRX5075169,SMARCA4,310
chr1,116356712,116356963,SRX5075175,SMARCA4,251
chr1,116356717,116356931,SRX5054308,FOSL2,214
chr1,116356745,116356957,SRX5716469,SMARCA4,212
chr1,116359105,116359353,SRX5075176,SMARCA4,248
chr1,116359117,116359393,SRX5075174,SMARCA4,276
chr1,116359174,116359421,SRX5075170,SMARCA4,247
chr1,116359198,116359754,SRX5075168,SMARCA4,556
chr1,116368229,116368527,SRX5075170,SMARCA4,298
chr1,116368235,116368533,SRX5075176,SMARCA4,298
chr1,116368276,116368545,SRX5075169,SMARCA4,269
chr1,116368298,116368516,SRX5075175,SMARCA4,218
chr1,116372947,116373343,SRX5075174,SMARCA4,396
chr1,116372949,116374047,SRX20140895,INTS13,1098
chr1,116373002,116373303,SRX5075168,SMARCA4,301
chr1,116373047,116373291,SRX5716463,SMARCA4,244
chr1,116373127,116373457,SRX20140897,INTS13,330
chr1,116373147,116373479,SRX20140867,INTS10,332
chr1,116373207,116373522,SRX20140868,INTS10,315
chr1,116373219,116373509,SRX20140881,CPSF3L,290
chr1,116377750,116378258,SRX5075170,SMARCA4,508
chr1,116377779,116378260,SRX5075176,SMARCA4,481
chr1,116377810,116378154,SRX5716470,SMARCA4,344
chr1,116377825,116378227,SRX5075169,SMARCA4,402
chr1,116377837,116378253,SRX5716467,SMARCA2,416
chr1,116377855,116378199,SRX5075175,SMARCA4,344
chr1,116377855,116378247,SRX5054309,FOSL2,392
chr1,116377880,116378242,SRX5054308,FOSL2,362
chr1,116377883,116378093,SRX5020211,SMARCA2,210
chr1,116377892,116378246,SRX5716469,SMARCA4,354
chr1,116377935,116378180,SRX5075174,SMARCA4,245
chr1,116377965,116378188,SRX5075168,SMARCA4,223
chr1,116377984,116378183,SRX5054307,FOSL2,199
chr1,116378026,116378277,SRX5020214,SMARCA2,251
chr1,116411825,116412031,SRX5054309,FOSL2,206
chr1,116418233,116418856,SRX20140869,INTS10,623
chr1,116418280,116418928,SRX5075174,SMARCA4,648
chr1,116418284,116418958,SRX20140868,INTS10,674
chr1,116418298,116418950,SRX20140895,INTS13,652
chr1,116418406,116418833,SRX20140897,INTS13,427
chr1,116418414,116418822,SRX20140867,INTS10,408
chr1,116418416,116418869,SRX5075169,SMARCA4,453
chr1,116418427,116418883,SRX5716470,SMARCA4,456
chr1,116418450,116418931,SRX5075176,SMARCA4,481
chr1,116418465,116418905,SRX5075168,SMARCA4,440
chr1,116418535,116418868,SRX5075170,SMARCA4,333
chr1,116418543,116418900,SRX5075175,SMARCA4,357
chr1,116418545,116418896,SRX5716469,SMARCA4,351
chr1,116418648,116418930,SRX5716463,SMARCA4,282
chr1,116451820,116452034,SRX5075176,SMARCA4,214
chr1,116472333,116472881,SRX5075170,SMARCA4,548
chr1,116472357,116472918,SRX5075176,SMARCA4,561
chr1,116472413,116472772,SRX5075169,SMARCA4,359
chr1,116472444,116472809,SRX5716469,SMARCA4,365
chr1,116472445,116472932,SRX5716470,SMARCA4,487
chr1,116472446,116472881,SRX5075175,SMARCA4,435
chr1,116472475,116472878,SRX5054308,FOSL2,403
chr1,116472651,116472862,SRX5054309,FOSL2,211
chr1,116472671,116472912,SRX5020211,SMARCA2,241
chr1,116485147,116485585,SRX4174629,CTCF,438
chr1,116485157,116485690,SRX16500061,CTCF,533
chr1,116485158,116485666,SRX16500059,CTCF,508
chr1,116485194,116485561,SRX5075168,SMARCA4,367
chr1,116485200,116485672,SRX16500062,CTCF,472
chr1,116485214,116485699,SRX16500060,CTCF,485
chr1,116485217,116485524,SRX5075174,SMARCA4,307
chr1,116486409,116486810,SRX5075169,SMARCA4,401
chr1,116486457,116486807,SRX5054308,FOSL2,350
chr1,116486476,116486850,SRX5054309,FOSL2,374
chr1,116486482,116486800,SRX5075176,SMARCA4,318
chr1,116486504,116486776,SRX5075170,SMARCA4,272
chr1,116486521,116486778,SRX5075175,SMARCA4,257
chr1,116486551,116486773,SRX5020214,SMARCA2,222
chr1,116494383,116494770,SRX5075168,SMARCA4,387
chr1,116494384,116494763,SRX5075174,SMARCA4,379
chr1,116494477,116494651,SRX5075170,SMARCA4,174
chr1,116497733,116497927,SRX5054309,FOSL2,194
chr1,116497775,116497955,SRX5054308,FOSL2,180
chr1,116498973,116499462,SRX16500061,CTCF,489
chr1,116498981,116499467,SRX16500060,CTCF,486
chr1,116498997,116499466,SRX16500059,CTCF,469
chr1,116499002,116499441,SRX16500062,CTCF,439
chr1,116499014,116499419,SRX4174629,CTCF,405
chr1,116499052,116499321,SRX5075174,SMARCA4,269
chr1,116499077,116499270,SRX5075175,SMARCA4,193
chr1,116499096,116499287,SRX5075170,SMARCA4,191
chr1,116508870,116509698,SRX5075169,SMARCA4,828
chr1,116508892,116509716,SRX5075175,SMARCA4,824
chr1,116508921,116509692,SRX5075170,SMARCA4,771
chr1,116508942,116509198,SRX5054309,FOSL2,256
chr1,116509058,116509746,SRX5075176,SMARCA4,688
chr1,116509148,116509596,SRX5716470,SMARCA4,448
chr1,116509326,116509658,SRX5716469,SMARCA4,332
chr1,116521238,116521504,SRX5075169,SMARCA4,266
chr1,116521263,116521500,SRX5075175,SMARCA4,237
chr1,116529324,116529519,SRX5054308,FOSL2,195
chr1,116529347,116529708,SRX5054309,FOSL2,361
chr1,116535865,116536169,SRX5075176,SMARCA4,304
chr1,116535874,116536072,SRX5054309,FOSL2,198
chr1,116535883,116536152,SRX5075170,SMARCA4,269
chr1,116535893,116536179,SRX5075169,SMARCA4,286
chr1,116535904,116536084,SRX5054308,FOSL2,180
chr1,116570261,116570617,SRX16500060,CTCF,356
chr1,116570289,116570699,SRX5075174,SMARCA4,410
chr1,116570297,116570684,SRX5075168,SMARCA4,387
chr1,116570303,116570689,SRX5716463,SMARCA4,386
chr1,116570313,116570652,SRX5075169,SMARCA4,339
chr1,116570314,116570653,SRX5716470,SMARCA4,339
chr1,116570321,116570658,SRX16500062,CTCF,337
chr1,116570321,116570676,SRX5075176,SMARCA4,355
chr1,116570322,116570680,SRX16500059,CTCF,358
chr1,116570323,116570633,SRX5716469,SMARCA4,310
chr1,116570344,116570692,SRX5075175,SMARCA4,348
chr1,116570358,116570607,SRX5716464,SMARCA4,249
chr1,116570359,116570642,SRX5075170,SMARCA4,283
chr1,116570365,116570659,SRX16500061,CTCF,294
chr1,116570435,116571369,SRX20140895,INTS13,934
chr1,116570646,116571179,SRX20140897,INTS13,533
chr1,116570701,116571191,SRX20140868,INTS10,490
chr1,116570754,116571038,SRX20140879,CPSF3L,284
chr1,116570860,116571271,SRX5075168,SMARCA4,411
chr1,116570880,116571311,SRX5075174,SMARCA4,431
chr1,116570898,116571265,SRX5075170,SMARCA4,367
chr1,116570958,116571248,SRX5716469,SMARCA4,290
chr1,116570966,116571309,SRX5075176,SMARCA4,343
chr1,116571085,116571305,SRX5716470,SMARCA4,220
chr1,116571093,116571344,SRX5075169,SMARCA4,251
chr1,116574568,116575014,SRX16500062,CTCF,446
chr1,116574587,116575005,SRX16500059,CTCF,418
chr1,116574603,116575003,SRX16500060,CTCF,400
chr1,116574629,116575046,SRX16500061,CTCF,417
chr1,116574641,116574931,SRX4174629,CTCF,290
chr1,116574704,116574936,SRX5075168,SMARCA4,232
chr1,116574705,116574949,SRX5075174,SMARCA4,244
chr1,116574712,116574930,SRX5075170,SMARCA4,218
chr1,116574751,116574931,SRX5075176,SMARCA4,180
chr1,116586930,116587184,SRX5075170,SMARCA4,254
chr1,116589376,116589645,SRX5054309,FOSL2,269
chr1,116591312,116591570,SRX5075174,SMARCA4,258
chr1,116591345,116591542,SRX5075176,SMARCA4,197
chr1,116591363,116591581,SRX5054308,FOSL2,218
chr1,116592218,116592566,SRX5075176,SMARCA4,348
chr1,116592223,116592496,SRX5075170,SMARCA4,273
chr1,116595589,116595815,SRX16500060,CTCF,226
chr1,116595594,116595876,SRX16500061,CTCF,282
chr1,116595663,116596717,SRX16500059,CTCF,1054
chr1,116596082,116596497,SRX5075174,SMARCA4,415
chr1,116596184,116596674,SRX16500060,CTCF,490
chr1,116596202,116596720,SRX16500062,CTCF,518
chr1,116596228,116596438,SRX4174629,CTCF,210
chr1,116596242,116596651,SRX16500061,CTCF,409
chr1,116596275,116596498,SRX5075168,SMARCA4,223
chr1,116627454,116627639,SRX5075176,SMARCA4,185
chr1,116627481,116627672,SRX5075170,SMARCA4,191
chr1,116630001,116630358,SRX16500060,CTCF,357
chr1,116630061,116630280,SRX16500061,CTCF,219
chr1,116637721,116637987,SRX5075174,SMARCA4,266
chr1,116643333,116643553,SRX5075174,SMARCA4,220
chr1,116644119,116644372,SRX5075176,SMARCA4,253
chr1,116644142,116644431,SRX5075170,SMARCA4,289
chr1,116644154,116644390,SRX5716468,SMARCA2,236
chr1,116644162,116644417,SRX5075181,SMARCA2,255
chr1,116644167,116644379,SRX5716469,SMARCA4,212
chr1,116644167,116644433,SRX5716470,SMARCA4,266
chr1,116644188,116644390,SRX5075169,SMARCA4,202
chr1,116646817,116647018,SRX5075174,SMARCA4,201
chr1,116667318,116667993,SRX5075174,SMARCA4,675
chr1,116667375,116667861,SRX5075170,SMARCA4,486
chr1,116667393,116667961,SRX5075176,SMARCA4,568
chr1,116667396,116668089,SRX20140895,INTS13,693
chr1,116667459,116667783,SRX5075175,SMARCA4,324
chr1,116667555,116668078,SRX20140868,INTS10,523
chr1,116667569,116667994,SRX5075168,SMARCA4,425
chr1,116672547,116672910,SRX16500059,CTCF,363
chr1,116672574,116672953,SRX16500060,CTCF,379
chr1,116672596,116672913,SRX16500062,CTCF,317
chr1,116672612,116672858,SRX16500061,CTCF,246
chr1,116673863,116674394,SRX5075176,SMARCA4,531
chr1,116673934,116674161,SRX5716467,SMARCA2,227
chr1,116674010,116674271,SRX5075170,SMARCA4,261
chr1,116674131,116674311,SRX5075169,SMARCA4,180
chr1,116674697,116675051,SRX5075176,SMARCA4,354
chr1,116690834,116691358,SRX5075170,SMARCA4,524
chr1,116690868,116691333,SRX5075176,SMARCA4,465
chr1,116690907,116691355,SRX5716467,SMARCA2,448
chr1,116690941,116691356,SRX5716470,SMARCA4,415
chr1,116690942,116691357,SRX5075169,SMARCA4,415
chr1,116690957,116691380,SRX5075175,SMARCA4,423
chr1,116690965,116691266,SRX5716468,SMARCA2,301
chr1,116690988,116691428,SRX5716469,SMARCA4,440
chr1,116710813,116711067,SRX5716470,SMARCA4,254
chr1,116710946,116711292,SRX5075170,SMARCA4,346
chr1,116710950,116711248,SRX5716467,SMARCA2,298
chr1,116710964,116711219,SRX5075175,SMARCA4,255
chr1,116711007,116711298,SRX5075176,SMARCA4,291
chr1,116711039,116711471,SRX5075169,SMARCA4,432
chr1,116712539,116712809,SRX5075170,SMARCA4,270
chr1,116724705,116725210,SRX16500060,CTCF,505
chr1,116724712,116725214,SRX16500062,CTCF,502
chr1,116724714,116725203,SRX16500061,CTCF,489
chr1,116724740,116725250,SRX16500059,CTCF,510
chr1,116737207,116737655,SRX16500062,CTCF,448
chr1,116737208,116737721,SRX16500059,CTCF,513
chr1,116737246,116737673,SRX16500060,CTCF,427
chr1,116737258,116737645,SRX16500061,CTCF,387
chr1,116737335,116737673,SRX5075168,SMARCA4,338
chr1,116737339,116737649,SRX4174629,CTCF,310
chr1,116737350,116737642,SRX5075174,SMARCA4,292
chr1,116737373,116737564,SRX5075170,SMARCA4,191
chr1,116737380,116737613,SRX5075176,SMARCA4,233
chr1,116763122,116763504,SRX5075175,SMARCA4,382
chr1,116763207,116763664,SRX5075174,SMARCA4,457
chr1,116763219,116763597,SRX5075176,SMARCA4,378
chr1,116763240,116763621,SRX5716469,SMARCA4,381
chr1,116763256,116763665,SRX5075170,SMARCA4,409
chr1,116763260,116763577,SRX5075169,SMARCA4,317
chr1,116763290,116763714,SRX5075168,SMARCA4,424
chr1,116763328,116763672,SRX20140867,INTS10,344
chr1,116764137,116764492,SRX16500061,CTCF,355
chr1,116764257,116764478,SRX16500060,CTCF,221
chr1,116769778,116770005,SRX5075170,SMARCA4,227
chr1,116769803,116769985,SRX5075176,SMARCA4,182
chr1,116777693,116778165,SRX5075176,SMARCA4,472
chr1,116777714,116778207,SRX5716470,SMARCA4,493
chr1,116777729,116778283,SRX5075169,SMARCA4,554
chr1,116777740,116778257,SRX5075175,SMARCA4,517
chr1,116777752,116778243,SRX5075170,SMARCA4,491
chr1,116777772,116778228,SRX5054308,FOSL2,456
chr1,116777775,116778210,SRX5054309,FOSL2,435
chr1,116777811,116778127,SRX5020211,SMARCA2,316
chr1,116777816,116778270,SRX5716469,SMARCA4,454
chr1,116777883,116778065,SRX5075168,SMARCA4,182
chr1,116777935,116778212,SRX5716467,SMARCA2,277
chr1,116777967,116778192,SRX5075182,SMARCA2,225
chr1,116810178,116810718,SRX5075168,SMARCA4,540
chr1,116810250,116810645,SRX5075174,SMARCA4,395
chr1,116810272,116810609,SRX5716463,SMARCA4,337
chr1,116820282,116820835,SRX5075170,SMARCA4,553
chr1,116820307,116820825,SRX5075176,SMARCA4,518
chr1,116820375,116820765,SRX5075169,SMARCA4,390
chr1,116820383,116820764,SRX5716469,SMARCA4,381
chr1,116820389,116820840,SRX5716467,SMARCA2,451
chr1,116820401,116820785,SRX5075175,SMARCA4,384
chr1,116820406,116820788,SRX5054308,FOSL2,382
chr1,116820411,116820771,SRX5716470,SMARCA4,360
chr1,116820424,116820695,SRX5020211,SMARCA2,271
chr1,116820433,116820782,SRX5054309,FOSL2,349
chr1,116820435,116820733,SRX5716459,Epitope tags,298
chr1,116820478,116820691,SRX5716468,SMARCA2,213
chr1,116825253,116825528,SRX5075174,SMARCA4,275
chr1,116827359,116827542,SRX5054309,FOSL2,183
chr1,116832313,116832722,SRX5075168,SMARCA4,409
chr1,116832347,116832551,SRX5716463,SMARCA4,204
chr1,116832404,116832802,SRX5075174,SMARCA4,398
chr1,116842768,116842943,SRX5075176,SMARCA4,175
chr1,116847866,116848071,SRX5075176,SMARCA4,205
chr1,116853609,116853987,SRX5054308,FOSL2,378
chr1,116853621,116853885,SRX5716468,SMARCA2,264
chr1,116853624,116854090,SRX5075176,SMARCA4,466
chr1,116853631,116853999,SRX5054309,FOSL2,368
chr1,116853637,116854000,SRX5075170,SMARCA4,363
chr1,116853648,116854015,SRX5075169,SMARCA4,367
chr1,116853663,116853980,SRX5716467,SMARCA2,317
chr1,116853667,116853990,SRX5075175,SMARCA4,323
chr1,116853671,116853959,SRX5020214,SMARCA2,288
chr1,116853689,116854221,SRX5075174,SMARCA4,532
chr1,116853693,116854109,SRX5075168,SMARCA4,416
chr1,116853694,116853922,SRX5075181,SMARCA2,228
chr1,116853696,116853966,SRX5716470,SMARCA4,270
chr1,116853701,116853994,SRX5020211,SMARCA2,293
chr1,116853707,116854004,SRX5716469,SMARCA4,297
chr1,116853730,116854008,SRX5075182,SMARCA2,278
chr1,116855863,116856288,SRX5075170,SMARCA4,425
chr1,116855876,116856267,SRX5075175,SMARCA4,391
chr1,116855895,116856348,SRX5075176,SMARCA4,453
chr1,116855908,116856275,SRX5716470,SMARCA4,367
chr1,116855921,116856328,SRX5075169,SMARCA4,407
chr1,116855925,116856286,SRX5716469,SMARCA4,361
chr1,116855932,116856236,SRX5716467,SMARCA2,304
chr1,116868375,116868627,SRX5075176,SMARCA4,252
chr1,116868441,116868710,SRX5075169,SMARCA4,269
chr1,116868456,116868726,SRX5054308,FOSL2,270
chr1,116868470,116868746,SRX5054309,FOSL2,276
chr1,116878043,116878690,SRX5075170,SMARCA4,647
chr1,116878045,116878577,SRX5075176,SMARCA4,532
chr1,116878097,116878378,SRX5075175,SMARCA4,281
chr1,116878097,116878551,SRX5716469,SMARCA4,454
chr1,116878107,116878619,SRX5716470,SMARCA4,512
chr1,116878144,116878484,SRX5075169,SMARCA4,340
chr1,116878155,116878561,SRX5075174,SMARCA4,406
chr1,116878247,116878532,SRX5075168,SMARCA4,285
chr1,116878299,116878618,SRX16500060,CTCF,319
chr1,116878316,116878530,SRX16500062,CTCF,214
chr1,116878362,116878707,SRX16500059,CTCF,345
chr1,116878526,116878823,SRX20140895,INTS13,297
chr1,116878948,116879336,SRX5075174,SMARCA4,388
chr1,116878987,116879395,SRX5075170,SMARCA4,408
chr1,116879028,116879273,SRX5716469,SMARCA4,245
chr1,116879070,116879397,SRX5075176,SMARCA4,327
chr1,116879154,116879366,SRX5075168,SMARCA4,212
chr1,116886175,116886454,SRX5075170,SMARCA4,279
chr1,116886207,116886914,SRX5075176,SMARCA4,707
chr1,116886266,116886648,SRX5716470,SMARCA4,382
chr1,116886275,116886599,SRX5716469,SMARCA4,324
chr1,116886594,116886898,SRX5075175,SMARCA4,304
chr1,116886597,116886826,SRX5075170,SMARCA4,229
chr1,116891880,116892063,SRX5075170,SMARCA4,183
chr1,116908938,116909177,SRX5075168,SMARCA4,239
chr1,116908940,116909113,SRX5075174,SMARCA4,173
chr1,116909726,116910072,SRX5075176,SMARCA4,346
chr1,116909755,116910025,SRX5075170,SMARCA4,270
chr1,116909821,116910008,SRX5075169,SMARCA4,187
chr1,116909827,116910643,SRX20140895,INTS13,816
chr1,116910350,116910653,SRX5716470,SMARCA4,303
chr1,116923343,116923610,SRX5075170,SMARCA4,267
chr1,116923378,116923665,SRX5075176,SMARCA4,287
chr1,116923386,116923715,SRX5075175,SMARCA4,329
chr1,116923399,116923628,SRX5054309,FOSL2,229
chr1,116923400,116923614,SRX5054308,FOSL2,214
chr1,116934866,116935125,SRX16500060,CTCF,259
chr1,116934891,116935165,SRX16500059,CTCF,274
chr1,116934937,116935170,SRX16500062,CTCF,233
chr1,116940878,116941161,SRX5075174,SMARCA4,283
chr1,116940885,116941229,SRX5716463,SMARCA4,344
chr1,116940968,116941370,SRX5075168,SMARCA4,402
chr1,116949693,116949972,SRX5075174,SMARCA4,279
chr1,116951572,116951880,SRX5075169,SMARCA4,308
chr1,116951577,116951763,SRX5054308,FOSL2,186
chr1,116951598,116951850,SRX5075176,SMARCA4,252
chr1,116951640,116951890,SRX5075170,SMARCA4,250
chr1,116972261,116972569,SRX5075176,SMARCA4,308
chr1,116972343,116972605,SRX5054309,FOSL2,262
chr1,116972396,116972910,SRX5075169,SMARCA4,514
chr1,116972658,116972910,SRX5075170,SMARCA4,252
chr1,116972708,116972901,SRX5075176,SMARCA4,193
chr1,116988269,116988528,SRX5716470,SMARCA4,259
chr1,116988288,116988727,SRX5075168,SMARCA4,439
chr1,116988316,116988582,SRX5075176,SMARCA4,266
chr1,116988346,116988776,SRX5075174,SMARCA4,430
chr1,116988354,116988647,SRX5075169,SMARCA4,293
chr1,116988355,116988611,SRX5054309,FOSL2,256
chr1,116988356,116988606,SRX5054308,FOSL2,250
chr1,116988375,116988640,SRX5075170,SMARCA4,265
chr1,116988405,116988604,SRX5075175,SMARCA4,199
chr1,116990646,116990979,SRX5075175,SMARCA4,333
chr1,116990666,116990913,SRX5075169,SMARCA4,247
chr1,116997062,116997670,SRX5075176,SMARCA4,608
chr1,116997086,116997784,SRX5075169,SMARCA4,698
chr1,116997106,116997580,SRX5075170,SMARCA4,474
chr1,116997126,116997321,SRX5054308,FOSL2,195
chr1,116997136,116997337,SRX5054309,FOSL2,201
chr1,116997155,116997489,SRX5716469,SMARCA4,334
chr1,116997156,116997466,SRX5716468,SMARCA2,310
chr1,116997161,116997588,SRX5020211,SMARCA2,427
chr1,116997162,116997531,SRX5075175,SMARCA4,369
chr1,116997209,116997591,SRX5716470,SMARCA4,382
chr1,116997217,116997512,SRX5075181,SMARCA2,295
chr1,116997251,116997533,SRX5716467,SMARCA2,282
chr1,117003507,117003850,SRX5075176,SMARCA4,343
chr1,117003564,117003784,SRX5716470,SMARCA4,220
chr1,117003617,117003834,SRX5075170,SMARCA4,217
chr1,117003640,117003824,SRX5075169,SMARCA4,184
chr1,117003676,117003878,SRX5054308,FOSL2,202
chr1,117014244,117014535,SRX5075175,SMARCA4,291
chr1,117014260,117014561,SRX5054309,FOSL2,301
chr1,117014338,117014557,SRX5075169,SMARCA4,219
chr1,117014341,117014521,SRX5054308,FOSL2,180
chr1,117026431,117026644,SRX5075176,SMARCA4,213
chr1,117026478,117026685,SRX5075170,SMARCA4,207
chr1,117026483,117026700,SRX5075169,SMARCA4,217
chr1,117032722,117032900,SRX5075170,SMARCA4,178
chr1,117055156,117055744,SRX16500060,CTCF,588
chr1,117055243,117055710,SRX16500061,CTCF,467
chr1,117055259,117055748,SRX16500059,CTCF,489
chr1,117055310,117055710,SRX16500062,CTCF,400
chr1,117055394,117055614,SRX5075174,SMARCA4,220
chr1,117059584,117060327,SRX5075168,SMARCA4,743
chr1,117059638,117060229,SRX20140895,INTS13,591
chr1,117059669,117060096,SRX20140881,CPSF3L,427
chr1,117059688,117060202,SRX20140868,INTS10,514
chr1,117059696,117060134,SRX20140897,INTS13,438
chr1,117059718,117060227,SRX5075174,SMARCA4,509
chr1,117059782,117060226,SRX20140867,INTS10,444
chr1,117059895,117060257,SRX5716464,SMARCA4,362
chr1,117059910,117060211,SRX16500062,CTCF,301
chr1,117060021,117060258,SRX5716463,SMARCA4,237
chr1,117060056,117060336,SRX5054307,FOSL2,280
chr1,117060096,117060347,SRX5716451,SOX2,251
chr1,117061958,117062257,SRX5075170,SMARCA4,299
chr1,117062011,117062238,SRX5075175,SMARCA4,227
chr1,117062051,117062276,SRX5075169,SMARCA4,225
chr1,117062060,117062309,SRX5054309,FOSL2,249
chr1,117067654,117068262,SRX16500059,CTCF,608
chr1,117067660,117068175,SRX16500062,CTCF,515
chr1,117067685,117068184,SRX16500060,CTCF,499
chr1,117067730,117068202,SRX16500061,CTCF,472
chr1,117067797,117068116,SRX5075174,SMARCA4,319
chr1,117067844,117068128,SRX4174629,CTCF,284
chr1,117067861,117068126,SRX5075168,SMARCA4,265
chr1,117067895,117068145,SRX5075170,SMARCA4,250
chr1,117067918,117068100,SRX5075176,SMARCA4,182
chr1,117077306,117077679,SRX5075170,SMARCA4,373
chr1,117077323,117077690,SRX5075175,SMARCA4,367
chr1,117077330,117077678,SRX5054309,FOSL2,348
chr1,117077361,117077714,SRX5075169,SMARCA4,353
chr1,117077405,117077695,SRX5075176,SMARCA4,290
chr1,117077435,117077727,SRX5054308,FOSL2,292
chr1,117093114,117093546,SRX5075176,SMARCA4,432
chr1,117093156,117093546,SRX5716469,SMARCA4,390
chr1,117093158,117093587,SRX5075169,SMARCA4,429
chr1,117093163,117093575,SRX5075170,SMARCA4,412
chr1,117093172,117093486,SRX5054309,FOSL2,314
chr1,117093205,117093521,SRX5075168,SMARCA4,316
chr1,117093211,117093560,SRX5075174,SMARCA4,349
chr1,117093232,117093458,SRX5054308,FOSL2,226
chr1,117093276,117093535,SRX5716470,SMARCA4,259
chr1,117093278,117093525,SRX5075175,SMARCA4,247
chr1,117093888,117094276,SRX5075174,SMARCA4,388
chr1,117093898,117094286,SRX5075168,SMARCA4,388
chr1,117093943,117094192,SRX5075176,SMARCA4,249
chr1,117093955,117094182,SRX5075169,SMARCA4,227
chr1,117093982,117094207,SRX5054308,FOSL2,225
chr1,117093983,117094226,SRX5075170,SMARCA4,243
chr1,117093984,117094204,SRX5054309,FOSL2,220
chr1,117094006,117094248,SRX16500061,CTCF,242
chr1,117094007,117094207,SRX5054307,FOSL2,200
chr1,117095141,117095626,SRX5075169,SMARCA4,485
chr1,117095195,117095681,SRX5075175,SMARCA4,486
chr1,117095222,117095654,SRX5075170,SMARCA4,432
chr1,117095237,117095655,SRX5075176,SMARCA4,418
chr1,117095260,117095693,SRX5716470,SMARCA4,433
chr1,117095269,117095649,SRX5054309,FOSL2,380
chr1,117095271,117095643,SRX5716467,SMARCA2,372
chr1,117095272,117095679,SRX5716469,SMARCA4,407
chr1,117095281,117095599,SRX5020214,SMARCA2,318
chr1,117095287,117095660,SRX5054308,FOSL2,373
chr1,117095292,117095591,SRX5020211,SMARCA2,299
chr1,117095302,117095731,SRX5075181,SMARCA2,429
chr1,117095368,117095584,SRX5716468,SMARCA2,216
chr1,117097537,117097721,SRX5075168,SMARCA4,184
chr1,117112436,117112609,SRX5075174,SMARCA4,173
chr1,117121324,117121911,SRX5075170,SMARCA4,587
chr1,117121383,117122091,SRX5075176,SMARCA4,708
chr1,117121384,117121654,SRX5716470,SMARCA4,270
chr1,117121455,117121744,SRX5075169,SMARCA4,289
chr1,117121456,117122500,SRX20140895,INTS13,1044
chr1,117121549,117122376,SRX5075168,SMARCA4,827
chr1,117121563,117122386,SRX20140867,INTS10,823
chr1,117121574,117122505,SRX5075174,SMARCA4,931
chr1,117121653,117121897,SRX5054309,FOSL2,244
chr1,117121750,117122464,SRX20140868,INTS10,714
chr1,117121771,117121987,SRX5054307,FOSL2,216
chr1,117121985,117122506,SRX16500059,CTCF,521
chr1,117122022,117122460,SRX16500060,CTCF,438
chr1,117122035,117122423,SRX16500061,CTCF,388
chr1,117122040,117122450,SRX16500062,CTCF,410
chr1,117122123,117122343,SRX5075170,SMARCA4,220
chr1,117122124,117122377,SRX4174629,CTCF,253
chr1,117122147,117122371,SRX5075175,SMARCA4,224
chr1,117128357,117128972,SRX16500059,CTCF,615
chr1,117128443,117129043,SRX5075174,SMARCA4,600
chr1,117128517,117129030,SRX5075168,SMARCA4,513
chr1,117128527,117129026,SRX16500062,CTCF,499
chr1,117128534,117128846,SRX5716469,SMARCA4,312
chr1,117128548,117128912,SRX5075170,SMARCA4,364
chr1,117128568,117128975,SRX5075176,SMARCA4,407
chr1,117128573,117128917,SRX5075175,SMARCA4,344
chr1,117128599,117128998,SRX16500060,CTCF,399
chr1,117128604,117128988,SRX16500061,CTCF,384
chr1,117128604,117129092,SRX5716470,SMARCA4,488
chr1,117128618,117128906,SRX5075169,SMARCA4,288
chr1,117128620,117128902,SRX5716464,SMARCA4,282
chr1,117138659,117138839,SRX5075170,SMARCA4,180
chr1,117146869,117147557,SRX5075175,SMARCA4,688
chr1,117146873,117147509,SRX5075176,SMARCA4,636
chr1,117146909,117147540,SRX5075169,SMARCA4,631
chr1,117146971,117147476,SRX5075170,SMARCA4,505
chr1,117146974,117147486,SRX5716470,SMARCA4,512
chr1,117146978,117147380,SRX5075168,SMARCA4,402
chr1,117146981,117147467,SRX5716467,SMARCA2,486
chr1,117146991,117147417,SRX5716469,SMARCA4,426
chr1,117147000,117147531,SRX5054309,FOSL2,531
chr1,117147013,117147398,SRX5075174,SMARCA4,385
chr1,117147017,117147429,SRX5020214,SMARCA2,412
chr1,117147021,117147323,SRX5716468,SMARCA2,302
chr1,117147022,117147458,SRX5054308,FOSL2,436
chr1,117147075,117147357,SRX5075182,SMARCA2,282
chr1,117147086,117147275,SRX5054307,FOSL2,189
chr1,117147104,117147349,SRX5075181,SMARCA2,245
chr1,117147991,117148187,SRX5075176,SMARCA4,196
chr1,117170113,117170517,SRX5075174,SMARCA4,404
chr1,117170238,117170488,SRX5716463,SMARCA4,250
chr1,117170296,117170499,SRX5075168,SMARCA4,203
chr1,117171787,117172506,SRX5075168,SMARCA4,719
chr1,117171822,117172465,SRX5075174,SMARCA4,643
chr1,117171873,117172241,SRX5075176,SMARCA4,368
chr1,117171874,117172253,SRX5075170,SMARCA4,379
chr1,117171881,117172712,SRX20140867,INTS10,831
chr1,117171892,117172709,SRX20140895,INTS13,817
chr1,117171900,117172313,SRX5716470,SMARCA4,413
chr1,117171910,117172137,SRX5075169,SMARCA4,227
chr1,117171936,117172451,SRX20140868,INTS10,515
chr1,117171962,117172364,SRX20140879,CPSF3L,402
chr1,117171969,117172460,SRX20140881,CPSF3L,491
chr1,117171980,117172203,SRX5716469,SMARCA4,223
chr1,117172030,117172301,SRX5716463,SMARCA4,271
chr1,117172033,117172340,SRX20140860,SOX2,307
chr1,117172063,117172323,SRX5716454,SOX3,260
chr1,117172066,117172268,SRX5075175,SMARCA4,202
chr1,117172079,117172389,SRX5716451,SOX2,310
chr1,117172104,117172329,SRX20140862,SOX2,225
chr1,117172142,117172408,SRX16500059,CTCF,266
chr1,117237731,117237966,SRX5075176,SMARCA4,235
chr1,117237753,117237972,SRX5054309,FOSL2,219
chr1,117237863,117238032,SRX5075170,SMARCA4,169
chr1,117250279,117250455,SRX5075170,SMARCA4,176
chr1,117284553,117284884,SRX4174629,CTCF,331
chr1,117284561,117285002,SRX16500062,CTCF,441
chr1,117284568,117285022,SRX16500059,CTCF,454
chr1,117284573,117285025,SRX16500060,CTCF,452
chr1,117284596,117285012,SRX16500061,CTCF,416
chr1,117284655,117284895,SRX5075174,SMARCA4,240
chr1,117284689,117284864,SRX5075176,SMARCA4,175
chr1,117284691,117284912,SRX5075168,SMARCA4,221
chr1,117290948,117291141,SRX5054309,FOSL2,193
chr1,117366525,117367539,SRX20140895,INTS13,1014
chr1,117366568,117366802,SRX5075176,SMARCA4,234
chr1,117366583,117367286,SRX20140867,INTS10,703
chr1,117366640,117366971,SRX5075174,SMARCA4,331
chr1,117366640,117367423,SRX20140868,INTS10,783
chr1,117366647,117366975,SRX5075175,SMARCA4,328
chr1,117366666,117366896,SRX5075170,SMARCA4,230
chr1,117366716,117366925,SRX5075168,SMARCA4,209
chr1,117366846,117367117,SRX20140896,INTS13,271
chr1,117366875,117367368,SRX20140897,INTS13,493
chr1,117367104,117367303,SRX5075169,SMARCA4,199
chr1,117367162,117367357,SRX5075170,SMARCA4,195
chr1,117367173,117367541,SRX5716470,SMARCA4,368
chr1,117367238,117367770,SRX20140881,CPSF3L,532
chr1,117367397,117367576,SRX5075176,SMARCA4,179
chr1,117392860,117393144,SRX5716470,SMARCA4,284
chr1,117392867,117393082,SRX5075169,SMARCA4,215
chr1,117392912,117393087,SRX5075176,SMARCA4,175
chr1,117467468,117467723,SRX5054309,FOSL2,255
chr1,117501386,117501673,SRX5054309,FOSL2,287
chr1,117501455,117501673,SRX5054308,FOSL2,218
chr1,117512746,117513129,SRX16500061,CTCF,383
chr1,117512756,117513184,SRX16500059,CTCF,428
chr1,117512763,117513189,SRX16500060,CTCF,426
chr1,117512776,117513141,SRX16500062,CTCF,365
chr1,117512880,117513126,SRX5075176,SMARCA4,246
chr1,117527748,117527977,SRX5075170,SMARCA4,229
chr1,117527775,117527957,SRX5075176,SMARCA4,182
chr1,117534862,117535294,SRX16500060,CTCF,432
chr1,117534863,117535367,SRX16500059,CTCF,504
chr1,117534974,117535393,SRX16500062,CTCF,419
chr1,117534977,117535347,SRX16500061,CTCF,370
chr1,117535012,117535386,SRX5075168,SMARCA4,374
chr1,117535064,117535363,SRX5075174,SMARCA4,299
chr1,117535085,117535298,SRX5716464,SMARCA4,213
chr1,117535086,117535364,SRX5716463,SMARCA4,278
chr1,117569836,117570312,SRX5075176,SMARCA4,476
chr1,117569866,117570206,SRX5075170,SMARCA4,340
chr1,117569913,117570209,SRX5075169,SMARCA4,296
chr1,117569952,117570189,SRX5716467,SMARCA2,237
chr1,117569979,117570190,SRX5716468,SMARCA2,211
chr1,117573425,117573758,SRX5075170,SMARCA4,333
chr1,117573446,117573735,SRX5054309,FOSL2,289
chr1,117573456,117573671,SRX5075176,SMARCA4,215
chr1,117573483,117573680,SRX5054308,FOSL2,197
chr1,117573489,117573700,SRX5075169,SMARCA4,211
chr1,117605443,117606088,SRX5075174,SMARCA4,645
chr1,117605522,117606111,SRX5075168,SMARCA4,589
chr1,117605550,117606062,SRX5075170,SMARCA4,512
chr1,117605762,117606011,SRX5716451,SOX2,249
chr1,117605766,117606069,SRX5054307,FOSL2,303
chr1,117605771,117605976,SRX5716454,SOX3,205
chr1,117605783,117606039,SRX5075176,SMARCA4,256
chr1,117605784,117606009,SRX5716469,SMARCA4,225
chr1,117605793,117605998,SRX5716464,SMARCA4,205
chr1,117605802,117606004,SRX5054309,FOSL2,202
chr1,117605804,117606100,SRX5716463,SMARCA4,296
chr1,117605845,117606262,SRX20140895,INTS13,417
chr1,117605906,117606183,SRX20140868,INTS10,277
chr1,117605935,117606358,SRX20140881,CPSF3L,423
chr1,117612865,117613132,SRX5054309,FOSL2,267
chr1,117612914,117613104,SRX5054308,FOSL2,190
chr1,117612946,117613127,SRX5075169,SMARCA4,181
chr1,117646070,117646250,SRX5075170,SMARCA4,180
chr1,117646088,117646282,SRX5075176,SMARCA4,194
chr1,117657043,117657351,SRX5075175,SMARCA4,308
chr1,117657044,117657351,SRX5075176,SMARCA4,307
chr1,117657045,117657243,SRX5075174,SMARCA4,198
chr1,117657053,117657355,SRX5054309,FOSL2,302
chr1,117657071,117657299,SRX5054308,FOSL2,228
chr1,117657092,117657398,SRX5075168,SMARCA4,306
chr1,117657118,117657386,SRX5075169,SMARCA4,268
chr1,117657122,117657362,SRX5075170,SMARCA4,240
chr1,117673527,117673810,SRX5054309,FOSL2,283
chr1,117686943,117687149,SRX5054309,FOSL2,206
chr1,117686971,117687162,SRX5054308,FOSL2,191
chr1,117735028,117735338,SRX5075169,SMARCA4,310
chr1,117735032,117735410,SRX5716470,SMARCA4,378
chr1,117735046,117735252,SRX5075168,SMARCA4,206
chr1,117735091,117735299,SRX5075174,SMARCA4,208
chr1,117735118,117735341,SRX5075170,SMARCA4,223
chr1,117735127,117735383,SRX5075176,SMARCA4,256
chr1,117735176,117735388,SRX5716469,SMARCA4,212
chr1,117754060,117754454,SRX16500060,CTCF,394
chr1,117754061,117754400,SRX16500062,CTCF,339
chr1,117754066,117754335,SRX5075174,SMARCA4,269
chr1,117754066,117754405,SRX16500059,CTCF,339
chr1,117754090,117754328,SRX5075168,SMARCA4,238
chr1,117754091,117754422,SRX16500061,CTCF,331
chr1,117754110,117754359,SRX5716463,SMARCA4,249
chr1,117758647,117759045,SRX5075175,SMARCA4,398
chr1,117758659,117759119,SRX5716470,SMARCA4,460
chr1,117758703,117759225,SRX16500062,CTCF,522
chr1,117758707,117759293,SRX16500060,CTCF,586
chr1,117758737,117759177,SRX5075174,SMARCA4,440
chr1,117758743,117759194,SRX5075168,SMARCA4,451
chr1,117758744,117759187,SRX5075176,SMARCA4,443
chr1,117758757,117759284,SRX16500059,CTCF,527
chr1,117758775,117759146,SRX5075170,SMARCA4,371
chr1,117758790,117759305,SRX16500061,CTCF,515
chr1,117758812,117759140,SRX5075169,SMARCA4,328
chr1,117758820,117759069,SRX4174629,CTCF,249
chr1,117758891,117759098,SRX5716463,SMARCA4,207
chr1,117780956,117781578,SRX5075176,SMARCA4,622
chr1,117780965,117781439,SRX5716470,SMARCA4,474
chr1,117781002,117781335,SRX5075169,SMARCA4,333
chr1,117781020,117781514,SRX5075170,SMARCA4,494
chr1,117781038,117781473,SRX5716468,SMARCA2,435
chr1,117781056,117781389,SRX5020211,SMARCA2,333
chr1,117781073,117781479,SRX5716467,SMARCA2,406
chr1,117781091,117781368,SRX5716469,SMARCA4,277
chr1,117781095,117781398,SRX5075175,SMARCA4,303
chr1,117781103,117781283,SRX5054308,FOSL2,180
chr1,117781131,117781375,SRX5020214,SMARCA2,244
chr1,117787706,117788041,SRX5075170,SMARCA4,335
chr1,117787707,117787950,SRX5075176,SMARCA4,243
chr1,117794060,117794514,SRX5075170,SMARCA4,454
chr1,117794072,117794471,SRX5075176,SMARCA4,399
chr1,117794080,117794310,SRX5716469,SMARCA4,230
chr1,117794087,117794383,SRX5075175,SMARCA4,296
chr1,117794090,117794418,SRX5716467,SMARCA2,328
chr1,117794097,117794363,SRX5716470,SMARCA4,266
chr1,117794106,117794359,SRX5075169,SMARCA4,253
chr1,117794192,117794422,SRX5020211,SMARCA2,230
chr1,117794283,117794463,SRX5054308,FOSL2,180
chr1,117795261,117795577,SRX5075170,SMARCA4,316
chr1,117795261,117795603,SRX5075176,SMARCA4,342
chr1,117795263,117795617,SRX5054309,FOSL2,354
chr1,117795322,117795592,SRX5075169,SMARCA4,270
chr1,117795392,117795582,SRX5054308,FOSL2,190
chr1,117801075,117801283,SRX5054309,FOSL2,208
chr1,117802444,117802831,SRX5075176,SMARCA4,387
chr1,117802564,117802953,SRX5075170,SMARCA4,389
chr1,117803417,117803589,SRX5075170,SMARCA4,172
chr1,117809884,117810084,SRX5075176,SMARCA4,200
chr1,117814982,117815493,SRX5075176,SMARCA4,511
chr1,117814986,117815370,SRX5716469,SMARCA4,384
chr1,117814995,117815322,SRX5716467,SMARCA2,327
chr1,117815006,117815366,SRX5075169,SMARCA4,360
chr1,117815013,117815456,SRX5075170,SMARCA4,443
chr1,117815026,117815352,SRX5054308,FOSL2,326
chr1,117815043,117815383,SRX5075175,SMARCA4,340
chr1,117815075,117815367,SRX5054309,FOSL2,292
chr1,117815076,117815326,SRX5716470,SMARCA4,250
chr1,117815078,117815289,SRX5716468,SMARCA2,211
chr1,117821765,117822080,SRX5075169,SMARCA4,315
chr1,117821773,117822090,SRX5054308,FOSL2,317
chr1,117821786,117822061,SRX5054309,FOSL2,275
chr1,117821795,117822066,SRX5075175,SMARCA4,271
chr1,117821797,117822080,SRX5075176,SMARCA4,283
chr1,117821801,117822115,SRX5075170,SMARCA4,314
chr1,117821804,117822032,SRX5716467,SMARCA2,228
chr1,117826459,117826761,SRX5075170,SMARCA4,302
chr1,117826495,117827005,SRX5075176,SMARCA4,510
chr1,117826508,117826748,SRX5075169,SMARCA4,240
chr1,117826538,117826765,SRX5054309,FOSL2,227
chr1,117826821,117827029,SRX5075170,SMARCA4,208
chr1,117828154,117828404,SRX5075169,SMARCA4,250
chr1,117828186,117828441,SRX5075170,SMARCA4,255
chr1,117828198,117828434,SRX5716469,SMARCA4,236
chr1,117838947,117839340,SRX5054309,FOSL2,393
chr1,117839010,117839204,SRX5075169,SMARCA4,194
chr1,117839026,117839307,SRX5075176,SMARCA4,281
chr1,117839033,117839307,SRX5075175,SMARCA4,274
chr1,117839057,117839278,SRX5716469,SMARCA4,221
chr1,117839138,117839311,SRX5075170,SMARCA4,173
chr1,117860939,117861298,SRX5075170,SMARCA4,359
chr1,117860998,117861329,SRX5075176,SMARCA4,331
chr1,117895429,117895882,SRX16500061,CTCF,453
chr1,117895471,117895830,SRX5075170,SMARCA4,359
chr1,117895472,117895996,SRX16500059,CTCF,524
chr1,117895498,117895847,SRX5075174,SMARCA4,349
chr1,117895506,117896044,SRX16500060,CTCF,538
chr1,117895510,117895816,SRX5075176,SMARCA4,306
chr1,117895515,117895938,SRX16500062,CTCF,423
chr1,117895534,117895745,SRX5716470,SMARCA4,211
chr1,117895540,117895720,SRX5054308,FOSL2,180
chr1,117895540,117895803,SRX5716463,SMARCA4,263
chr1,117895542,117895858,SRX5075168,SMARCA4,316
chr1,117895550,117895792,SRX5075175,SMARCA4,242
chr1,117895559,117895904,SRX4174629,CTCF,345
chr1,117895562,117895767,SRX5716464,SMARCA4,205
chr1,117895588,117895791,SRX5075169,SMARCA4,203
chr1,117928827,117929037,SRX5075168,SMARCA4,210
chr1,117928830,117929029,SRX5075174,SMARCA4,199
chr1,117929363,117929638,SRX5075170,SMARCA4,275
chr1,117929440,117929841,SRX5075174,SMARCA4,401
chr1,117959375,117959709,SRX5075176,SMARCA4,334
chr1,117959444,117959739,SRX5075170,SMARCA4,295
chr1,117967457,117967773,SRX16500060,CTCF,316
chr1,117967485,117967695,SRX16500062,CTCF,210
chr1,117967527,117968087,SRX5075176,SMARCA4,560
chr1,117967562,117967927,SRX16500059,CTCF,365
chr1,117967570,117967954,SRX5075169,SMARCA4,384
chr1,117967570,117968242,SRX5075170,SMARCA4,672
chr1,117967606,117967874,SRX16500061,CTCF,268
chr1,117967616,117968058,SRX5716470,SMARCA4,442
chr1,117967636,117967925,SRX5716469,SMARCA4,289
chr1,118042441,118042888,SRX5054309,FOSL2,447
chr1,118042465,118042949,SRX5075176,SMARCA4,484
chr1,118042476,118042870,SRX5054308,FOSL2,394
chr1,118042496,118042919,SRX5075170,SMARCA4,423
chr1,118042517,118042890,SRX5075175,SMARCA4,373
chr1,118042579,118042885,SRX5075169,SMARCA4,306
chr1,118042589,118042904,SRX5020211,SMARCA2,315
chr1,118042617,118042891,SRX5716470,SMARCA4,274
chr1,118073937,118074335,SRX5075176,SMARCA4,398
chr1,118073991,118074421,SRX5075170,SMARCA4,430
chr1,118074108,118074320,SRX5716469,SMARCA4,212
chr1,118074171,118074386,SRX5716467,SMARCA2,215
chr1,118075088,118075399,SRX5054309,FOSL2,311
chr1,118075133,118075422,SRX5054308,FOSL2,289
chr1,118075165,118075360,SRX5075170,SMARCA4,195
chr1,118075179,118075354,SRX5075176,SMARCA4,175
chr1,118077251,118077731,SRX16500062,CTCF,480
chr1,118077277,118077691,SRX16500061,CTCF,414
chr1,118077280,118077774,SRX16500059,CTCF,494
chr1,118077287,118077725,SRX16500060,CTCF,438
chr1,118077438,118077680,SRX5075176,SMARCA4,242
chr1,118097745,118098039,SRX5075169,SMARCA4,294
chr1,118097781,118098002,SRX5075170,SMARCA4,221
chr1,118097802,118097991,SRX5054308,FOSL2,189
chr1,118097802,118098023,SRX5075175,SMARCA4,221
chr1,118100782,118101003,SRX5054309,FOSL2,221
chr1,118101382,118101751,SRX5716467,SMARCA2,369
chr1,118101384,118101850,SRX5075176,SMARCA4,466
chr1,118101416,118101745,SRX5075175,SMARCA4,329
chr1,118101428,118101727,SRX5075181,SMARCA2,299
chr1,118101433,118101782,SRX5054309,FOSL2,349
chr1,118101436,118101812,SRX5075169,SMARCA4,376
chr1,118101468,118101791,SRX5054308,FOSL2,323
chr1,118101496,118101766,SRX5075170,SMARCA4,270
chr1,118101532,118101820,SRX5716469,SMARCA4,288
chr1,118111328,118111582,SRX5075181,SMARCA2,254
chr1,118111338,118111664,SRX5716469,SMARCA4,326
chr1,118111362,118111710,SRX5716470,SMARCA4,348
chr1,118111396,118111603,SRX5075175,SMARCA4,207
chr1,118111469,118111647,SRX5075170,SMARCA4,178
chr1,118113234,118113612,SRX5020214,SMARCA2,378
chr1,118113312,118113646,SRX5075170,SMARCA4,334
chr1,118113313,118113665,SRX5075169,SMARCA4,352
chr1,118113328,118113606,SRX5075175,SMARCA4,278
chr1,118113338,118113648,SRX5075176,SMARCA4,310
chr1,118113352,118113694,SRX5054309,FOSL2,342
chr1,118113437,118113682,SRX5054308,FOSL2,245
chr1,118115656,118115886,SRX5054309,FOSL2,230
chr1,118116411,118116581,SRX5075170,SMARCA4,170
chr1,118116528,118116755,SRX5075176,SMARCA4,227
chr1,118122231,118122588,SRX5075170,SMARCA4,357
chr1,118122265,118122486,SRX5054309,FOSL2,221
chr1,118122283,118122541,SRX5716469,SMARCA4,258
chr1,118122299,118122550,SRX5075169,SMARCA4,251
chr1,118122325,118122617,SRX5075176,SMARCA4,292
chr1,118136375,118136969,SRX5075170,SMARCA4,594
chr1,118136408,118136985,SRX5075169,SMARCA4,577
chr1,118136445,118136890,SRX5716467,SMARCA2,445
chr1,118136450,118136940,SRX5075175,SMARCA4,490
chr1,118136456,118137110,SRX5075176,SMARCA4,654
chr1,118136472,118136917,SRX5716470,SMARCA4,445
chr1,118136517,118136968,SRX5054309,FOSL2,451
chr1,118136521,118136962,SRX5054308,FOSL2,441
chr1,118136543,118136743,SRX5075174,SMARCA4,200
chr1,118136563,118136960,SRX5716469,SMARCA4,397
chr1,118144600,118145150,SRX5075170,SMARCA4,550
chr1,118144659,118145167,SRX5075176,SMARCA4,508
chr1,118144765,118145084,SRX5075169,SMARCA4,319
chr1,118147561,118147880,SRX5716470,SMARCA4,319
chr1,118147601,118147813,SRX5716469,SMARCA4,212
chr1,118147618,118147870,SRX5075169,SMARCA4,252
chr1,118147627,118147843,SRX5075175,SMARCA4,216
chr1,118147642,118147855,SRX5075170,SMARCA4,213
chr1,118147670,118147859,SRX5075176,SMARCA4,189
chr1,118151244,118151785,SRX16500059,CTCF,541
chr1,118151262,118151790,SRX16500060,CTCF,528
chr1,118151289,118151761,SRX16500061,CTCF,472
chr1,118151335,118151741,SRX16500062,CTCF,406
chr1,118151341,118151686,SRX5075170,SMARCA4,345
chr1,118151425,118151646,SRX5075168,SMARCA4,221
chr1,118151434,118151641,SRX5075176,SMARCA4,207
chr1,118151443,118151724,SRX5075174,SMARCA4,281
chr1,118158975,118159222,SRX5075169,SMARCA4,247
chr1,118158988,118159266,SRX5054309,FOSL2,278
chr1,118166145,118166546,SRX5075176,SMARCA4,401
chr1,118166187,118166516,SRX5075170,SMARCA4,329
chr1,118185080,118185614,SRX5075168,SMARCA4,534
chr1,118185085,118185704,SRX5075174,SMARCA4,619
chr1,118185099,118185582,SRX20140895,INTS13,483
chr1,118185169,118185468,SRX5716464,SMARCA4,299
chr1,118185191,118185594,SRX5716463,SMARCA4,403
chr1,118185248,118185423,SRX5075170,SMARCA4,175
chr1,118190709,118191156,SRX5075176,SMARCA4,447
chr1,118190899,118191177,SRX5716467,SMARCA2,278
chr1,118190918,118191168,SRX5075170,SMARCA4,250
chr1,118204787,118204987,SRX5075176,SMARCA4,200
chr1,118208365,118209144,SRX5075170,SMARCA4,779
chr1,118208406,118209002,SRX5075176,SMARCA4,596
chr1,118208536,118209055,SRX5075169,SMARCA4,519
chr1,118208541,118208907,SRX5716468,SMARCA2,366
chr1,118208592,118208995,SRX5075175,SMARCA4,403
chr1,118208639,118208988,SRX5716470,SMARCA4,349
chr1,118208692,118208944,SRX5716467,SMARCA2,252
chr1,118208719,118208919,SRX5020211,SMARCA2,200
chr1,118208812,118209018,SRX5054308,FOSL2,206
chr1,118217147,118217704,SRX5075170,SMARCA4,557
chr1,118217212,118217603,SRX5716470,SMARCA4,391
chr1,118217263,118217469,SRX5075175,SMARCA4,206
chr1,118217285,118217547,SRX5075176,SMARCA4,262
chr1,118217394,118217625,SRX5075169,SMARCA4,231
chr1,118223396,118223714,SRX16500059,CTCF,318
chr1,118244229,118244496,SRX5075170,SMARCA4,267
chr1,118244274,118244527,SRX5075176,SMARCA4,253
chr1,118250394,118250661,SRX5075174,SMARCA4,267
chr1,118256377,118256616,SRX5075170,SMARCA4,239
chr1,118256392,118256605,SRX5075176,SMARCA4,213
chr1,118258033,118258309,SRX5075170,SMARCA4,276
chr1,118258072,118258354,SRX5075176,SMARCA4,282
chr1,118275695,118276182,SRX5075170,SMARCA4,487
chr1,118275746,118276187,SRX5075176,SMARCA4,441
chr1,118275793,118276041,SRX5716470,SMARCA4,248
chr1,118275796,118276078,SRX5075169,SMARCA4,282
chr1,118275802,118276028,SRX5716464,SMARCA4,226
chr1,118275824,118276116,SRX5075175,SMARCA4,292
chr1,118275866,118276082,SRX5075174,SMARCA4,216
chr1,118294947,118295482,SRX5075170,SMARCA4,535
chr1,118294999,118295340,SRX5075169,SMARCA4,341
chr1,118295063,118295420,SRX5075176,SMARCA4,357
chr1,118295100,118295302,SRX5075175,SMARCA4,202
chr1,118300835,118301124,SRX5075174,SMARCA4,289
chr1,118300843,118301125,SRX5075176,SMARCA4,282
chr1,118300887,118301125,SRX5716463,SMARCA4,238
chr1,118300901,118301145,SRX5716470,SMARCA4,244
chr1,118300923,118301195,SRX5075170,SMARCA4,272
chr1,118300926,118301129,SRX5075169,SMARCA4,203
chr1,118300939,118301186,SRX5716464,SMARCA4,247
chr1,118300946,118301171,SRX5075168,SMARCA4,225
chr1,118304930,118305329,SRX16500061,CTCF,399
chr1,118304948,118305183,SRX16500059,CTCF,235
chr1,118304992,118305311,SRX16500060,CTCF,319
chr1,118305038,118305299,SRX16500062,CTCF,261
chr1,118317855,118318089,SRX5075170,SMARCA4,234
chr1,118317856,118318074,SRX5075176,SMARCA4,218
chr1,118317906,118318105,SRX5075169,SMARCA4,199
chr1,118321985,118322417,SRX5075170,SMARCA4,432
chr1,118322056,118322383,SRX5075176,SMARCA4,327
chr1,118325633,118325820,SRX5054308,FOSL2,187
chr1,118333799,118334125,SRX5075175,SMARCA4,326
chr1,118333818,118334275,SRX5075170,SMARCA4,457
chr1,118333838,118334222,SRX5075169,SMARCA4,384
chr1,118333951,118334167,SRX5075176,SMARCA4,216
chr1,118335242,118335433,SRX5075176,SMARCA4,191
chr1,118335258,118335664,SRX5716470,SMARCA4,406
chr1,118335350,118335644,SRX5054309,FOSL2,294
chr1,118335404,118335584,SRX5054308,FOSL2,180
chr1,118335408,118335708,SRX5716469,SMARCA4,300
chr1,118335449,118335649,SRX5075175,SMARCA4,200
chr1,118360836,118361144,SRX5054308,FOSL2,308
chr1,118360840,118361152,SRX5054309,FOSL2,312
chr1,118360875,118361157,SRX5075176,SMARCA4,282
chr1,118360928,118361157,SRX5075170,SMARCA4,229
chr1,118366266,118366650,SRX5075169,SMARCA4,384
chr1,118366328,118366664,SRX5075176,SMARCA4,336
chr1,118366331,118366639,SRX5075170,SMARCA4,308
chr1,118366334,118366631,SRX5716467,SMARCA2,297
chr1,118366351,118366604,SRX5075175,SMARCA4,253
chr1,118366389,118366692,SRX5054309,FOSL2,303
chr1,118366431,118366670,SRX5716469,SMARCA4,239
chr1,118385889,118386268,SRX5075176,SMARCA4,379
chr1,118385962,118386364,SRX5075170,SMARCA4,402
chr1,118385985,118386223,SRX5716469,SMARCA4,238
chr1,118388366,118388575,SRX5054309,FOSL2,209
chr1,118397060,118397796,SRX5075170,SMARCA4,736
chr1,118397129,118397609,SRX5075176,SMARCA4,480
chr1,118397145,118397456,SRX5716468,SMARCA2,311
chr1,118397146,118397586,SRX5075175,SMARCA4,440
chr1,118397151,118397633,SRX5716470,SMARCA4,482
chr1,118397177,118397439,SRX5075174,SMARCA4,262
chr1,118397223,118397532,SRX5716469,SMARCA4,309
chr1,118397229,118397518,SRX5020211,SMARCA2,289
chr1,118397236,118397565,SRX5716467,SMARCA2,329
chr1,118397251,118397469,SRX5075169,SMARCA4,218
chr1,118397266,118397513,SRX5075181,SMARCA2,247
chr1,118397304,118397514,SRX5054308,FOSL2,210
chr1,118442264,118442552,SRX5075170,SMARCA4,288
chr1,118442386,118442559,SRX5075174,SMARCA4,173
chr1,118504185,118504354,SRX5075170,SMARCA4,169
chr1,118504211,118504391,SRX5075176,SMARCA4,180
chr1,118589323,118589962,SRX5075170,SMARCA4,639
chr1,118589327,118589843,SRX5075176,SMARCA4,516
chr1,118650410,118650626,SRX5075176,SMARCA4,216
chr1,118659697,118659866,SRX5075170,SMARCA4,169
chr1,118659719,118659898,SRX5075168,SMARCA4,179
chr1,118659767,118659947,SRX5075174,SMARCA4,180
chr1,118661997,118662445,SRX5054309,FOSL2,448
chr1,118662047,118662323,SRX5054308,FOSL2,276
chr1,118688922,118689196,SRX5075169,SMARCA4,274
chr1,118688944,118689196,SRX5020211,SMARCA2,252
chr1,118688970,118689298,SRX5075176,SMARCA4,328
chr1,118688977,118689251,SRX5054308,FOSL2,274
chr1,118688978,118689189,SRX5716470,SMARCA4,211
chr1,118688981,118689222,SRX5075170,SMARCA4,241
chr1,118716773,118717072,SRX16500059,CTCF,299
chr1,118716774,118717148,SRX16500060,CTCF,374
chr1,118716842,118717140,SRX16500062,CTCF,298
chr1,118739351,118739982,SRX5075176,SMARCA4,631
chr1,118739465,118739910,SRX5075175,SMARCA4,445
chr1,118739474,118740000,SRX5075170,SMARCA4,526
chr1,118739540,118740057,SRX5716470,SMARCA4,517
chr1,118739543,118739873,SRX5020211,SMARCA2,330
chr1,118739559,118739861,SRX5716468,SMARCA2,302
chr1,118739572,118739887,SRX5075174,SMARCA4,315
chr1,118739575,118740008,SRX5075169,SMARCA4,433
chr1,118739585,118740021,SRX5716469,SMARCA4,436
chr1,118739586,118739852,SRX5075168,SMARCA4,266
chr1,118739618,118739887,SRX5020214,SMARCA2,269
chr1,118739622,118739980,SRX5054309,FOSL2,358
chr1,118739642,118739866,SRX5075181,SMARCA2,224
chr1,118739677,118740006,SRX5716467,SMARCA2,329
chr1,118739690,118740026,SRX5054308,FOSL2,336
chr1,118751272,118751619,SRX5054309,FOSL2,347
chr1,118751283,118751628,SRX5075176,SMARCA4,345
chr1,118751293,118751543,SRX5075170,SMARCA4,250
chr1,118783400,118783645,SRX5075170,SMARCA4,245
chr1,118783452,118783666,SRX5075176,SMARCA4,214
chr1,118785360,118785686,SRX5075170,SMARCA4,326
chr1,118785373,118785624,SRX5075169,SMARCA4,251
chr1,118788384,118788723,SRX5075176,SMARCA4,339
chr1,118788402,118788644,SRX5075169,SMARCA4,242
chr1,118788411,118788677,SRX5075170,SMARCA4,266
chr1,118788412,118788651,SRX5075175,SMARCA4,239
chr1,118788505,118788685,SRX5054308,FOSL2,180
chr1,118850982,118851157,SRX5075174,SMARCA4,175
chr1,118862638,118863080,SRX5716469,SMARCA4,442
chr1,118862721,118863174,SRX5075169,SMARCA4,453
chr1,118862726,118863122,SRX5075175,SMARCA4,396
chr1,118862730,118863116,SRX5716470,SMARCA4,386
chr1,118862784,118863104,SRX5054309,FOSL2,320
chr1,118862808,118863080,SRX5054308,FOSL2,272
chr1,118869525,118869745,SRX5054309,FOSL2,220
chr1,118902549,118903024,SRX5054309,FOSL2,475
chr1,118902720,118902900,SRX5054308,FOSL2,180
chr1,118929033,118929294,SRX5075168,SMARCA4,261
chr1,118929035,118929219,SRX5075176,SMARCA4,184
chr1,118929035,118929222,SRX5075175,SMARCA4,187
chr1,118944135,118944416,SRX5054309,FOSL2,281
chr1,118944157,118944402,SRX5054308,FOSL2,245
chr1,118945518,118945835,SRX5075170,SMARCA4,317
chr1,118945524,118945776,SRX5716468,SMARCA2,252
chr1,118945543,118945861,SRX5075176,SMARCA4,318
chr1,118945579,118945779,SRX5075169,SMARCA4,200
chr1,118945596,118945816,SRX5075175,SMARCA4,220
chr1,118947967,118948165,SRX5075169,SMARCA4,198
chr1,118949301,118949542,SRX5075170,SMARCA4,241
chr1,118960063,118960325,SRX5054308,FOSL2,262
chr1,118960071,118960284,SRX5020211,SMARCA2,213
chr1,118961276,118961481,SRX5054309,FOSL2,205
chr1,118963501,118963714,SRX5054309,FOSL2,213
chr1,119002058,119002539,SRX5075175,SMARCA4,481
chr1,119002075,119002386,SRX5054308,FOSL2,311
chr1,119002079,119002497,SRX5075169,SMARCA4,418
chr1,119002103,119002343,SRX5075176,SMARCA4,240
chr1,119002104,119002403,SRX5075170,SMARCA4,299
chr1,119002106,119002356,SRX5054309,FOSL2,250
chr1,119002177,119002443,SRX5716470,SMARCA4,266
chr1,119002187,119002475,SRX5716469,SMARCA4,288
chr1,119008597,119009063,SRX16500059,CTCF,466
chr1,119008609,119009084,SRX16500060,CTCF,475
chr1,119008618,119009071,SRX16500061,CTCF,453
chr1,119008647,119009073,SRX16500062,CTCF,426
chr1,119008701,119008955,SRX5075168,SMARCA4,254
chr1,119008719,119009594,SRX5075170,SMARCA4,875
chr1,119008725,119008959,SRX5075174,SMARCA4,234
chr1,119008773,119009018,SRX5075176,SMARCA4,245
chr1,119008993,119009381,SRX5716470,SMARCA4,388
chr1,119009032,119009348,SRX5054309,FOSL2,316
chr1,119009036,119009489,SRX5075174,SMARCA4,453
chr1,119009087,119009431,SRX5716469,SMARCA4,344
chr1,119009122,119009473,SRX5075176,SMARCA4,351
chr1,119009125,119009342,SRX5054308,FOSL2,217
chr1,119009135,119009314,SRX5075168,SMARCA4,179
chr1,119009151,119009396,SRX5075169,SMARCA4,245
chr1,119010233,119010466,SRX5075176,SMARCA4,233
chr1,119046656,119046981,SRX5075176,SMARCA4,325
chr1,119046658,119046944,SRX5075170,SMARCA4,286
chr1,119046673,119046958,SRX5716470,SMARCA4,285
chr1,119046738,119046938,SRX5020211,SMARCA2,200
chr1,119046747,119046961,SRX5716469,SMARCA4,214
chr1,119047047,119047282,SRX5075170,SMARCA4,235
chr1,119075627,119075894,SRX5054309,FOSL2,267
chr1,119075630,119075853,SRX5054308,FOSL2,223
chr1,119080149,119081052,SRX5075170,SMARCA4,903
chr1,119080368,119080987,SRX5075176,SMARCA4,619
chr1,119080463,119081012,SRX5716470,SMARCA4,549
chr1,119080494,119080924,SRX5716467,SMARCA2,430
chr1,119080495,119081005,SRX5075169,SMARCA4,510
chr1,119080553,119080871,SRX5716459,Epitope tags,318
chr1,119080563,119081040,SRX5716469,SMARCA4,477
chr1,119080569,119081017,SRX5075175,SMARCA4,448
chr1,119080587,119080904,SRX5020211,SMARCA2,317
chr1,119080595,119080965,SRX5054309,FOSL2,370
chr1,119080624,119080841,SRX5020214,SMARCA2,217
chr1,119080629,119080862,SRX5054308,FOSL2,233
chr1,119080638,119080938,SRX5716468,SMARCA2,300
chr1,119080643,119080936,SRX5075182,SMARCA2,293
chr1,119080646,119080884,SRX5075181,SMARCA2,238
chr1,119081391,119081584,SRX5075176,SMARCA4,193
chr1,119091595,119092149,SRX5075170,SMARCA4,554
chr1,119091608,119092072,SRX5075176,SMARCA4,464
chr1,119091660,119091967,SRX5075169,SMARCA4,307
chr1,119091667,119092012,SRX5075175,SMARCA4,345
chr1,119091678,119091969,SRX5075174,SMARCA4,291
chr1,119091694,119092008,SRX5075168,SMARCA4,314
chr1,119091701,119092012,SRX5716467,SMARCA2,311
chr1,119091706,119091911,SRX5716464,SMARCA4,205
chr1,119091721,119091932,SRX5716468,SMARCA2,211
chr1,119091727,119092033,SRX5716470,SMARCA4,306
chr1,119091734,119091963,SRX5054309,FOSL2,229
chr1,119091776,119092068,SRX5020211,SMARCA2,292
chr1,119097389,119097822,SRX5075176,SMARCA4,433
chr1,119097415,119097682,SRX5054309,FOSL2,267
chr1,119097450,119097727,SRX5075175,SMARCA4,277
chr1,119097451,119097718,SRX5054308,FOSL2,267
chr1,119097454,119097811,SRX5075170,SMARCA4,357
chr1,119097462,119097728,SRX5075169,SMARCA4,266
chr1,119097511,119097734,SRX5716469,SMARCA4,223
chr1,119134049,119134269,SRX5054309,FOSL2,220
chr1,119136485,119136672,SRX5075176,SMARCA4,187
chr1,119136497,119136727,SRX5075169,SMARCA4,230
chr1,119140017,119140493,SRX5075168,SMARCA4,476
chr1,119140064,119140926,SRX5075174,SMARCA4,862
chr1,119140086,119141049,SRX20140895,INTS13,963
chr1,119140139,119140611,SRX5716463,SMARCA4,472
chr1,119140156,119140509,SRX5075170,SMARCA4,353
chr1,119140331,119140862,SRX20140897,INTS13,531
chr1,119140370,119140962,SRX20140867,INTS10,592
chr1,119140376,119140992,SRX20140868,INTS10,616
chr1,119140386,119140669,SRX20140869,INTS10,283
chr1,119140494,119140884,SRX20140881,CPSF3L,390
chr1,119140582,119141028,SRX20140879,CPSF3L,446
chr1,119140657,119140904,SRX20140894,INTS13,247
chr1,119140668,119140912,SRX5075168,SMARCA4,244
chr1,119140673,119140886,SRX5075176,SMARCA4,213
chr1,119140972,119141279,SRX16500060,CTCF,307
chr1,119147683,119147984,SRX5716469,SMARCA4,301
chr1,119147807,119148038,SRX5075176,SMARCA4,231
chr1,119147869,119148115,SRX5075169,SMARCA4,246
chr1,119160870,119161100,SRX5716467,SMARCA2,230
chr1,119160907,119161254,SRX5075176,SMARCA4,347
chr1,119160908,119161205,SRX5075170,SMARCA4,297
chr1,119160952,119161145,SRX5075169,SMARCA4,193
chr1,119161010,119161317,SRX5716470,SMARCA4,307
chr1,119181253,119181482,SRX5075170,SMARCA4,229
chr1,119181353,119181537,SRX5075176,SMARCA4,184
chr1,119204170,119204609,SRX5075176,SMARCA4,439
chr1,119204268,119204609,SRX5075169,SMARCA4,341
chr1,119204300,119204586,SRX5716470,SMARCA4,286
chr1,119204319,119204577,SRX5716467,SMARCA2,258
chr1,119204366,119204569,SRX5075170,SMARCA4,203
chr1,119209066,119209248,SRX5075170,SMARCA4,182
chr1,119220978,119221355,SRX5054309,FOSL2,377
chr1,119221055,119221318,SRX5054308,FOSL2,263
chr1,119225288,119225568,SRX5075176,SMARCA4,280
chr1,119225337,119225637,SRX5075170,SMARCA4,300
chr1,119225749,119225976,SRX16500061,CTCF,227
chr1,119227526,119227876,SRX5075176,SMARCA4,350
chr1,119227540,119227994,SRX5075170,SMARCA4,454
chr1,119253456,119253679,SRX5054308,FOSL2,223
chr1,119253463,119253721,SRX5054309,FOSL2,258
chr1,119275309,119275805,SRX16500061,CTCF,496
chr1,119275342,119275841,SRX16500059,CTCF,499
chr1,119275377,119275801,SRX16500060,CTCF,424
chr1,119275402,119275807,SRX16500062,CTCF,405
chr1,119275463,119275756,SRX5075174,SMARCA4,293
chr1,119275475,119275751,SRX5075168,SMARCA4,276
chr1,119275482,119275713,SRX5716463,SMARCA4,231
chr1,119275506,119275736,SRX5716464,SMARCA4,230
chr1,119275519,119275693,SRX5075170,SMARCA4,174
chr1,119279394,119279713,SRX5020211,SMARCA2,319
chr1,119279396,119279856,SRX5054309,FOSL2,460
chr1,119279402,119280372,SRX5075176,SMARCA4,970
chr1,119279407,119279804,SRX5054308,FOSL2,397
chr1,119279409,119279778,SRX5716469,SMARCA4,369
chr1,119279419,119279857,SRX5075170,SMARCA4,438
chr1,119279423,119279849,SRX5075169,SMARCA4,426
chr1,119279425,119279910,SRX5075175,SMARCA4,485
chr1,119279452,119279804,SRX5716470,SMARCA4,352
chr1,119279474,119279778,SRX5020214,SMARCA2,304
chr1,119279480,119279863,SRX5716467,SMARCA2,383
chr1,119279503,119279695,SRX5075174,SMARCA4,192
chr1,119279510,119279693,SRX5075182,SMARCA2,183
chr1,119279512,119279820,SRX20140869,INTS10,308
chr1,119279529,119279841,SRX5716459,Epitope tags,312
chr1,119279954,119280341,SRX5716469,SMARCA4,387
chr1,119280005,119280444,SRX5075170,SMARCA4,439
chr1,119280022,119280374,SRX5075169,SMARCA4,352
chr1,119280043,119280347,SRX5716470,SMARCA4,304
chr1,119285315,119285870,SRX5075176,SMARCA4,555
chr1,119285347,119285889,SRX5075170,SMARCA4,542
chr1,119285398,119285724,SRX5716469,SMARCA4,326
chr1,119285402,119285758,SRX5054308,FOSL2,356
chr1,119285410,119285800,SRX5075169,SMARCA4,390
chr1,119285414,119285849,SRX5075175,SMARCA4,435
chr1,119285420,119285784,SRX5054309,FOSL2,364
chr1,119285432,119285690,SRX5716470,SMARCA4,258
chr1,119285489,119285741,SRX5716467,SMARCA2,252
chr1,119286481,119287014,SRX16500059,CTCF,533
chr1,119286560,119287023,SRX16500060,CTCF,463
chr1,119286594,119286977,SRX16500061,CTCF,383
chr1,119286619,119286992,SRX16500062,CTCF,373
chr1,119286702,119286893,SRX5075168,SMARCA4,191
chr1,119286714,119286974,SRX5716463,SMARCA4,260
chr1,119286720,119286983,SRX5075174,SMARCA4,263
chr1,119298657,119299096,SRX5075170,SMARCA4,439
chr1,119298665,119298989,SRX5020211,SMARCA2,324
chr1,119298686,119298959,SRX5716467,SMARCA2,273
chr1,119298712,119299073,SRX5716470,SMARCA4,361
chr1,119298718,119299073,SRX5075176,SMARCA4,355
chr1,119298729,119299126,SRX5075169,SMARCA4,397
chr1,119298740,119299018,SRX5054308,FOSL2,278
chr1,119298744,119299100,SRX5716469,SMARCA4,356
chr1,119298745,119298971,SRX5075182,SMARCA2,226
chr1,119298747,119299012,SRX5054309,FOSL2,265
chr1,119300065,119300310,SRX5075176,SMARCA4,245
chr1,119327829,119328230,SRX16500060,CTCF,401
chr1,119327845,119328190,SRX16500062,CTCF,345
chr1,119327855,119328284,SRX16500059,CTCF,429
chr1,119327870,119328199,SRX16500061,CTCF,329
chr1,119347878,119348186,SRX5054309,FOSL2,308
chr1,119354057,119354472,SRX5075176,SMARCA4,415
chr1,119367392,119367901,SRX16500060,CTCF,509
chr1,119367442,119367910,SRX16500059,CTCF,468
chr1,119367497,119367858,SRX16500062,CTCF,361
chr1,119367507,119367875,SRX16500061,CTCF,368
chr1,119367522,119367691,SRX5075170,SMARCA4,169
chr1,119367526,119367758,SRX5075176,SMARCA4,232
chr1,119371949,119372138,SRX5075176,SMARCA4,189
chr1,119371954,119372219,SRX5716470,SMARCA4,265
chr1,119371979,119372177,SRX5075169,SMARCA4,198
chr1,119372006,119372175,SRX5075170,SMARCA4,169
chr1,119372045,119372233,SRX5075175,SMARCA4,188
chr1,119372576,119372814,SRX16500061,CTCF,238
chr1,119372600,119372856,SRX16500060,CTCF,256
chr1,119409678,119410158,SRX5716470,SMARCA4,480
chr1,119409732,119410048,SRX5716468,SMARCA2,316
chr1,119409746,119410072,SRX5054309,FOSL2,326
chr1,119409768,119410114,SRX5716469,SMARCA4,346
chr1,119409769,119410193,SRX5075170,SMARCA4,424
chr1,119409774,119410134,SRX5075169,SMARCA4,360
chr1,119409788,119410131,SRX5075181,SMARCA2,343
chr1,119409800,119410168,SRX5075176,SMARCA4,368
chr1,119409860,119410122,SRX5075175,SMARCA4,262
chr1,119409861,119410103,SRX5020211,SMARCA2,242
chr1,119452881,119453372,SRX5716470,SMARCA4,491
chr1,119452984,119453338,SRX5075169,SMARCA4,354
chr1,119453019,119453350,SRX5075175,SMARCA4,331
chr1,119453042,119453337,SRX5075176,SMARCA4,295
chr1,119453047,119453271,SRX5716467,SMARCA2,224
chr1,119453053,119453423,SRX5716469,SMARCA4,370
chr1,119453109,119453463,SRX5075170,SMARCA4,354
chr1,119475728,119476208,SRX16500059,CTCF,480
chr1,119475785,119476186,SRX16500060,CTCF,401
chr1,119475844,119476194,SRX4174629,CTCF,350
chr1,119475866,119476296,SRX16500061,CTCF,430
chr1,119475915,119476154,SRX16500062,CTCF,239
chr1,119475937,119476194,SRX5075174,SMARCA4,257
chr1,119475951,119476168,SRX5075168,SMARCA4,217
chr1,119475960,119476147,SRX5075176,SMARCA4,187
chr1,119475986,119476162,SRX5075170,SMARCA4,176
chr1,119531908,119532299,SRX5716470,SMARCA4,391
chr1,119531922,119532332,SRX5075170,SMARCA4,410
chr1,119531946,119532304,SRX5716469,SMARCA4,358
chr1,119531953,119532340,SRX5075176,SMARCA4,387
chr1,119531972,119532287,SRX5075169,SMARCA4,315
chr1,119532084,119532341,SRX5716467,SMARCA2,257
chr1,119532122,119532361,SRX5716468,SMARCA2,239
chr1,119532156,119532395,SRX5075175,SMARCA4,239
chr1,119549638,119549950,SRX16500060,CTCF,312
chr1,119549651,119549974,SRX16500059,CTCF,323
chr1,119549655,119549971,SRX16500062,CTCF,316
chr1,119549679,119549993,SRX16500061,CTCF,314
chr1,119549690,119549863,SRX5075174,SMARCA4,173
chr1,119554024,119554662,SRX5075176,SMARCA4,638
chr1,119554086,119554679,SRX5075170,SMARCA4,593
chr1,119554094,119554588,SRX5020211,SMARCA2,494
chr1,119554103,119554712,SRX5716470,SMARCA4,609
chr1,119554109,119554653,SRX5716469,SMARCA4,544
chr1,119554109,119554708,SRX5075169,SMARCA4,599
chr1,119554118,119554710,SRX5075175,SMARCA4,592
chr1,119554208,119554553,SRX5054309,FOSL2,345
chr1,119554211,119554640,SRX5716468,SMARCA2,429
chr1,119554214,119554609,SRX5716467,SMARCA2,395
chr1,119554248,119554507,SRX5075181,SMARCA2,259
chr1,119554267,119554505,SRX5020214,SMARCA2,238
chr1,119554280,119554622,SRX5054308,FOSL2,342
chr1,119570318,119570612,SRX16500059,CTCF,294
chr1,119570338,119570582,SRX16500061,CTCF,244
chr1,119582890,119583111,SRX16500060,CTCF,221
chr1,119582893,119583112,SRX16500061,CTCF,219
chr1,119582929,119583174,SRX16500059,CTCF,245
chr1,119587283,119587758,SRX5075170,SMARCA4,475
chr1,119587350,119587803,SRX5716470,SMARCA4,453
chr1,119587371,119587787,SRX5075175,SMARCA4,416
chr1,119587395,119587757,SRX5716469,SMARCA4,362
chr1,119587404,119587789,SRX5075169,SMARCA4,385
chr1,119587432,119587692,SRX5716467,SMARCA2,260
chr1,119587447,119587682,SRX5716468,SMARCA2,235
chr1,119587460,119587804,SRX5075176,SMARCA4,344
chr1,119594161,119594356,SRX5075169,SMARCA4,195
chr1,119594188,119594801,SRX5075176,SMARCA4,613
chr1,119594239,119594677,SRX5075175,SMARCA4,438
chr1,119594292,119594722,SRX5075170,SMARCA4,430
chr1,119594363,119594707,SRX5716470,SMARCA4,344
chr1,119594376,119594690,SRX5716469,SMARCA4,314
chr1,119594394,119594731,SRX5716468,SMARCA2,337
chr1,119594407,119594754,SRX5054309,FOSL2,347
chr1,119594414,119594684,SRX5075169,SMARCA4,270
chr1,119594457,119594707,SRX5054308,FOSL2,250
chr1,119611600,119612016,SRX16500059,CTCF,416
chr1,119611602,119611994,SRX16500061,CTCF,392
chr1,119611602,119612002,SRX16500060,CTCF,400
chr1,119611620,119611983,SRX16500062,CTCF,363
chr1,119611687,119611952,SRX5075174,SMARCA4,265
chr1,119611693,119611977,SRX5075168,SMARCA4,284
chr1,119611707,119611917,SRX5075175,SMARCA4,210
chr1,119611739,119611942,SRX5075169,SMARCA4,203
chr1,119613721,119614174,SRX16500060,CTCF,453
chr1,119613750,119614116,SRX16500062,CTCF,366
chr1,119613751,119614157,SRX16500059,CTCF,406
chr1,119613752,119614166,SRX16500061,CTCF,414
chr1,119613841,119614133,SRX4174629,CTCF,292
chr1,119613864,119614083,SRX5716463,SMARCA4,219
chr1,119613867,119614057,SRX5075170,SMARCA4,190
chr1,119613874,119614078,SRX5075174,SMARCA4,204
chr1,119613900,119614124,SRX5075168,SMARCA4,224
chr1,119618408,119618638,SRX5716470,SMARCA4,230
chr1,119618446,119618734,SRX5075170,SMARCA4,288
chr1,119618447,119618656,SRX5075176,SMARCA4,209
chr1,119626746,119627538,SRX5075176,SMARCA4,792
chr1,119626802,119627604,SRX5075170,SMARCA4,802
chr1,119626807,119627185,SRX5054309,FOSL2,378
chr1,119626821,119627427,SRX5075169,SMARCA4,606
chr1,119626824,119627124,SRX5054308,FOSL2,300
chr1,119626861,119627379,SRX5716469,SMARCA4,518
chr1,119626864,119627294,SRX5716470,SMARCA4,430
chr1,119626881,119627149,SRX5020211,SMARCA2,268
chr1,119626882,119627421,SRX5075175,SMARCA4,539
chr1,119626895,119627168,SRX5075181,SMARCA2,273
chr1,119627029,119627283,SRX5716467,SMARCA2,254
chr1,119627142,119627506,SRX20140869,INTS10,364
chr1,119645942,119646229,SRX5054309,FOSL2,287
chr1,119645945,119646172,SRX5054308,FOSL2,227
chr1,119646962,119647142,SRX5075169,SMARCA4,180
chr1,119647504,119648174,SRX16500061,CTCF,670
chr1,119647523,119648096,SRX16500062,CTCF,573
chr1,119647525,119648115,SRX16500059,CTCF,590
chr1,119647527,119648153,SRX16500060,CTCF,626
chr1,119647675,119648732,SRX20140895,INTS13,1057
chr1,119647679,119648152,SRX20140868,INTS10,473
chr1,119648023,119648619,SRX20140867,INTS10,596
chr1,119648058,119648661,SRX5075170,SMARCA4,603
chr1,119648258,119648663,SRX5075174,SMARCA4,405
chr1,119648362,119648725,SRX5075168,SMARCA4,363
chr1,119648381,119648718,SRX5075175,SMARCA4,337
chr1,119648399,119648647,SRX5716470,SMARCA4,248
chr1,119648426,119648633,SRX5075169,SMARCA4,207
chr1,119648462,119648684,SRX5075176,SMARCA4,222
chr1,119655243,119655506,SRX5075169,SMARCA4,263
chr1,119655294,119655481,SRX5075175,SMARCA4,187
chr1,119663081,119663381,SRX4174629,CTCF,300
chr1,119663150,119663545,SRX16500059,CTCF,395
chr1,119663166,119663448,SRX5075174,SMARCA4,282
chr1,119663171,119663569,SRX16500062,CTCF,398
chr1,119663187,119663596,SRX16500060,CTCF,409
chr1,119663220,119663441,SRX5075168,SMARCA4,221
chr1,119663220,119663445,SRX5075169,SMARCA4,225
chr1,119663222,119663430,SRX5075170,SMARCA4,208
chr1,119663223,119663508,SRX16500061,CTCF,285
chr1,119663251,119663471,SRX5075176,SMARCA4,220
chr1,119674037,119674451,SRX5075168,SMARCA4,414
chr1,119674043,119674371,SRX5054309,FOSL2,328
chr1,119674078,119674331,SRX5075169,SMARCA4,253
chr1,119674095,119674439,SRX5075176,SMARCA4,344
chr1,119674120,119674329,SRX5054308,FOSL2,209
chr1,119674122,119674392,SRX5075174,SMARCA4,270
chr1,119674152,119674404,SRX5075170,SMARCA4,252
chr1,119674901,119675324,SRX4174629,CTCF,423
chr1,119675403,119675845,SRX4174629,CTCF,442
chr1,119675484,119675993,SRX16500062,CTCF,509
chr1,119675484,119675997,SRX16500059,CTCF,513
chr1,119675505,119675971,SRX16500061,CTCF,466
chr1,119675524,119675984,SRX16500060,CTCF,460
chr1,119675539,119675866,SRX5075169,SMARCA4,327
chr1,119675547,119675870,SRX5075174,SMARCA4,323
chr1,119675550,119675847,SRX5075175,SMARCA4,297
chr1,119675557,119675847,SRX5075168,SMARCA4,290
chr1,119675579,119675833,SRX5716463,SMARCA4,254
chr1,119675587,119675853,SRX5075170,SMARCA4,266
chr1,119675594,119675877,SRX5716464,SMARCA4,283
chr1,119675605,119675867,SRX5075176,SMARCA4,262
chr1,119675625,119675877,SRX5716470,SMARCA4,252
chr1,119686780,119686963,SRX5075176,SMARCA4,183
chr1,119689503,119689839,SRX5716463,SMARCA4,336
chr1,119689524,119689857,SRX5075174,SMARCA4,333
chr1,119689589,119689835,SRX5716451,SOX2,246
chr1,119689621,119689846,SRX5075168,SMARCA4,225
chr1,119711667,119711941,SRX5075174,SMARCA4,274
chr1,119711682,119711947,SRX5075176,SMARCA4,265
chr1,119711712,119711947,SRX5075168,SMARCA4,235
chr1,119711783,119712230,SRX20140895,INTS13,447
chr1,119711808,119712005,SRX5075170,SMARCA4,197
chr1,119711870,119712125,SRX20140897,INTS13,255
chr1,119712319,119712765,SRX5075169,SMARCA4,446
chr1,119712504,119712948,SRX5075170,SMARCA4,444
chr1,119712505,119712874,SRX20140895,INTS13,369
chr1,119712507,119712963,SRX5075174,SMARCA4,456
chr1,119712513,119712971,SRX5075168,SMARCA4,458
chr1,119712702,119712913,SRX5716470,SMARCA4,211
chr1,119712774,119712974,SRX5075176,SMARCA4,200
chr1,119743961,119744508,SRX16500059,CTCF,547
chr1,119743996,119744484,SRX16500062,CTCF,488
chr1,119743998,119744464,SRX16500061,CTCF,466
chr1,119744003,119744525,SRX16500060,CTCF,522
chr1,119744114,119744375,SRX5075168,SMARCA4,261
chr1,119744148,119744330,SRX5075176,SMARCA4,182
chr1,119744164,119744396,SRX5075174,SMARCA4,232
chr1,119744166,119744458,SRX4174629,CTCF,292
chr1,119744193,119744418,SRX5075169,SMARCA4,225
chr1,119744224,119744398,SRX5075170,SMARCA4,174
chr1,119767454,119767757,SRX5054309,FOSL2,303
chr1,119767475,119767756,SRX5054308,FOSL2,281
chr1,119767515,119767688,SRX5075170,SMARCA4,173
chr1,119767573,119767778,SRX5075176,SMARCA4,205
chr1,119771073,119771315,SRX5075170,SMARCA4,242
chr1,119773963,119774229,SRX5075174,SMARCA4,266
chr1,119787760,119788503,SRX5075176,SMARCA4,743
chr1,119787834,119788080,SRX5020214,SMARCA2,246
chr1,119787865,119788161,SRX5075170,SMARCA4,296
chr1,119787878,119788452,SRX5716470,SMARCA4,574
chr1,119787894,119788136,SRX5054309,FOSL2,242
chr1,119787926,119788172,SRX5716469,SMARCA4,246
chr1,119788008,119788403,SRX5075169,SMARCA4,395
chr1,119808891,119809397,SRX16500060,CTCF,506
chr1,119808908,119809474,SRX16500059,CTCF,566
chr1,119808921,119809389,SRX16500062,CTCF,468
chr1,119808950,119809429,SRX16500061,CTCF,479
chr1,119808980,119809334,SRX4174629,CTCF,354
chr1,119808994,119809313,SRX5075174,SMARCA4,319
chr1,119809005,119809329,SRX5075168,SMARCA4,324
chr1,119809015,119809334,SRX5716463,SMARCA4,319
chr1,119809038,119809306,SRX5075176,SMARCA4,268
chr1,119809040,119809306,SRX5075170,SMARCA4,266
chr1,119809040,119809322,SRX5075175,SMARCA4,282
chr1,119809050,119809267,SRX5716470,SMARCA4,217
chr1,119809080,119809324,SRX5075169,SMARCA4,244
chr1,119809092,119809344,SRX5716464,SMARCA4,252
chr1,119815464,119815647,SRX5054309,FOSL2,183
chr1,119816537,119816768,SRX5054308,FOSL2,231
chr1,119827044,119827440,SRX16500060,CTCF,396
chr1,119827069,119827351,SRX16500062,CTCF,282
chr1,119827094,119827472,SRX16500059,CTCF,378
chr1,119844224,119844534,SRX16500060,CTCF,310
chr1,119844244,119844543,SRX16500062,CTCF,299
chr1,119844267,119844537,SRX16500061,CTCF,270
chr1,119859604,119859991,SRX5054308,FOSL2,387
chr1,119859608,119860024,SRX5075170,SMARCA4,416
chr1,119859613,119859928,SRX5054309,FOSL2,315
chr1,119859639,119860035,SRX5075176,SMARCA4,396
chr1,119859664,119859963,SRX5075169,SMARCA4,299
chr1,119859669,119859943,SRX5075175,SMARCA4,274
chr1,119870826,119871292,SRX16500061,CTCF,466
chr1,119870847,119871314,SRX16500060,CTCF,467
chr1,119870850,119871334,SRX16500059,CTCF,484
chr1,119870898,119871329,SRX16500062,CTCF,431
chr1,119870900,119871294,SRX4174629,CTCF,394
chr1,119870937,119871273,SRX5075168,SMARCA4,336
chr1,119870973,119871290,SRX5075174,SMARCA4,317
chr1,119871037,119871213,SRX5075170,SMARCA4,176
chr1,119871037,119871258,SRX5075175,SMARCA4,221
chr1,119871041,119871228,SRX5075176,SMARCA4,187
chr1,119873557,119873955,SRX5716469,SMARCA4,398
chr1,119873596,119873959,SRX5054308,FOSL2,363
chr1,119873627,119873971,SRX5716467,SMARCA2,344
chr1,119873641,119873931,SRX5020211,SMARCA2,290
chr1,119873646,119874029,SRX5075169,SMARCA4,383
chr1,119873650,119874048,SRX5075176,SMARCA4,398
chr1,119873652,119873991,SRX5054309,FOSL2,339
chr1,119873660,119874021,SRX5075170,SMARCA4,361
chr1,119873671,119873973,SRX5716470,SMARCA4,302
chr1,119873717,119873954,SRX5716468,SMARCA2,237
chr1,119873724,119873973,SRX5020214,SMARCA2,249
chr1,119873738,119873967,SRX5075175,SMARCA4,229
chr1,119884783,119885043,SRX5075170,SMARCA4,260
chr1,119884843,119885059,SRX5075176,SMARCA4,216
chr1,119886097,119886547,SRX16500061,CTCF,450
chr1,119886152,119886476,SRX16500062,CTCF,324
chr1,119886171,119886496,SRX16500060,CTCF,325
chr1,119886199,119886616,SRX16500059,CTCF,417
chr1,119886245,119886489,SRX5075174,SMARCA4,244
chr1,119886284,119886496,SRX5075168,SMARCA4,212
chr1,119943357,119943548,SRX5075170,SMARCA4,191
chr1,119947493,119947893,SRX5075176,SMARCA4,400
chr1,119947499,119947825,SRX5075170,SMARCA4,326
chr1,119947518,119947759,SRX5054308,FOSL2,241
chr1,119947556,119947813,SRX5075169,SMARCA4,257
chr1,119947559,119947794,SRX5054309,FOSL2,235
chr1,119947562,119947837,SRX5075175,SMARCA4,275
chr1,119948538,119949052,SRX16500060,CTCF,514
chr1,119948546,119949079,SRX16500059,CTCF,533
chr1,119948621,119949010,SRX4174629,CTCF,389
chr1,119948628,119949036,SRX16500062,CTCF,408
chr1,119948629,119949061,SRX16500061,CTCF,432
chr1,119948665,119948911,SRX5716470,SMARCA4,246
chr1,119948682,119948931,SRX5075169,SMARCA4,249
chr1,119948684,119948937,SRX5075170,SMARCA4,253
chr1,119948690,119948962,SRX5075176,SMARCA4,272
chr1,119948733,119948959,SRX5075174,SMARCA4,226
chr1,119948778,119948957,SRX5075168,SMARCA4,179
chr1,119964768,119965407,SRX5075170,SMARCA4,639
chr1,119964798,119965323,SRX5075169,SMARCA4,525
chr1,119964800,119965441,SRX5075176,SMARCA4,641
chr1,119964862,119965350,SRX5075175,SMARCA4,488
chr1,119964868,119965361,SRX5716469,SMARCA4,493
chr1,119964898,119965302,SRX5716467,SMARCA2,404
chr1,119964945,119965362,SRX5716470,SMARCA4,417
chr1,119964957,119965343,SRX5020211,SMARCA2,386
chr1,119965002,119965349,SRX5716468,SMARCA2,347
chr1,119965006,119965318,SRX5054308,FOSL2,312
chr1,119965018,119965280,SRX5075181,SMARCA2,262
chr1,119965030,119965293,SRX5054309,FOSL2,263
chr1,119966188,119966370,SRX5075170,SMARCA4,182
chr1,119967956,119968406,SRX16500060,CTCF,450
chr1,119967970,119968350,SRX16500062,CTCF,380
chr1,119967983,119968454,SRX16500059,CTCF,471
chr1,119967994,119968317,SRX5075174,SMARCA4,323
chr1,119968006,119968375,SRX16500061,CTCF,369
chr1,119968032,119968297,SRX5075168,SMARCA4,265
chr1,119981986,119982398,SRX5075169,SMARCA4,412
chr1,119981999,119982306,SRX5716469,SMARCA4,307
chr1,119981999,119982465,SRX5075176,SMARCA4,466
chr1,119982004,119982455,SRX5075175,SMARCA4,451
chr1,119982029,119982481,SRX5075170,SMARCA4,452
chr1,119982065,119982441,SRX5054308,FOSL2,376
chr1,119982093,119982436,SRX5020211,SMARCA2,343
chr1,119982096,119982376,SRX5054309,FOSL2,280
chr1,119982173,119982367,SRX5075181,SMARCA2,194
chr1,119987106,119987512,SRX5075169,SMARCA4,406
chr1,119987130,119987434,SRX5075170,SMARCA4,304
chr1,119987137,119987404,SRX5075176,SMARCA4,267
chr1,119987139,119987353,SRX5716469,SMARCA4,214
chr1,119987145,119987526,SRX5075175,SMARCA4,381
chr1,119987161,119987455,SRX5054309,FOSL2,294
chr1,119987176,119987401,SRX5054308,FOSL2,225
chr1,119994747,119995374,SRX5075175,SMARCA4,627
chr1,119994882,119995464,SRX5075170,SMARCA4,582
chr1,119994928,119995397,SRX5075176,SMARCA4,469
chr1,119995037,119995255,SRX5075181,SMARCA2,218
chr1,119995058,119995305,SRX5054308,FOSL2,247
chr1,119995069,119995387,SRX5716470,SMARCA4,318
chr1,119995071,119995328,SRX5716468,SMARCA2,257
chr1,119995080,119995312,SRX5075169,SMARCA4,232
chr1,119995109,119995313,SRX5020211,SMARCA2,204
chr1,119995144,119995327,SRX5054309,FOSL2,183
chr1,119995936,119996211,SRX5075176,SMARCA4,275
chr1,120014801,120015563,SRX5075170,SMARCA4,762
chr1,120014802,120015468,SRX5075175,SMARCA4,666
chr1,120014816,120015465,SRX5075176,SMARCA4,649
chr1,120014900,120015592,SRX5716470,SMARCA4,692
chr1,120014984,120015416,SRX5716467,SMARCA2,432
chr1,120015008,120015490,SRX5075169,SMARCA4,482
chr1,120015014,120015420,SRX5716469,SMARCA4,406
chr1,120015048,120015400,SRX5716468,SMARCA2,352
chr1,120015137,120015397,SRX5020211,SMARCA2,260
chr1,120015168,120015371,SRX5075181,SMARCA2,203
chr1,120037138,120037544,SRX5075169,SMARCA4,406
chr1,120037218,120037675,SRX5075176,SMARCA4,457
chr1,120037492,120037666,SRX5075170,SMARCA4,174
chr1,120044754,120045092,SRX5075175,SMARCA4,338
chr1,120044758,120045244,SRX5075169,SMARCA4,486
chr1,120044765,120045104,SRX5075176,SMARCA4,339
chr1,120044783,120045167,SRX5716469,SMARCA4,384
chr1,120044798,120045154,SRX5075170,SMARCA4,356
chr1,120044817,120045120,SRX5054308,FOSL2,303
chr1,120044851,120045237,SRX5054309,FOSL2,386
chr1,120052352,120052607,SRX5075169,SMARCA4,255
chr1,120052352,120052637,SRX5075176,SMARCA4,285
chr1,120052355,120052615,SRX5075170,SMARCA4,260
chr1,120052374,120052601,SRX5075175,SMARCA4,227
chr1,120052430,120052642,SRX5054308,FOSL2,212
chr1,120058791,120059169,SRX16500060,CTCF,378
chr1,120059139,120059725,SRX20140881,CPSF3L,586
chr1,120059151,120059831,SRX5075176,SMARCA4,680
chr1,120059153,120059674,SRX5716470,SMARCA4,521
chr1,120059161,120059600,SRX20140869,INTS10,439
chr1,120059173,120059743,SRX5075168,SMARCA4,570
chr1,120059194,120059885,SRX5075175,SMARCA4,691
chr1,120059196,120059741,SRX5054309,FOSL2,545
chr1,120059197,120059819,SRX5075170,SMARCA4,622
chr1,120059198,120059792,SRX5054308,FOSL2,594
chr1,120059205,120059654,SRX5075181,SMARCA2,449
chr1,120059211,120059774,SRX5716469,SMARCA4,563
chr1,120059222,120059855,SRX5075174,SMARCA4,633
chr1,120059230,120059723,SRX20140867,INTS10,493
chr1,120059231,120059810,SRX5075169,SMARCA4,579
chr1,120059238,120059725,SRX5020211,SMARCA2,487
chr1,120059240,120059585,SRX5716467,SMARCA2,345
chr1,120059259,120059709,SRX5716463,SMARCA4,450
chr1,120059262,120059525,SRX5020214,SMARCA2,263
chr1,120059262,120059727,SRX20140896,INTS13,465
chr1,120059268,120059525,SRX5716468,SMARCA2,257
chr1,120059298,120059580,SRX5716464,SMARCA4,282
chr1,120059299,120059546,SRX20140897,INTS13,247
chr1,120069072,120069953,SRX20140895,INTS13,881
chr1,120069297,120069892,SRX20140867,INTS10,595
chr1,120069343,120069850,SRX20140896,INTS13,507
chr1,120069398,120069872,SRX20140868,INTS10,474
chr1,120069401,120069914,SRX20140881,CPSF3L,513
chr1,120069404,120069829,SRX20140879,CPSF3L,425
chr1,120069490,120069896,SRX20140897,INTS13,406
chr1,120069556,120069803,SRX20140894,INTS13,247
chr1,120069560,120069851,SRX20140870,INTS10,291
chr1,120069674,120069902,SRX5075168,SMARCA4,228
chr1,120069681,120070038,SRX5075174,SMARCA4,357
chr1,120069689,120069877,SRX5075170,SMARCA4,188
chr1,120069711,120070039,SRX5075169,SMARCA4,328
chr1,120069722,120069961,SRX5075176,SMARCA4,239
chr1,120069783,120070013,SRX5716469,SMARCA4,230
chr1,120090932,120091130,SRX5054308,FOSL2,198
chr1,120090934,120091149,SRX5054309,FOSL2,215
chr1,120101421,120101989,SRX5075169,SMARCA4,568
chr1,120101504,120101988,SRX5075176,SMARCA4,484
chr1,120101511,120101926,SRX5716470,SMARCA4,415
chr1,120101541,120101904,SRX5075170,SMARCA4,363
chr1,120101564,120101914,SRX5020211,SMARCA2,350
chr1,120101565,120101892,SRX5716469,SMARCA4,327
chr1,120101566,120101875,SRX5716468,SMARCA2,309
chr1,120101600,120101925,SRX5716467,SMARCA2,325
chr1,120101610,120101895,SRX5075175,SMARCA4,285
chr1,120116156,120116416,SRX5716469,SMARCA4,260
chr1,120116168,120116397,SRX5075169,SMARCA4,229
chr1,120116183,120116402,SRX5054308,FOSL2,219
chr1,120116185,120116392,SRX5075175,SMARCA4,207
chr1,120116206,120116403,SRX5075176,SMARCA4,197
chr1,120116210,120116473,SRX5054309,FOSL2,263
chr1,120117447,120117704,SRX5075176,SMARCA4,257
chr1,120117458,120117688,SRX5075169,SMARCA4,230
chr1,120117476,120117761,SRX5075170,SMARCA4,285
chr1,120117499,120117735,SRX5716470,SMARCA4,236
chr1,120120577,120120843,SRX5075175,SMARCA4,266
chr1,120120593,120120884,SRX5716470,SMARCA4,291
chr1,120120601,120120859,SRX5020211,SMARCA2,258
chr1,120120613,120120881,SRX5075176,SMARCA4,268
chr1,120120627,120120858,SRX5075170,SMARCA4,231
chr1,120131771,120132679,SRX5075176,SMARCA4,908
chr1,120131792,120132420,SRX5075169,SMARCA4,628
chr1,120131798,120132230,SRX5716469,SMARCA4,432
chr1,120131798,120132620,SRX5075170,SMARCA4,822
chr1,120131808,120132553,SRX5716470,SMARCA4,745
chr1,120131828,120132404,SRX5075175,SMARCA4,576
chr1,120132013,120132285,SRX5716468,SMARCA2,272
chr1,120142901,120143205,SRX5075175,SMARCA4,304
chr1,120142901,120143260,SRX5075169,SMARCA4,359
chr1,120143090,120143329,SRX5054309,FOSL2,239
chr1,120144696,120144871,SRX5075176,SMARCA4,175
chr1,120144742,120144968,SRX5075169,SMARCA4,226
chr1,120145693,120146234,SRX16500059,CTCF,541
chr1,120145726,120146222,SRX16500062,CTCF,496
chr1,120145727,120146257,SRX16500060,CTCF,530
chr1,120145758,120146235,SRX16500061,CTCF,477
chr1,120145838,120146044,SRX5075176,SMARCA4,206
chr1,120145873,120146064,SRX5075174,SMARCA4,191
chr1,120145891,120146170,SRX4174629,CTCF,279
chr1,120145894,120146068,SRX5075170,SMARCA4,174
chr1,120162641,120163164,SRX5075174,SMARCA4,523
chr1,120162734,120163223,SRX5075168,SMARCA4,489
chr1,120162821,120163099,SRX5716463,SMARCA4,278
chr1,120176184,120176693,SRX20140895,INTS13,509
chr1,120176324,120176635,SRX20140867,INTS10,311
chr1,120176395,120176695,SRX5075168,SMARCA4,300
chr1,120176441,120176739,SRX5075174,SMARCA4,298
chr1,120179972,120180566,SRX5075176,SMARCA4,594
chr1,120179973,120180470,SRX5075169,SMARCA4,497
chr1,120179978,120180545,SRX5075175,SMARCA4,567
chr1,120179987,120180489,SRX5716470,SMARCA4,502
chr1,120180003,120180579,SRX5075170,SMARCA4,576
chr1,120180015,120180365,SRX5054309,FOSL2,350
chr1,120180017,120180394,SRX5716468,SMARCA2,377
chr1,120180018,120180482,SRX5716469,SMARCA4,464
chr1,120180025,120180438,SRX5716467,SMARCA2,413
chr1,120180053,120180351,SRX5075182,SMARCA2,298
chr1,120180066,120180435,SRX5075181,SMARCA2,369
chr1,120180080,120180334,SRX5020214,SMARCA2,254
chr1,120180101,120180402,SRX5075174,SMARCA4,301
chr1,120180102,120180374,SRX5054308,FOSL2,272
chr1,120180112,120180439,SRX5020211,SMARCA2,327
chr1,120180154,120180462,SRX5075168,SMARCA4,308
chr1,120180217,120180465,SRX5716459,Epitope tags,248
chr1,120182283,120182538,SRX5054309,FOSL2,255
chr1,120182301,120182548,SRX5054308,FOSL2,247
chr1,120188582,120188889,SRX5716470,SMARCA4,307
chr1,120188582,120188964,SRX5075169,SMARCA4,382
chr1,120188583,120189030,SRX5075170,SMARCA4,447
chr1,120188590,120188926,SRX5716467,SMARCA2,336
chr1,120188595,120189030,SRX5075176,SMARCA4,435
chr1,120188644,120189126,SRX5716469,SMARCA4,482
chr1,120188672,120188968,SRX5075175,SMARCA4,296
chr1,120188775,120188986,SRX5716468,SMARCA2,211
chr1,120189191,120189521,SRX5075175,SMARCA4,330
chr1,120189195,120189439,SRX5054308,FOSL2,244
chr1,120189215,120189491,SRX5075169,SMARCA4,276
chr1,120197104,120197313,SRX5075169,SMARCA4,209
chr1,120197143,120197390,SRX5075170,SMARCA4,247
chr1,120213588,120213931,SRX16500059,CTCF,343
chr1,120213608,120213986,SRX16500060,CTCF,378
chr1,120213622,120213975,SRX16500061,CTCF,353
chr1,120213661,120213934,SRX16500062,CTCF,273
chr1,120217588,120217976,SRX5716470,SMARCA4,388
chr1,120217605,120218103,SRX5075176,SMARCA4,498
chr1,120217615,120218041,SRX5716469,SMARCA4,426
chr1,120217631,120217962,SRX5716468,SMARCA2,331
chr1,120217632,120217985,SRX5075170,SMARCA4,353
chr1,120217637,120217887,SRX5054309,FOSL2,250
chr1,120217638,120217941,SRX5054308,FOSL2,303
chr1,120217641,120217939,SRX5075181,SMARCA2,298
chr1,120217641,120218011,SRX5075175,SMARCA4,370
chr1,120217649,120217993,SRX5075169,SMARCA4,344
chr1,120217652,120217916,SRX5020211,SMARCA2,264
chr1,120217654,120218004,SRX5716467,SMARCA2,350
chr1,120229751,120230123,SRX5075176,SMARCA4,372
chr1,120229839,120230211,SRX5054309,FOSL2,372
chr1,120229861,120230120,SRX5075175,SMARCA4,259
chr1,120229879,120230158,SRX5075170,SMARCA4,279
chr1,120229940,120230131,SRX5075169,SMARCA4,191
chr1,120229943,120230140,SRX5054308,FOSL2,197
chr1,120232781,120233239,SRX5075168,SMARCA4,458
chr1,120232857,120233123,SRX5075174,SMARCA4,266
chr1,120232863,120233155,SRX5075175,SMARCA4,292
chr1,120232863,120233161,SRX5716469,SMARCA4,298
chr1,120232869,120233166,SRX5075170,SMARCA4,297
chr1,120232900,120233104,SRX5716463,SMARCA4,204
chr1,120232920,120233150,SRX5075176,SMARCA4,230
chr1,120233013,120233222,SRX5075169,SMARCA4,209
chr1,120240176,120240647,SRX5075169,SMARCA4,471
chr1,120240234,120240593,SRX5075175,SMARCA4,359
chr1,120240263,120240580,SRX5054308,FOSL2,317
chr1,120240312,120240599,SRX5054309,FOSL2,287
chr1,120244054,120244246,SRX5075170,SMARCA4,192
chr1,120244065,120244279,SRX5075176,SMARCA4,214
chr1,120247664,120247980,SRX5054308,FOSL2,316
chr1,120247684,120247962,SRX5054309,FOSL2,278
chr1,120248963,120249229,SRX5075168,SMARCA4,266
chr1,120257685,120258059,SRX5716470,SMARCA4,374
chr1,120257701,120258094,SRX5075170,SMARCA4,393
chr1,120257722,120258017,SRX5075176,SMARCA4,295
chr1,120257729,120258202,SRX16500060,CTCF,473
chr1,120257765,120258146,SRX16500062,CTCF,381
chr1,120257769,120258074,SRX5716469,SMARCA4,305
chr1,120257772,120258206,SRX16500059,CTCF,434
chr1,120257783,120258073,SRX5075175,SMARCA4,290
chr1,120257787,120258095,SRX5716463,SMARCA4,308
chr1,120257791,120258079,SRX5075168,SMARCA4,288
chr1,120257796,120258034,SRX5075169,SMARCA4,238
chr1,120257799,120258156,SRX5075174,SMARCA4,357
chr1,120257811,120258213,SRX16500061,CTCF,402
chr1,120257844,120258058,SRX5716464,SMARCA4,214
chr1,120262695,120263229,SRX5075175,SMARCA4,534
chr1,120262757,120263352,SRX5075170,SMARCA4,595
chr1,120262764,120263473,SRX5075176,SMARCA4,709
chr1,120262785,120263197,SRX5054308,FOSL2,412
chr1,120262785,120263266,SRX5075169,SMARCA4,481
chr1,120262805,120263298,SRX5716470,SMARCA4,493
chr1,120262818,120263209,SRX5716467,SMARCA2,391
chr1,120262827,120263185,SRX5020211,SMARCA2,358
chr1,120262839,120263181,SRX5054309,FOSL2,342
chr1,120262865,120263261,SRX5716468,SMARCA2,396
chr1,120262867,120263227,SRX5716469,SMARCA4,360
chr1,120269377,120269728,SRX5075176,SMARCA4,351
chr1,120269395,120269737,SRX5075170,SMARCA4,342
chr1,120269424,120269676,SRX5054308,FOSL2,252
chr1,120269457,120269702,SRX5054309,FOSL2,245
chr1,120269463,120269652,SRX5075169,SMARCA4,189
chr1,120269475,120269680,SRX5075175,SMARCA4,205
chr1,120282730,120282932,SRX5075176,SMARCA4,202
chr1,120282736,120283100,SRX5075169,SMARCA4,364
chr1,120282815,120283133,SRX5075175,SMARCA4,318
chr1,120282845,120283078,SRX5716470,SMARCA4,233
chr1,120282850,120283094,SRX5075170,SMARCA4,244
chr1,120282871,120283159,SRX5716469,SMARCA4,288
chr1,120282959,120283172,SRX5054308,FOSL2,213
chr1,120288957,120289204,SRX5716470,SMARCA4,247
chr1,120289011,120289362,SRX5075170,SMARCA4,351
chr1,120289012,120289259,SRX5075176,SMARCA4,247
chr1,120289014,120289237,SRX5716467,SMARCA2,223
chr1,120289024,120289257,SRX5075169,SMARCA4,233
chr1,120289487,120289674,SRX5075175,SMARCA4,187
chr1,120297395,120297740,SRX5075174,SMARCA4,345
chr1,120299439,120299695,SRX16500060,CTCF,256
chr1,120299513,120299770,SRX16500062,CTCF,257
chr1,120305018,120305453,SRX5075169,SMARCA4,435
chr1,120305037,120305404,SRX5716470,SMARCA4,367
chr1,120305046,120305437,SRX5075170,SMARCA4,391
chr1,120305058,120305488,SRX5716469,SMARCA4,430
chr1,120305064,120305505,SRX5075175,SMARCA4,441
chr1,120305068,120305457,SRX5075176,SMARCA4,389
chr1,120305112,120305426,SRX5716467,SMARCA2,314
chr1,120305176,120305391,SRX5054309,FOSL2,215
chr1,120305212,120305473,SRX20140881,CPSF3L,261
chr1,120335020,120335317,SRX5075175,SMARCA4,297
chr1,120335026,120335319,SRX5075169,SMARCA4,293
chr1,120335172,120335385,SRX5075176,SMARCA4,213
chr1,120340765,120341267,SRX20140895,INTS13,502
chr1,120340813,120341176,SRX5075169,SMARCA4,363
chr1,120340865,120341156,SRX5075174,SMARCA4,291
chr1,120340882,120341255,SRX5075168,SMARCA4,373
chr1,120340883,120341157,SRX5075170,SMARCA4,274
chr1,120342059,120342367,SRX5075176,SMARCA4,308
chr1,120342093,120342442,SRX5075170,SMARCA4,349
chr1,120342102,120342438,SRX5716470,SMARCA4,336
chr1,120342175,120342386,SRX5075168,SMARCA4,211
chr1,120342201,120342446,SRX5075169,SMARCA4,245
chr1,120342212,120342467,SRX5075175,SMARCA4,255
chr1,120342215,120342402,SRX5075174,SMARCA4,187
chr1,120354911,120355598,SRX20140881,CPSF3L,687
chr1,120355005,120355634,SRX20140896,INTS13,629
chr1,120355031,120355347,SRX20140868,INTS10,316
chr1,120355073,120355633,SRX20140867,INTS10,560
chr1,120355083,120355649,SRX20140895,INTS13,566
chr1,120355171,120355415,SRX20140897,INTS13,244
chr1,120356133,120356439,SRX16500059,CTCF,306
chr1,120362205,120362564,SRX5075176,SMARCA4,359
chr1,120362247,120362616,SRX5075170,SMARCA4,369
chr1,120362288,120362592,SRX5075169,SMARCA4,304
chr1,120362310,120362510,SRX5020211,SMARCA2,200
chr1,120362321,120362554,SRX5716470,SMARCA4,233
chr1,120367004,120367184,SRX5075169,SMARCA4,180
chr1,120367004,120367288,SRX5054309,FOSL2,284
chr1,120367040,120367286,SRX5054308,FOSL2,246
chr1,120388859,120389030,SRX5075170,SMARCA4,171
chr1,120388898,120389244,SRX4174629,CTCF,346
chr1,120388946,120389174,SRX16500060,CTCF,228
chr1,120393557,120393870,SRX5075176,SMARCA4,313
chr1,120393557,120393946,SRX5075168,SMARCA4,389
chr1,120393575,120393955,SRX16500060,CTCF,380
chr1,120393576,120393848,SRX5075170,SMARCA4,272
chr1,120393584,120393971,SRX16500059,CTCF,387
chr1,120393604,120393838,SRX5716470,SMARCA4,234
chr1,120393605,120393929,SRX4174629,CTCF,324
chr1,120393613,120393889,SRX16500061,CTCF,276
chr1,120393634,120393840,SRX5075175,SMARCA4,206
chr1,120393646,120393839,SRX5075169,SMARCA4,193
chr1,120393663,120393931,SRX5075174,SMARCA4,268
chr1,120393672,120393977,SRX16500062,CTCF,305
chr1,120398923,120399123,SRX5075174,SMARCA4,200
chr1,120398949,120399238,SRX5075168,SMARCA4,289
chr1,120402549,120402719,SRX5075170,SMARCA4,170
chr1,120414561,120414937,SRX5075170,SMARCA4,376
chr1,120414614,120415241,SRX20140895,INTS13,627
chr1,120414655,120415048,SRX5075168,SMARCA4,393
chr1,120414773,120415120,SRX5075174,SMARCA4,347
chr1,120414780,120414955,SRX5075176,SMARCA4,175
chr1,120414820,120415025,SRX5075169,SMARCA4,205
chr1,120415677,120415899,SRX5716470,SMARCA4,222
chr1,120415698,120415931,SRX5075175,SMARCA4,233
chr1,120431514,120431901,SRX5075168,SMARCA4,387
chr1,120431518,120431708,SRX5075174,SMARCA4,190
chr1,120436386,120436799,SRX16500059,CTCF,413
chr1,120436422,120436817,SRX16500061,CTCF,395
chr1,120436450,120436793,SRX16500062,CTCF,343
chr1,120436452,120436779,SRX16500060,CTCF,327
chr1,120436495,120436710,SRX4174629,CTCF,215
chr1,120442709,120443066,SRX16500060,CTCF,357
chr1,120442713,120443122,SRX4174629,CTCF,409
chr1,120442748,120443080,SRX16500061,CTCF,332
chr1,120442792,120442966,SRX5075170,SMARCA4,174
chr1,120442805,120443174,SRX16500059,CTCF,369
chr1,120442830,120443041,SRX16500062,CTCF,211
chr1,120442833,120443059,SRX5075168,SMARCA4,226
chr1,120449076,120449514,SRX16500061,CTCF,438
chr1,120449094,120449379,SRX4174629,CTCF,285
chr1,120449113,120449509,SRX16500059,CTCF,396
chr1,120449124,120449339,SRX5075168,SMARCA4,215
chr1,120449142,120449525,SRX16500062,CTCF,383
chr1,120449159,120449514,SRX16500060,CTCF,355
chr1,120449165,120449368,SRX5075174,SMARCA4,203
chr1,120449175,120449363,SRX5075176,SMARCA4,188
chr1,120449179,120449372,SRX5075169,SMARCA4,193
chr1,120449185,120449377,SRX5075175,SMARCA4,192
chr1,120514388,120514780,SRX5075168,SMARCA4,392
chr1,120514402,120514791,SRX5075174,SMARCA4,389
chr1,120514435,120514772,SRX5716464,SMARCA4,337
chr1,120514441,120514785,SRX5716463,SMARCA4,344
chr1,120514508,120514703,SRX5716451,SOX2,195
chr1,120514591,120514967,SRX16500060,CTCF,376
chr1,120514662,120514947,SRX16500061,CTCF,285
chr1,120514665,120514910,SRX16500059,CTCF,245
chr1,120514740,120514960,SRX16500062,CTCF,220
chr1,120529417,120530005,SRX5075175,SMARCA4,588
chr1,120529419,120529902,SRX5054309,FOSL2,483
chr1,120529420,120529896,SRX5054308,FOSL2,476
chr1,120529440,120529878,SRX5075176,SMARCA4,438
chr1,120529444,120529979,SRX5075170,SMARCA4,535
chr1,120529454,120529673,SRX5716469,SMARCA4,219
chr1,120529457,120529864,SRX5075169,SMARCA4,407
chr1,120535024,120535545,SRX5075169,SMARCA4,521
chr1,120535122,120535485,SRX5716469,SMARCA4,363
chr1,120535159,120535600,SRX5075175,SMARCA4,441
chr1,120535173,120535503,SRX5075176,SMARCA4,330
chr1,120535180,120535554,SRX5075170,SMARCA4,374
chr1,120535180,120535567,SRX5054309,FOSL2,387
chr1,120535291,120535491,SRX5054308,FOSL2,200
chr1,120541407,120541638,SRX5075169,SMARCA4,231
chr1,120544140,120544920,SRX4174629,CTCF,780
chr1,120544371,120544843,SRX16500062,CTCF,472
chr1,120544382,120544895,SRX16500060,CTCF,513
chr1,120544387,120544882,SRX16500061,CTCF,495
chr1,120544390,120544922,SRX16500059,CTCF,532
chr1,120544458,120544808,SRX5075168,SMARCA4,350
chr1,120544485,120544805,SRX5075174,SMARCA4,320
chr1,120544508,120544787,SRX5075176,SMARCA4,279
chr1,120544520,120544751,SRX5716469,SMARCA4,231
chr1,120544520,120544757,SRX5075170,SMARCA4,237
chr1,120544570,120544763,SRX5075169,SMARCA4,193
chr1,120544577,120544798,SRX5716464,SMARCA4,221
chr1,120544597,120544829,SRX5716470,SMARCA4,232
chr1,120550071,120550269,SRX5075170,SMARCA4,198
chr1,120558209,120559021,SRX20140895,INTS13,812
chr1,120558322,120558574,SRX5716463,SMARCA4,252
chr1,120558337,120559060,SRX5075168,SMARCA4,723
chr1,120558340,120559038,SRX5075174,SMARCA4,698
chr1,120558355,120558579,SRX5075170,SMARCA4,224
chr1,120558362,120558599,SRX5075176,SMARCA4,237
chr1,120558367,120558595,SRX5075169,SMARCA4,228
chr1,120558389,120558640,SRX20140897,INTS13,251
chr1,120558838,120559069,SRX5075176,SMARCA4,231
chr1,120563277,120563689,SRX5075170,SMARCA4,412
chr1,120563278,120563681,SRX5716470,SMARCA4,403
chr1,120563306,120563664,SRX5075175,SMARCA4,358
chr1,120563306,120563693,SRX5075176,SMARCA4,387
chr1,120563323,120563645,SRX5020211,SMARCA2,322
chr1,120563330,120563566,SRX5075181,SMARCA2,236
chr1,120563358,120563711,SRX5716468,SMARCA2,353
chr1,120563361,120563693,SRX5716467,SMARCA2,332
chr1,120563376,120563628,SRX5054309,FOSL2,252
chr1,120563388,120563651,SRX5075169,SMARCA4,263
chr1,120563420,120563664,SRX5020214,SMARCA2,244
chr1,120567400,120568178,SRX5075174,SMARCA4,778
chr1,120567401,120568300,SRX5075168,SMARCA4,899
chr1,120567447,120568097,SRX5716469,SMARCA4,650
chr1,120567456,120568095,SRX5075176,SMARCA4,639
chr1,120567458,120568133,SRX5716470,SMARCA4,675
chr1,120567469,120568100,SRX5075169,SMARCA4,631
chr1,120567474,120568079,SRX5716464,SMARCA4,605
chr1,120567490,120568073,SRX5075175,SMARCA4,583
chr1,120567495,120568092,SRX5716463,SMARCA4,597
chr1,120567521,120568078,SRX5716467,SMARCA2,557
chr1,120567526,120568106,SRX5075170,SMARCA4,580
chr1,120567582,120568069,SRX20140881,CPSF3L,487
chr1,120567583,120567939,SRX5054308,FOSL2,356
chr1,120567583,120568072,SRX5716468,SMARCA2,489
chr1,120567621,120567991,SRX5054309,FOSL2,370
chr1,120567705,120568000,SRX5075182,SMARCA2,295
chr1,120567705,120568043,SRX5075181,SMARCA2,338
chr1,120567708,120568045,SRX5020211,SMARCA2,337
chr1,120567709,120567952,SRX5020214,SMARCA2,243
chr1,120567733,120567980,SRX5716454,SOX3,247
chr1,120567841,120568107,SRX20140869,INTS10,266
chr1,120592902,120593333,SRX5716469,SMARCA4,431
chr1,120592923,120593302,SRX5716470,SMARCA4,379
chr1,120592932,120593258,SRX5075169,SMARCA4,326
chr1,120592943,120593350,SRX5075175,SMARCA4,407
chr1,120592943,120593440,SRX5075176,SMARCA4,497
chr1,120592988,120593336,SRX5075170,SMARCA4,348
chr1,120593130,120593303,SRX5075174,SMARCA4,173
chr1,120600612,120600991,SRX5075174,SMARCA4,379
chr1,120600737,120601013,SRX5075168,SMARCA4,276
chr1,120608779,120609340,SRX5716469,SMARCA4,561
chr1,120608928,120609417,SRX5075170,SMARCA4,489
chr1,120609019,120609354,SRX5075175,SMARCA4,335
chr1,120609090,120609361,SRX5075176,SMARCA4,271
chr1,120609125,120609401,SRX5075169,SMARCA4,276
chr1,120615163,120615624,SRX5075169,SMARCA4,461
chr1,120615230,120615620,SRX5716470,SMARCA4,390
chr1,120615267,120615549,SRX5716469,SMARCA4,282
chr1,120615272,120615645,SRX5075175,SMARCA4,373
chr1,120615274,120615611,SRX5075170,SMARCA4,337
chr1,120615305,120615566,SRX5716467,SMARCA2,261
chr1,120615308,120615493,SRX5054308,FOSL2,185
chr1,120615312,120615687,SRX5075176,SMARCA4,375
chr1,120628663,120628923,SRX5075176,SMARCA4,260
chr1,120628701,120629038,SRX5075170,SMARCA4,337
chr1,120628739,120628956,SRX5054308,FOSL2,217
chr1,120628747,120628969,SRX5054309,FOSL2,222
chr1,120634869,120635551,SRX5716470,SMARCA4,682
chr1,120634892,120635673,SRX5075175,SMARCA4,781
chr1,120634955,120635222,SRX5716460,Epitope tags,267
chr1,120635013,120635600,SRX5075176,SMARCA4,587
chr1,120635077,120635615,SRX5075170,SMARCA4,538
chr1,120635146,120635652,SRX5075169,SMARCA4,506
chr1,120635194,120635587,SRX5716469,SMARCA4,393
chr1,120635195,120635590,SRX5716467,SMARCA2,395
chr1,120635197,120635627,SRX5054308,FOSL2,430
chr1,120635209,120635571,SRX5020211,SMARCA2,362
chr1,120635238,120635590,SRX5054309,FOSL2,352
chr1,120635349,120635605,SRX5716468,SMARCA2,256
chr1,120640239,120640603,SRX16500061,CTCF,364
chr1,120640242,120640577,SRX16500062,CTCF,335
chr1,120640252,120640595,SRX16500059,CTCF,343
chr1,120640256,120640600,SRX16500060,CTCF,344
chr1,120640259,120640538,SRX5075168,SMARCA4,279
chr1,120640260,120640567,SRX5075176,SMARCA4,307
chr1,120640294,120640565,SRX5075174,SMARCA4,271
chr1,120640294,120640569,SRX5075170,SMARCA4,275
chr1,120640297,120640587,SRX5075169,SMARCA4,290
chr1,120640350,120640561,SRX5716470,SMARCA4,211
chr1,120640354,120640600,SRX5075175,SMARCA4,246
chr1,120640404,120640620,SRX5716469,SMARCA4,216
chr1,120650354,120650666,SRX5054309,FOSL2,312
chr1,120650372,120650646,SRX5054308,FOSL2,274
chr1,120654133,120654383,SRX5075175,SMARCA4,250
chr1,120654174,120654415,SRX5075176,SMARCA4,241
chr1,120654221,120654438,SRX5075170,SMARCA4,217
chr1,120657751,120658237,SRX5075169,SMARCA4,486
chr1,120657771,120658082,SRX5054308,FOSL2,311
chr1,120657782,120658113,SRX5054309,FOSL2,331
chr1,120657790,120658209,SRX5716469,SMARCA4,419
chr1,120657797,120658100,SRX5075175,SMARCA4,303
chr1,120657818,120658049,SRX5716467,SMARCA2,231
chr1,120657839,120658126,SRX5075176,SMARCA4,287
chr1,120657858,120658108,SRX5075170,SMARCA4,250
chr1,120657919,120658164,SRX5716470,SMARCA4,245
chr1,120665083,120665554,SRX5075174,SMARCA4,471
chr1,120665111,120665502,SRX5716470,SMARCA4,391
chr1,120665167,120665543,SRX5075170,SMARCA4,376
chr1,120665168,120665433,SRX5716464,SMARCA4,265
chr1,120665185,120665525,SRX5075169,SMARCA4,340
chr1,120665206,120665467,SRX5075176,SMARCA4,261
chr1,120665223,120665539,SRX5716469,SMARCA4,316
chr1,120665225,120665544,SRX5075175,SMARCA4,319
chr1,120665247,120665667,SRX5075168,SMARCA4,420
chr1,120668204,120668579,SRX5054309,FOSL2,375
chr1,120668239,120668571,SRX5075176,SMARCA4,332
chr1,120668291,120668499,SRX5054308,FOSL2,208
chr1,120668296,120668507,SRX5075169,SMARCA4,211
chr1,120668335,120668599,SRX5075175,SMARCA4,264
chr1,120668336,120668567,SRX5075170,SMARCA4,231
chr1,120680402,120680795,SRX5716467,SMARCA2,393
chr1,120680414,120680817,SRX5075170,SMARCA4,403
chr1,120680416,120680794,SRX5716470,SMARCA4,378
chr1,120680421,120680792,SRX5716468,SMARCA2,371
chr1,120680427,120680773,SRX5075181,SMARCA2,346
chr1,120680432,120680864,SRX5075176,SMARCA4,432
chr1,120680443,120680809,SRX5075169,SMARCA4,366
chr1,120680447,120680803,SRX5075175,SMARCA4,356
chr1,120680479,120680827,SRX5020211,SMARCA2,348
chr1,120680480,120680754,SRX5054309,FOSL2,274
chr1,120680500,120680795,SRX5054308,FOSL2,295
chr1,120680504,120680858,SRX5716469,SMARCA4,354
chr1,120684425,120684811,SRX16500061,CTCF,386
chr1,120684430,120684725,SRX16500062,CTCF,295
chr1,120684457,120684805,SRX16500059,CTCF,348
chr1,120684463,120684775,SRX16500060,CTCF,312
chr1,120690626,120690821,SRX5075176,SMARCA4,195
chr1,120700897,120701077,SRX5075169,SMARCA4,180
chr1,120700919,120701154,SRX5075170,SMARCA4,235
chr1,120723456,120723921,SRX5075176,SMARCA4,465
chr1,120723579,120723929,SRX5075175,SMARCA4,350
chr1,120723595,120723774,SRX5075168,SMARCA4,179
chr1,120723597,120723797,SRX5075174,SMARCA4,200
chr1,120723616,120724248,SRX20140895,INTS13,632
chr1,120723660,120723884,SRX5716470,SMARCA4,224
chr1,120723661,120723881,SRX5075170,SMARCA4,220
chr1,120723684,120723867,SRX5054309,FOSL2,183
chr1,120723716,120724058,SRX20140867,INTS10,342
chr1,120723746,120724105,SRX20140868,INTS10,359
chr1,120723772,120724009,SRX20140879,CPSF3L,237
chr1,120724821,120725117,SRX5075174,SMARCA4,296
chr1,120733766,120734543,SRX5075170,SMARCA4,777
chr1,120733775,120734327,SRX20140867,INTS10,552
chr1,120733780,120734381,SRX5075175,SMARCA4,601
chr1,120733784,120734331,SRX5054309,FOSL2,547
chr1,120733804,120734418,SRX20140881,CPSF3L,614
chr1,120733805,120734323,SRX5075169,SMARCA4,518
chr1,120733814,120734446,SRX5075176,SMARCA4,632
chr1,120733827,120734375,SRX5054308,FOSL2,548
chr1,120733845,120734295,SRX5716464,SMARCA4,450
chr1,120733866,120734367,SRX5075168,SMARCA4,501
chr1,120733875,120734432,SRX5716470,SMARCA4,557
chr1,120733885,120734393,SRX5075174,SMARCA4,508
chr1,120733906,120734361,SRX5716463,SMARCA4,455
chr1,120733931,120734363,SRX5716469,SMARCA4,432
chr1,120733950,120734451,SRX20140896,INTS13,501
chr1,120733963,120734338,SRX5716467,SMARCA2,375
chr1,120733975,120734392,SRX20140869,INTS10,417
chr1,120734021,120734304,SRX5020214,SMARCA2,283
chr1,120734045,120734367,SRX5716468,SMARCA2,322
chr1,120734047,120734288,SRX5075181,SMARCA2,241
chr1,120734075,120734321,SRX5020211,SMARCA2,246
chr1,120734093,120734278,SRX5075182,SMARCA2,185
chr1,120734447,120734732,SRX16500059,CTCF,285
chr1,120740877,120741191,SRX5075170,SMARCA4,314
chr1,120740902,120741246,SRX5075175,SMARCA4,344
chr1,120740907,120741228,SRX5075176,SMARCA4,321
chr1,120741022,120741204,SRX5075169,SMARCA4,182
chr1,120748366,120748803,SRX5075176,SMARCA4,437
chr1,120748443,120748873,SRX5075169,SMARCA4,430
chr1,120748452,120748816,SRX5075170,SMARCA4,364
chr1,120748466,120748749,SRX5054308,FOSL2,283
chr1,120748514,120748859,SRX5075175,SMARCA4,345
chr1,120748534,120748814,SRX5716467,SMARCA2,280
chr1,120748579,120748792,SRX5716470,SMARCA4,213
chr1,120756018,120756233,SRX5716467,SMARCA2,215
chr1,120756021,120756328,SRX5075170,SMARCA4,307
chr1,120756102,120756464,SRX5075175,SMARCA4,362
chr1,120756135,120756461,SRX5075169,SMARCA4,326
chr1,120777980,120778509,SRX5075175,SMARCA4,529
chr1,120778092,120778868,SRX5075176,SMARCA4,776
chr1,120778108,120778638,SRX5716470,SMARCA4,530
chr1,120778126,120778541,SRX5075169,SMARCA4,415
chr1,120778157,120778846,SRX5075170,SMARCA4,689
chr1,120778242,120778518,SRX5716467,SMARCA2,276
chr1,120778246,120778600,SRX5716469,SMARCA4,354
chr1,120778266,120778529,SRX5716468,SMARCA2,263
chr1,120778270,120778556,SRX5020211,SMARCA2,286
chr1,120795004,120795659,SRX5075170,SMARCA4,655
chr1,120795078,120795665,SRX5075176,SMARCA4,587
chr1,120795106,120795308,SRX5054308,FOSL2,202
chr1,120795106,120795389,SRX5716467,SMARCA2,283
chr1,120795126,120795662,SRX5075169,SMARCA4,536
chr1,120795130,120795518,SRX5075175,SMARCA4,388
chr1,120795161,120795427,SRX5716469,SMARCA4,266
chr1,120795174,120795427,SRX5716470,SMARCA4,253
chr1,120795263,120795480,SRX5020211,SMARCA2,217
chr1,120795342,120795694,SRX5054309,FOSL2,352
chr1,120795438,120795740,SRX5054308,FOSL2,302
chr1,120805479,120805770,SRX16500059,CTCF,291
chr1,120805518,120805812,SRX16500060,CTCF,294
chr1,120805519,120805806,SRX16500062,CTCF,287
chr1,120805531,120805795,SRX16500061,CTCF,264
chr1,120811728,120812258,SRX16500061,CTCF,530
chr1,120811770,120812226,SRX16500059,CTCF,456
chr1,120811791,120812270,SRX16500060,CTCF,479
chr1,120811803,120812163,SRX5075168,SMARCA4,360
chr1,120811808,120812140,SRX5075174,SMARCA4,332
chr1,120811817,120812068,SRX4174629,CTCF,251
chr1,120811819,120812090,SRX5075170,SMARCA4,271
chr1,120811836,120812290,SRX16500062,CTCF,454
chr1,120811845,120812171,SRX5075176,SMARCA4,326
chr1,120811892,120812107,SRX5716464,SMARCA4,215
chr1,120811902,120812087,SRX5075169,SMARCA4,185
chr1,120811942,120812129,SRX5075175,SMARCA4,187
chr1,120844521,120845100,SRX16500059,CTCF,579
chr1,120844538,120845048,SRX16500060,CTCF,510
chr1,120844545,120845081,SRX16500061,CTCF,536
chr1,120844548,120845029,SRX16500062,CTCF,481
chr1,120844580,120845042,SRX5075169,SMARCA4,462
chr1,120844585,120845085,SRX4174629,CTCF,500
chr1,120844660,120844991,SRX5075174,SMARCA4,331
chr1,120844677,120844903,SRX5075168,SMARCA4,226
chr1,120844704,120844929,SRX5075170,SMARCA4,225
chr1,120844744,120845028,SRX5075175,SMARCA4,284
chr1,120844758,120844970,SRX5716469,SMARCA4,212
chr1,120844811,120845047,SRX5075176,SMARCA4,236
chr1,120850045,120851155,SRX20140867,INTS10,1110
chr1,120850050,120851057,SRX20140879,CPSF3L,1007
chr1,120850063,120851021,SRX20140896,INTS13,958
chr1,120850087,120851043,SRX20140881,CPSF3L,956
chr1,120850112,120851207,SRX20140869,INTS10,1095
chr1,120850246,120851191,SRX20140895,INTS13,945
chr1,120850291,120850797,SRX5716469,SMARCA4,506
chr1,120850429,120851007,SRX20140894,INTS13,578
chr1,120850444,120851066,SRX20140897,INTS13,622
chr1,120850490,120851031,SRX20140868,INTS10,541
chr1,120850496,120850680,SRX5075176,SMARCA4,184
chr1,120850536,120850917,SRX5075169,SMARCA4,381
chr1,120850736,120850982,SRX5075176,SMARCA4,246
chr1,120851158,120851528,SRX5075170,SMARCA4,370
chr1,120851180,120851428,SRX5075168,SMARCA4,248
chr1,120851208,120851411,SRX5075176,SMARCA4,203
chr1,120859661,120860073,SRX5054309,FOSL2,412
chr1,120859675,120860064,SRX5075169,SMARCA4,389
chr1,120859696,120860041,SRX5054308,FOSL2,345
chr1,120859703,120859966,SRX5075174,SMARCA4,263
chr1,120859718,120860058,SRX5075175,SMARCA4,340
chr1,120859737,120859964,SRX5075168,SMARCA4,227
chr1,120859753,120859986,SRX5075176,SMARCA4,233
chr1,120859784,120859981,SRX5075170,SMARCA4,197
chr1,120859813,120860031,SRX5716469,SMARCA4,218
chr1,120912674,120913019,SRX5075168,SMARCA4,345
chr1,120912695,120913194,SRX5075170,SMARCA4,499
chr1,120912754,120913134,SRX5075176,SMARCA4,380
chr1,120912934,120913243,SRX5075169,SMARCA4,309
chr1,120913967,120914384,SRX5075169,SMARCA4,417
chr1,120913974,120914209,SRX5075176,SMARCA4,235
chr1,120913991,120914348,SRX5075168,SMARCA4,357
chr1,120914021,120914400,SRX5075174,SMARCA4,379
chr1,120942071,120942426,SRX5075174,SMARCA4,355
chr1,120942121,120943266,SRX20140895,INTS13,1145
chr1,120942220,120942503,SRX5075168,SMARCA4,283
chr1,120942241,120942492,SRX5075170,SMARCA4,251
chr1,120942373,120942890,SRX20140868,INTS10,517
chr1,120942411,120943313,SRX20140867,INTS10,902
chr1,120942434,120943092,SRX20140897,INTS13,658
chr1,120942521,120943349,SRX20140881,CPSF3L,828
chr1,120942554,120943195,SRX20140869,INTS10,641
chr1,120942596,120943095,SRX20140879,CPSF3L,499
chr1,120942741,120943199,SRX20140896,INTS13,458
chr1,120955986,120956226,SRX5075168,SMARCA4,240
chr1,120956028,120956320,SRX5075174,SMARCA4,292
chr1,120956030,120956213,SRX5054309,FOSL2,183
chr1,120972899,120973206,SRX5075170,SMARCA4,307
chr1,120972926,120973226,SRX5075176,SMARCA4,300
chr1,120972978,120973209,SRX5075174,SMARCA4,231
chr1,120972980,120973226,SRX5054308,FOSL2,246
chr1,120972991,120973254,SRX5054309,FOSL2,263
chr1,120977313,120977631,SRX5075176,SMARCA4,318
chr1,120977316,120977527,SRX5075170,SMARCA4,211
chr1,120987631,120987811,SRX5075169,SMARCA4,180
chr1,120987773,120988027,SRX5075170,SMARCA4,254
chr1,120995103,120995453,SRX16500059,CTCF,350
chr1,120995114,120995378,SRX16500060,CTCF,264
chr1,120995142,120995361,SRX16500061,CTCF,219
chr1,121019785,121020210,SRX16500061,CTCF,425
chr1,121019807,121020288,SRX16500059,CTCF,481
chr1,121019826,121020218,SRX16500060,CTCF,392
chr1,121019839,121020230,SRX16500062,CTCF,391
chr1,121019851,121020213,SRX4174629,CTCF,362
chr1,121019864,121020037,SRX5075174,SMARCA4,173
chr1,121019869,121020109,SRX5075170,SMARCA4,240
chr1,121019885,121020147,SRX5075176,SMARCA4,262
chr1,121019912,121020108,SRX5075169,SMARCA4,196
chr1,121019927,121020138,SRX5716470,SMARCA4,211
chr1,121020680,121020956,SRX20140869,INTS10,276
chr1,121096983,121097747,SRX4174629,CTCF,764
chr1,121097014,121097941,SRX16500061,CTCF,927
chr1,121097045,121097943,SRX16500060,CTCF,898
chr1,121097054,121097889,SRX5075174,SMARCA4,835
chr1,121097057,121097671,SRX5075169,SMARCA4,614
chr1,121097059,121097962,SRX16500059,CTCF,903
chr1,121097061,121097900,SRX16500062,CTCF,839
chr1,121097071,121097374,SRX5075175,SMARCA4,303
chr1,121097077,121097913,SRX5075170,SMARCA4,836
chr1,121097094,121097889,SRX5075168,SMARCA4,795
chr1,121097114,121097446,SRX5075176,SMARCA4,332
chr1,121097131,121097355,SRX5716469,SMARCA4,224
chr1,121097169,121097623,SRX5716464,SMARCA4,454
chr1,121097183,121097449,SRX20140869,INTS10,266
chr1,121097252,121097829,SRX20140895,INTS13,577
chr1,121097281,121097560,SRX20140867,INTS10,279
chr1,121097319,121097750,SRX20140868,INTS10,431
chr1,121097467,121097688,SRX5716470,SMARCA4,221
chr1,121097529,121097744,SRX5075175,SMARCA4,215
chr1,121118290,121118779,SRX20140895,INTS13,489
chr1,121118329,121118791,SRX20140881,CPSF3L,462
chr1,121118369,121118764,SRX20140867,INTS10,395
chr1,121118451,121118788,SRX20140896,INTS13,337
chr1,121118473,121118756,SRX20140868,INTS10,283
chr1,121118490,121118738,SRX20140879,CPSF3L,248
chr1,121148398,121148980,SRX4174629,CTCF,582
chr1,121148433,121148943,SRX16500060,CTCF,510
chr1,121148497,121148950,SRX16500062,CTCF,453
chr1,121148517,121149025,SRX16500059,CTCF,508
chr1,121148519,121149007,SRX16500061,CTCF,488
chr1,121148630,121149073,SRX5075174,SMARCA4,443
chr1,121148647,121148892,SRX5075169,SMARCA4,245
chr1,121148652,121148897,SRX5075168,SMARCA4,245
chr1,121148653,121148869,SRX5075175,SMARCA4,216
chr1,121148668,121148889,SRX5075176,SMARCA4,221
chr1,121148673,121148855,SRX5075170,SMARCA4,182
chr1,121157639,121157959,SRX5054309,FOSL2,320
chr1,121157641,121157993,SRX5075169,SMARCA4,352
chr1,121157657,121157935,SRX5716469,SMARCA4,278
chr1,121157657,121157967,SRX5075176,SMARCA4,310
chr1,121157664,121158008,SRX5075175,SMARCA4,344
chr1,121157680,121158022,SRX5054308,FOSL2,342
chr1,121157699,121157997,SRX5075170,SMARCA4,298
chr1,121163721,121164318,SRX5075175,SMARCA4,597
chr1,121163808,121164247,SRX5075170,SMARCA4,439
chr1,121163828,121164301,SRX5075176,SMARCA4,473
chr1,121163829,121164239,SRX5716469,SMARCA4,410
chr1,121163840,121164658,SRX5075169,SMARCA4,818
chr1,121163847,121164095,SRX5716467,SMARCA2,248
chr1,121163848,121164151,SRX5716468,SMARCA2,303
chr1,121163867,121164216,SRX5716470,SMARCA4,349
chr1,121164347,121164733,SRX5054309,FOSL2,386
chr1,121164376,121164703,SRX5075175,SMARCA4,327
chr1,121164437,121164735,SRX5054308,FOSL2,298
chr1,121164450,121164650,SRX5020211,SMARCA2,200
chr1,121164475,121164648,SRX5075174,SMARCA4,173
chr1,121164553,121164722,SRX5075170,SMARCA4,169
chr1,121184321,121184928,SRX5054307,FOSL2,607
chr1,121184351,121184679,SRX5054309,FOSL2,328
chr1,121184435,121184937,SRX5075174,SMARCA4,502
chr1,121184452,121184668,SRX5054308,FOSL2,216
chr1,121184764,121184977,SRX5054308,FOSL2,213
chr1,121185015,121185245,SRX20140867,INTS10,230
chr1,121197700,121197985,SRX5716463,SMARCA4,285
chr1,121197760,121197939,SRX5075174,SMARCA4,179
chr1,121200624,121200893,SRX5075170,SMARCA4,269
chr1,121214686,121214901,SRX5075170,SMARCA4,215
chr1,121216813,121217004,SRX5075169,SMARCA4,191
chr1,121216833,121217035,SRX5075170,SMARCA4,202
chr1,121231892,121232455,SRX5075174,SMARCA4,563
chr1,121231899,121232396,SRX5075168,SMARCA4,497
chr1,121231937,121232222,SRX20140895,INTS13,285
chr1,121231950,121232282,SRX20140867,INTS10,332
chr1,121231974,121232230,SRX5716454,SOX3,256
chr1,121232030,121232220,SRX5716451,SOX2,190
chr1,121233828,121234733,SRX5075170,SMARCA4,905
chr1,121233865,121234780,SRX5075176,SMARCA4,915
chr1,121233877,121234741,SRX5075169,SMARCA4,864
chr1,121233881,121234788,SRX5075175,SMARCA4,907
chr1,121233930,121234258,SRX5020211,SMARCA2,328
chr1,121233963,121234677,SRX5716470,SMARCA4,714
chr1,121233967,121234551,SRX5716469,SMARCA4,584
chr1,121233990,121234546,SRX5716467,SMARCA2,556
chr1,121233992,121234329,SRX5054309,FOSL2,337
chr1,121234016,121234353,SRX5716468,SMARCA2,337
chr1,121234045,121234351,SRX5075181,SMARCA2,306
chr1,121234058,121234242,SRX5054308,FOSL2,184
chr1,121234345,121234648,SRX5020211,SMARCA2,303
chr1,121234413,121234644,SRX5716468,SMARCA2,231
chr1,121234481,121234846,SRX5075181,SMARCA2,365
chr1,121244040,121244300,SRX5054309,FOSL2,260
chr1,121244052,121244316,SRX5075169,SMARCA4,264
chr1,121244089,121244277,SRX5054308,FOSL2,188
chr1,121245486,121245661,SRX5075176,SMARCA4,175
chr1,121246286,121246722,SRX5075176,SMARCA4,436
chr1,121246527,121246795,SRX5075169,SMARCA4,268
chr1,121246528,121246744,SRX5075170,SMARCA4,216
chr1,121246550,121246805,SRX5075175,SMARCA4,255
chr1,121263859,121264462,SRX5075169,SMARCA4,603
chr1,121263860,121264446,SRX5075175,SMARCA4,586
chr1,121263878,121264335,SRX5075170,SMARCA4,457
chr1,121263925,121264284,SRX5054309,FOSL2,359
chr1,121263928,121264382,SRX5075176,SMARCA4,454
chr1,121263934,121264394,SRX5716469,SMARCA4,460
chr1,121263937,121264387,SRX5054308,FOSL2,450
chr1,121263972,121264172,SRX5020211,SMARCA2,200
chr1,121263985,121264251,SRX5716467,SMARCA2,266
chr1,121264022,121264280,SRX5716470,SMARCA4,258
chr1,121269950,121270345,SRX5075176,SMARCA4,395
chr1,121269964,121270362,SRX5075175,SMARCA4,398
chr1,121269976,121270354,SRX5075170,SMARCA4,378
chr1,121269985,121270346,SRX5054309,FOSL2,361
chr1,121269996,121270355,SRX5075169,SMARCA4,359
chr1,121270002,121270359,SRX5054308,FOSL2,357
chr1,121270060,121270275,SRX5716467,SMARCA2,215
chr1,121280846,121281219,SRX20140895,INTS13,373
chr1,121280877,121281218,SRX5075174,SMARCA4,341
chr1,121280940,121281257,SRX5075168,SMARCA4,317
chr1,121280971,121281185,SRX20140867,INTS10,214
chr1,121285591,121285883,SRX5716467,SMARCA2,292
chr1,121285599,121285908,SRX5075175,SMARCA4,309
chr1,121285600,121285940,SRX5075176,SMARCA4,340
chr1,121285603,121285940,SRX5075170,SMARCA4,337
chr1,121285610,121285886,SRX5716469,SMARCA4,276
chr1,121285619,121285847,SRX5716468,SMARCA2,228
chr1,121285622,121285847,SRX5716470,SMARCA4,225
chr1,121285637,121285849,SRX5020211,SMARCA2,212
chr1,121285648,121285860,SRX5075169,SMARCA4,212
chr1,121285713,121285908,SRX5075181,SMARCA2,195
chr1,121293285,121293802,SRX5075174,SMARCA4,517
chr1,121293314,121293614,SRX5075168,SMARCA4,300
chr1,121293326,121293689,SRX5716463,SMARCA4,363
chr1,121293327,121293804,SRX20140867,INTS10,477
chr1,121293338,121293776,SRX20140895,INTS13,438
chr1,121293382,121293605,SRX5716464,SMARCA4,223
chr1,121293469,121293708,SRX5716470,SMARCA4,239
chr1,121293649,121293893,SRX5075170,SMARCA4,244
chr1,121298393,121299151,SRX5075168,SMARCA4,758
chr1,121298416,121299173,SRX5075174,SMARCA4,757
chr1,121298506,121299025,SRX5716463,SMARCA4,519
chr1,121298521,121299049,SRX5716464,SMARCA4,528
chr1,121298623,121299137,SRX5716451,SOX2,514
chr1,121299651,121299837,SRX5075170,SMARCA4,186
chr1,121301849,121302181,SRX5054308,FOSL2,332
chr1,121301869,121302225,SRX5054309,FOSL2,356
chr1,121304508,121304784,SRX5075174,SMARCA4,276
chr1,121307772,121308062,SRX20140881,CPSF3L,290
chr1,121307855,121308061,SRX5075168,SMARCA4,206
chr1,121318777,121319055,SRX5075176,SMARCA4,278
chr1,121318781,121319019,SRX5716470,SMARCA4,238
chr1,121318781,121319028,SRX5075174,SMARCA4,247
chr1,121318810,121319074,SRX5075170,SMARCA4,264
chr1,121318816,121318996,SRX5075169,SMARCA4,180
chr1,121318852,121319092,SRX5075175,SMARCA4,240
chr1,121318865,121319044,SRX5075168,SMARCA4,179
chr1,121331379,121331799,SRX5075176,SMARCA4,420
chr1,121331385,121331703,SRX5075169,SMARCA4,318
chr1,121331385,121331755,SRX5054309,FOSL2,370
chr1,121331406,121331751,SRX5075175,SMARCA4,345
chr1,121331433,121331824,SRX5075170,SMARCA4,391
chr1,121331476,121331708,SRX5054308,FOSL2,232
chr1,121338026,121338299,SRX5054309,FOSL2,273
chr1,121338034,121338302,SRX5075175,SMARCA4,268
chr1,121338037,121338356,SRX5075174,SMARCA4,319
chr1,121338050,121338230,SRX5054308,FOSL2,180
chr1,121338052,121338267,SRX5075176,SMARCA4,215
chr1,121338055,121338256,SRX5075169,SMARCA4,201
chr1,121338057,121338298,SRX5075170,SMARCA4,241
chr1,121338119,121338393,SRX5075168,SMARCA4,274
chr1,121347481,121347809,SRX5716463,SMARCA4,328
chr1,121347514,121347933,SRX20140881,CPSF3L,419
chr1,121347575,121347916,SRX20140867,INTS10,341
chr1,121347647,121347882,SRX5075174,SMARCA4,235
chr1,121347682,121347889,SRX5075168,SMARCA4,207
chr1,121356020,121356496,SRX5075176,SMARCA4,476
chr1,121356066,121356365,SRX5075169,SMARCA4,299
chr1,121356071,121356407,SRX5075170,SMARCA4,336
chr1,121356085,121356399,SRX5075175,SMARCA4,314
chr1,121361559,121362444,SRX5075176,SMARCA4,885
chr1,121361590,121362500,SRX5075170,SMARCA4,910
chr1,121361596,121362275,SRX5075168,SMARCA4,679
chr1,121361627,121362321,SRX5075169,SMARCA4,694
chr1,121361670,121362074,SRX5054309,FOSL2,404
chr1,121361678,121362013,SRX5075175,SMARCA4,335
chr1,121361686,121361977,SRX5054308,FOSL2,291
chr1,121361749,121362327,SRX5075174,SMARCA4,578
chr1,121361806,121362017,SRX5716470,SMARCA4,211
chr1,121361942,121362207,SRX16500060,CTCF,265
chr1,121361977,121362249,SRX16500059,CTCF,272
chr1,121361998,121362217,SRX16500061,CTCF,219
chr1,121362670,121362847,SRX5075174,SMARCA4,177
chr1,121362678,121362869,SRX5075168,SMARCA4,191
chr1,121375085,121375339,SRX5075169,SMARCA4,254
chr1,121375104,121375390,SRX5054309,FOSL2,286
chr1,121375121,121375401,SRX5075175,SMARCA4,280
chr1,121385070,121385461,SRX5075176,SMARCA4,391
chr1,121385084,121385371,SRX5075175,SMARCA4,287
chr1,121385096,121385559,SRX5075170,SMARCA4,463
chr1,121385142,121385511,SRX5716470,SMARCA4,369
chr1,121385157,121385369,SRX5716469,SMARCA4,212
chr1,121385202,121385555,SRX5075169,SMARCA4,353
chr1,121395704,121395888,SRX5075176,SMARCA4,184
chr1,121395755,121395996,SRX5075175,SMARCA4,241
chr1,121438948,121439166,SRX5075170,SMARCA4,218
chr1,121438957,121439223,SRX5075176,SMARCA4,266
chr1,121447144,121447774,SRX16500059,CTCF,630
chr1,121447191,121447771,SRX16500060,CTCF,580
chr1,121447237,121447710,SRX16500061,CTCF,473
chr1,121447271,121447647,SRX16500062,CTCF,376
chr1,121469362,121469686,SRX5075168,SMARCA4,324
chr1,121469466,121469689,SRX5075174,SMARCA4,223
chr1,121484011,121484299,SRX5075170,SMARCA4,288
chr1,121484021,121484268,SRX5054308,FOSL2,247
chr1,121484027,121484306,SRX5054309,FOSL2,279
chr1,121484049,121484301,SRX5075169,SMARCA4,252
chr1,121518995,121519444,SRX5075176,SMARCA4,449
chr1,121519171,121519504,SRX5075169,SMARCA4,333
chr1,121519262,121519515,SRX5075175,SMARCA4,253
chr1,121519337,121519510,SRX5075174,SMARCA4,173
chr1,121519396,121519881,SRX20140895,INTS13,485
chr1,121519443,121519765,SRX5075170,SMARCA4,322
chr1,121519512,121519749,SRX5075168,SMARCA4,237
chr1,121519608,121519804,SRX5075174,SMARCA4,196
chr1,121519621,121519812,SRX5075176,SMARCA4,191
chr1,121519623,121519839,SRX5075175,SMARCA4,216
chr1,121519647,121519880,SRX5716470,SMARCA4,233
chr1,121528873,121529372,SRX5075176,SMARCA4,499
chr1,121528881,121529238,SRX5075175,SMARCA4,357
chr1,121528905,121529402,SRX5075170,SMARCA4,497
chr1,121528919,121529308,SRX5075169,SMARCA4,389
chr1,121528969,121529190,SRX5054309,FOSL2,221
chr1,121529004,121529232,SRX5054308,FOSL2,228
chr1,121558486,121558893,SRX5075176,SMARCA4,407
chr1,121558495,121558910,SRX5075169,SMARCA4,415
chr1,121558496,121558926,SRX5075170,SMARCA4,430
chr1,121558504,121558876,SRX5075175,SMARCA4,372
chr1,121558537,121558858,SRX5054308,FOSL2,321
chr1,121558549,121558818,SRX5716469,SMARCA4,269
chr1,121558579,121558864,SRX5054309,FOSL2,285
chr1,121558598,121558839,SRX5716468,SMARCA2,241
chr1,121558617,121558819,SRX5020211,SMARCA2,202
chr1,121558623,121558842,SRX5716467,SMARCA2,219
chr1,121558645,121558925,SRX5716470,SMARCA4,280
chr1,121573817,121574177,SRX5716469,SMARCA4,360
chr1,121573844,121574234,SRX5075169,SMARCA4,390
chr1,121573856,121574214,SRX5075176,SMARCA4,358
chr1,121573889,121574194,SRX5075170,SMARCA4,305
chr1,121573918,121574159,SRX5054309,FOSL2,241
chr1,121573918,121574227,SRX5075175,SMARCA4,309
chr1,121573927,121574189,SRX5054308,FOSL2,262
chr1,121587792,121588037,SRX5054309,FOSL2,245
chr1,121587804,121588057,SRX5054308,FOSL2,253
chr1,121587824,121588082,SRX5075170,SMARCA4,258
chr1,121587851,121588067,SRX5075176,SMARCA4,216
chr1,121587880,121588095,SRX5716470,SMARCA4,215
chr1,121587941,121588125,SRX5075169,SMARCA4,184
chr1,121613184,121613440,SRX20140895,INTS13,256
chr1,121615921,121616271,SRX16500061,CTCF,350
chr1,121615925,121616259,SRX16500062,CTCF,334
chr1,121616042,121616277,SRX16500059,CTCF,235
chr1,121743335,121743594,SRX20140892,SOX2,259
chr1,121743448,121743735,SRX20140895,INTS13,287
chr1,121743453,121743754,SRX20140870,INTS10,301
chr1,121743456,121743729,SRX20140860,SOX2,273
chr1,121743474,121743721,SRX20140880,CPSF3L,247
chr1,121743498,121743753,SRX20140861,SOX2,255
chr1,121750236,121750514,SRX20140868,INTS10,278
chr1,121750238,121750553,SRX20140895,INTS13,315
chr1,121750250,121750514,SRX20140860,SOX2,264
chr1,121750250,121750549,SRX20140880,CPSF3L,299
chr1,121750251,121750518,SRX20140891,SOX2,267
chr1,121750251,121750556,SRX20140882,CPSF3L,305
chr1,121750252,121750566,SRX20140897,INTS13,314
chr1,121750258,121750558,SRX20140869,INTS10,300
chr1,121750265,121750515,SRX20140879,CPSF3L,250
chr1,121750273,121750523,SRX20140861,SOX2,250
chr1,121750275,121750513,SRX20140890,SOX2,238
chr1,121750294,121750593,SRX20140862,SOX2,299
chr1,121750304,121750527,SRX20140867,INTS10,223
chr1,121764757,121765022,SRX9989505,GFP,265
chr1,121767504,121767790,SRX9989504,GFP,286
chr1,121767515,121767797,SRX9989505,GFP,282
chr1,121771557,121771878,SRX9989504,GFP,321
chr1,121771582,121771880,SRX9989505,GFP,298
chr1,121775096,121775418,SRX20140882,CPSF3L,322
chr1,121775108,121775666,SRX20140897,INTS13,558
chr1,121775142,121775707,SRX20140869,INTS10,565
chr1,121775169,121775662,SRX20140895,INTS13,493
chr1,121775172,121775422,SRX20140891,SOX2,250
chr1,121775181,121775656,SRX20140890,SOX2,475
chr1,121775216,121775546,SRX20140868,INTS10,330
chr1,121775228,121775504,SRX9989504,GFP,276
chr1,121775233,121775555,SRX9989505,GFP,322
chr1,121775249,121775496,SRX20140862,SOX2,247
chr1,121775272,121775644,SRX20140892,SOX2,372
chr1,121860366,121860703,SRX20140895,INTS13,337
chr1,121860447,121860706,SRX20140897,INTS13,259
chr1,121863300,121863520,SRX16500061,CTCF,220
chr1,121863301,121863536,SRX16500059,CTCF,235
chr1,121967904,121968182,SRX20140860,SOX2,278
chr1,121968402,121968707,SRX16500059,CTCF,305
chr1,121968418,121968765,SRX16500060,CTCF,347
chr1,121968419,121968710,SRX16500061,CTCF,291
chr1,121968420,121968762,SRX16500062,CTCF,342
chr1,121968436,121968616,SRX5075182,SMARCA2,180
chr1,122503497,122503950,SRX20140867,INTS10,453
chr1,122503525,122503949,SRX20140897,INTS13,424
chr1,122503526,122503929,SRX20140880,CPSF3L,403
chr1,122503533,122503950,SRX20140894,INTS13,417
chr1,122503553,122503906,SRX20140891,SOX2,353
chr1,122503564,122503952,SRX20140895,INTS13,388
chr1,122503576,122503954,SRX20140881,CPSF3L,378
chr1,122503582,122503955,SRX20140890,SOX2,373
chr1,122503582,122503975,SRX20140869,INTS10,393
chr1,122503604,122503946,SRX20140860,SOX2,342
chr1,122503606,122503933,SRX20140882,CPSF3L,327
chr1,122503631,122503939,SRX20140896,INTS13,308
chr1,122503653,122503945,SRX20140879,CPSF3L,292
chr1,122503670,122503947,SRX20140868,INTS10,277
chr1,122503678,122503932,SRX20140861,SOX2,254
chr1,122503725,122504066,SRX16500060,CTCF,341
chr1,122503730,122504059,SRX16500061,CTCF,329
chr1,122503787,122503995,SRX5075174,SMARCA4,208
chr1,122503896,122503950,SRX5075180,SMARCA2,54
chr1,122524472,122525079,SRX20140880,CPSF3L,607
chr1,122524528,122524894,SRX9989504,GFP,366
chr1,122524549,122524869,SRX9989505,GFP,320
chr1,122524608,122524972,SRX20140862,SOX2,364
chr1,122524643,122525021,SRX20140882,CPSF3L,378
chr1,122524765,122525086,SRX20140891,SOX2,321
chr1,122528369,122528615,SRX16500061,CTCF,246
chr1,122528376,122528615,SRX16500060,CTCF,239
chr1,122528381,122528677,SRX16500062,CTCF,296
chr1,122528382,122528576,SRX5075181,SMARCA2,194
chr1,122528391,122528662,SRX16500059,CTCF,271
chr1,122528511,122528725,SRX5716470,SMARCA4,214
chr1,122528524,122528575,SRX5075180,SMARCA2,51
chr1,122528524,122528579,SRX5020208,SMARCA2,55
chr1,122530479,122530759,SRX20140895,INTS13,280
chr1,122530486,122530737,SRX20140880,CPSF3L,251
chr1,122534567,122534913,SRX16500061,CTCF,346
chr1,122534570,122534912,SRX16500060,CTCF,342
chr1,122534576,122534902,SRX16500062,CTCF,326
chr1,122544668,122544972,SRX20140897,INTS13,304
chr1,122550890,122551177,SRX5075182,SMARCA2,287
chr1,122550907,122551231,SRX16500059,CTCF,324
chr1,122550932,122551215,SRX16500061,CTCF,283
chr1,122550970,122551191,SRX16500062,CTCF,221
chr1,122550980,122551220,SRX16500060,CTCF,240
chr1,122550995,122551211,SRX5716468,SMARCA2,216
chr1,122550995,122551247,SRX5716459,Epitope tags,252
chr1,122550999,122551186,SRX5075169,SMARCA4,187
chr1,122550999,122551187,SRX5075175,SMARCA4,188
chr1,122551003,122551059,SRX5020208,SMARCA2,56
chr1,122551003,122551060,SRX5075180,SMARCA2,57
chr1,122552650,122552897,SRX20140879,CPSF3L,247
chr1,122552651,122552952,SRX20140880,CPSF3L,301
chr1,122552712,122552972,SRX20140897,INTS13,260
chr1,122552746,122552993,SRX20140894,INTS13,247
chr1,122553759,122554040,SRX9989504,GFP,281
chr1,122569873,122570132,SRX20140867,INTS10,259
chr1,122571253,122571560,SRX20140861,SOX2,307
chr1,122571272,122571561,SRX20140860,SOX2,289
chr1,122571275,122571701,SRX20140880,CPSF3L,426
chr1,122571277,122571560,SRX20140895,INTS13,283
chr1,122571279,122571538,SRX20140879,CPSF3L,259
chr1,122571279,122571553,SRX20140868,INTS10,274
chr1,122571284,122571563,SRX20140882,CPSF3L,279
chr1,122571288,122571539,SRX20140897,INTS13,251
chr1,122571293,122571559,SRX20140869,INTS10,266
chr1,122571295,122571562,SRX20140894,INTS13,267
chr1,122571304,122571622,SRX9989504,GFP,318
chr1,122571314,122571615,SRX20140867,INTS10,301
chr1,122571318,122571579,SRX20140890,SOX2,261
chr1,122571326,122571677,SRX20140891,SOX2,351
chr1,122571339,122571574,SRX20140892,SOX2,235
chr1,122571348,122571662,SRX20140862,SOX2,314
chr1,122582535,122582783,SRX16500061,CTCF,248
chr1,122582860,122583116,SRX20140897,INTS13,256
chr1,122585583,122585919,SRX20140869,INTS10,336
chr1,122585593,122585928,SRX20140868,INTS10,335
chr1,122585609,122585950,SRX20140895,INTS13,341
chr1,122585627,122585874,SRX20140867,INTS10,247
chr1,122585629,122585895,SRX20140897,INTS13,266
chr1,122585638,122585941,SRX20140860,SOX2,303
chr1,122585639,122585860,SRX20140861,SOX2,221
chr1,122585648,122585875,SRX20140891,SOX2,227
chr1,122585661,122585933,SRX20140890,SOX2,272
chr1,122591864,122592154,SRX20140891,SOX2,290
chr1,122591881,122592296,SRX20140880,CPSF3L,415
chr1,122591886,122592212,SRX20140897,INTS13,326
chr1,122591891,122592224,SRX20140895,INTS13,333
chr1,122591891,122592248,SRX20140862,SOX2,357
chr1,122591904,122592169,SRX20140879,CPSF3L,265
chr1,122591909,122592173,SRX20140861,SOX2,264
chr1,122591912,122592186,SRX20140860,SOX2,274
chr1,122591913,122592219,SRX20140869,INTS10,306
chr1,122591920,122592216,SRX20140868,INTS10,296
chr1,122596108,122596405,SRX9989505,GFP,297
chr1,122596108,122596433,SRX9989504,GFP,325
chr1,122598534,122598586,SRX5020208,SMARCA2,52
chr1,122598534,122598586,SRX5075180,SMARCA2,52
chr1,122599265,122599305,SRX1424891,POU3F2,40
chr1,122599266,122599309,SRX1424892,POU3F2,43
chr1,122599266,122599309,SRX1424894,POU3F2,43
chr1,122599266,122599310,SRX1424893,POU3F2,44
chr1,122612563,122612821,SRX20140879,CPSF3L,258
chr1,122612573,122612824,SRX20140891,SOX2,251
chr1,122612581,122612825,SRX20140880,CPSF3L,244
chr1,122615463,122615771,SRX16500060,CTCF,308
chr1,122615602,122615821,SRX16500061,CTCF,219
chr1,122615618,122615982,SRX20140882,CPSF3L,364
chr1,122615629,122616185,SRX20140880,CPSF3L,556
chr1,122615632,122616096,SRX20140895,INTS13,464
chr1,122615647,122616066,SRX20140892,SOX2,419
chr1,122615652,122616041,SRX20140897,INTS13,389
chr1,122615658,122616023,SRX20140870,INTS10,365
chr1,122615659,122616179,SRX20140862,SOX2,520
chr1,122615666,122616020,SRX20140869,INTS10,354
chr1,122615671,122615996,SRX20140860,SOX2,325
chr1,122615672,122615990,SRX20140868,INTS10,318
chr1,122615673,122616194,SRX20140891,SOX2,521
chr1,122615688,122615987,SRX20140894,INTS13,299
chr1,122615693,122615938,SRX20140879,CPSF3L,245
chr1,122615697,122616077,SRX20140890,SOX2,380
chr1,122615703,122615937,SRX20140867,INTS10,234
chr1,122615705,122615998,SRX20140896,INTS13,293
chr1,122615711,122615947,SRX20140861,SOX2,236
chr1,122624247,122624495,SRX20140891,SOX2,248
chr1,122624261,122624476,SRX20140862,SOX2,215
chr1,122624291,122624505,SRX20140892,SOX2,214
chr1,122628894,122629375,SRX20140894,INTS13,481
chr1,122629035,122629372,SRX20140869,INTS10,337
chr1,122629044,122629379,SRX20140860,SOX2,335
chr1,122629058,122629352,SRX20140880,CPSF3L,294
chr1,122629059,122629320,SRX20140868,INTS10,261
chr1,122629080,122629368,SRX20140895,INTS13,288
chr1,122629088,122629313,SRX20140867,INTS10,225
chr1,122629092,122629369,SRX20140891,SOX2,277
chr1,122629111,122629359,SRX20140897,INTS13,248
chr1,122644831,122645247,SRX9989504,GFP,416
chr1,122644844,122645205,SRX9989505,GFP,361
chr1,122652809,122653332,SRX20140869,INTS10,523
chr1,122652819,122653152,SRX20140860,SOX2,333
chr1,122652822,122653323,SRX20140897,INTS13,501
chr1,122652829,122653313,SRX20140895,INTS13,484
chr1,122652872,122653371,SRX20140868,INTS10,499
chr1,122652878,122653161,SRX20140881,CPSF3L,283
chr1,122652912,122653301,SRX20140890,SOX2,389
chr1,122652916,122653167,SRX20140867,INTS10,251
chr1,122652935,122653259,SRX20140896,INTS13,324
chr1,122657043,122657405,SRX20140880,CPSF3L,362
chr1,122661600,122661897,SRX20140868,INTS10,297
chr1,122661948,122662214,SRX20140869,INTS10,266
chr1,122661985,122662227,SRX20140860,SOX2,242
chr1,122667196,122667481,SRX20140882,CPSF3L,285
chr1,122667235,122667664,SRX20140880,CPSF3L,429
chr1,122667250,122667634,SRX20140891,SOX2,384
chr1,122667420,122667668,SRX20140860,SOX2,248
chr1,122668528,122668908,SRX16500059,CTCF,380
chr1,122668539,122668814,SRX5716470,SMARCA4,275
chr1,122668544,122668900,SRX16500061,CTCF,356
chr1,122668544,122668902,SRX16500060,CTCF,358
chr1,122668545,122668756,SRX5716468,SMARCA2,211
chr1,122668548,122668886,SRX16500062,CTCF,338
chr1,122668552,122668874,SRX5020214,SMARCA2,322
chr1,122668560,122668852,SRX5075181,SMARCA2,292
chr1,122668565,122668881,SRX5075175,SMARCA4,316
chr1,122668581,122668860,SRX5075170,SMARCA4,279
chr1,122668617,122668798,SRX5075176,SMARCA4,181
chr1,122668693,122668747,SRX5075180,SMARCA2,54
chr1,122668696,122668749,SRX5020208,SMARCA2,53
chr1,122672255,122672611,SRX16500059,CTCF,356
chr1,122672278,122672596,SRX16500062,CTCF,318
chr1,122672284,122672608,SRX16500061,CTCF,324
chr1,122672380,122672606,SRX16500060,CTCF,226
chr1,122682424,122682707,SRX20140895,INTS13,283
chr1,122683096,122683497,SRX9989504,GFP,401
chr1,122683113,122683536,SRX9989505,GFP,423
chr1,122683160,122683572,SRX20140892,SOX2,412
chr1,122683204,122683803,SRX20140895,INTS13,599
chr1,122683237,122683785,SRX20140880,CPSF3L,548
chr1,122683388,122683777,SRX20140879,CPSF3L,389
chr1,122683410,122683690,SRX20140869,INTS10,280
chr1,122683434,122683676,SRX20140891,SOX2,242
chr1,122683502,122683816,SRX20140860,SOX2,314
chr1,122685553,122685896,SRX5716459,Epitope tags,343
chr1,122685559,122685950,SRX16500059,CTCF,391
chr1,122685571,122685873,SRX5716469,SMARCA4,302
chr1,122685575,122685933,SRX16500061,CTCF,358
chr1,122685577,122685941,SRX16500060,CTCF,364
chr1,122685585,122685930,SRX16500062,CTCF,345
chr1,122685594,122685858,SRX5075181,SMARCA2,264
chr1,122685595,122685790,SRX5075175,SMARCA4,195
chr1,122685596,122685868,SRX5075182,SMARCA2,272
chr1,122685604,122685783,SRX5054307,FOSL2,179
chr1,122685608,122685861,SRX5075169,SMARCA4,253
chr1,122685611,122685895,SRX5075176,SMARCA4,284
chr1,122685612,122685886,SRX5075170,SMARCA4,274
chr1,122685662,122685934,SRX5716468,SMARCA2,272
chr1,122685721,122685781,SRX5075180,SMARCA2,60
chr1,122685723,122685780,SRX5020208,SMARCA2,57
chr1,122694654,122695135,SRX20140895,INTS13,481
chr1,122694746,122695028,SRX20140897,INTS13,282
chr1,122694763,122695129,SRX20140881,CPSF3L,366
chr1,122699743,122699985,SRX20140891,SOX2,242
chr1,122699760,122700005,SRX20140880,CPSF3L,245
chr1,122699794,122700065,SRX20140892,SOX2,271
chr1,122703309,122703564,SRX9989504,GFP,255
chr1,122720431,122720495,SRX5020208,SMARCA2,64
chr1,122722495,122722847,SRX20140895,INTS13,352
chr1,122722520,122722780,SRX20140897,INTS13,260
chr1,122725400,122725625,SRX20140891,SOX2,225
chr1,122730184,122730454,SRX9989505,GFP,270
chr1,122738029,122738333,SRX9989504,GFP,304
chr1,122738046,122738342,SRX9989505,GFP,296
chr1,122741453,122742169,SRX20140895,INTS13,716
chr1,122741456,122741869,SRX20140891,SOX2,413
chr1,122741457,122741899,SRX20140879,CPSF3L,442
chr1,122741463,122741864,SRX20140880,CPSF3L,401
chr1,122741464,122742140,SRX20140860,SOX2,676
chr1,122741465,122741795,SRX20140868,INTS10,330
chr1,122741467,122741806,SRX20140897,INTS13,339
chr1,122741470,122741799,SRX20140867,INTS10,329
chr1,122741470,122741903,SRX20140894,INTS13,433
chr1,122741481,122741819,SRX20140861,SOX2,338
chr1,122741481,122741867,SRX20140890,SOX2,386
chr1,122741488,122741805,SRX20140882,CPSF3L,317
chr1,122741490,122741738,SRX20140862,SOX2,248
chr1,122741491,122741706,SRX20140892,SOX2,215
chr1,122741501,122742076,SRX20140869,INTS10,575
chr1,122741520,122741993,SRX20140896,INTS13,473
chr1,122741879,122742160,SRX20140881,CPSF3L,281
chr1,122756146,122756447,SRX16500060,CTCF,301
chr1,122756162,122756499,SRX16500059,CTCF,337
chr1,122756163,122756427,SRX16500062,CTCF,264
chr1,122756222,122756454,SRX20140861,SOX2,232
chr1,122773649,122773949,SRX20140895,INTS13,300
chr1,122785516,122785803,SRX20140895,INTS13,287
chr1,122798239,122798495,SRX20140894,INTS13,256
chr1,122798278,122798497,SRX20140891,SOX2,219
chr1,122798867,122799193,SRX9989504,GFP,326
chr1,122798941,122799204,SRX9989505,GFP,263
chr1,122806015,122806334,SRX20140860,SOX2,319
chr1,122806027,122806324,SRX16500061,CTCF,297
chr1,122806075,122806370,SRX20140895,INTS13,295
chr1,122806138,122806371,SRX20140867,INTS10,233
chr1,122806167,122806381,SRX20140892,SOX2,214
chr1,122818182,122818449,SRX9989504,GFP,267
chr1,122819362,122819606,SRX20140880,CPSF3L,244
chr1,122819379,122819615,SRX16500059,CTCF,236
chr1,122819406,122819620,SRX20140891,SOX2,214
chr1,122820426,122820681,SRX9989505,GFP,255
chr1,122823350,122823613,SRX20140897,INTS13,263
chr1,122827253,122827558,SRX20140895,INTS13,305
chr1,122827271,122827709,SRX20140880,CPSF3L,438
chr1,122827339,122827657,SRX20140862,SOX2,318
chr1,122827341,122827710,SRX20140891,SOX2,369
chr1,122827361,122827579,SRX20140892,SOX2,218
chr1,122827415,122827690,SRX20140897,INTS13,275
chr1,122830345,122830581,SRX20140879,CPSF3L,236
chr1,122839170,122839459,SRX20140880,CPSF3L,289
chr1,122842594,122842889,SRX9989504,GFP,295
chr1,122842613,122842904,SRX20140882,CPSF3L,291
chr1,122842622,122842919,SRX9989505,GFP,297
chr1,122842647,122842911,SRX20140880,CPSF3L,264
chr1,122842651,122842878,SRX20140892,SOX2,227
chr1,122842651,122842897,SRX20140891,SOX2,246
chr1,122842652,122842923,SRX20140868,INTS10,271
chr1,122842656,122842891,SRX20140862,SOX2,235
chr1,122844483,122844814,SRX20140879,CPSF3L,331
chr1,122848691,122849192,SRX5716455,SOX3,501
chr1,122848708,122848982,SRX5716452,SOX2,274
chr1,122848719,122849150,SRX5716459,Epitope tags,431
chr1,122848731,122849166,SRX5716460,Epitope tags,435
chr1,122848751,122849150,SRX16500059,CTCF,399
chr1,122848761,122849122,SRX5716467,SMARCA2,361
chr1,122848763,122849122,SRX5716469,SMARCA4,359
chr1,122848763,122849130,SRX5716468,SMARCA2,367
chr1,122848765,122849114,SRX5716470,SMARCA4,349
chr1,122848767,122849132,SRX16500060,CTCF,365
chr1,122848771,122849122,SRX5020214,SMARCA2,351
chr1,122848772,122848974,SRX5020211,SMARCA2,202
chr1,122848773,122849134,SRX16500061,CTCF,361
chr1,122848775,122849097,SRX5716464,SMARCA4,322
chr1,122848777,122849126,SRX16500062,CTCF,349
chr1,122848778,122849106,SRX5075175,SMARCA4,328
chr1,122848781,122849115,SRX5075181,SMARCA2,334
chr1,122848788,122848994,SRX5075168,SMARCA4,206
chr1,122848788,122849012,SRX5054307,FOSL2,224
chr1,122848788,122849101,SRX5075169,SMARCA4,313
chr1,122848791,122848982,SRX5716451,SOX2,191
chr1,122848791,122849069,SRX5075170,SMARCA4,278
chr1,122848793,122849097,SRX5075182,SMARCA2,304
chr1,122848794,122849064,SRX5075174,SMARCA4,270
chr1,122848801,122849083,SRX5075176,SMARCA4,282
chr1,122848905,122848981,SRX5075180,SMARCA2,76
chr1,122848906,122849143,SRX5716453,SOX2,237
chr1,122848907,122848982,SRX5020208,SMARCA2,75
chr1,122850175,122850549,SRX20140880,CPSF3L,374
chr1,122850225,122850514,SRX20140895,INTS13,289
chr1,122850238,122850540,SRX20140881,CPSF3L,302
chr1,122857310,122857357,SRX1424893,POU3F2,47
chr1,122857312,122857352,SRX1424891,POU3F2,40
chr1,122857312,122857353,SRX1424892,POU3F2,41
chr1,122857313,122857354,SRX1424894,POU3F2,41
chr1,122861266,122861569,SRX20140895,INTS13,303
chr1,122861289,122861606,SRX16500060,CTCF,317
chr1,122861291,122861626,SRX16500062,CTCF,335
chr1,122861293,122861657,SRX16500059,CTCF,364
chr1,122861301,122861633,SRX16500061,CTCF,332
chr1,122870281,122870775,SRX20140880,CPSF3L,494
chr1,122870283,122870757,SRX20140894,INTS13,474
chr1,122870294,122870740,SRX20140890,SOX2,446
chr1,122870295,122870798,SRX20140895,INTS13,503
chr1,122870303,122870783,SRX20140879,CPSF3L,480
chr1,122870305,122870765,SRX20140891,SOX2,460
chr1,122870306,122870631,SRX16500062,CTCF,325
chr1,122870309,122870741,SRX20140881,CPSF3L,432
chr1,122870317,122870640,SRX20140882,CPSF3L,323
chr1,122870318,122870776,SRX20140861,SOX2,458
chr1,122870331,122870788,SRX20140860,SOX2,457
chr1,122870332,122870750,SRX20140868,INTS10,418
chr1,122870360,122870757,SRX20140869,INTS10,397
chr1,122870377,122870707,SRX20140870,INTS10,330
chr1,122870380,122870804,SRX20140897,INTS13,424
chr1,122870404,122870708,SRX20140867,INTS10,304
chr1,122870420,122870729,SRX20140862,SOX2,309
chr1,122877202,122877442,SRX20140880,CPSF3L,240
chr1,122877206,122877491,SRX20140894,INTS13,285
chr1,122877211,122877641,SRX20140895,INTS13,430
chr1,122877394,122877446,SRX5075180,SMARCA2,52
chr1,122879740,122880225,SRX20140891,SOX2,485
chr1,122879761,122880218,SRX20140880,CPSF3L,457
chr1,122879806,122880216,SRX20140869,INTS10,410
chr1,122879933,122880217,SRX20140868,INTS10,284
chr1,122879935,122880169,SRX20140892,SOX2,234
chr1,122879936,122880212,SRX20140882,CPSF3L,276
chr1,122879945,122880168,SRX20140862,SOX2,223
chr1,122879962,122880309,SRX20140895,INTS13,347
chr1,122889251,122889497,SRX20140879,CPSF3L,246
chr1,122894287,122894507,SRX16500061,CTCF,220
chr1,122894604,122894853,SRX20140897,INTS13,249
chr1,122894685,122895021,SRX20140890,SOX2,336
chr1,122904100,122904371,SRX9989504,GFP,271
chr1,122904215,122904457,SRX20140879,CPSF3L,242
chr1,122904227,122904523,SRX20140895,INTS13,296
chr1,122904257,122904631,SRX20140880,CPSF3L,374
chr1,122904353,122904564,SRX20140891,SOX2,211
chr1,122912410,122912838,SRX20140895,INTS13,428
chr1,122912472,122912864,SRX20140880,CPSF3L,392
chr1,122912474,122912843,SRX20140897,INTS13,369
chr1,122912476,122912825,SRX20140882,CPSF3L,349
chr1,122912481,122912841,SRX20140891,SOX2,360
chr1,122912482,122912793,SRX20140896,INTS13,311
chr1,122912492,122912846,SRX20140894,INTS13,354
chr1,122912494,122912832,SRX20140890,SOX2,338
chr1,122912494,122912848,SRX20140867,INTS10,354
chr1,122912497,122912854,SRX20140879,CPSF3L,357
chr1,122912498,122912846,SRX20140861,SOX2,348
chr1,122912502,122912840,SRX20140869,INTS10,338
chr1,122912504,122912831,SRX20140860,SOX2,327
chr1,122912522,122912836,SRX20140881,CPSF3L,314
chr1,122912522,122912852,SRX20140868,INTS10,330
chr1,122912524,122912833,SRX20140870,INTS10,309
chr1,122912561,122912900,SRX5716455,SOX3,339
chr1,122912574,122912970,SRX16500061,CTCF,396
chr1,122912587,122912853,SRX20140862,SOX2,266
chr1,122912593,122912981,SRX16500059,CTCF,388
chr1,122912600,122912976,SRX16500060,CTCF,376
chr1,122912606,122912837,SRX20140892,SOX2,231
chr1,122912613,122912959,SRX16500062,CTCF,346
chr1,122912625,122912838,SRX5075175,SMARCA4,213
chr1,122912633,122912962,SRX5716468,SMARCA2,329
chr1,122912653,122912902,SRX5716459,Epitope tags,249
chr1,122912658,122912922,SRX5075169,SMARCA4,264
chr1,122912680,122912931,SRX5075182,SMARCA2,251
chr1,122912729,122912948,SRX5075181,SMARCA2,219
chr1,122912748,122912930,SRX5075176,SMARCA4,182
chr1,122912751,122912958,SRX5020214,SMARCA2,207
chr1,122912752,122912809,SRX5075180,SMARCA2,57
chr1,122912761,122912814,SRX5020208,SMARCA2,53
chr1,122922681,122922988,SRX20140891,SOX2,307
chr1,122925534,122925815,SRX20140860,SOX2,281
chr1,122925540,122925793,SRX20140897,INTS13,253
chr1,122925550,122925829,SRX20140895,INTS13,279
chr1,122925574,122925833,SRX20140879,CPSF3L,259
chr1,122925585,122925941,SRX20140867,INTS10,356
chr1,122925597,122925871,SRX20140890,SOX2,274
chr1,122925654,122925899,SRX20140880,CPSF3L,245
chr1,122929219,122929564,SRX20140868,INTS10,345
chr1,122929221,122929549,SRX20140860,SOX2,328
chr1,122929238,122929544,SRX20140895,INTS13,306
chr1,122929247,122929517,SRX20140879,CPSF3L,270
chr1,122929260,122929535,SRX20140897,INTS13,275
chr1,122929271,122929555,SRX20140881,CPSF3L,284
chr1,122929272,122929559,SRX20140894,INTS13,287
chr1,122929274,122929510,SRX16500061,CTCF,236
chr1,122929290,122929533,SRX20140890,SOX2,243
chr1,122929313,122929557,SRX20140862,SOX2,244
chr1,122936721,122937004,SRX20140880,CPSF3L,283
chr1,122936723,122937000,SRX20140860,SOX2,277
chr1,122936749,122937028,SRX20140897,INTS13,279
chr1,122961512,122961984,SRX20140895,INTS13,472
chr1,122961515,122961881,SRX20140880,CPSF3L,366
chr1,122961527,122961863,SRX20140894,INTS13,336
chr1,122961533,122961891,SRX20140861,SOX2,358
chr1,122961551,122961800,SRX20140897,INTS13,249
chr1,122961553,122961917,SRX20140860,SOX2,364
chr1,122961555,122961810,SRX20140890,SOX2,255
chr1,122961566,122961947,SRX20140879,CPSF3L,381
chr1,122961762,122962072,SRX20140868,INTS10,310
chr1,122968790,122969012,SRX20140862,SOX2,222
chr1,122968796,122969013,SRX20140891,SOX2,217
chr1,122979101,122979279,SRX5075176,SMARCA4,178
chr1,122981123,122981394,SRX9989505,GFP,271
chr1,122981123,122981399,SRX9989504,GFP,276
chr1,122998178,122998438,SRX20140895,INTS13,260
chr1,122998180,122998447,SRX20140897,INTS13,267
chr1,122998186,122998441,SRX20140860,SOX2,255
chr1,122998190,122998430,SRX20140880,CPSF3L,240
chr1,123001242,123001497,SRX9989504,GFP,255
chr1,123003051,123003453,SRX20140880,CPSF3L,402
chr1,123003058,123003305,SRX20140894,INTS13,247
chr1,123003088,123003418,SRX20140860,SOX2,330
chr1,123003119,123003415,SRX20140891,SOX2,296
chr1,123003123,123003444,SRX20140897,INTS13,321
chr1,123003131,123003427,SRX20140895,INTS13,296
chr1,123003166,123003396,SRX20140862,SOX2,230
chr1,123010047,123010091,SRX1424894,POU3F2,44
chr1,123010047,123010094,SRX1424891,POU3F2,47
chr1,123010049,123010092,SRX1424893,POU3F2,43
chr1,123013361,123013622,SRX20140881,CPSF3L,261
chr1,123017307,123017747,SRX5716460,Epitope tags,440
chr1,123017332,123017748,SRX5716459,Epitope tags,416
chr1,123017337,123017716,SRX16500059,CTCF,379
chr1,123017345,123017708,SRX16500060,CTCF,363
chr1,123017351,123017701,SRX16500061,CTCF,350
chr1,123017352,123017724,SRX5716467,SMARCA2,372
chr1,123017358,123017712,SRX5716470,SMARCA4,354
chr1,123017360,123017687,SRX16500062,CTCF,327
chr1,123017360,123017717,SRX5716468,SMARCA2,357
chr1,123017362,123017711,SRX5020214,SMARCA2,349
chr1,123017364,123017694,SRX5020211,SMARCA2,330
chr1,123017369,123017693,SRX5075181,SMARCA2,324
chr1,123017378,123017694,SRX5075175,SMARCA4,316
chr1,123017382,123017693,SRX5075169,SMARCA4,311
chr1,123017388,123017683,SRX5075176,SMARCA4,295
chr1,123017388,123017686,SRX5075182,SMARCA2,298
chr1,123017389,123017670,SRX5716451,SOX2,281
chr1,123017392,123017678,SRX5075168,SMARCA4,286
chr1,123017399,123017675,SRX5075170,SMARCA4,276
chr1,123017459,123017642,SRX5054309,FOSL2,183
chr1,123017470,123017674,SRX5075174,SMARCA4,204
chr1,123017501,123017569,SRX5075180,SMARCA2,68
chr1,123017505,123017575,SRX5020208,SMARCA2,70
chr1,123036040,123036332,SRX20140895,INTS13,292
chr1,123049327,123049544,SRX20140891,SOX2,217
chr1,123051241,123051522,SRX20140869,INTS10,281
chr1,123051264,123051564,SRX20140881,CPSF3L,300
chr1,123051281,123051528,SRX20140897,INTS13,247
chr1,123051311,123051553,SRX20140860,SOX2,242
chr1,123058718,123059100,SRX20140894,INTS13,382
chr1,123058726,123059076,SRX16500061,CTCF,350
chr1,123058727,123059110,SRX20140882,CPSF3L,383
chr1,123058728,123059080,SRX16500060,CTCF,352
chr1,123058728,123059120,SRX20140880,CPSF3L,392
chr1,123058730,123059003,SRX20140881,CPSF3L,273
chr1,123058732,123059082,SRX20140891,SOX2,350
chr1,123058732,123059136,SRX20140895,INTS13,404
chr1,123058734,123059043,SRX20140897,INTS13,309
chr1,123058735,123059036,SRX20140867,INTS10,301
chr1,123058735,123059101,SRX20140861,SOX2,366
chr1,123058736,123059041,SRX20140890,SOX2,305
chr1,123058740,123059013,SRX20140868,INTS10,273
chr1,123058741,123059083,SRX20140869,INTS10,342
chr1,123058746,123059088,SRX16500059,CTCF,342
chr1,123058749,123059015,SRX20140879,CPSF3L,266
chr1,123058751,123059061,SRX16500062,CTCF,310
chr1,123058756,123059113,SRX20140860,SOX2,357
chr1,123058767,123059057,SRX20140892,SOX2,290
chr1,123058770,123059072,SRX20140862,SOX2,302
chr1,123070535,123071055,SRX5716455,SOX3,520
chr1,123070557,123071035,SRX5716452,SOX2,478
chr1,123070562,123071031,SRX5716460,Epitope tags,469
chr1,123070576,123071019,SRX5716459,Epitope tags,443
chr1,123070586,123070985,SRX16500059,CTCF,399
chr1,123070589,123071016,SRX5716456,SOX3,427
chr1,123070593,123070906,SRX5716453,SOX2,313
chr1,123070601,123070966,SRX16500060,CTCF,365
chr1,123070608,123070968,SRX16500061,CTCF,360
chr1,123070608,123070986,SRX5716467,SMARCA2,378
chr1,123070610,123070983,SRX5716469,SMARCA4,373
chr1,123070612,123070979,SRX5716468,SMARCA2,367
chr1,123070612,123070979,SRX5716470,SMARCA4,367
chr1,123070616,123070963,SRX16500062,CTCF,347
chr1,123070616,123070978,SRX5020214,SMARCA2,362
chr1,123070623,123070933,SRX5716463,SMARCA4,310
chr1,123070623,123070962,SRX5716464,SMARCA4,339
chr1,123070623,123070976,SRX5020211,SMARCA2,353
chr1,123070626,123070969,SRX5075181,SMARCA2,343
chr1,123070634,123070958,SRX5716454,SOX3,324
chr1,123070637,123070958,SRX5075175,SMARCA4,321
chr1,123070639,123070947,SRX5716451,SOX2,308
chr1,123070640,123070953,SRX5054309,FOSL2,313
chr1,123070640,123070956,SRX5075169,SMARCA4,316
chr1,123070641,123070944,SRX5054307,FOSL2,303
chr1,123070643,123070948,SRX5075176,SMARCA4,305
chr1,123070643,123070953,SRX5075182,SMARCA2,310
chr1,123070645,123070949,SRX5054308,FOSL2,304
chr1,123070650,123070949,SRX5075168,SMARCA4,299
chr1,123070651,123070939,SRX5075174,SMARCA4,288
chr1,123070652,123070944,SRX5075170,SMARCA4,292
chr1,123070759,123070833,SRX5020208,SMARCA2,74
chr1,123070761,123070833,SRX5075180,SMARCA2,72
chr1,123075567,123075812,SRX20140860,SOX2,245
chr1,123075570,123075947,SRX20140895,INTS13,377
chr1,123075582,123075988,SRX20140867,INTS10,406
chr1,123075604,123076008,SRX20140861,SOX2,404
chr1,123075645,123076000,SRX20140897,INTS13,355
chr1,123088206,123088536,SRX20140869,INTS10,330
chr1,123088206,123088639,SRX20140897,INTS13,433
chr1,123088227,123088469,SRX20140890,SOX2,242
chr1,123088231,123088666,SRX20140895,INTS13,435
chr1,123088240,123088539,SRX20140860,SOX2,299
chr1,123088370,123088631,SRX20140868,INTS10,261
chr1,123088376,123088686,SRX20140891,SOX2,310
chr1,123088383,123088678,SRX20140879,CPSF3L,295
chr1,123098317,123098578,SRX20140897,INTS13,261
chr1,123098323,123098589,SRX20140869,INTS10,266
chr1,123098327,123098641,SRX20140860,SOX2,314
chr1,123107187,123107442,SRX9989505,GFP,255
chr1,123107369,123107635,SRX20140895,INTS13,266
chr1,123107431,123107716,SRX20140891,SOX2,285
chr1,123107449,123107695,SRX20140897,INTS13,246
chr1,123107453,123107713,SRX20140894,INTS13,260
chr1,123107457,123107708,SRX20140880,CPSF3L,251
chr1,123107464,123107697,SRX20140861,SOX2,233
chr1,123107470,123107743,SRX16500059,CTCF,273
chr1,123107480,123107720,SRX16500061,CTCF,240
chr1,123107503,123107734,SRX16500062,CTCF,231
chr1,123113128,123113352,SRX20140861,SOX2,224
chr1,123113460,123113514,SRX5075180,SMARCA2,54
chr1,123113463,123113514,SRX5020208,SMARCA2,51
chr1,123118588,123118856,SRX20140880,CPSF3L,268
chr1,123120257,123120556,SRX9989504,GFP,299
chr1,123120263,123120540,SRX9989505,GFP,277
chr1,123128526,123128911,SRX16500059,CTCF,385
chr1,123128571,123128783,SRX16500062,CTCF,212
chr1,123128675,123128899,SRX16500060,CTCF,224
chr1,123128675,123128899,SRX16500061,CTCF,224
chr1,123128702,123128756,SRX5020208,SMARCA2,54
chr1,123128703,123128756,SRX5075180,SMARCA2,53
chr1,123130333,123130573,SRX20140880,CPSF3L,240
chr1,123137923,123138165,SRX16500060,CTCF,242
chr1,123146901,123147115,SRX20140892,SOX2,214
chr1,123146941,123147248,SRX20140880,CPSF3L,307
chr1,123148171,123148413,SRX20140860,SOX2,242
chr1,123167146,123167651,SRX20140895,INTS13,505
chr1,123167162,123167564,SRX20140880,CPSF3L,402
chr1,123167164,123167472,SRX20140897,INTS13,308
chr1,123167197,123167466,SRX20140861,SOX2,269
chr1,123167255,123167516,SRX20140868,INTS10,261
chr1,123167371,123167606,SRX20140879,CPSF3L,235
chr1,123169676,123169931,SRX9989505,GFP,255
chr1,123175889,123176207,SRX20140880,CPSF3L,318
chr1,123175917,123176173,SRX20140862,SOX2,256
chr1,123175922,123176172,SRX20140891,SOX2,250
chr1,123176920,123177198,SRX20140895,INTS13,278
chr1,123176926,123177218,SRX20140897,INTS13,292
chr1,123176935,123177194,SRX20140860,SOX2,259
chr1,123185620,123186107,SRX20140895,INTS13,487
chr1,123185621,123186028,SRX20140879,CPSF3L,407
chr1,123185631,123185983,SRX20140869,INTS10,352
chr1,123185637,123186128,SRX20140882,CPSF3L,491
chr1,123185642,123186041,SRX20140890,SOX2,399
chr1,123185650,123186050,SRX20140881,CPSF3L,400
chr1,123185653,123185919,SRX20140894,INTS13,266
chr1,123185659,123186209,SRX20140880,CPSF3L,550
chr1,123185664,123185931,SRX20140897,INTS13,267
chr1,123185672,123186145,SRX20140891,SOX2,473
chr1,123185682,123186163,SRX20140862,SOX2,481
chr1,123185683,123185925,SRX20140860,SOX2,242
chr1,123185771,123186049,SRX20140868,INTS10,278
chr1,123185840,123186113,SRX20140892,SOX2,273
chr1,123195440,123195979,SRX20140895,INTS13,539
chr1,123195450,123195926,SRX20140881,CPSF3L,476
chr1,123195454,123195892,SRX20140860,SOX2,438
chr1,123195480,123195926,SRX20140868,INTS10,446
chr1,123195483,123195770,SRX20140896,INTS13,287
chr1,123195485,123195797,SRX20140882,CPSF3L,312
chr1,123195485,123195967,SRX20140869,INTS10,482
chr1,123195492,123195912,SRX20140867,INTS10,420
chr1,123195496,123195890,SRX20140894,INTS13,394
chr1,123195498,123195929,SRX20140897,INTS13,431
chr1,123195499,123195869,SRX20140891,SOX2,370
chr1,123195508,123195908,SRX20140880,CPSF3L,400
chr1,123195511,123195875,SRX20140890,SOX2,364
chr1,123195515,123195894,SRX20140879,CPSF3L,379
chr1,123195524,123195896,SRX20140861,SOX2,372
chr1,123195532,123195857,SRX16500061,CTCF,325
chr1,123195542,123195885,SRX16500062,CTCF,343
chr1,123195547,123195925,SRX16500059,CTCF,378
chr1,123195549,123195917,SRX16500060,CTCF,368
chr1,123195555,123195888,SRX20140862,SOX2,333
chr1,123195562,123195856,SRX9989505,GFP,294
chr1,123195564,123195787,SRX5716463,SMARCA4,223
chr1,123195564,123195847,SRX20140892,SOX2,283
chr1,123195598,123195853,SRX9989504,GFP,255
chr1,123195612,123195862,SRX5075174,SMARCA4,250
chr1,123195617,123195875,SRX5075170,SMARCA4,258
chr1,123195683,123195888,SRX5075175,SMARCA4,205
chr1,123195706,123195771,SRX5075180,SMARCA2,65
chr1,123195708,123195766,SRX5020208,SMARCA2,58
chr1,123195719,123195768,SRX1424892,POU3F2,49
chr1,123195719,123195769,SRX1424891,POU3F2,50
chr1,123195723,123195766,SRX1424893,POU3F2,43
chr1,123217124,123217346,SRX16500060,CTCF,222
chr1,123225473,123225909,SRX20140880,CPSF3L,436
chr1,123225490,123225923,SRX20140868,INTS10,433
chr1,123225498,123225954,SRX20140895,INTS13,456
chr1,123225535,123225940,SRX20140894,INTS13,405
chr1,123225548,123225825,SRX20140890,SOX2,277
chr1,123225564,123225924,SRX20140897,INTS13,360
chr1,123225574,123225910,SRX20140860,SOX2,336
chr1,123225575,123225922,SRX20140861,SOX2,347
chr1,123225585,123225908,SRX20140879,CPSF3L,323
chr1,123225608,123225884,SRX20140867,INTS10,276
chr1,123225618,123225859,SRX20140891,SOX2,241
chr1,123225623,123225986,SRX20140881,CPSF3L,363
chr1,123225634,123225843,SRX20140862,SOX2,209
chr1,123225634,123225919,SRX20140896,INTS13,285
chr1,123225714,123226079,SRX9989504,GFP,365
chr1,123225751,123226061,SRX9989505,GFP,310
chr1,123238852,123239122,SRX20140895,INTS13,270
chr1,123238871,123239135,SRX20140868,INTS10,264
chr1,123287653,123288078,SRX16500060,CTCF,425
chr1,123287709,123288024,SRX16500059,CTCF,315
chr1,123287720,123288001,SRX16500061,CTCF,281
chr1,123287736,123288025,SRX16500062,CTCF,289
chr1,123305794,123306010,SRX16500062,CTCF,216
chr1,123305799,123306020,SRX20140891,SOX2,221
chr1,123305843,123306088,SRX20140867,INTS10,245
chr1,123305843,123306107,SRX20140895,INTS13,264
chr1,123324264,123324505,SRX16500061,CTCF,241
chr1,123334428,123334828,SRX20140882,CPSF3L,400
chr1,123334554,123334874,SRX20140880,CPSF3L,320
chr1,123334558,123334893,SRX20140895,INTS13,335
chr1,123334563,123334846,SRX20140897,INTS13,283
chr1,123334567,123334870,SRX20140869,INTS10,303
chr1,123334570,123334847,SRX20140891,SOX2,277
chr1,123334572,123334833,SRX20140868,INTS10,261
chr1,123334574,123334821,SRX20140890,SOX2,247
chr1,123334575,123334842,SRX20140867,INTS10,267
chr1,123334578,123334805,SRX20140892,SOX2,227
chr1,123334583,123334825,SRX20140860,SOX2,242
chr1,123334617,123334869,SRX20140861,SOX2,252
chr1,123334644,123334860,SRX20140862,SOX2,216
chr1,123342212,123342485,SRX20140895,INTS13,273
chr1,123347109,123347159,SRX5075180,SMARCA2,50
chr1,123347113,123347153,SRX1424894,POU3F2,40
chr1,123352526,123352760,SRX16500061,CTCF,234
chr1,123355429,123355673,SRX20140897,INTS13,244
chr1,123370015,123370376,SRX20140869,INTS10,361
chr1,123372461,123372755,SRX9989505,GFP,294
chr1,123372463,123372753,SRX9989504,GFP,290
chr1,123380220,123380630,SRX20140861,SOX2,410
chr1,123380244,123380708,SRX20140895,INTS13,464
chr1,123380355,123380607,SRX20140890,SOX2,252
chr1,123388630,123388994,SRX20140895,INTS13,364
chr1,123388677,123388983,SRX20140869,INTS10,306
chr1,123388684,123389012,SRX20140897,INTS13,328
chr1,123388685,123388966,SRX20140881,CPSF3L,281
chr1,123388686,123388946,SRX20140861,SOX2,260
chr1,123388687,123388938,SRX20140860,SOX2,251
chr1,123388707,123388963,SRX20140890,SOX2,256
chr1,123388712,123388971,SRX20140894,INTS13,259
chr1,123388721,123388982,SRX20140868,INTS10,261
chr1,123388792,123389027,SRX20140879,CPSF3L,235
chr1,123393598,123393808,SRX16500062,CTCF,210
chr1,123394767,123395148,SRX20140880,CPSF3L,381
chr1,123394774,123395110,SRX20140891,SOX2,336
chr1,123394780,123395143,SRX20140897,INTS13,363
chr1,123394790,123395162,SRX20140869,INTS10,372
chr1,123394804,123395070,SRX20140881,CPSF3L,266
chr1,123400003,123400264,SRX20140868,INTS10,261
chr1,123400031,123400333,SRX20140894,INTS13,302
chr1,123422759,123423148,SRX20140891,SOX2,389
chr1,123422777,123423166,SRX20140897,INTS13,389
chr1,123422893,123423148,SRX20140894,INTS13,255
chr1,123422895,123423195,SRX20140882,CPSF3L,300
chr1,123422903,123423170,SRX20140860,SOX2,267
chr1,123422909,123423193,SRX20140880,CPSF3L,284
chr1,123422927,123423209,SRX20140895,INTS13,282
chr1,123422955,123423196,SRX20140867,INTS10,241
chr1,123422959,123423179,SRX20140892,SOX2,220
chr1,123433414,123433706,SRX20140895,INTS13,292
chr1,123433438,123433676,SRX20140879,CPSF3L,238
chr1,123446462,123446688,SRX20140867,INTS10,226
chr1,123466784,123467139,SRX9989504,GFP,355
chr1,123466827,123467131,SRX9989505,GFP,304
chr1,123468546,123468927,SRX20140868,INTS10,381
chr1,123468560,123468925,SRX20140895,INTS13,365
chr1,123468685,123468932,SRX20140897,INTS13,247
chr1,123468697,123468937,SRX20140880,CPSF3L,240
chr1,123468712,123468932,SRX20140862,SOX2,220
chr1,123498594,123499024,SRX20140860,SOX2,430
chr1,123498611,123499022,SRX20140897,INTS13,411
chr1,123498616,123498962,SRX20140895,INTS13,346
chr1,123498617,123498904,SRX20140861,SOX2,287
chr1,123498622,123498935,SRX20140868,INTS10,313
chr1,123498646,123498929,SRX20140894,INTS13,283
chr1,123498651,123498964,SRX20140879,CPSF3L,313
chr1,123498653,123498913,SRX20140867,INTS10,260
chr1,123498687,123498906,SRX20140891,SOX2,219
chr1,123510693,123511000,SRX20140895,INTS13,307
chr1,123510728,123511001,SRX20140860,SOX2,273
chr1,123510741,123511076,SRX20140897,INTS13,335
chr1,123510748,123511140,SRX20140882,CPSF3L,392
chr1,123510755,123511119,SRX20140880,CPSF3L,364
chr1,123510770,123511037,SRX20140894,INTS13,267
chr1,123510780,123511127,SRX9989504,GFP,347
chr1,123510783,123511132,SRX9989505,GFP,349
chr1,123510791,123511029,SRX20140891,SOX2,238
chr1,123510819,123511073,SRX20140862,SOX2,254
chr1,123510822,123511053,SRX20140892,SOX2,231
chr1,123519104,123519365,SRX16500061,CTCF,261
chr1,123519105,123519427,SRX16500062,CTCF,322
chr1,123524297,123524724,SRX20140895,INTS13,427
chr1,123524439,123524846,SRX20140897,INTS13,407
chr1,123524455,123524786,SRX20140881,CPSF3L,331
chr1,123524465,123524839,SRX20140860,SOX2,374
chr1,123524469,123524712,SRX20140891,SOX2,243
chr1,123524472,123524726,SRX20140890,SOX2,254
chr1,123524581,123524853,SRX20140894,INTS13,272
chr1,123527857,123528117,SRX20140892,SOX2,260
chr1,123527860,123528117,SRX20140891,SOX2,257
chr1,123527891,123528110,SRX20140862,SOX2,219
chr1,123535494,123535829,SRX20140879,CPSF3L,335
chr1,123535571,123535909,SRX20140895,INTS13,338
chr1,123535577,123535852,SRX20140894,INTS13,275
chr1,123535607,123535863,SRX20140860,SOX2,256
chr1,123535625,123535923,SRX20140891,SOX2,298
chr1,123535655,123535908,SRX20140880,CPSF3L,253
chr1,123535672,123536010,SRX9989504,GFP,338
chr1,123550639,123550960,SRX20140882,CPSF3L,321
chr1,123550646,123550958,SRX20140895,INTS13,312
chr1,123550669,123550942,SRX20140880,CPSF3L,273
chr1,123550672,123550933,SRX20140868,INTS10,261
chr1,123550674,123550925,SRX20140860,SOX2,251
chr1,123550685,123550922,SRX20140891,SOX2,237
chr1,123550685,123550939,SRX20140897,INTS13,254
chr1,123550710,123550922,SRX20140862,SOX2,212
chr1,123555009,123555260,SRX20140879,CPSF3L,251
chr1,123555013,123555247,SRX20140861,SOX2,234
chr1,123555018,123555336,SRX20140895,INTS13,318
chr1,123555022,123555333,SRX20140891,SOX2,311
chr1,123555025,123555285,SRX20140897,INTS13,260
chr1,123555025,123555286,SRX20140868,INTS10,261
chr1,123555038,123555293,SRX20140860,SOX2,255
chr1,123555040,123555367,SRX20140880,CPSF3L,327
chr1,123555079,123555317,SRX20140867,INTS10,238
chr1,123556319,123556606,SRX9989505,GFP,287
chr1,123556327,123556615,SRX9989504,GFP,288
chr1,123558091,123558501,SRX9989505,GFP,410
chr1,123558095,123558515,SRX9989504,GFP,420
chr1,123558142,123558359,SRX20140892,SOX2,217
chr1,123558150,123558364,SRX20140867,INTS10,214
chr1,123558159,123558417,SRX20140879,CPSF3L,258
chr1,123558180,123558434,SRX20140860,SOX2,254
chr1,123558210,123558475,SRX20140895,INTS13,265
chr1,123587755,123588050,SRX20140895,INTS13,295
chr1,123587795,123588044,SRX20140897,INTS13,249
chr1,123587803,123588029,SRX20140861,SOX2,226
chr1,123594860,123595321,SRX20140895,INTS13,461
chr1,123594866,123595323,SRX20140869,INTS10,457
chr1,123597081,123597440,SRX20140860,SOX2,359
chr1,123597088,123597322,SRX20140892,SOX2,234
chr1,123597091,123597357,SRX20140897,INTS13,266
chr1,123597098,123597422,SRX20140868,INTS10,324
chr1,123597100,123597389,SRX20140880,CPSF3L,289
chr1,123597101,123597357,SRX20140895,INTS13,256
chr1,123597108,123597423,SRX20140879,CPSF3L,315
chr1,123597109,123597393,SRX20140882,CPSF3L,284
chr1,123597111,123597358,SRX20140861,SOX2,247
chr1,123597118,123597400,SRX20140890,SOX2,282
chr1,123597119,123597332,SRX20140862,SOX2,213
chr1,123597138,123597354,SRX20140891,SOX2,216
chr1,123597138,123597405,SRX20140869,INTS10,267
chr1,123597163,123597436,SRX20140881,CPSF3L,273
chr1,123608218,123608506,SRX20140891,SOX2,288
chr1,123608239,123608507,SRX20140880,CPSF3L,268
chr1,123615436,123615762,SRX20140880,CPSF3L,326
chr1,123618567,123618879,SRX20140881,CPSF3L,312
chr1,123618571,123618889,SRX20140894,INTS13,318
chr1,123618584,123618892,SRX20140869,INTS10,308
chr1,123618587,123618879,SRX20140895,INTS13,292
chr1,123618588,123618875,SRX20140897,INTS13,287
chr1,123618591,123618856,SRX20140890,SOX2,265
chr1,123618594,123618881,SRX20140860,SOX2,287
chr1,123618601,123618863,SRX20140879,CPSF3L,262
chr1,123618602,123618865,SRX20140861,SOX2,263
chr1,123618606,123618887,SRX20140868,INTS10,281
chr1,123618611,123618875,SRX20140867,INTS10,264
chr1,123635454,123635903,SRX20140890,SOX2,449
chr1,123635466,123635818,SRX16500062,CTCF,352
chr1,123635469,123635692,SRX16500061,CTCF,223
chr1,123635481,123635950,SRX20140895,INTS13,469
chr1,123635489,123635931,SRX20140867,INTS10,442
chr1,123635493,123635949,SRX20140880,CPSF3L,456
chr1,123635496,123635941,SRX20140860,SOX2,445
chr1,123635497,123635915,SRX20140869,INTS10,418
chr1,123635497,123635931,SRX20140861,SOX2,434
chr1,123635499,123635952,SRX20140897,INTS13,453
chr1,123635503,123635916,SRX20140868,INTS10,413
chr1,123635507,123635891,SRX20140881,CPSF3L,384
chr1,123635507,123635904,SRX20140882,CPSF3L,397
chr1,123635512,123635825,SRX16500060,CTCF,313
chr1,123635513,123635895,SRX20140879,CPSF3L,382
chr1,123635516,123635863,SRX20140891,SOX2,347
chr1,123635523,123635899,SRX20140894,INTS13,376
chr1,123635527,123635919,SRX20140870,INTS10,392
chr1,123635559,123635918,SRX20140862,SOX2,359
chr1,123635579,123635831,SRX20140892,SOX2,252
chr1,123635612,123635885,SRX20140896,INTS13,273
chr1,123648165,123648471,SRX16500061,CTCF,306
chr1,123648248,123648485,SRX16500059,CTCF,237
chr1,123648249,123648468,SRX16500062,CTCF,219
chr1,123648304,123648574,SRX20140862,SOX2,270
chr1,123648306,123648600,SRX20140882,CPSF3L,294
chr1,123648317,123648580,SRX20140891,SOX2,263
chr1,123648317,123648730,SRX20140880,CPSF3L,413
chr1,123648330,123648732,SRX20140860,SOX2,402
chr1,123648335,123648870,SRX20140895,INTS13,535
chr1,123648337,123648607,SRX20140869,INTS10,270
chr1,123648338,123648710,SRX20140879,CPSF3L,372
chr1,123648343,123648687,SRX20140897,INTS13,344
chr1,123648369,123648706,SRX20140868,INTS10,337
chr1,123648372,123648732,SRX20140890,SOX2,360
chr1,123648374,123648771,SRX20140861,SOX2,397
chr1,123665159,123665416,SRX20140891,SOX2,257
chr1,123665170,123665412,SRX20140862,SOX2,242
chr1,123665189,123665441,SRX20140897,INTS13,252
chr1,123677255,123677498,SRX20140861,SOX2,243
chr1,123677284,123677557,SRX20140869,INTS10,273
chr1,123677288,123677776,SRX20140895,INTS13,488
chr1,123677295,123677601,SRX20140897,INTS13,306
chr1,123677297,123677589,SRX20140880,CPSF3L,292
chr1,123677301,123677535,SRX20140891,SOX2,234
chr1,123677303,123677754,SRX20140894,INTS13,451
chr1,123677337,123677585,SRX20140879,CPSF3L,248
chr1,123681961,123682176,SRX16500062,CTCF,215
chr1,123687857,123688077,SRX5716470,SMARCA4,220
chr1,123687862,123688233,SRX16500059,CTCF,371
chr1,123687871,123688234,SRX16500060,CTCF,363
chr1,123687873,123688212,SRX16500062,CTCF,339
chr1,123687877,123688219,SRX16500061,CTCF,342
chr1,123687893,123688188,SRX5075182,SMARCA2,295
chr1,123687898,123688218,SRX5716468,SMARCA2,320
chr1,123687900,123688181,SRX5075176,SMARCA4,281
chr1,123687942,123688189,SRX5075175,SMARCA4,247
chr1,123687972,123688201,SRX5020214,SMARCA2,229
chr1,123687982,123688159,SRX5075170,SMARCA4,177
chr1,123688002,123688203,SRX5075181,SMARCA2,201
chr1,123688002,123688262,SRX5716460,Epitope tags,260
chr1,123688006,123688067,SRX5075180,SMARCA2,61
chr1,123688008,123688067,SRX5020208,SMARCA2,59
chr1,123689894,123690256,SRX16500060,CTCF,362
chr1,123689894,123690273,SRX16500059,CTCF,379
chr1,123689905,123690198,SRX5716468,SMARCA2,293
chr1,123689909,123690264,SRX16500061,CTCF,355
chr1,123689917,123690230,SRX5075175,SMARCA4,313
chr1,123689919,123690254,SRX16500062,CTCF,335
chr1,123689921,123690109,SRX5075168,SMARCA4,188
chr1,123689926,123690222,SRX5075182,SMARCA2,296
chr1,123689934,123690229,SRX5075169,SMARCA4,295
chr1,123689967,123690242,SRX5075181,SMARCA2,275
chr1,123690013,123690260,SRX5716467,SMARCA2,247
chr1,123690026,123690249,SRX5020214,SMARCA2,223
chr1,123690027,123690209,SRX5075170,SMARCA4,182
chr1,123690032,123690215,SRX5054309,FOSL2,183
chr1,123690039,123690215,SRX5075176,SMARCA4,176
chr1,123690040,123690108,SRX5020208,SMARCA2,68
chr1,123690041,123690104,SRX5075180,SMARCA2,63
chr1,123692179,123692482,SRX20140882,CPSF3L,303
chr1,123692186,123692472,SRX20140895,INTS13,286
chr1,123692193,123692450,SRX20140880,CPSF3L,257
chr1,123692197,123692451,SRX20140891,SOX2,254
chr1,123692198,123692460,SRX20140897,INTS13,262
chr1,123692202,123692471,SRX20140881,CPSF3L,269
chr1,123692204,123692438,SRX20140892,SOX2,234
chr1,123692208,123692443,SRX20140867,INTS10,235
chr1,123692213,123692427,SRX20140862,SOX2,214
chr1,123694760,123694999,SRX20140879,CPSF3L,239
chr1,123694783,123694994,SRX20140891,SOX2,211
chr1,123699865,123700158,SRX20140880,CPSF3L,293
chr1,123699884,123700213,SRX20140895,INTS13,329
chr1,123699885,123700120,SRX20140879,CPSF3L,235
chr1,123699901,123700152,SRX20140897,INTS13,251
chr1,123699916,123700182,SRX20140860,SOX2,266
chr1,123699923,123700208,SRX20140869,INTS10,285
chr1,123699928,123700182,SRX20140894,INTS13,254
chr1,123707367,123707421,SRX1424893,POU3F2,54
chr1,123712650,123712912,SRX20140894,INTS13,262
chr1,123712676,123712947,SRX20140895,INTS13,271
chr1,123712757,123712976,SRX20140861,SOX2,219
chr1,123714705,123715035,SRX20140879,CPSF3L,330
chr1,123714717,123715004,SRX20140880,CPSF3L,287
chr1,123714718,123715030,SRX20140895,INTS13,312
chr1,123714725,123714983,SRX20140894,INTS13,258
chr1,123714733,123714989,SRX20140860,SOX2,256
chr1,123714734,123714976,SRX20140890,SOX2,242
chr1,123714742,123714995,SRX20140897,INTS13,253
chr1,123714760,123715095,SRX16500062,CTCF,335
chr1,123714766,123714992,SRX16500061,CTCF,226
chr1,123714777,123715006,SRX20140891,SOX2,229
chr1,123714782,123715046,SRX20140867,INTS10,264
chr1,123720122,123720165,SRX1424893,POU3F2,43
chr1,123723059,123723361,SRX9989505,GFP,302
chr1,123742123,123742389,SRX20140868,INTS10,266
chr1,123742128,123742433,SRX20140895,INTS13,305
chr1,123742157,123742434,SRX20140882,CPSF3L,277
chr1,123742198,123742432,SRX20140891,SOX2,234
chr1,123742230,123742456,SRX20140892,SOX2,226
chr1,123743242,123743283,SRX1424891,POU3F2,41
chr1,123743245,123743287,SRX1424892,POU3F2,42
chr1,123751144,123751504,SRX20140880,CPSF3L,360
chr1,123751199,123751467,SRX20140895,INTS13,268
chr1,123753548,123753793,SRX20140879,CPSF3L,245
chr1,123753565,123753811,SRX16500059,CTCF,246
chr1,123753587,123753807,SRX16500061,CTCF,220
chr1,123753592,123753818,SRX16500060,CTCF,226
chr1,123753593,123753870,SRX16500062,CTCF,277
chr1,123760435,123760850,SRX5716459,Epitope tags,415
chr1,123760461,123760810,SRX16500059,CTCF,349
chr1,123760467,123760813,SRX16500060,CTCF,346
chr1,123760468,123760815,SRX16500061,CTCF,347
chr1,123760471,123760832,SRX5716468,SMARCA2,361
chr1,123760476,123760854,SRX5716460,Epitope tags,378
chr1,123760483,123760810,SRX5020214,SMARCA2,327
chr1,123760492,123760863,SRX5716452,SOX2,371
chr1,123760501,123760809,SRX5075169,SMARCA4,308
chr1,123760503,123760796,SRX5075175,SMARCA4,293
chr1,123760503,123760798,SRX5075182,SMARCA2,295
chr1,123760513,123760769,SRX5075176,SMARCA4,256
chr1,123760519,123760692,SRX5075174,SMARCA4,173
chr1,123760521,123760732,SRX5716470,SMARCA4,211
chr1,123760534,123760811,SRX5075181,SMARCA2,277
chr1,123760538,123760791,SRX16500062,CTCF,253
chr1,123760602,123760785,SRX5075170,SMARCA4,183
chr1,123760610,123760685,SRX5020208,SMARCA2,75
chr1,123760620,123760690,SRX5075180,SMARCA2,70
chr1,123760660,123760700,SRX1424891,POU3F2,40
chr1,123763714,123763958,SRX20140897,INTS13,244
chr1,123775318,123775562,SRX20140860,SOX2,244
chr1,123783275,123783826,SRX20140895,INTS13,551
chr1,123783275,123783866,SRX20140891,SOX2,591
chr1,123783287,123783823,SRX20140868,INTS10,536
chr1,123783384,123783783,SRX20140869,INTS10,399
chr1,123783387,123783786,SRX20140894,INTS13,399
chr1,123783387,123783867,SRX20140880,CPSF3L,480
chr1,123783393,123783791,SRX20140879,CPSF3L,398
chr1,123783406,123783832,SRX20140897,INTS13,426
chr1,123783407,123783706,SRX20140870,INTS10,299
chr1,123783408,123783827,SRX20140860,SOX2,419
chr1,123783412,123783804,SRX20140890,SOX2,392
chr1,123783412,123783821,SRX20140861,SOX2,409
chr1,123783414,123783849,SRX20140862,SOX2,435
chr1,123783419,123783841,SRX20140882,CPSF3L,422
chr1,123783422,123783744,SRX20140896,INTS13,322
chr1,123783428,123783764,SRX20140867,INTS10,336
chr1,123783478,123783778,SRX20140881,CPSF3L,300
chr1,123783521,123783870,SRX20140892,SOX2,349
chr1,123783537,123783848,SRX16500060,CTCF,311
chr1,123783539,123783880,SRX16500061,CTCF,341
chr1,123783542,123783855,SRX16500059,CTCF,313
chr1,123783554,123783876,SRX16500062,CTCF,322
chr1,123790212,123790513,SRX20140860,SOX2,301
chr1,123790230,123790501,SRX9989504,GFP,271
chr1,123790241,123790486,SRX20140897,INTS13,245
chr1,123790243,123790557,SRX20140895,INTS13,314
chr1,123790249,123790510,SRX9989505,GFP,261
chr1,123790298,123790538,SRX20140890,SOX2,240
chr1,123794180,123794457,SRX16500059,CTCF,277
chr1,123798371,123798712,SRX9989505,GFP,341
chr1,123798377,123798726,SRX9989504,GFP,349
chr1,123806223,123806430,SRX5075181,SMARCA2,207
chr1,123806224,123806411,SRX5075175,SMARCA4,187
chr1,123806234,123806411,SRX5075176,SMARCA4,177
chr1,123820118,123820466,SRX20140881,CPSF3L,348
chr1,123820118,123820614,SRX20140894,INTS13,496
chr1,123820153,123820688,SRX20140897,INTS13,535
chr1,123820193,123820593,SRX20140860,SOX2,400
chr1,123820216,123820684,SRX20140895,INTS13,468
chr1,123820224,123820472,SRX20140861,SOX2,248
chr1,123820225,123820612,SRX20140880,CPSF3L,387
chr1,123820226,123820472,SRX20140890,SOX2,246
chr1,123820230,123820677,SRX20140869,INTS10,447
chr1,123820231,123820607,SRX20140867,INTS10,376
chr1,123820233,123820591,SRX20140879,CPSF3L,358
chr1,123820233,123820645,SRX20140868,INTS10,412
chr1,123820268,123820581,SRX20140870,INTS10,313
chr1,123820280,123820502,SRX16500061,CTCF,222
chr1,123829797,123830063,SRX20140895,INTS13,266
chr1,123848753,123849161,SRX20140895,INTS13,408
chr1,123848769,123849024,SRX20140894,INTS13,255
chr1,123848771,123849060,SRX20140897,INTS13,289
chr1,123848779,123849067,SRX20140861,SOX2,288
chr1,123848811,123849101,SRX20140860,SOX2,290
chr1,123848813,123849083,SRX20140890,SOX2,270
chr1,123848829,123849115,SRX20140879,CPSF3L,286
chr1,123848839,123849117,SRX20140880,CPSF3L,278
chr1,123859449,123859493,SRX1424891,POU3F2,44
chr1,123859450,123859492,SRX1424892,POU3F2,42
chr1,123872522,123872783,SRX20140897,INTS13,261
chr1,123872541,123872806,SRX20140880,CPSF3L,265
chr1,123872553,123872841,SRX20140891,SOX2,288
chr1,123882649,123882879,SRX20140891,SOX2,230
chr1,123914591,123914934,SRX20140895,INTS13,343
chr1,123914606,123915150,SRX20140869,INTS10,544
chr1,123914659,123914958,SRX20140880,CPSF3L,299
chr1,123914677,123914888,SRX20140891,SOX2,211
chr1,123914679,123914944,SRX20140868,INTS10,265
chr1,123919180,123919608,SRX20140895,INTS13,428
chr1,123926075,123926503,SRX20140879,CPSF3L,428
chr1,123926079,123926564,SRX20140895,INTS13,485
chr1,123926081,123926522,SRX20140868,INTS10,441
chr1,123926084,123926614,SRX20140880,CPSF3L,530
chr1,123926089,123926541,SRX20140894,INTS13,452
chr1,123926090,123926545,SRX20140861,SOX2,455
chr1,123926090,123926553,SRX20140860,SOX2,463
chr1,123926090,123926590,SRX20140882,CPSF3L,500
chr1,123926097,123926540,SRX20140867,INTS10,443
chr1,123926097,123926546,SRX20140890,SOX2,449
chr1,123926097,123926591,SRX20140869,INTS10,494
chr1,123926105,123926599,SRX20140891,SOX2,494
chr1,123926109,123926486,SRX16500059,CTCF,377
chr1,123926113,123926571,SRX20140862,SOX2,458
chr1,123926116,123926482,SRX16500061,CTCF,366
chr1,123926121,123926548,SRX20140897,INTS13,427
chr1,123926123,123926554,SRX20140892,SOX2,431
chr1,123926126,123926524,SRX20140881,CPSF3L,398
chr1,123926127,123926471,SRX16500062,CTCF,344
chr1,123926141,123926479,SRX16500060,CTCF,338
chr1,123926159,123926537,SRX20140896,INTS13,378
chr1,123926169,123926459,SRX20140870,INTS10,290
chr1,123926226,123926395,SRX5075170,SMARCA4,169
chr1,123937658,123937917,SRX20140895,INTS13,259
chr1,123945907,123946196,SRX20140882,CPSF3L,289
chr1,123945917,123946271,SRX20140870,INTS10,354
chr1,123945933,123946282,SRX20140881,CPSF3L,349
chr1,123945933,123946289,SRX20140860,SOX2,356
chr1,123945937,123946366,SRX20140895,INTS13,429
chr1,123945949,123946207,SRX20140892,SOX2,258
chr1,123945952,123946309,SRX20140897,INTS13,357
chr1,123945952,123946338,SRX20140880,CPSF3L,386
chr1,123945969,123946195,SRX16500061,CTCF,226
chr1,123945969,123946269,SRX20140868,INTS10,300
chr1,123945972,123946193,SRX16500060,CTCF,221
chr1,123945974,123946310,SRX20140891,SOX2,336
chr1,123945988,123946299,SRX20140862,SOX2,311
chr1,123945992,123946282,SRX20140869,INTS10,290
chr1,123946064,123946300,SRX20140867,INTS10,236
chr1,123952170,123952212,SRX1424892,POU3F2,42
chr1,123952171,123952211,SRX1424894,POU3F2,40
chr1,123952185,123952458,SRX20140895,INTS13,273
chr1,123952302,123952602,SRX5075175,SMARCA4,300
chr1,123952366,123952585,SRX16500062,CTCF,219
chr1,123959559,123959601,SRX1424891,POU3F2,42
chr1,123962214,123962477,SRX20140880,CPSF3L,263
chr1,123962247,123962514,SRX9989505,GFP,267
chr1,123979860,123980220,SRX9989504,GFP,360
chr1,123979865,123980195,SRX9989505,GFP,330
chr1,123979870,123980130,SRX20140880,CPSF3L,260
chr1,123979906,123980129,SRX20140862,SOX2,223
chr1,123979925,123980276,SRX20140897,INTS13,351
chr1,123979931,123980208,SRX20140860,SOX2,277
chr1,123979946,123980200,SRX20140867,INTS10,254
chr1,123979972,123980303,SRX20140882,CPSF3L,331
chr1,123980036,123980298,SRX20140894,INTS13,262
chr1,123980039,123980310,SRX20140895,INTS13,271
chr1,123985248,123985582,SRX20140869,INTS10,334
chr1,123985258,123985559,SRX20140895,INTS13,301
chr1,123985260,123985532,SRX20140894,INTS13,272
chr1,123985279,123985582,SRX20140880,CPSF3L,303
chr1,123985280,123985534,SRX20140879,CPSF3L,254
chr1,123985283,123985578,SRX20140868,INTS10,295
chr1,123985284,123985575,SRX20140867,INTS10,291
chr1,123985284,123985606,SRX20140897,INTS13,322
chr1,123985289,123985554,SRX20140890,SOX2,265
chr1,123985294,123985577,SRX20140891,SOX2,283
chr1,123985301,123985578,SRX20140860,SOX2,277
chr1,123985308,123985543,SRX20140861,SOX2,235
chr1,123985312,123985542,SRX20140862,SOX2,230
chr1,124005619,124005991,SRX20140880,CPSF3L,372
chr1,124005638,124006022,SRX20140860,SOX2,384
chr1,124005646,124005964,SRX20140891,SOX2,318
chr1,124005650,124005878,SRX16500062,CTCF,228
chr1,124005680,124005996,SRX20140861,SOX2,316
chr1,124005687,124006026,SRX20140894,INTS13,339
chr1,124005696,124005965,SRX20140869,INTS10,269
chr1,124005698,124006021,SRX20140895,INTS13,323
chr1,124005721,124006005,SRX20140890,SOX2,284
chr1,124005728,124005989,SRX20140897,INTS13,261
chr1,124007341,124007552,SRX20140891,SOX2,211
chr1,124012710,124012994,SRX20140897,INTS13,284
chr1,124012721,124012986,SRX20140894,INTS13,265
chr1,124012723,124013159,SRX20140881,CPSF3L,436
chr1,124012731,124012997,SRX20140869,INTS10,266
chr1,124012732,124013212,SRX20140895,INTS13,480
chr1,124012736,124013305,SRX20140880,CPSF3L,569
chr1,124012746,124013004,SRX20140860,SOX2,258
chr1,124012750,124013028,SRX20140867,INTS10,278
chr1,124012757,124013099,SRX20140879,CPSF3L,342
chr1,124012784,124013108,SRX20140890,SOX2,324
chr1,124012799,124013077,SRX20140892,SOX2,278
chr1,124026167,124026412,SRX16500060,CTCF,245
chr1,124026288,124026499,SRX20140891,SOX2,211
chr1,124038392,124038613,SRX16500060,CTCF,221
chr1,124044584,124045031,SRX20140895,INTS13,447
chr1,124044606,124044994,SRX20140882,CPSF3L,388
chr1,124044628,124045035,SRX20140879,CPSF3L,407
chr1,124044674,124045024,SRX20140890,SOX2,350
chr1,124044688,124045021,SRX20140861,SOX2,333
chr1,124044690,124045022,SRX20140894,INTS13,332
chr1,124044693,124045009,SRX20140892,SOX2,316
chr1,124044694,124045032,SRX20140880,CPSF3L,338
chr1,124044695,124045045,SRX20140867,INTS10,350
chr1,124044700,124045025,SRX20140860,SOX2,325
chr1,124044709,124045027,SRX20140897,INTS13,318
chr1,124044721,124045010,SRX20140881,CPSF3L,289
chr1,124044732,124045025,SRX20140868,INTS10,293
chr1,124044736,124045025,SRX20140862,SOX2,289
chr1,124044737,124045007,SRX20140869,INTS10,270
chr1,124044795,124045019,SRX20140891,SOX2,224
chr1,124054566,124054909,SRX9989504,GFP,343
chr1,124054589,124054890,SRX9989505,GFP,301
chr1,124061867,124062136,SRX9989505,GFP,269
chr1,124063842,124064071,SRX5716468,SMARCA2,229
chr1,124064773,124065001,SRX20140867,INTS10,228
chr1,124064783,124065064,SRX20140895,INTS13,281
chr1,124064785,124065075,SRX20140869,INTS10,290
chr1,124064791,124065048,SRX20140897,INTS13,257
chr1,124064808,124065084,SRX20140860,SOX2,276
chr1,124069127,124069405,SRX9989504,GFP,278
chr1,124083273,124083494,SRX16500060,CTCF,221
chr1,124083305,124083612,SRX20140868,INTS10,307
chr1,124084352,124084625,SRX9989504,GFP,273
chr1,124084358,124084618,SRX9989505,GFP,260
chr1,124090542,124090582,SRX1424891,POU3F2,40
chr1,124098653,124099112,SRX20140894,INTS13,459
chr1,124098655,124099119,SRX20140897,INTS13,464
chr1,124098672,124099110,SRX20140895,INTS13,438
chr1,124098673,124099123,SRX20140880,CPSF3L,450
chr1,124098697,124099102,SRX20140869,INTS10,405
chr1,124098704,124099105,SRX20140861,SOX2,401
chr1,124098709,124099086,SRX20140882,CPSF3L,377
chr1,124098712,124099087,SRX20140868,INTS10,375
chr1,124098716,124099133,SRX20140879,CPSF3L,417
chr1,124098718,124099076,SRX20140881,CPSF3L,358
chr1,124098725,124099105,SRX20140860,SOX2,380
chr1,124098728,124099117,SRX20140890,SOX2,389
chr1,124098747,124099121,SRX20140862,SOX2,374
chr1,124098753,124099109,SRX20140891,SOX2,356
chr1,124098753,124099224,SRX16500059,CTCF,471
chr1,124098754,124099057,SRX20140896,INTS13,303
chr1,124098756,124099229,SRX5716455,SOX3,473
chr1,124098775,124099211,SRX16500060,CTCF,436
chr1,124098780,124099059,SRX20140892,SOX2,279
chr1,124098782,124099245,SRX5716460,Epitope tags,463
chr1,124098783,124099133,SRX20140867,INTS10,350
chr1,124098783,124099214,SRX16500061,CTCF,431
chr1,124098789,124099208,SRX16500062,CTCF,419
chr1,124098790,124099233,SRX5716459,Epitope tags,443
chr1,124098793,124099247,SRX5716452,SOX2,454
chr1,124098802,124099210,SRX5716468,SMARCA2,408
chr1,124098820,124099164,SRX5716453,SOX2,344
chr1,124098821,124099209,SRX5716467,SMARCA2,388
chr1,124098822,124099172,SRX5075182,SMARCA2,350
chr1,124098831,124099197,SRX5020214,SMARCA2,366
chr1,124098834,124099192,SRX5716469,SMARCA4,358
chr1,124098837,124099078,SRX5716454,SOX3,241
chr1,124098839,124099162,SRX5075169,SMARCA4,323
chr1,124098843,124099194,SRX5075181,SMARCA2,351
chr1,124098844,124099145,SRX5716470,SMARCA4,301
chr1,124098845,124099190,SRX5075175,SMARCA4,345
chr1,124098850,124099113,SRX5716464,SMARCA4,263
chr1,124098851,124099131,SRX5020211,SMARCA2,280
chr1,124098856,124099132,SRX5716451,SOX2,276
chr1,124098857,124099167,SRX5075168,SMARCA4,310
chr1,124098865,124099164,SRX5075176,SMARCA4,299
chr1,124098866,124099118,SRX5054309,FOSL2,252
chr1,124098866,124099159,SRX5075170,SMARCA4,293
chr1,124098868,124099133,SRX5075174,SMARCA4,265
chr1,124098883,124099172,SRX5054307,FOSL2,289
chr1,124098930,124099059,SRX5020208,SMARCA2,129
chr1,124098930,124099059,SRX5075180,SMARCA2,129
chr1,124101791,124101979,SRX5075175,SMARCA4,188
chr1,124101819,124102081,SRX5075176,SMARCA4,262
chr1,124101882,124102099,SRX16500062,CTCF,217
chr1,124101915,124101973,SRX5075180,SMARCA2,58
chr1,124101918,124101970,SRX5020208,SMARCA2,52
chr1,124119263,124119635,SRX20140894,INTS13,372
chr1,124119317,124119681,SRX20140880,CPSF3L,364
chr1,124119329,124119667,SRX20140897,INTS13,338
chr1,124119332,124119651,SRX20140861,SOX2,319
chr1,124119391,124119699,SRX20140895,INTS13,308
chr1,124119411,124119650,SRX20140879,CPSF3L,239
chr1,124119412,124119662,SRX20140860,SOX2,250
chr1,124132741,124132985,SRX20140880,CPSF3L,244
chr1,124132766,124132978,SRX20140891,SOX2,212
chr1,124144729,124144771,SRX1424894,POU3F2,42
chr1,124146741,124146985,SRX16500061,CTCF,244
chr1,124146753,124146993,SRX16500059,CTCF,240
chr1,124168074,124168431,SRX20140880,CPSF3L,357
chr1,124168082,124168409,SRX20140895,INTS13,327
chr1,124168089,124168362,SRX20140892,SOX2,273
chr1,124168089,124168376,SRX20140891,SOX2,287
chr1,124168096,124168416,SRX20140862,SOX2,320
chr1,124168098,124168429,SRX20140882,CPSF3L,331
chr1,124168110,124168417,SRX20140897,INTS13,307
chr1,124168122,124168390,SRX20140879,CPSF3L,268
chr1,124168122,124168396,SRX20140867,INTS10,274
chr1,124168141,124168398,SRX20140860,SOX2,257
chr1,124168149,124168410,SRX20140881,CPSF3L,261
chr1,124168151,124168467,SRX20140894,INTS13,316
chr1,124168163,124168438,SRX20140868,INTS10,275
chr1,124173296,124173581,SRX20140880,CPSF3L,285
chr1,124189670,124189990,SRX20140881,CPSF3L,320
chr1,124189689,124189952,SRX20140895,INTS13,263
chr1,124189699,124189971,SRX20140880,CPSF3L,272
chr1,124189701,124190011,SRX20140868,INTS10,310
chr1,124189735,124190028,SRX20140860,SOX2,293
chr1,124197835,124198138,SRX20140879,CPSF3L,303
chr1,124210942,124211199,SRX9989505,GFP,257
chr1,124225240,124225490,SRX16500062,CTCF,250
chr1,124225255,124225483,SRX16500061,CTCF,228
chr1,124228294,124228745,SRX20140895,INTS13,451
chr1,124228394,124228733,SRX20140897,INTS13,339
chr1,124228432,124228738,SRX20140869,INTS10,306
chr1,124228435,124228743,SRX20140881,CPSF3L,308
chr1,124228443,124228726,SRX20140894,INTS13,283
chr1,124228446,124228723,SRX20140868,INTS10,277
chr1,124228447,124228727,SRX20140860,SOX2,280
chr1,124228459,124228714,SRX20140890,SOX2,255
chr1,124228463,124228702,SRX20140891,SOX2,239
chr1,124228463,124228731,SRX20140880,CPSF3L,268
chr1,124228469,124228704,SRX20140861,SOX2,235
chr1,124228469,124228723,SRX20140879,CPSF3L,254
chr1,124228487,124228706,SRX20140867,INTS10,219
chr1,124237553,124237835,SRX9989504,GFP,282
chr1,124237563,124237841,SRX9989505,GFP,278
chr1,124250639,124251063,SRX20140880,CPSF3L,424
chr1,124250645,124251028,SRX20140891,SOX2,383
chr1,124250648,124251090,SRX20140897,INTS13,442
chr1,124250650,124251009,SRX20140862,SOX2,359
chr1,124250651,124251006,SRX20140892,SOX2,355
chr1,124250651,124251034,SRX20140867,INTS10,383
chr1,124250655,124251052,SRX20140860,SOX2,397
chr1,124250656,124251017,SRX20140894,INTS13,361
chr1,124250663,124250967,SRX20140879,CPSF3L,304
chr1,124250663,124250992,SRX20140882,CPSF3L,329
chr1,124250671,124251071,SRX20140861,SOX2,400
chr1,124250675,124251068,SRX20140868,INTS10,393
chr1,124250677,124251091,SRX20140895,INTS13,414
chr1,124250690,124251052,SRX20140869,INTS10,362
chr1,124250691,124251027,SRX20140890,SOX2,336
chr1,124250705,124251061,SRX20140881,CPSF3L,356
chr1,124250713,124251003,SRX20140870,INTS10,290
chr1,124262717,124262978,SRX9989505,GFP,261
chr1,124290540,124290874,SRX9989505,GFP,334
chr1,124290562,124290820,SRX9989504,GFP,258
chr1,124306496,124306851,SRX20140895,INTS13,355
chr1,124306505,124306791,SRX20140869,INTS10,286
chr1,124306505,124306797,SRX20140879,CPSF3L,292
chr1,124306536,124306814,SRX20140867,INTS10,278
chr1,124306546,124306792,SRX20140861,SOX2,246
chr1,124306549,124306796,SRX20140894,INTS13,247
chr1,124306568,124306844,SRX20140890,SOX2,276
chr1,124309612,124309895,SRX9989505,GFP,283
chr1,124309623,124309905,SRX9989504,GFP,282
chr1,124309643,124309890,SRX20140880,CPSF3L,247
chr1,124315862,124316081,SRX16500061,CTCF,219
chr1,124315867,124316081,SRX16500062,CTCF,214
chr1,124318088,124318376,SRX9989505,GFP,288
chr1,124318109,124318365,SRX20140897,INTS13,256
chr1,124318116,124318372,SRX20140890,SOX2,256
chr1,124318120,124318380,SRX9989504,GFP,260
chr1,124318122,124318423,SRX20140895,INTS13,301
chr1,124318132,124318390,SRX20140860,SOX2,258
chr1,124320835,124321082,SRX20140897,INTS13,247
chr1,124341407,124341800,SRX20140895,INTS13,393
chr1,124341461,124341807,SRX20140869,INTS10,346
chr1,124341475,124341720,SRX20140879,CPSF3L,245
chr1,124341497,124341764,SRX20140890,SOX2,267
chr1,124341531,124341792,SRX20140868,INTS10,261
chr1,124341540,124341839,SRX20140897,INTS13,299
chr1,124341551,124341832,SRX20140882,CPSF3L,281
chr1,124344572,124344817,SRX20140880,CPSF3L,245
chr1,124344636,124345023,SRX16500059,CTCF,387
chr1,124344639,124345009,SRX16500060,CTCF,370
chr1,124344645,124345011,SRX16500061,CTCF,366
chr1,124344651,124344995,SRX16500062,CTCF,344
chr1,124344660,124345003,SRX5716468,SMARCA2,343
chr1,124344667,124344925,SRX5075181,SMARCA2,258
chr1,124344674,124344965,SRX5075182,SMARCA2,291
chr1,124344676,124344954,SRX5075175,SMARCA4,278
chr1,124344682,124344964,SRX5075176,SMARCA4,282
chr1,124344693,124344911,SRX5075170,SMARCA4,218
chr1,124344718,124344923,SRX5020214,SMARCA2,205
chr1,124344787,124344967,SRX5075169,SMARCA4,180
chr1,124344791,124344855,SRX5020208,SMARCA2,64
chr1,124344798,124344850,SRX5075180,SMARCA2,52
chr1,124355559,124355800,SRX20140880,CPSF3L,241
chr1,124369997,124370317,SRX9989505,GFP,320
chr1,124370015,124370320,SRX9989504,GFP,305
chr1,124373317,124373357,SRX1424891,POU3F2,40
chr1,124377055,124377463,SRX20140881,CPSF3L,408
chr1,124377056,124377415,SRX16500059,CTCF,359
chr1,124377059,124377421,SRX16500061,CTCF,362
chr1,124377063,124377418,SRX16500060,CTCF,355
chr1,124377071,124377410,SRX16500062,CTCF,339
chr1,124377096,124377456,SRX20140880,CPSF3L,360
chr1,124377098,124377479,SRX20140882,CPSF3L,381
chr1,124377109,124377456,SRX9989505,GFP,347
chr1,124377111,124377465,SRX9989504,GFP,354
chr1,124377112,124377467,SRX20140896,INTS13,355
chr1,124377113,124377477,SRX20140869,INTS10,364
chr1,124377114,124377471,SRX20140868,INTS10,357
chr1,124377114,124377486,SRX20140895,INTS13,372
chr1,124377121,124377483,SRX20140860,SOX2,362
chr1,124377125,124377481,SRX20140894,INTS13,356
chr1,124377127,124377492,SRX20140897,INTS13,365
chr1,124377130,124377458,SRX20140891,SOX2,328
chr1,124377135,124377427,SRX20140892,SOX2,292
chr1,124377139,124377412,SRX20140867,INTS10,273
chr1,124377139,124377447,SRX20140890,SOX2,308
chr1,124377145,124377450,SRX20140879,CPSF3L,305
chr1,124377174,124377452,SRX20140861,SOX2,278
chr1,124377177,124377442,SRX20140862,SOX2,265
chr1,124377184,124377479,SRX20140870,INTS10,295
chr1,124377203,124377262,SRX5075180,SMARCA2,59
chr1,124397163,124397479,SRX9989505,GFP,316
chr1,124397184,124397502,SRX9989504,GFP,318
chr1,124400322,124400649,SRX20140895,INTS13,327
chr1,124400339,124400588,SRX20140894,INTS13,249
chr1,124400356,124400679,SRX20140891,SOX2,323
chr1,124400362,124400601,SRX20140879,CPSF3L,239
chr1,124402492,124402769,SRX9989504,GFP,277
chr1,124406495,124406790,SRX16500061,CTCF,295
chr1,124420757,124421174,SRX20140891,SOX2,417
chr1,124420757,124421175,SRX20140868,INTS10,418
chr1,124420770,124421168,SRX20140882,CPSF3L,398
chr1,124420775,124421169,SRX20140890,SOX2,394
chr1,124420780,124421172,SRX20140860,SOX2,392
chr1,124420782,124421173,SRX20140897,INTS13,391
chr1,124420783,124421180,SRX20140879,CPSF3L,397
chr1,124420789,124421153,SRX20140869,INTS10,364
chr1,124420795,124421168,SRX20140881,CPSF3L,373
chr1,124420795,124421180,SRX20140880,CPSF3L,385
chr1,124420797,124421189,SRX20140895,INTS13,392
chr1,124420804,124421179,SRX20140894,INTS13,375
chr1,124420819,124421175,SRX20140867,INTS10,356
chr1,124420819,124421183,SRX20140861,SOX2,364
chr1,124420822,124421097,SRX20140896,INTS13,275
chr1,124420832,124421151,SRX20140870,INTS10,319
chr1,124420852,124421188,SRX9989505,GFP,336
chr1,124420882,124421171,SRX20140892,SOX2,289
chr1,124420886,124421185,SRX9989504,GFP,299
chr1,124420915,124421165,SRX20140862,SOX2,250
chr1,124420940,124421241,SRX16500061,CTCF,301
chr1,124437210,124437536,SRX9989504,GFP,326
chr1,124437220,124437536,SRX9989505,GFP,316
chr1,124438190,124438459,SRX9989505,GFP,269
chr1,124446191,124446651,SRX20140860,SOX2,460
chr1,124446222,124446628,SRX20140892,SOX2,406
chr1,124446225,124446769,SRX20140880,CPSF3L,544
chr1,124446248,124446524,SRX9989504,GFP,276
chr1,124446266,124446774,SRX20140869,INTS10,508
chr1,124446278,124446775,SRX20140895,INTS13,497
chr1,124446284,124446590,SRX20140891,SOX2,306
chr1,124446289,124446639,SRX20140894,INTS13,350
chr1,124446300,124446589,SRX20140882,CPSF3L,289
chr1,124446302,124446713,SRX20140868,INTS10,411
chr1,124446317,124446735,SRX20140861,SOX2,418
chr1,124446338,124446548,SRX16500062,CTCF,210
chr1,124446357,124446785,SRX20140881,CPSF3L,428
chr1,124446381,124446743,SRX20140879,CPSF3L,362
chr1,124446389,124446661,SRX20140862,SOX2,272
chr1,124446395,124446646,SRX20140897,INTS13,251
chr1,124446415,124446693,SRX20140890,SOX2,278
chr1,124450824,124451049,SRX16500060,CTCF,225
chr1,124450839,124450881,SRX1424893,POU3F2,42
chr1,124454359,124454662,SRX20140869,INTS10,303
chr1,124454359,124454671,SRX20140881,CPSF3L,312
chr1,124454365,124454628,SRX20140880,CPSF3L,263
chr1,124454370,124454584,SRX20140892,SOX2,214
chr1,124454409,124454644,SRX20140879,CPSF3L,235
chr1,124454848,124455243,SRX20140895,INTS13,395
chr1,124454854,124455122,SRX20140880,CPSF3L,268
chr1,124454894,124455175,SRX20140867,INTS10,281
chr1,124454897,124455114,SRX20140892,SOX2,217
chr1,124454906,124455160,SRX20140862,SOX2,254
chr1,124456435,124456662,SRX16500061,CTCF,227
chr1,124456584,124456626,SRX1424893,POU3F2,42
chr1,124456590,124456632,SRX1424894,POU3F2,42
chr1,124475780,124476076,SRX20140882,CPSF3L,296
chr1,124475791,124476055,SRX20140895,INTS13,264
chr1,124475797,124476078,SRX20140869,INTS10,281
chr1,124475805,124476090,SRX20140880,CPSF3L,285
chr1,124485965,124486260,SRX16500060,CTCF,295
chr1,124486033,124486267,SRX16500062,CTCF,234
chr1,124490895,124491127,SRX20140891,SOX2,232
chr1,124499113,124499456,SRX9989504,GFP,343
chr1,124499124,124499436,SRX9989505,GFP,312
chr1,124507570,124507863,SRX20140895,INTS13,293
chr1,124507587,124507848,SRX20140879,CPSF3L,261
chr1,124507603,124507864,SRX20140880,CPSF3L,261
chr1,124507626,124507915,SRX20140894,INTS13,289
chr1,124507630,124507877,SRX20140861,SOX2,247
chr1,124507639,124507949,SRX20140897,INTS13,310
chr1,124513934,124514319,SRX20140895,INTS13,385
chr1,124513980,124514297,SRX20140869,INTS10,317
chr1,124514003,124514301,SRX20140897,INTS13,298
chr1,124514003,124514311,SRX20140894,INTS13,308
chr1,124514007,124514333,SRX20140882,CPSF3L,326
chr1,124514012,124514285,SRX20140896,INTS13,273
chr1,124514012,124514396,SRX16500061,CTCF,384
chr1,124514017,124514294,SRX20140890,SOX2,277
chr1,124514018,124514413,SRX16500059,CTCF,395
chr1,124514020,124514343,SRX20140880,CPSF3L,323
chr1,124514022,124514296,SRX20140868,INTS10,274
chr1,124514022,124514397,SRX16500060,CTCF,375
chr1,124514023,124514311,SRX20140891,SOX2,288
chr1,124514025,124514387,SRX16500062,CTCF,362
chr1,124514030,124514292,SRX20140881,CPSF3L,262
chr1,124514031,124514331,SRX20140879,CPSF3L,300
chr1,124514036,124514319,SRX20140860,SOX2,283
chr1,124514041,124514324,SRX20140867,INTS10,283
chr1,124514049,124514283,SRX5716468,SMARCA2,234
chr1,124514050,124514296,SRX20140861,SOX2,246
chr1,124514063,124514294,SRX20140892,SOX2,231
chr1,124514069,124514323,SRX5075182,SMARCA2,254
chr1,124514094,124514315,SRX20140862,SOX2,221
chr1,124514100,124514310,SRX5075175,SMARCA4,210
chr1,124514192,124514249,SRX5075180,SMARCA2,57
chr1,124518832,124519120,SRX9989504,GFP,288
chr1,124531297,124531602,SRX9989505,GFP,305
chr1,124531303,124531593,SRX9989504,GFP,290
chr1,124533241,124533452,SRX20140891,SOX2,211
chr1,124534410,124534675,SRX20140891,SOX2,265
chr1,124538507,124538840,SRX20140895,INTS13,333
chr1,124538513,124538777,SRX20140880,CPSF3L,264
chr1,124538535,124538817,SRX20140890,SOX2,282
chr1,124538594,124538835,SRX20140879,CPSF3L,241
chr1,124545657,124545954,SRX9989504,GFP,297
chr1,124545671,124545947,SRX9989505,GFP,276
chr1,124549658,124550021,SRX16500061,CTCF,363
chr1,124549717,124550022,SRX16500060,CTCF,305
chr1,124549730,124549991,SRX16500062,CTCF,261
chr1,124549797,124549894,SRX5075180,SMARCA2,97
chr1,124549861,124550110,SRX20140894,INTS13,249
chr1,124549864,124550124,SRX20140895,INTS13,260
chr1,124562005,124562267,SRX9989504,GFP,262
chr1,124562016,124562296,SRX9989505,GFP,280
chr1,124562050,124562558,SRX20140891,SOX2,508
chr1,124562060,124562535,SRX20140867,INTS10,475
chr1,124562073,124562520,SRX20140862,SOX2,447
chr1,124562098,124562500,SRX20140895,INTS13,402
chr1,124562110,124562539,SRX20140880,CPSF3L,429
chr1,124562135,124562482,SRX20140861,SOX2,347
chr1,124562136,124562490,SRX20140890,SOX2,354
chr1,124562167,124562504,SRX20140894,INTS13,337
chr1,124562175,124562528,SRX20140881,CPSF3L,353
chr1,124562190,124562520,SRX20140869,INTS10,330
chr1,124562237,124562520,SRX20140860,SOX2,283
chr1,124562237,124562530,SRX20140897,INTS13,293
chr1,124562243,124562523,SRX20140868,INTS10,280
chr1,124562269,124562512,SRX16500060,CTCF,243
chr1,124562271,124562516,SRX16500061,CTCF,245
chr1,124562309,124562539,SRX20140892,SOX2,230
chr1,124562433,124562485,SRX5075180,SMARCA2,52
chr1,124567517,124567737,SRX20140891,SOX2,220
chr1,124568386,124568655,SRX9989504,GFP,269
chr1,124568395,124568668,SRX20140894,INTS13,273
chr1,124568419,124568677,SRX20140895,INTS13,258
chr1,124570223,124570586,SRX9989505,GFP,363
chr1,124570232,124570510,SRX9989504,GFP,278
chr1,124575260,124575516,SRX20140895,INTS13,256
chr1,124579393,124579670,SRX20140895,INTS13,277
chr1,124579413,124579655,SRX20140860,SOX2,242
chr1,124580599,124580994,SRX16500059,CTCF,395
chr1,124580606,124580976,SRX16500060,CTCF,370
chr1,124580608,124580972,SRX16500061,CTCF,364
chr1,124580616,124580967,SRX16500062,CTCF,351
chr1,124580672,124580946,SRX5075182,SMARCA2,274
chr1,124580751,124580938,SRX5075175,SMARCA4,187
chr1,124580761,124580981,SRX5716468,SMARCA2,220
chr1,124580762,124581011,SRX5716459,Epitope tags,249
chr1,124580768,124580831,SRX5075180,SMARCA2,63
chr1,124580770,124580841,SRX5020208,SMARCA2,71
chr1,124597019,124597298,SRX9989504,GFP,279
chr1,124597023,124597279,SRX9989505,GFP,256
chr1,124602865,124603157,SRX9989505,GFP,292
chr1,124602881,124603243,SRX9989504,GFP,362
chr1,124602932,124603272,SRX20140892,SOX2,340
chr1,124602962,124603237,SRX20140894,INTS13,275
chr1,124602968,124603268,SRX20140891,SOX2,300
chr1,124602974,124603330,SRX20140869,INTS10,356
chr1,124602976,124603384,SRX20140880,CPSF3L,408
chr1,124602982,124603256,SRX20140881,CPSF3L,274
chr1,124602983,124603255,SRX20140879,CPSF3L,272
chr1,124602991,124603280,SRX20140890,SOX2,289
chr1,124602995,124603277,SRX20140897,INTS13,282
chr1,124602998,124603265,SRX20140860,SOX2,267
chr1,124603014,124603269,SRX20140861,SOX2,255
chr1,124603019,124603300,SRX20140895,INTS13,281
chr1,124603023,124603277,SRX20140867,INTS10,254
chr1,124603024,124603329,SRX20140882,CPSF3L,305
chr1,124603026,124603271,SRX20140862,SOX2,245
chr1,124603626,124603952,SRX20140880,CPSF3L,326
chr1,124603703,124604001,SRX20140894,INTS13,298
chr1,124603722,124604016,SRX20140895,INTS13,294
chr1,124603728,124603994,SRX20140868,INTS10,266
chr1,124603744,124604021,SRX20140890,SOX2,277
chr1,124613177,124613442,SRX20140881,CPSF3L,265
chr1,124613203,124613474,SRX20140895,INTS13,271
chr1,124613222,124613505,SRX20140869,INTS10,283
chr1,124613227,124613447,SRX20140891,SOX2,220
chr1,124613245,124613516,SRX9989504,GFP,271
chr1,124615041,124615254,SRX16500062,CTCF,213
chr1,124615090,124615334,SRX20140897,INTS13,244
chr1,124617211,124617600,SRX20140895,INTS13,389
chr1,124617225,124617601,SRX20140882,CPSF3L,376
chr1,124617239,124617601,SRX20140869,INTS10,362
chr1,124617268,124617614,SRX20140880,CPSF3L,346
chr1,124617277,124617598,SRX20140897,INTS13,321
chr1,124617288,124617609,SRX20140891,SOX2,321
chr1,124617290,124617602,SRX20140861,SOX2,312
chr1,124617293,124617593,SRX20140862,SOX2,300
chr1,124617297,124617604,SRX20140890,SOX2,307
chr1,124617298,124617568,SRX20140892,SOX2,270
chr1,124617311,124617612,SRX20140894,INTS13,301
chr1,124617313,124617613,SRX20140860,SOX2,300
chr1,124617315,124617598,SRX20140879,CPSF3L,283
chr1,124617315,124617614,SRX20140868,INTS10,299
chr1,124617330,124617617,SRX20140867,INTS10,287
chr1,124623143,124623449,SRX20140862,SOX2,306
chr1,124623156,124623538,SRX20140895,INTS13,382
chr1,124623165,124623443,SRX20140860,SOX2,278
chr1,124623165,124623481,SRX20140890,SOX2,316
chr1,124623193,124623513,SRX20140880,CPSF3L,320
chr1,124623196,124623524,SRX20140894,INTS13,328
chr1,124623219,124623481,SRX20140897,INTS13,262
chr1,124623223,124623486,SRX20140879,CPSF3L,263
chr1,124623232,124623485,SRX20140891,SOX2,253
chr1,124631366,124631623,SRX9989505,GFP,257
chr1,124631385,124631652,SRX20140862,SOX2,267
chr1,124631392,124631644,SRX20140892,SOX2,252
chr1,124631394,124631649,SRX20140880,CPSF3L,255
chr1,124642240,124642540,SRX9989504,GFP,300
chr1,124642269,124642556,SRX9989505,GFP,287
chr1,124648617,124648901,SRX20140895,INTS13,284
chr1,124659856,124660150,SRX9989505,GFP,294
chr1,124659857,124660162,SRX9989504,GFP,305
chr1,124671810,124672265,SRX20140897,INTS13,455
chr1,124673033,124673392,SRX9989504,GFP,359
chr1,124673038,124673393,SRX9989505,GFP,355
chr1,124686301,124686706,SRX20140895,INTS13,405
chr1,124686316,124686578,SRX9989504,GFP,262
chr1,124686316,124686580,SRX9989505,GFP,264
chr1,124686337,124686685,SRX20140880,CPSF3L,348
chr1,124686347,124686696,SRX20140897,INTS13,349
chr1,124686348,124686678,SRX20140882,CPSF3L,330
chr1,124686349,124686632,SRX20140861,SOX2,283
chr1,124686365,124686691,SRX20140867,INTS10,326
chr1,124686369,124686681,SRX20140891,SOX2,312
chr1,124686376,124686677,SRX20140868,INTS10,301
chr1,124686384,124686685,SRX20140890,SOX2,301
chr1,124686412,124686683,SRX20140860,SOX2,271
chr1,124686444,124686706,SRX20140892,SOX2,262
chr1,124686445,124686696,SRX20140894,INTS13,251
chr1,124686445,124686706,SRX20140881,CPSF3L,261
chr1,124700384,124700619,SRX16500059,CTCF,235
chr1,124700392,124700635,SRX16500061,CTCF,243
chr1,124700409,124700637,SRX16500060,CTCF,228
chr1,124705785,124706041,SRX20140895,INTS13,256
chr1,124705815,124706057,SRX20140860,SOX2,242
chr1,124714690,124715129,SRX9989505,GFP,439
chr1,124714723,124715133,SRX9989504,GFP,410
chr1,124714781,124715045,SRX20140880,CPSF3L,264
chr1,124714806,124715062,SRX20140894,INTS13,256
chr1,124714808,124715072,SRX20140895,INTS13,264
chr1,124714821,124715079,SRX20140879,CPSF3L,258
chr1,124714865,124715086,SRX20140892,SOX2,221
chr1,124721823,124722060,SRX20140861,SOX2,237
chr1,124724984,124725257,SRX20140897,INTS13,273
chr1,124730954,124731240,SRX5075176,SMARCA4,286
chr1,124730954,124731245,SRX5075182,SMARCA2,291
chr1,124730960,124731231,SRX5075170,SMARCA4,271
chr1,124731029,124731279,SRX5716468,SMARCA2,250
chr1,124731049,124731253,SRX5075175,SMARCA4,204
chr1,124731060,124731274,SRX5020214,SMARCA2,214
chr1,124731061,124731246,SRX5054307,FOSL2,185
chr1,124731061,124731284,SRX5716467,SMARCA2,223
chr1,124731063,124731313,SRX5716459,Epitope tags,250
chr1,124731064,124731328,SRX5716460,Epitope tags,264
chr1,124731065,124731263,SRX5075181,SMARCA2,198
chr1,124731067,124731336,SRX5716452,SOX2,269
chr1,124731068,124731128,SRX5075180,SMARCA2,60
chr1,124731069,124731125,SRX5020208,SMARCA2,56
chr1,124732215,124732501,SRX9989504,GFP,286
chr1,124732233,124732521,SRX9989505,GFP,288
chr1,124737074,124737347,SRX20140868,INTS10,273
chr1,124737085,124737353,SRX20140869,INTS10,268
chr1,124737087,124737371,SRX20140895,INTS13,284
chr1,124737121,124737346,SRX20140891,SOX2,225
chr1,124740207,124740479,SRX9989504,GFP,272
chr1,124740220,124740478,SRX9989505,GFP,258
chr1,124741180,124741513,SRX20140881,CPSF3L,333
chr1,124741182,124741516,SRX20140869,INTS10,334
chr1,124741194,124741519,SRX20140895,INTS13,325
chr1,124741198,124741500,SRX20140894,INTS13,302
chr1,124741203,124741537,SRX20140897,INTS13,334
chr1,124741209,124741530,SRX20140880,CPSF3L,321
chr1,124741216,124741500,SRX20140860,SOX2,284
chr1,124741218,124741497,SRX20140879,CPSF3L,279
chr1,124741227,124741487,SRX20140861,SOX2,260
chr1,124741240,124741601,SRX16500059,CTCF,361
chr1,124741241,124741540,SRX20140892,SOX2,299
chr1,124741242,124741592,SRX16500061,CTCF,350
chr1,124741247,124741604,SRX16500060,CTCF,357
chr1,124741248,124741541,SRX20140862,SOX2,293
chr1,124741251,124741515,SRX20140890,SOX2,264
chr1,124741255,124741559,SRX20140891,SOX2,304
chr1,124741259,124741588,SRX16500062,CTCF,329
chr1,124741261,124741566,SRX20140867,INTS10,305
chr1,124741280,124741453,SRX5075174,SMARCA4,173
chr1,124741296,124741578,SRX9989504,GFP,282
chr1,124741396,124741453,SRX5075180,SMARCA2,57
chr1,124745471,124745768,SRX9989505,GFP,297
chr1,124745485,124745769,SRX9989504,GFP,284
chr1,124757512,124757874,SRX20140895,INTS13,362
chr1,124757523,124757910,SRX9989504,GFP,387
chr1,124757525,124757876,SRX9989505,GFP,351
chr1,124757532,124757911,SRX20140897,INTS13,379
chr1,124757537,124757928,SRX20140880,CPSF3L,391
chr1,124757540,124757922,SRX20140869,INTS10,382
chr1,124757543,124757922,SRX16500059,CTCF,379
chr1,124757546,124757861,SRX20140881,CPSF3L,315
chr1,124757553,124757903,SRX20140867,INTS10,350
chr1,124757556,124757791,SRX16500061,CTCF,235
chr1,124757556,124757887,SRX20140868,INTS10,331
chr1,124757556,124757899,SRX16500060,CTCF,343
chr1,124757557,124757855,SRX20140860,SOX2,298
chr1,124757558,124757914,SRX20140891,SOX2,356
chr1,124757564,124757895,SRX16500062,CTCF,331
chr1,124757571,124757879,SRX20140862,SOX2,308
chr1,124757572,124757894,SRX20140861,SOX2,322
chr1,124757573,124757923,SRX20140892,SOX2,350
chr1,124757593,124757858,SRX20140890,SOX2,265
chr1,124757596,124757882,SRX20140879,CPSF3L,286
chr1,124757600,124757886,SRX20140894,INTS13,286
chr1,124757702,124757881,SRX5075176,SMARCA4,179
chr1,124757708,124757763,SRX5075180,SMARCA2,55
chr1,124757709,124757762,SRX5020208,SMARCA2,53
chr1,124763784,124764095,SRX9989505,GFP,311
chr1,124763785,124764109,SRX9989504,GFP,324
chr1,124770895,124771155,SRX9989504,GFP,260
chr1,124770932,124771150,SRX20140892,SOX2,218
chr1,124770948,124771167,SRX20140867,INTS10,219
chr1,124774829,124775144,SRX9989505,GFP,315
chr1,124774839,124775100,SRX9989504,GFP,261
chr1,124778045,124778316,SRX9989505,GFP,271
chr1,124778053,124778332,SRX9989504,GFP,279
chr1,124782071,124782294,SRX16500061,CTCF,223
chr1,124784050,124784325,SRX9989504,GFP,275
chr1,124784052,124784307,SRX9989505,GFP,255
chr1,124923336,124923378,SRX1424894,POU3F2,42
chr1,125069317,125069661,SRX16500062,CTCF,344
chr1,125069352,125069690,SRX16500059,CTCF,338
chr1,125069353,125069673,SRX16500061,CTCF,320
chr1,125069441,125069659,SRX5020214,SMARCA2,218
chr1,125069461,125069516,SRX5020208,SMARCA2,55
chr1,125069463,125069507,SRX1424891,POU3F2,44
chr1,125069463,125069517,SRX5075180,SMARCA2,54
chr1,125069466,125069514,SRX1424894,POU3F2,48
chr1,125075038,125075079,SRX1424893,POU3F2,41
chr1,125075039,125075079,SRX1424891,POU3F2,40
chr1,125075149,125075207,SRX1424894,POU3F2,58
chr1,125075150,125075210,SRX1424891,POU3F2,60
chr1,125075151,125075193,SRX1424893,POU3F2,42
chr1,125075151,125075201,SRX1424892,POU3F2,50
chr1,125075451,125075502,SRX1424894,POU3F2,51
chr1,125075455,125075507,SRX1424891,POU3F2,52
chr1,125075455,125075508,SRX1424893,POU3F2,53
chr1,125075461,125075510,SRX1424892,POU3F2,49
chr1,125081167,125081209,SRX1424894,POU3F2,42
chr1,125081168,125081212,SRX1424893,POU3F2,44
chr1,125094485,125094740,SRX9989504,GFP,255
chr1,125166286,125166342,SRX1424893,POU3F2,56
chr1,125166288,125166349,SRX1424892,POU3F2,61
chr1,125166289,125166355,SRX1424894,POU3F2,66
chr1,125166302,125166353,SRX1424891,POU3F2,51
chr1,125166908,125167246,SRX16500060,CTCF,338
chr1,125166908,125167265,SRX16500062,CTCF,357
chr1,125166913,125167249,SRX4174629,CTCF,336
chr1,125166913,125167374,SRX16500059,CTCF,461
chr1,125166915,125167368,SRX16500061,CTCF,453
chr1,125166919,125167254,SRX20140870,INTS10,335
chr1,125166920,125167014,SRX1424892,POU3F2,94
chr1,125166923,125167009,SRX1424891,POU3F2,86
chr1,125166926,125167253,SRX20140867,INTS10,327
chr1,125166928,125167007,SRX1424894,POU3F2,79
chr1,125166928,125167434,SRX20140897,INTS13,506
chr1,125166929,125167391,SRX20140895,INTS13,462
chr1,125166931,125167011,SRX1424893,POU3F2,80
chr1,125166934,125167440,SRX20140890,SOX2,506
chr1,125166937,125167252,SRX20140869,INTS10,315
chr1,125166940,125167267,SRX20140868,INTS10,327
chr1,125166944,125167248,SRX20140861,SOX2,304
chr1,125166945,125167234,SRX20140882,CPSF3L,289
chr1,125166947,125168324,SRX20140860,SOX2,1377
chr1,125166951,125167247,SRX20140879,CPSF3L,296
chr1,125166953,125167208,SRX20140880,CPSF3L,255
chr1,125166958,125167424,SRX20140881,CPSF3L,466
chr1,125166959,125167214,SRX5075175,SMARCA4,255
chr1,125166967,125167421,SRX20140894,INTS13,454
chr1,125166975,125167200,SRX20140892,SOX2,225
chr1,125166986,125167208,SRX20140891,SOX2,222
chr1,125166997,125167210,SRX5716468,SMARCA2,213
chr1,125167011,125167207,SRX5075181,SMARCA2,196
chr1,125167063,125167404,SRX20140896,INTS13,341
chr1,125167138,125167243,SRX1424891,POU3F2,105
chr1,125167140,125167244,SRX1424892,POU3F2,104
chr1,125167141,125167242,SRX1424893,POU3F2,101
chr1,125167141,125167243,SRX1424894,POU3F2,102
chr1,125167174,125167234,SRX5020208,SMARCA2,60
chr1,125167178,125167232,SRX5075180,SMARCA2,54
chr1,125167484,125168130,SRX20140890,SOX2,646
chr1,125167552,125168234,SRX20140897,INTS13,682
chr1,125167555,125168141,SRX20140879,CPSF3L,586
chr1,125167562,125168115,SRX20140868,INTS10,553
chr1,125167566,125168063,SRX20140880,CPSF3L,497
chr1,125167570,125168233,SRX20140861,SOX2,663
chr1,125167571,125168034,SRX20140891,SOX2,463
chr1,125167571,125168038,SRX20140862,SOX2,467
chr1,125167572,125168234,SRX20140869,INTS10,662
chr1,125167573,125168323,SRX20140881,CPSF3L,750
chr1,125167576,125168065,SRX20140867,INTS10,489
chr1,125167581,125168229,SRX20140894,INTS13,648
chr1,125167596,125168165,SRX20140895,INTS13,569
chr1,125167646,125168037,SRX20140892,SOX2,391
chr1,125167661,125168116,SRX20140896,INTS13,455
chr1,125167662,125168097,SRX4174629,CTCF,435
chr1,125167674,125168127,SRX20140882,CPSF3L,453
chr1,125167690,125168212,SRX16500061,CTCF,522
chr1,125167692,125168108,SRX16500059,CTCF,416
chr1,125167694,125168228,SRX16500060,CTCF,534
chr1,125167695,125168047,SRX9989504,GFP,352
chr1,125167696,125168120,SRX16500062,CTCF,424
chr1,125167705,125168151,SRX20140870,INTS10,446
chr1,125167706,125168105,SRX5716455,SOX3,399
chr1,125167713,125167995,SRX5075181,SMARCA2,282
chr1,125167727,125167969,SRX5716451,SOX2,242
chr1,125167727,125168103,SRX5716468,SMARCA2,376
chr1,125167730,125168034,SRX9989505,GFP,304
chr1,125167742,125168121,SRX5716459,Epitope tags,379
chr1,125167753,125168020,SRX5075169,SMARCA4,267
chr1,125167782,125167983,SRX5075170,SMARCA4,201
chr1,125167789,125168016,SRX5075182,SMARCA2,227
chr1,125167801,125167984,SRX1424893,POU3F2,183
chr1,125167804,125167981,SRX1424894,POU3F2,177
chr1,125167806,125168011,SRX5075168,SMARCA4,205
chr1,125167808,125167991,SRX1424891,POU3F2,183
chr1,125167810,125167967,SRX1424892,POU3F2,157
chr1,125167823,125167972,SRX5075180,SMARCA2,149
chr1,125167824,125168009,SRX5075176,SMARCA4,185
chr1,125167824,125168085,SRX5075175,SMARCA4,261
chr1,125167830,125167950,SRX5020208,SMARCA2,120
chr1,125167839,125168052,SRX5020214,SMARCA2,213
chr1,125168183,125168240,SRX1424893,POU3F2,57
chr1,125168186,125168237,SRX1424894,POU3F2,51
chr1,125168186,125168241,SRX1424891,POU3F2,55
chr1,125168186,125168241,SRX1424892,POU3F2,55
chr1,125168294,125168338,SRX1424892,POU3F2,44
chr1,125169950,125170025,SRX1424894,POU3F2,75
chr1,125169956,125170029,SRX1424892,POU3F2,73
chr1,125169964,125170025,SRX1424893,POU3F2,61
chr1,125169985,125170026,SRX1424891,POU3F2,41
chr1,125169998,125170191,SRX5075174,SMARCA4,193
chr1,125170105,125170180,SRX1424892,POU3F2,75
chr1,125170106,125170179,SRX1424894,POU3F2,73
chr1,125170106,125170182,SRX1424891,POU3F2,76
chr1,125170108,125170181,SRX1424893,POU3F2,73
chr1,125174018,125174068,SRX1424892,POU3F2,50
chr1,125174021,125174075,SRX1424893,POU3F2,54
chr1,125174022,125174068,SRX1424894,POU3F2,46
chr1,125174024,125174064,SRX1424891,POU3F2,40
chr1,125178881,125179383,SRX9989505,GFP,502
chr1,125178885,125179369,SRX9989504,GFP,484
chr1,125178903,125180739,SRX20140891,SOX2,1836
chr1,125178906,125180723,SRX20140892,SOX2,1817
chr1,125178909,125180715,SRX20140862,SOX2,1806
chr1,125178919,125180705,SRX20140880,CPSF3L,1786
chr1,125178920,125179480,SRX4174629,CTCF,560
chr1,125178920,125180729,SRX20140867,INTS10,1809
chr1,125178922,125180706,SRX20140895,INTS13,1784
chr1,125178924,125180745,SRX20140897,INTS13,1821
chr1,125178925,125180734,SRX20140890,SOX2,1809
chr1,125178928,125180722,SRX16500061,CTCF,1794
chr1,125178934,125180663,SRX20140882,CPSF3L,1729
chr1,125178934,125180722,SRX20140879,CPSF3L,1788
chr1,125178935,125180703,SRX20140869,INTS10,1768
chr1,125178941,125180701,SRX20140868,INTS10,1760
chr1,125178946,125180713,SRX16500062,CTCF,1767
chr1,125178946,125180723,SRX20140861,SOX2,1777
chr1,125178948,125180720,SRX20140860,SOX2,1772
chr1,125178949,125180673,SRX16500059,CTCF,1724
chr1,125178952,125180679,SRX20140894,INTS13,1727
chr1,125178956,125180705,SRX16500060,CTCF,1749
chr1,125178958,125179904,SRX5075181,SMARCA2,946
chr1,125178959,125180716,SRX20140881,CPSF3L,1757
chr1,125178978,125179926,SRX5716468,SMARCA2,948
chr1,125178982,125179464,SRX5075182,SMARCA2,482
chr1,125178989,125180730,SRX20140870,INTS10,1741
chr1,125179002,125180665,SRX20140896,INTS13,1663
chr1,125179004,125179467,SRX5075175,SMARCA4,463
chr1,125179046,125180478,SRX5716455,SOX3,1432
chr1,125179067,125180484,SRX5716459,Epitope tags,1417
chr1,125179078,125180477,SRX5020214,SMARCA2,1399
chr1,125179085,125179458,SRX5075174,SMARCA4,373
chr1,125179089,125179463,SRX5075170,SMARCA4,374
chr1,125179091,125179657,SRX5716452,SOX2,566
chr1,125179094,125179562,SRX5075169,SMARCA4,468
chr1,125179096,125180432,SRX5716460,Epitope tags,1336
chr1,125179100,125179482,SRX5075176,SMARCA4,382
chr1,125179118,125179560,SRX5075168,SMARCA4,442
chr1,125179127,125179446,SRX5716451,SOX2,319
chr1,125179151,125179483,SRX5054309,FOSL2,332
chr1,125179163,125179450,SRX5054307,FOSL2,287
chr1,125179167,125179454,SRX5716467,SMARCA2,287
chr1,125179172,125179468,SRX5716470,SMARCA4,296
chr1,125179181,125179431,SRX5020211,SMARCA2,250
chr1,125179236,125179452,SRX5716464,SMARCA4,216
chr1,125179241,125179466,SRX5716469,SMARCA4,225
chr1,125179277,125179446,SRX5075180,SMARCA2,169
chr1,125179370,125179446,SRX1424894,POU3F2,76
chr1,125179372,125179448,SRX1424892,POU3F2,76
chr1,125179373,125179448,SRX1424893,POU3F2,75
chr1,125179374,125179454,SRX5020208,SMARCA2,80
chr1,125179382,125179444,SRX1424891,POU3F2,62
chr1,125179549,125180390,SRX5716467,SMARCA2,841
chr1,125179554,125180579,SRX4174629,CTCF,1025
chr1,125179564,125180685,SRX9989505,GFP,1121
chr1,125179568,125180687,SRX9989504,GFP,1119
chr1,125179610,125179909,SRX5075174,SMARCA4,299
chr1,125179644,125179918,SRX5075182,SMARCA2,274
chr1,125179650,125179917,SRX5075169,SMARCA4,267
chr1,125179652,125179887,SRX5075175,SMARCA4,235
chr1,125179652,125180351,SRX5075170,SMARCA4,699
chr1,125179659,125179923,SRX5075176,SMARCA4,264
chr1,125179672,125179755,SRX5020208,SMARCA2,83
chr1,125179675,125179888,SRX5075168,SMARCA4,213
chr1,125179677,125179754,SRX5075180,SMARCA2,77
chr1,125179704,125180411,SRX5716470,SMARCA4,707
chr1,125179893,125180434,SRX5716452,SOX2,541
chr1,125179917,125180411,SRX5716456,SOX3,494
chr1,125179979,125180466,SRX5716468,SMARCA2,487
chr1,125179991,125180416,SRX5716469,SMARCA4,425
chr1,125179996,125180378,SRX5075176,SMARCA4,382
chr1,125180001,125180334,SRX5054309,FOSL2,333
chr1,125180003,125180335,SRX5054307,FOSL2,332
chr1,125180004,125180449,SRX5075175,SMARCA4,445
chr1,125180008,125180447,SRX5075181,SMARCA2,439
chr1,125180009,125180339,SRX5075174,SMARCA4,330
chr1,125180009,125180487,SRX5075182,SMARCA2,478
chr1,125180015,125180315,SRX5716463,SMARCA4,300
chr1,125180018,125180365,SRX5075169,SMARCA4,347
chr1,125180021,125180370,SRX5020211,SMARCA2,349
chr1,125180038,125180358,SRX5716464,SMARCA4,320
chr1,125180041,125180366,SRX5716451,SOX2,325
chr1,125180095,125180349,SRX5075168,SMARCA4,254
chr1,125180131,125180299,SRX5075180,SMARCA2,168
chr1,125180137,125180294,SRX5020208,SMARCA2,157
chr1,125180139,125180226,SRX1424892,POU3F2,87
chr1,125180146,125180226,SRX1424893,POU3F2,80
chr1,125180149,125180189,SRX1424894,POU3F2,40
chr1,125182036,125183105,SRX20140869,INTS10,1069
chr1,125182037,125183107,SRX20140881,CPSF3L,1070
chr1,125182055,125183100,SRX20140860,SOX2,1045
chr1,125182072,125183094,SRX20140894,INTS13,1022
chr1,125182084,125183103,SRX20140861,SOX2,1019
chr1,125182096,125183105,SRX20140897,INTS13,1009
chr1,125182096,125183108,SRX20140895,INTS13,1012
chr1,125182098,125183102,SRX20140879,CPSF3L,1004
chr1,125182100,125183072,SRX20140868,INTS10,972
chr1,125182106,125183098,SRX20140890,SOX2,992
chr1,125182121,125183134,SRX20140867,INTS10,1013
chr1,125182124,125182750,SRX16500061,CTCF,626
chr1,125182138,125182752,SRX16500062,CTCF,614
chr1,125182142,125183132,SRX4174629,CTCF,990
chr1,125182143,125182740,SRX20140891,SOX2,597
chr1,125182144,125182737,SRX20140892,SOX2,593
chr1,125182148,125183072,SRX20140896,INTS13,924
chr1,125182148,125183158,SRX16500059,CTCF,1010
chr1,125182155,125183086,SRX20140880,CPSF3L,931
chr1,125182155,125183122,SRX16500060,CTCF,967
chr1,125182157,125182736,SRX20140862,SOX2,579
chr1,125182165,125183062,SRX20140882,CPSF3L,897
chr1,125182172,125183026,SRX20140870,INTS10,854
chr1,125182179,125182647,SRX5075170,SMARCA4,468
chr1,125182182,125182733,SRX5716468,SMARCA2,551
chr1,125182182,125182738,SRX5075175,SMARCA4,556
chr1,125182183,125182736,SRX5075181,SMARCA2,553
chr1,125182186,125182737,SRX9989505,GFP,551
chr1,125182186,125182745,SRX5075168,SMARCA4,559
chr1,125182187,125182712,SRX5075176,SMARCA4,525
chr1,125182187,125182762,SRX5075182,SMARCA2,575
chr1,125182188,125183028,SRX5020214,SMARCA2,840
chr1,125182189,125182884,SRX5716459,Epitope tags,695
chr1,125182197,125182730,SRX9989504,GFP,533
chr1,125182198,125183081,SRX5716460,Epitope tags,883
chr1,125182201,125182266,SRX1424892,POU3F2,65
chr1,125182202,125182258,SRX1424893,POU3F2,56
chr1,125182206,125182264,SRX1424894,POU3F2,58
chr1,125182209,125182694,SRX5054307,FOSL2,485
chr1,125182211,125182732,SRX5075169,SMARCA4,521
chr1,125182215,125182893,SRX5716455,SOX3,678
chr1,125182216,125182735,SRX5716451,SOX2,519
chr1,125182221,125182262,SRX1424891,POU3F2,41
chr1,125182232,125182687,SRX5716467,SMARCA2,455
chr1,125182235,125182643,SRX5716452,SOX2,408
chr1,125182239,125182725,SRX5075174,SMARCA4,486
chr1,125182249,125182744,SRX5716470,SMARCA4,495
chr1,125182314,125182414,SRX1424892,POU3F2,100
chr1,125182328,125182421,SRX5075180,SMARCA2,93
chr1,125182362,125182680,SRX5716464,SMARCA4,318
chr1,125182368,125182418,SRX1424894,POU3F2,50
chr1,125182368,125182662,SRX5716454,SOX3,294
chr1,125182369,125182600,SRX5020211,SMARCA2,231
chr1,125182371,125182424,SRX1424891,POU3F2,53
chr1,125182372,125182423,SRX1424893,POU3F2,51
chr1,125182494,125182665,SRX5020208,SMARCA2,171
chr1,125182502,125182661,SRX5075180,SMARCA2,159
chr1,125182505,125182659,SRX1424894,POU3F2,154
chr1,125182506,125182670,SRX1424891,POU3F2,164
chr1,125182509,125182654,SRX1424893,POU3F2,145
chr1,125182510,125182657,SRX1424892,POU3F2,147
chr1,125182832,125183133,SRX16500062,CTCF,301
chr1,125182841,125183144,SRX16500061,CTCF,303
chr1,125182847,125183120,SRX5075168,SMARCA4,273
chr1,125182862,125183099,SRX5075181,SMARCA2,237
chr1,125182932,125183122,SRX5075182,SMARCA2,190
chr1,125182942,125183139,SRX5075175,SMARCA4,197
chr1,125182976,125183081,SRX5020208,SMARCA2,105
chr1,125182977,125183093,SRX1424892,POU3F2,116
chr1,125182979,125183084,SRX1424894,POU3F2,105
chr1,125182983,125183095,SRX1424893,POU3F2,112
chr1,125182984,125183085,SRX1424891,POU3F2,101
chr1,125183007,125183084,SRX5075180,SMARCA2,77
chr1,125183729,125183828,SRX1424894,POU3F2,99
chr1,125183742,125183818,SRX1424893,POU3F2,76
chr1,125183752,125183851,SRX1424891,POU3F2,99
chr1,125184450,125184527,SRX1424893,POU3F2,77
chr1,125184465,125184517,SRX1424891,POU3F2,52
chr1,143184608,143185359,SRX5075175,SMARCA4,751
chr1,143184610,143184907,SRX5054307,FOSL2,297
chr1,143184611,143185442,SRX5075182,SMARCA2,831
chr1,143184618,143185427,SRX16500060,CTCF,809
chr1,143184620,143185336,SRX5020214,SMARCA2,716
chr1,143184620,143185424,SRX16500059,CTCF,804
chr1,143184621,143185410,SRX16500061,CTCF,789
chr1,143184626,143185428,SRX5716467,SMARCA2,802
chr1,143184626,143185433,SRX16500062,CTCF,807
chr1,143184628,143185348,SRX5075181,SMARCA2,720
chr1,143184628,143185556,SRX5716459,Epitope tags,928
chr1,143184632,143184781,SRX1424894,POU3F2,149
chr1,143184636,143184988,SRX1424891,POU3F2,352
chr1,143184637,143184842,SRX5075170,SMARCA4,205
chr1,143184638,143185335,SRX5075176,SMARCA4,697
chr1,143184642,143184781,SRX1424892,POU3F2,139
chr1,143184642,143184984,SRX1424893,POU3F2,342
chr1,143184649,143185440,SRX5716455,SOX3,791
chr1,143184651,143185465,SRX4174629,CTCF,814
chr1,143184654,143185348,SRX5075168,SMARCA4,694
chr1,143184655,143185412,SRX5716460,Epitope tags,757
chr1,143184657,143184746,SRX5075180,SMARCA2,89
chr1,143184658,143184751,SRX5020208,SMARCA2,93
chr1,143184662,143185345,SRX5716468,SMARCA2,683
chr1,143184663,143184910,SRX5075169,SMARCA4,247
chr1,143184665,143184989,SRX5075174,SMARCA4,324
chr1,143184666,143185467,SRX20140867,INTS10,801
chr1,143184668,143185463,SRX20140879,CPSF3L,795
chr1,143184669,143185471,SRX20140895,INTS13,802
chr1,143184670,143184950,SRX5716469,SMARCA4,280
chr1,143184670,143185477,SRX20140869,INTS10,807
chr1,143184671,143185456,SRX20140891,SOX2,785
chr1,143184672,143185468,SRX20140860,SOX2,796
chr1,143184673,143185446,SRX20140894,INTS13,773
chr1,143184673,143185455,SRX20140868,INTS10,782
chr1,143184676,143185448,SRX20140861,SOX2,772
chr1,143184677,143185444,SRX20140882,CPSF3L,767
chr1,143184677,143185468,SRX20140897,INTS13,791
chr1,143184679,143185445,SRX20140892,SOX2,766
chr1,143184681,143185470,SRX20140890,SOX2,789
chr1,143184682,143185550,SRX20140881,CPSF3L,868
chr1,143184689,143185461,SRX20140880,CPSF3L,772
chr1,143184701,143185446,SRX20140862,SOX2,745
chr1,143184728,143185453,SRX20140896,INTS13,725
chr1,143184728,143185477,SRX20140870,INTS10,749
chr1,143184778,143184989,SRX5716470,SMARCA4,211
chr1,143184785,143185443,SRX9989505,GFP,658
chr1,143184824,143184990,SRX1424894,POU3F2,166
chr1,143184845,143184986,SRX1424892,POU3F2,141
chr1,143184855,143184942,SRX5020208,SMARCA2,87
chr1,143184858,143185441,SRX9989504,GFP,583
chr1,143184909,143184959,SRX5075180,SMARCA2,50
chr1,143184970,143185350,SRX5075169,SMARCA4,380
chr1,143185022,143185351,SRX5020211,SMARCA2,329
chr1,143185083,143185343,SRX5716470,SMARCA4,260
chr1,143185084,143185323,SRX5075170,SMARCA4,239
chr1,143185090,143185356,SRX1424893,POU3F2,266
chr1,143185091,143185352,SRX1424892,POU3F2,261
chr1,143185091,143185356,SRX1424891,POU3F2,265
chr1,143185094,143185358,SRX1424894,POU3F2,264
chr1,143185129,143185234,SRX5075180,SMARCA2,105
chr1,143185136,143185214,SRX5020208,SMARCA2,78
chr1,143185162,143185360,SRX5075174,SMARCA4,198
chr1,143185403,143185462,SRX1424893,POU3F2,59
chr1,143185404,143185456,SRX1424894,POU3F2,52
chr1,143185407,143185462,SRX1424892,POU3F2,55
chr1,143185408,143185459,SRX1424891,POU3F2,51
chr1,143185712,143185760,SRX1424891,POU3F2,48
chr1,143185713,143185764,SRX1424892,POU3F2,51
chr1,143185717,143185759,SRX1424894,POU3F2,42
chr1,143185718,143185761,SRX1424893,POU3F2,43
chr1,143185725,143186244,SRX20140897,INTS13,519
chr1,143185805,143186235,SRX20140869,INTS10,430
chr1,143185809,143186065,SRX20140895,INTS13,256
chr1,143185832,143186074,SRX20140867,INTS10,242
chr1,143185834,143186064,SRX4174629,CTCF,230
chr1,143185886,143185947,SRX1424891,POU3F2,61
chr1,143186762,143186814,SRX1424892,POU3F2,52
chr1,143186765,143186807,SRX1424893,POU3F2,42
chr1,143186767,143186812,SRX1424891,POU3F2,45
chr1,143186767,143186818,SRX1424894,POU3F2,51
chr1,143186784,143187337,SRX20140861,SOX2,553
chr1,143186784,143187355,SRX20140897,INTS13,571
chr1,143186899,143187291,SRX20140896,INTS13,392
chr1,143186900,143187368,SRX20140895,INTS13,468
chr1,143186904,143187299,SRX20140894,INTS13,395
chr1,143186908,143187366,SRX20140869,INTS10,458
chr1,143186911,143187338,SRX20140890,SOX2,427
chr1,143186911,143187340,SRX20140879,CPSF3L,429
chr1,143186911,143187356,SRX20140881,CPSF3L,445
chr1,143186914,143187285,SRX20140880,CPSF3L,371
chr1,143186916,143187357,SRX20140867,INTS10,441
chr1,143186918,143187371,SRX20140868,INTS10,453
chr1,143186919,143186976,SRX1424893,POU3F2,57
chr1,143186922,143186977,SRX1424891,POU3F2,55
chr1,143186928,143186973,SRX1424892,POU3F2,45
chr1,143186928,143186974,SRX1424894,POU3F2,46
chr1,143186932,143187356,SRX20140860,SOX2,424
chr1,143186941,143187309,SRX20140882,CPSF3L,368
chr1,143186989,143187332,SRX20140870,INTS10,343
chr1,143187040,143187334,SRX4174629,CTCF,294
chr1,143187041,143187317,SRX20140862,SOX2,276
chr1,143187042,143187319,SRX20140892,SOX2,277
chr1,143187065,143187316,SRX20140891,SOX2,251
chr1,143187075,143187300,SRX5075182,SMARCA2,225
chr1,143187207,143187272,SRX1424891,POU3F2,65
chr1,143187209,143187270,SRX1424893,POU3F2,61
chr1,143187210,143187283,SRX1424892,POU3F2,73
chr1,143187211,143187293,SRX1424894,POU3F2,82
chr1,143192263,143193852,SRX20140891,SOX2,1589
chr1,143192275,143193865,SRX20140880,CPSF3L,1590
chr1,143192279,143193866,SRX20140867,INTS10,1587
chr1,143192289,143193844,SRX20140892,SOX2,1555
chr1,143192309,143193846,SRX20140862,SOX2,1537
chr1,143192313,143193868,SRX20140879,CPSF3L,1555
chr1,143192316,143193762,SRX20140870,INTS10,1446
chr1,143192329,143193849,SRX16500059,CTCF,1520
chr1,143192337,143193860,SRX20140882,CPSF3L,1523
chr1,143192338,143193896,SRX20140897,INTS13,1558
chr1,143192338,143193901,SRX20140868,INTS10,1563
chr1,143192342,143193884,SRX20140860,SOX2,1542
chr1,143192345,143193945,SRX20140869,INTS10,1600
chr1,143192349,143193865,SRX20140890,SOX2,1516
chr1,143192351,143193918,SRX20140895,INTS13,1567
chr1,143192353,143193906,SRX20140881,CPSF3L,1553
chr1,143192367,143193881,SRX20140861,SOX2,1514
chr1,143192440,143193926,SRX20140894,INTS13,1486
chr1,143192554,143193728,SRX20140896,INTS13,1174
chr1,143192563,143193348,SRX16500061,CTCF,785
chr1,143192585,143193225,SRX16500060,CTCF,640
chr1,143192653,143192954,SRX5020214,SMARCA2,301
chr1,143192667,143193338,SRX16500062,CTCF,671
chr1,143192668,143193866,SRX4174629,CTCF,1198
chr1,143192675,143192976,SRX5075182,SMARCA2,301
chr1,143192676,143192902,SRX5075176,SMARCA4,226
chr1,143192680,143192877,SRX5075181,SMARCA2,197
chr1,143192681,143192941,SRX5054307,FOSL2,260
chr1,143192692,143192929,SRX5075174,SMARCA4,237
chr1,143192696,143192970,SRX5716468,SMARCA2,274
chr1,143192707,143192890,SRX5075168,SMARCA4,183
chr1,143192718,143193037,SRX5716459,Epitope tags,319
chr1,143192723,143192976,SRX5075175,SMARCA4,253
chr1,143192748,143193250,SRX9989505,GFP,502
chr1,143192757,143192851,SRX5075180,SMARCA2,94
chr1,143192766,143192856,SRX5020208,SMARCA2,90
chr1,143192774,143192896,SRX1424893,POU3F2,122
chr1,143192796,143193088,SRX5716455,SOX3,292
chr1,143192801,143192863,SRX1424894,POU3F2,62
chr1,143192802,143192853,SRX1424891,POU3F2,51
chr1,143192803,143192865,SRX1424892,POU3F2,62
chr1,143192908,143193250,SRX9989504,GFP,342
chr1,143193414,143193871,SRX16500062,CTCF,457
chr1,143193418,143193859,SRX5075175,SMARCA4,441
chr1,143193425,143193717,SRX5716455,SOX3,292
chr1,143193425,143193887,SRX16500060,CTCF,462
chr1,143193429,143193883,SRX16500061,CTCF,454
chr1,143193431,143193498,SRX5020208,SMARCA2,67
chr1,143193431,143193840,SRX5075182,SMARCA2,409
chr1,143193433,143193496,SRX5075180,SMARCA2,63
chr1,143193437,143193728,SRX5054307,FOSL2,291
chr1,143193438,143193492,SRX1424891,POU3F2,54
chr1,143193438,143193810,SRX5716468,SMARCA2,372
chr1,143193441,143193513,SRX1424894,POU3F2,72
chr1,143193445,143193514,SRX1424893,POU3F2,69
chr1,143193448,143193503,SRX1424892,POU3F2,55
chr1,143193470,143193764,SRX5716459,Epitope tags,294
chr1,143193491,143193869,SRX9989504,GFP,378
chr1,143193545,143193770,SRX5075174,SMARCA4,225
chr1,143193548,143193838,SRX5075176,SMARCA4,290
chr1,143193553,143193845,SRX5075181,SMARCA2,292
chr1,143193571,143193874,SRX9989505,GFP,303
chr1,143193589,143193870,SRX5020214,SMARCA2,281
chr1,143193597,143193793,SRX5075170,SMARCA4,196
chr1,143193821,143193871,SRX1424892,POU3F2,50
chr1,143194855,143195263,SRX16500060,CTCF,408
chr1,143194862,143195552,SRX20140881,CPSF3L,690
chr1,143194870,143195271,SRX16500061,CTCF,401
chr1,143194873,143195285,SRX9989505,GFP,412
chr1,143194874,143195265,SRX16500062,CTCF,391
chr1,143194875,143195256,SRX16500059,CTCF,381
chr1,143194886,143195280,SRX9989504,GFP,394
chr1,143194903,143195276,SRX4174629,CTCF,373
chr1,143194903,143195666,SRX20140869,INTS10,763
chr1,143194910,143195457,SRX20140882,CPSF3L,547
chr1,143194918,143195442,SRX20140880,CPSF3L,524
chr1,143194920,143195300,SRX20140892,SOX2,380
chr1,143194923,143195331,SRX20140895,INTS13,408
chr1,143194924,143195296,SRX20140891,SOX2,372
chr1,143194925,143195342,SRX20140879,CPSF3L,417
chr1,143194927,143195334,SRX20140894,INTS13,407
chr1,143194929,143195662,SRX20140897,INTS13,733
chr1,143194933,143195324,SRX20140890,SOX2,391
chr1,143194934,143195349,SRX20140861,SOX2,415
chr1,143194938,143195303,SRX20140896,INTS13,365
chr1,143194938,143195648,SRX20140860,SOX2,710
chr1,143194940,143195546,SRX20140868,INTS10,606
chr1,143194957,143195286,SRX20140867,INTS10,329
chr1,143194959,143195420,SRX20140862,SOX2,461
chr1,143194961,143195192,SRX5020214,SMARCA2,231
chr1,143194968,143195148,SRX5075169,SMARCA4,180
chr1,143194976,143195199,SRX5075182,SMARCA2,223
chr1,143195028,143195267,SRX5716467,SMARCA2,239
chr1,143195389,143195664,SRX20140879,CPSF3L,275
chr1,143195393,143195650,SRX20140894,INTS13,257
chr1,143195653,143195725,SRX1424891,POU3F2,72
chr1,143195661,143195724,SRX1424893,POU3F2,63
chr1,143195665,143195725,SRX1424892,POU3F2,60
chr1,143195678,143195730,SRX1424894,POU3F2,52
chr1,143200169,143200881,SRX20140867,INTS10,712
chr1,143200172,143200889,SRX20140869,INTS10,717
chr1,143200174,143200884,SRX20140897,INTS13,710
chr1,143200175,143200561,SRX16500059,CTCF,386
chr1,143200183,143200453,SRX16500060,CTCF,270
chr1,143200193,143200858,SRX16500061,CTCF,665
chr1,143200200,143200853,SRX20140890,SOX2,653
chr1,143200208,143200428,SRX4174629,CTCF,220
chr1,143200210,143200879,SRX20140861,SOX2,669
chr1,143200214,143200877,SRX20140894,INTS13,663
chr1,143200214,143200880,SRX20140895,INTS13,666
chr1,143200218,143200865,SRX20140892,SOX2,647
chr1,143200228,143200809,SRX20140881,CPSF3L,581
chr1,143200228,143200896,SRX20140879,CPSF3L,668
chr1,143200234,143200874,SRX20140862,SOX2,640
chr1,143200242,143200876,SRX20140860,SOX2,634
chr1,143200248,143200766,SRX20140870,INTS10,518
chr1,143200248,143200795,SRX20140868,INTS10,547
chr1,143200293,143200876,SRX20140882,CPSF3L,583
chr1,143200302,143200847,SRX20140891,SOX2,545
chr1,143200302,143200883,SRX20140880,CPSF3L,581
chr1,143200365,143200817,SRX20140896,INTS13,452
chr1,143200513,143200896,SRX4174629,CTCF,383
chr1,143200650,143200794,SRX1424891,POU3F2,144
chr1,143200653,143200739,SRX1424892,POU3F2,86
chr1,143200653,143200799,SRX1424893,POU3F2,146
chr1,143200654,143200795,SRX1424894,POU3F2,141
chr1,143200859,143200899,SRX1424892,POU3F2,40
chr1,143200861,143200906,SRX1424894,POU3F2,45
chr1,143201158,143201210,SRX1424894,POU3F2,52
chr1,143201162,143201217,SRX1424893,POU3F2,55
chr1,143201165,143201222,SRX1424892,POU3F2,57
chr1,143201167,143201215,SRX1424891,POU3F2,48
chr1,143201458,143201680,SRX16500060,CTCF,222
chr1,143201467,143201679,SRX16500062,CTCF,212
chr1,143202127,143202887,SRX20140881,CPSF3L,760
chr1,143202159,143202864,SRX20140894,INTS13,705
chr1,143202162,143202886,SRX20140882,CPSF3L,724
chr1,143202184,143202880,SRX20140869,INTS10,696
chr1,143202248,143202871,SRX20140860,SOX2,623
chr1,143202263,143202866,SRX20140896,INTS13,603
chr1,143202279,143202881,SRX20140879,CPSF3L,602
chr1,143202299,143202884,SRX20140880,CPSF3L,585
chr1,143202303,143202864,SRX20140861,SOX2,561
chr1,143202320,143202866,SRX20140890,SOX2,546
chr1,143202332,143202886,SRX20140895,INTS13,554
chr1,143202355,143202885,SRX20140897,INTS13,530
chr1,143202361,143202875,SRX20140868,INTS10,514
chr1,143202426,143202893,SRX9989504,GFP,467
chr1,143202429,143202872,SRX20140867,INTS10,443
chr1,143202429,143202901,SRX9989505,GFP,472
chr1,143202437,143202849,SRX20140870,INTS10,412
chr1,143202441,143202886,SRX16500061,CTCF,445
chr1,143202442,143202878,SRX16500062,CTCF,436
chr1,143202443,143202881,SRX20140892,SOX2,438
chr1,143202444,143202860,SRX16500059,CTCF,416
chr1,143202451,143202877,SRX20140891,SOX2,426
chr1,143202453,143202885,SRX16500060,CTCF,432
chr1,143202457,143202880,SRX20140862,SOX2,423
chr1,143202460,143202547,SRX1424894,POU3F2,87
chr1,143202461,143202530,SRX1424891,POU3F2,69
chr1,143202463,143202537,SRX1424893,POU3F2,74
chr1,143202465,143202868,SRX4174629,CTCF,403
chr1,143202466,143202837,SRX5075182,SMARCA2,371
chr1,143202504,143202842,SRX5075175,SMARCA4,338
chr1,143202512,143202783,SRX5716468,SMARCA2,271
chr1,143202528,143202861,SRX5075169,SMARCA4,333
chr1,143202531,143202764,SRX5075174,SMARCA4,233
chr1,143202537,143202853,SRX5075176,SMARCA4,316
chr1,143202545,143202840,SRX5075181,SMARCA2,295
chr1,143202549,143202798,SRX5716467,SMARCA2,249
chr1,143202561,143202770,SRX5075170,SMARCA4,209
chr1,143202667,143202727,SRX5075180,SMARCA2,60
chr1,143202670,143202778,SRX1424894,POU3F2,108
chr1,143202674,143202795,SRX1424893,POU3F2,121
chr1,143202690,143202785,SRX1424892,POU3F2,95
chr1,143202737,143202791,SRX1424891,POU3F2,54
chr1,143203286,143203532,SRX20140891,SOX2,246
chr1,143203290,143203536,SRX20140880,CPSF3L,246
chr1,143203292,143203536,SRX20140890,SOX2,244
chr1,143203294,143203521,SRX4174629,CTCF,227
chr1,143203295,143203542,SRX16500061,CTCF,247
chr1,143203297,143203519,SRX20140862,SOX2,222
chr1,143203299,143203536,SRX16500062,CTCF,237
chr1,143203303,143203526,SRX20140867,INTS10,223
chr1,143203304,143203540,SRX20140892,SOX2,236
chr1,143205578,143205621,SRX1424891,POU3F2,43
chr1,143205581,143205634,SRX1424894,POU3F2,53
chr1,143205958,143206524,SRX5716459,Epitope tags,566
chr1,143205982,143206506,SRX5716468,SMARCA2,524
chr1,143205997,143206807,SRX16500059,CTCF,810
chr1,143206015,143206810,SRX16500060,CTCF,795
chr1,143206026,143206413,SRX5075170,SMARCA4,387
chr1,143206036,143206463,SRX5075176,SMARCA4,427
chr1,143206037,143206498,SRX5020214,SMARCA2,461
chr1,143206037,143206811,SRX16500061,CTCF,774
chr1,143206042,143206230,SRX5075174,SMARCA4,188
chr1,143206042,143206333,SRX5075168,SMARCA4,291
chr1,143206043,143206810,SRX16500062,CTCF,767
chr1,143206045,143206316,SRX5054307,FOSL2,271
chr1,143206049,143206508,SRX5075181,SMARCA2,459
chr1,143206051,143206515,SRX5075169,SMARCA4,464
chr1,143206053,143206520,SRX5075182,SMARCA2,467
chr1,143206056,143206440,SRX5716455,SOX3,384
chr1,143206059,143206186,SRX5075180,SMARCA2,127
chr1,143206061,143206186,SRX1424893,POU3F2,125
chr1,143206061,143206664,SRX4174629,CTCF,603
chr1,143206062,143206186,SRX1424892,POU3F2,124
chr1,143206063,143206184,SRX1424891,POU3F2,121
chr1,143206064,143206180,SRX5020208,SMARCA2,116
chr1,143206064,143206187,SRX1424894,POU3F2,123
chr1,143206065,143206297,SRX5075175,SMARCA4,232
chr1,143206071,143206354,SRX5020211,SMARCA2,283
chr1,143206078,143207136,SRX20140867,INTS10,1058
chr1,143206080,143207132,SRX20140895,INTS13,1052
chr1,143206082,143207130,SRX20140869,INTS10,1048
chr1,143206083,143206509,SRX5716451,SOX2,426
chr1,143206083,143207127,SRX20140879,CPSF3L,1044
chr1,143206091,143207119,SRX20140894,INTS13,1028
chr1,143206097,143207169,SRX20140897,INTS13,1072
chr1,143206104,143206799,SRX20140891,SOX2,695
chr1,143206105,143207129,SRX20140861,SOX2,1024
chr1,143206106,143207131,SRX20140868,INTS10,1025
chr1,143206107,143206809,SRX20140892,SOX2,702
chr1,143206107,143207141,SRX20140880,CPSF3L,1034
chr1,143206110,143207130,SRX20140890,SOX2,1020
chr1,143206113,143206674,SRX20140862,SOX2,561
chr1,143206113,143207133,SRX20140860,SOX2,1020
chr1,143206124,143206307,SRX5054309,FOSL2,183
chr1,143206133,143207146,SRX20140882,CPSF3L,1013
chr1,143206134,143207172,SRX20140881,CPSF3L,1038
chr1,143206139,143206464,SRX5716467,SMARCA2,325
chr1,143206144,143207038,SRX20140870,INTS10,894
chr1,143206176,143207083,SRX20140896,INTS13,907
chr1,143206240,143206633,SRX5716460,Epitope tags,393
chr1,143206273,143206336,SRX1424891,POU3F2,63
chr1,143206276,143206340,SRX1424892,POU3F2,64
chr1,143206289,143206348,SRX1424894,POU3F2,59
chr1,143206423,143206475,SRX1424892,POU3F2,52
chr1,143206424,143206485,SRX1424893,POU3F2,61
chr1,143206432,143206482,SRX1424894,POU3F2,50
chr1,143206436,143206482,SRX1424891,POU3F2,46
chr1,143206905,143207164,SRX20140862,SOX2,259
chr1,143206914,143207129,SRX4174629,CTCF,215
chr1,143206914,143207143,SRX20140891,SOX2,229
chr1,143206917,143206957,SRX1424894,POU3F2,40
chr1,143206924,143207177,SRX16500062,CTCF,253
chr1,143207044,143207188,SRX1424893,POU3F2,144
chr1,143207049,143207155,SRX1424891,POU3F2,106
chr1,143207053,143207194,SRX1424894,POU3F2,141
chr1,143207055,143207199,SRX1424892,POU3F2,144
chr1,143208467,143208507,SRX1424894,POU3F2,40
chr1,143212691,143213191,SRX20140860,SOX2,500
chr1,143212831,143213320,SRX20140891,SOX2,489
chr1,143212844,143213216,SRX20140895,INTS13,372
chr1,143212847,143213178,SRX20140890,SOX2,331
chr1,143212847,143213356,SRX20140868,INTS10,509
chr1,143212848,143213185,SRX20140894,INTS13,337
chr1,143212861,143213303,SRX20140880,CPSF3L,442
chr1,143212862,143213303,SRX20140897,INTS13,441
chr1,143212883,143213186,SRX20140870,INTS10,303
chr1,143212901,143213262,SRX20140869,INTS10,361
chr1,143212906,143213194,SRX20140882,CPSF3L,288
chr1,143212933,143213306,SRX20140892,SOX2,373
chr1,143212939,143213327,SRX20140867,INTS10,388
chr1,143212975,143213263,SRX20140862,SOX2,288
chr1,143213001,143213369,SRX9989505,GFP,368
chr1,143213007,143213370,SRX9989504,GFP,363
chr1,143213043,143213278,SRX20140879,CPSF3L,235
chr1,143213066,143213325,SRX16500059,CTCF,259
chr1,143213069,143213311,SRX16500061,CTCF,242
chr1,143213071,143213300,SRX16500062,CTCF,229
chr1,143213081,143213318,SRX16500060,CTCF,237
chr1,143214240,143214895,SRX9989504,GFP,655
chr1,143214246,143214896,SRX9989505,GFP,650
chr1,143214251,143215236,SRX20140897,INTS13,985
chr1,143214252,143215102,SRX20140867,INTS10,850
chr1,143214268,143215166,SRX20140881,CPSF3L,898
chr1,143214269,143214946,SRX20140862,SOX2,677
chr1,143214270,143215176,SRX20140882,CPSF3L,906
chr1,143214271,143215263,SRX20140890,SOX2,992
chr1,143214272,143215083,SRX20140861,SOX2,811
chr1,143214273,143215244,SRX20140895,INTS13,971
chr1,143214273,143215245,SRX20140860,SOX2,972
chr1,143214274,143215190,SRX20140894,INTS13,916
chr1,143214280,143215284,SRX20140880,CPSF3L,1004
chr1,143214282,143214948,SRX20140892,SOX2,666
chr1,143214284,143215060,SRX16500061,CTCF,776
chr1,143214287,143214956,SRX16500062,CTCF,669
chr1,143214289,143215330,SRX20140891,SOX2,1041
chr1,143214290,143215242,SRX20140869,INTS10,952
chr1,143214293,143215054,SRX16500060,CTCF,761
chr1,143214293,143215252,SRX20140879,CPSF3L,959
chr1,143214295,143215104,SRX20140868,INTS10,809
chr1,143214299,143215164,SRX20140896,INTS13,865
chr1,143214302,143215049,SRX20140870,INTS10,747
chr1,143214310,143214958,SRX16500059,CTCF,648
chr1,143214528,143214966,SRX5716455,SOX3,438
chr1,143214539,143214935,SRX4174629,CTCF,396
chr1,143214565,143214987,SRX5716460,Epitope tags,422
chr1,143214571,143215038,SRX5716459,Epitope tags,467
chr1,143214589,143214975,SRX5020214,SMARCA2,386
chr1,143214603,143214923,SRX5020211,SMARCA2,320
chr1,143214605,143214968,SRX5716467,SMARCA2,363
chr1,143214618,143214914,SRX5716470,SMARCA4,296
chr1,143214618,143214958,SRX5716468,SMARCA2,340
chr1,143214619,143214950,SRX5075175,SMARCA4,331
chr1,143214621,143214943,SRX5075169,SMARCA4,322
chr1,143214626,143214939,SRX5075168,SMARCA4,313
chr1,143214627,143214922,SRX5716464,SMARCA4,295
chr1,143214628,143214947,SRX5075182,SMARCA2,319
chr1,143214631,143214961,SRX5075181,SMARCA2,330
chr1,143214632,143214925,SRX5075176,SMARCA4,293
chr1,143214639,143214925,SRX5075170,SMARCA4,286
chr1,143214641,143214932,SRX5054307,FOSL2,291
chr1,143214644,143214933,SRX5075174,SMARCA4,289
chr1,143214691,143214905,SRX5054308,FOSL2,214
chr1,143214740,143214853,SRX5020208,SMARCA2,113
chr1,143214741,143214834,SRX5075180,SMARCA2,93
chr1,143219654,143220032,SRX20140880,CPSF3L,378
chr1,143219656,143220501,SRX20140882,CPSF3L,845
chr1,143219660,143219973,SRX20140892,SOX2,313
chr1,143219663,143220530,SRX20140881,CPSF3L,867
chr1,143219667,143219976,SRX20140891,SOX2,309
chr1,143219667,143219997,SRX9989505,GFP,330
chr1,143219669,143219906,SRX20140867,INTS10,237
chr1,143219670,143219994,SRX9989504,GFP,324
chr1,143219672,143219951,SRX20140862,SOX2,279
chr1,143219672,143220010,SRX20140897,INTS13,338
chr1,143219674,143220010,SRX20140890,SOX2,336
chr1,143219686,143220016,SRX20140869,INTS10,330
chr1,143219687,143219991,SRX20140870,INTS10,304
chr1,143219687,143220008,SRX20140894,INTS13,321
chr1,143219687,143220009,SRX20140860,SOX2,322
chr1,143219687,143220015,SRX20140895,INTS13,328
chr1,143219697,143220009,SRX20140868,INTS10,312
chr1,143219708,143220003,SRX20140896,INTS13,295
chr1,143219723,143219945,SRX20140861,SOX2,222
chr1,143219747,143220009,SRX20140879,CPSF3L,262
chr1,143220095,143220523,SRX20140880,CPSF3L,428
chr1,143220192,143220466,SRX20140862,SOX2,274
chr1,143220240,143220512,SRX20140892,SOX2,272
chr1,143220249,143220523,SRX20140891,SOX2,274
chr1,143220281,143220528,SRX20140894,INTS13,247
chr1,143220292,143220545,SRX20140897,INTS13,253
chr1,143220841,143221084,SRX16500061,CTCF,243
chr1,143222099,143222515,SRX20140868,INTS10,416
chr1,143222103,143222542,SRX20140879,CPSF3L,439
chr1,143222107,143222584,SRX20140860,SOX2,477
chr1,143222108,143222518,SRX20140867,INTS10,410
chr1,143222108,143222574,SRX20140869,INTS10,466
chr1,143222108,143222604,SRX20140897,INTS13,496
chr1,143222109,143222324,SRX20140862,SOX2,215
chr1,143222113,143222343,SRX20140891,SOX2,230
chr1,143222114,143222599,SRX20140890,SOX2,485
chr1,143222115,143222519,SRX20140880,CPSF3L,404
chr1,143222116,143222504,SRX20140861,SOX2,388
chr1,143222116,143222624,SRX20140895,INTS13,508
chr1,143222117,143222623,SRX20140894,INTS13,506
chr1,143222123,143222576,SRX20140881,CPSF3L,453
chr1,143222182,143222531,SRX20140882,CPSF3L,349
chr1,143222266,143222614,SRX16500062,CTCF,348
chr1,143222271,143222613,SRX16500060,CTCF,342
chr1,143223204,143223246,SRX1424893,POU3F2,42
chr1,143227390,143227609,SRX16500062,CTCF,219
chr1,143230132,143230458,SRX20140870,INTS10,326
chr1,143230134,143230441,SRX20140896,INTS13,307
chr1,143230134,143230545,SRX20140869,INTS10,411
chr1,143230135,143230519,SRX20140879,CPSF3L,384
chr1,143230135,143230545,SRX20140897,INTS13,410
chr1,143230135,143230547,SRX20140895,INTS13,412
chr1,143230135,143230575,SRX20140860,SOX2,440
chr1,143230137,143230493,SRX20140881,CPSF3L,356
chr1,143230144,143230540,SRX20140894,INTS13,396
chr1,143230145,143230552,SRX20140868,INTS10,407
chr1,143230149,143230497,SRX20140867,INTS10,348
chr1,143230157,143230533,SRX20140880,CPSF3L,376
chr1,143230157,143230552,SRX20140890,SOX2,395
chr1,143230161,143230488,SRX20140891,SOX2,327
chr1,143230163,143230486,SRX4174629,CTCF,323
chr1,143230163,143230544,SRX20140882,CPSF3L,381
chr1,143230164,143230496,SRX20140892,SOX2,332
chr1,143230165,143230493,SRX20140861,SOX2,328
chr1,143230166,143230512,SRX20140862,SOX2,346
chr1,143230183,143230493,SRX16500060,CTCF,310
chr1,143230186,143230564,SRX16500061,CTCF,378
chr1,143230213,143230493,SRX16500062,CTCF,280
chr1,143230226,143230446,SRX5075182,SMARCA2,220
chr1,143230242,143230512,SRX16500059,CTCF,270
chr1,143230253,143230454,SRX5075168,SMARCA4,201
chr1,143230254,143230432,SRX5075174,SMARCA4,178
chr1,143230257,143230458,SRX5075170,SMARCA4,201
chr1,143230260,143230466,SRX5020214,SMARCA2,206
chr1,143230262,143230476,SRX5075175,SMARCA4,214
chr1,143230269,143230405,SRX1424894,POU3F2,136
chr1,143230272,143230425,SRX1424893,POU3F2,153
chr1,143230273,143230403,SRX1424891,POU3F2,130
chr1,143230273,143230418,SRX1424892,POU3F2,145
chr1,143230277,143230495,SRX5075169,SMARCA4,218
chr1,143230288,143230410,SRX5020208,SMARCA2,122
chr1,143230299,143230380,SRX5075180,SMARCA2,81
chr1,143231215,143231543,SRX20140867,INTS10,328
chr1,143231245,143231582,SRX16500059,CTCF,337
chr1,143231255,143231580,SRX20140880,CPSF3L,325
chr1,143231256,143231561,SRX20140860,SOX2,305
chr1,143231258,143231555,SRX16500060,CTCF,297
chr1,143231260,143231569,SRX16500062,CTCF,309
chr1,143231261,143231580,SRX16500061,CTCF,319
chr1,143231264,143231467,SRX5075182,SMARCA2,203
chr1,143231267,143231570,SRX20140892,SOX2,303
chr1,143231272,143231546,SRX20140897,INTS13,274
chr1,143231274,143231552,SRX20140891,SOX2,278
chr1,143231274,143231557,SRX20140862,SOX2,283
chr1,143231275,143231543,SRX4174629,CTCF,268
chr1,143231279,143231542,SRX20140879,CPSF3L,263
chr1,143231289,143231538,SRX20140894,INTS13,249
chr1,143231306,143231583,SRX9989505,GFP,277
chr1,143231309,143231581,SRX9989504,GFP,272
chr1,143232495,143233544,SRX20140897,INTS13,1049
chr1,143232581,143233535,SRX20140869,INTS10,954
chr1,143232584,143233550,SRX20140881,CPSF3L,966
chr1,143232704,143233327,SRX20140868,INTS10,623
chr1,143232704,143233553,SRX20140895,INTS13,849
chr1,143232724,143233326,SRX20140894,INTS13,602
chr1,143232742,143233335,SRX20140861,SOX2,593
chr1,143232746,143233534,SRX20140882,CPSF3L,788
chr1,143232749,143233555,SRX20140860,SOX2,806
chr1,143232752,143233338,SRX20140890,SOX2,586
chr1,143232753,143233276,SRX20140879,CPSF3L,523
chr1,143232754,143233288,SRX16500060,CTCF,534
chr1,143232762,143233355,SRX20140880,CPSF3L,593
chr1,143232763,143233337,SRX20140867,INTS10,574
chr1,143232764,143233251,SRX16500061,CTCF,487
chr1,143232764,143233299,SRX20140891,SOX2,535
chr1,143232767,143233248,SRX16500059,CTCF,481
chr1,143232777,143233322,SRX9989504,GFP,545
chr1,143232780,143233253,SRX20140862,SOX2,473
chr1,143232781,143233315,SRX9989505,GFP,534
chr1,143232783,143233032,SRX5020214,SMARCA2,249
chr1,143232784,143233288,SRX20140892,SOX2,504
chr1,143232786,143233289,SRX16500062,CTCF,503
chr1,143232801,143233005,SRX5075181,SMARCA2,204
chr1,143232801,143233106,SRX5075175,SMARCA4,305
chr1,143232801,143233260,SRX20140896,INTS13,459
chr1,143232802,143233204,SRX4174629,CTCF,402
chr1,143232808,143233416,SRX20140870,INTS10,608
chr1,143232809,143232984,SRX5075176,SMARCA4,175
chr1,143232842,143233100,SRX5075182,SMARCA2,258
chr1,143232847,143233124,SRX5075168,SMARCA4,277
chr1,143237469,143237713,SRX20140897,INTS13,244
chr1,143237768,143238218,SRX20140868,INTS10,450
chr1,143237774,143238278,SRX20140869,INTS10,504
chr1,143237777,143238263,SRX20140860,SOX2,486
chr1,143237782,143238225,SRX20140861,SOX2,443
chr1,143237787,143238226,SRX20140880,CPSF3L,439
chr1,143237787,143238273,SRX20140879,CPSF3L,486
chr1,143237792,143238252,SRX20140895,INTS13,460
chr1,143237796,143238207,SRX20140862,SOX2,411
chr1,143237799,143238242,SRX20140891,SOX2,443
chr1,143237801,143238249,SRX20140894,INTS13,448
chr1,143237808,143238290,SRX20140897,INTS13,482
chr1,143237816,143238249,SRX20140881,CPSF3L,433
chr1,143237833,143238224,SRX20140882,CPSF3L,391
chr1,143237947,143238257,SRX20140867,INTS10,310
chr1,143237950,143238185,SRX20140892,SOX2,235
chr1,143237957,143238241,SRX20140890,SOX2,284
chr1,143237976,143238195,SRX16500061,CTCF,219
chr1,143237978,143238235,SRX16500059,CTCF,257
chr1,143239318,143239803,SRX16500062,CTCF,485
chr1,143239319,143239755,SRX20140869,INTS10,436
chr1,143239333,143239723,SRX20140890,SOX2,390
chr1,143239338,143239696,SRX20140860,SOX2,358
chr1,143239344,143239753,SRX20140879,CPSF3L,409
chr1,143239347,143239753,SRX20140867,INTS10,406
chr1,143239355,143239759,SRX20140868,INTS10,404
chr1,143239360,143239807,SRX16500059,CTCF,447
chr1,143239373,143239781,SRX16500060,CTCF,408
chr1,143239373,143239828,SRX16500061,CTCF,455
chr1,143239381,143239803,SRX20140895,INTS13,422
chr1,143239382,143239772,SRX20140882,CPSF3L,390
chr1,143239382,143239916,SRX9989504,GFP,534
chr1,143239388,143239886,SRX9989505,GFP,498
chr1,143239394,143239769,SRX20140891,SOX2,375
chr1,143239405,143239824,SRX20140892,SOX2,419
chr1,143239411,143239747,SRX20140861,SOX2,336
chr1,143239412,143239821,SRX20140880,CPSF3L,409
chr1,143239419,143239844,SRX20140881,CPSF3L,425
chr1,143239420,143239763,SRX20140862,SOX2,343
chr1,143239427,143239700,SRX20140894,INTS13,273
chr1,143239433,143239761,SRX20140897,INTS13,328
chr1,143239922,143240603,SRX20140881,CPSF3L,681
chr1,143239954,143240509,SRX20140880,CPSF3L,555
chr1,143239969,143240561,SRX20140868,INTS10,592
chr1,143239983,143240584,SRX20140894,INTS13,601
chr1,143239986,143240562,SRX20140895,INTS13,576
chr1,143239999,143240574,SRX20140897,INTS13,575
chr1,143240013,143240499,SRX20140882,CPSF3L,486
chr1,143240065,143240561,SRX20140870,INTS10,496
chr1,143240066,143240506,SRX20140869,INTS10,440
chr1,143240066,143240509,SRX20140892,SOX2,443
chr1,143240070,143240497,SRX20140861,SOX2,427
chr1,143240070,143240569,SRX20140879,CPSF3L,499
chr1,143240073,143240559,SRX20140867,INTS10,486
chr1,143240076,143240564,SRX20140890,SOX2,488
chr1,143240080,143240579,SRX20140860,SOX2,499
chr1,143240084,143240508,SRX20140891,SOX2,424
chr1,143240085,143240501,SRX20140862,SOX2,416
chr1,143240121,143240333,SRX4174629,CTCF,212
chr1,143240145,143240481,SRX9989504,GFP,336
chr1,143240163,143240477,SRX9989505,GFP,314
chr1,143240203,143240566,SRX20140896,INTS13,363
chr1,143240215,143240472,SRX16500061,CTCF,257
chr1,143240216,143240454,SRX16500062,CTCF,238
chr1,143240233,143240281,SRX1424893,POU3F2,48
chr1,143245063,143245377,SRX20140881,CPSF3L,314
chr1,143245459,143245512,SRX1424893,POU3F2,53
chr1,143245462,143245523,SRX1424894,POU3F2,61
chr1,143245463,143245510,SRX1424891,POU3F2,47
chr1,143245464,143245507,SRX1424892,POU3F2,43
chr1,143245467,143245519,SRX5075180,SMARCA2,52
chr1,143246827,143247389,SRX20140881,CPSF3L,562
chr1,143246851,143247390,SRX20140882,CPSF3L,539
chr1,143246852,143247407,SRX16500059,CTCF,555
chr1,143246857,143246942,SRX1424894,POU3F2,85
chr1,143246859,143246945,SRX1424891,POU3F2,86
chr1,143246861,143246947,SRX1424893,POU3F2,86
chr1,143246861,143247383,SRX20140860,SOX2,522
chr1,143246861,143247386,SRX20140894,INTS13,525
chr1,143246862,143247400,SRX20140880,CPSF3L,538
chr1,143246863,143246943,SRX1424892,POU3F2,80
chr1,143246863,143247403,SRX20140879,CPSF3L,540
chr1,143246869,143247424,SRX16500062,CTCF,555
chr1,143246874,143247488,SRX9989505,GFP,614
chr1,143246876,143247415,SRX16500061,CTCF,539
chr1,143246877,143247418,SRX16500060,CTCF,541
chr1,143246879,143247422,SRX20140897,INTS13,543
chr1,143246884,143247381,SRX20140861,SOX2,497
chr1,143246887,143247388,SRX20140869,INTS10,501
chr1,143246894,143247391,SRX20140862,SOX2,497
chr1,143246894,143247429,SRX20140892,SOX2,535
chr1,143246905,143247090,SRX5075169,SMARCA4,185
chr1,143246906,143247364,SRX5716468,SMARCA2,458
chr1,143246908,143247463,SRX9989504,GFP,555
chr1,143246914,143247352,SRX5075182,SMARCA2,438
chr1,143246921,143247404,SRX20140895,INTS13,483
chr1,143246924,143247345,SRX20140896,INTS13,421
chr1,143246926,143247412,SRX20140890,SOX2,486
chr1,143246933,143247395,SRX20140868,INTS10,462
chr1,143246978,143247390,SRX20140870,INTS10,412
chr1,143246991,143247409,SRX20140891,SOX2,418
chr1,143247004,143247407,SRX20140867,INTS10,403
chr1,143247148,143247405,SRX4174629,CTCF,257
chr1,143247149,143247367,SRX5075175,SMARCA4,218
chr1,143247161,143247342,SRX5075170,SMARCA4,181
chr1,143247266,143247376,SRX1424894,POU3F2,110
chr1,143247328,143247376,SRX1424891,POU3F2,48
chr1,143249695,143250030,SRX20140867,INTS10,335
chr1,143249695,143250033,SRX16500060,CTCF,338
chr1,143249698,143250020,SRX20140890,SOX2,322
chr1,143249699,143250016,SRX20140881,CPSF3L,317
chr1,143249702,143250028,SRX20140897,INTS13,326
chr1,143249705,143250019,SRX20140869,INTS10,314
chr1,143249710,143250125,SRX16500062,CTCF,415
chr1,143249711,143250056,SRX9989505,GFP,345
chr1,143249716,143250025,SRX16500061,CTCF,309
chr1,143249716,143250047,SRX20140868,INTS10,331
chr1,143249717,143250026,SRX20140895,INTS13,309
chr1,143249719,143250044,SRX16500059,CTCF,325
chr1,143249732,143250061,SRX9989504,GFP,329
chr1,143249734,143250023,SRX20140879,CPSF3L,289
chr1,143249743,143250013,SRX20140894,INTS13,270
chr1,143249752,143250024,SRX20140860,SOX2,272
chr1,143249756,143250013,SRX20140892,SOX2,257
chr1,143249760,143250027,SRX20140880,CPSF3L,267
chr1,143249761,143250001,SRX20140862,SOX2,240
chr1,143249761,143250019,SRX20140861,SOX2,258
chr1,143249763,143250044,SRX5716460,Epitope tags,281
chr1,143249771,143250021,SRX20140891,SOX2,250
chr1,143249773,143250011,SRX4174629,CTCF,238
chr1,143249779,143250000,SRX5075170,SMARCA4,221
chr1,143249780,143250000,SRX5075182,SMARCA2,220
chr1,143249781,143249836,SRX1424892,POU3F2,55
chr1,143249785,143250037,SRX5075181,SMARCA2,252
chr1,143249793,143250006,SRX5020214,SMARCA2,213
chr1,143249795,143250008,SRX5075175,SMARCA4,213
chr1,143249799,143249994,SRX5075169,SMARCA4,195
chr1,143249811,143250008,SRX5075174,SMARCA4,197
chr1,143249953,143250002,SRX1424892,POU3F2,49
chr1,143249955,143250001,SRX1424894,POU3F2,46
chr1,143250255,143250296,SRX1424894,POU3F2,41
chr1,143251605,143252116,SRX16500061,CTCF,511
chr1,143251769,143252183,SRX20140897,INTS13,414
chr1,143251775,143252085,SRX20140882,CPSF3L,310
chr1,143251783,143252173,SRX20140869,INTS10,390
chr1,143251898,143252143,SRX20140891,SOX2,245
chr1,143251931,143252217,SRX16500062,CTCF,286
chr1,143252734,143253176,SRX20140891,SOX2,442
chr1,143252742,143253167,SRX20140862,SOX2,425
chr1,143252758,143253113,SRX20140869,INTS10,355
chr1,143252764,143253129,SRX20140897,INTS13,365
chr1,143252766,143253110,SRX20140890,SOX2,344
chr1,143252770,143253132,SRX20140895,INTS13,362
chr1,143252770,143253160,SRX20140867,INTS10,390
chr1,143252775,143253105,SRX20140868,INTS10,330
chr1,143252778,143253069,SRX20140896,INTS13,291
chr1,143252778,143253171,SRX20140880,CPSF3L,393
chr1,143252785,143253175,SRX20140892,SOX2,390
chr1,143252802,143253109,SRX20140894,INTS13,307
chr1,143252810,143253133,SRX20140882,CPSF3L,323
chr1,143252813,143253090,SRX20140860,SOX2,277
chr1,143252813,143253121,SRX20140879,CPSF3L,308
chr1,143252819,143253100,SRX20140861,SOX2,281
chr1,143252823,143253099,SRX20140881,CPSF3L,276
chr1,143252835,143253204,SRX16500060,CTCF,369
chr1,143252837,143253147,SRX4174629,CTCF,310
chr1,143252839,143253203,SRX16500059,CTCF,364
chr1,143252842,143253207,SRX9989504,GFP,365
chr1,143252844,143253204,SRX16500061,CTCF,360
chr1,143252846,143253148,SRX5075181,SMARCA2,302
chr1,143252849,143253172,SRX5075182,SMARCA2,323
chr1,143252849,143253198,SRX16500062,CTCF,349
chr1,143252855,143253113,SRX5020214,SMARCA2,258
chr1,143252856,143253169,SRX5716467,SMARCA2,313
chr1,143252880,143253204,SRX9989505,GFP,324
chr1,143252929,143253166,SRX5075175,SMARCA4,237
chr1,143252996,143253105,SRX5075180,SMARCA2,109
chr1,143253006,143253114,SRX5020208,SMARCA2,108
chr1,143253021,143253094,SRX1424894,POU3F2,73
chr1,143253030,143253098,SRX1424893,POU3F2,68
chr1,143253051,143253103,SRX1424891,POU3F2,52
chr1,143253994,143255146,SRX20140881,CPSF3L,1152
chr1,143254030,143255063,SRX20140882,CPSF3L,1033
chr1,143254191,143255235,SRX20140894,INTS13,1044
chr1,143254282,143255050,SRX20140880,CPSF3L,768
chr1,143254372,143255023,SRX9989505,GFP,651
chr1,143254394,143255145,SRX20140879,CPSF3L,751
chr1,143254403,143255158,SRX20140869,INTS10,755
chr1,143254414,143255027,SRX9989504,GFP,613
chr1,143254423,143255050,SRX20140861,SOX2,627
chr1,143254427,143255067,SRX4174629,CTCF,640
chr1,143254433,143255055,SRX16500060,CTCF,622
chr1,143254436,143255041,SRX16500062,CTCF,605
chr1,143254437,143255053,SRX16500061,CTCF,616
chr1,143254438,143255017,SRX20140892,SOX2,579
chr1,143254447,143255059,SRX16500059,CTCF,612
chr1,143254451,143254983,SRX5716468,SMARCA2,532
chr1,143254453,143255045,SRX20140862,SOX2,592
chr1,143254453,143255074,SRX20140860,SOX2,621
chr1,143254460,143255048,SRX5075176,SMARCA4,588
chr1,143254461,143255037,SRX5075182,SMARCA2,576
chr1,143254485,143255054,SRX20140891,SOX2,569
chr1,143254488,143254537,SRX1424892,POU3F2,49
chr1,143254488,143255058,SRX20140867,INTS10,570
chr1,143254506,143255134,SRX20140896,INTS13,628
chr1,143254506,143255149,SRX20140897,INTS13,643
chr1,143254511,143254959,SRX5075174,SMARCA4,448
chr1,143254514,143255074,SRX20140895,INTS13,560
chr1,143254529,143255135,SRX20140870,INTS10,606
chr1,143254541,143255056,SRX5075170,SMARCA4,515
chr1,143254544,143255056,SRX20140890,SOX2,512
chr1,143254570,143254955,SRX5716455,SOX3,385
chr1,143254581,143255062,SRX20140868,INTS10,481
chr1,143254593,143255041,SRX5716459,Epitope tags,448
chr1,143254594,143255040,SRX5716467,SMARCA2,446
chr1,143254598,143254999,SRX5075175,SMARCA4,401
chr1,143254614,143255063,SRX5716460,Epitope tags,449
chr1,143254626,143254943,SRX5716452,SOX2,317
chr1,143254629,143254988,SRX5075169,SMARCA4,359
chr1,143254633,143254928,SRX5716456,SOX3,295
chr1,143254640,143254987,SRX5020214,SMARCA2,347
chr1,143254652,143255000,SRX5075181,SMARCA2,348
chr1,143254676,143254982,SRX5716464,SMARCA4,306
chr1,143254681,143255042,SRX5054307,FOSL2,361
chr1,143254686,143255039,SRX5716451,SOX2,353
chr1,143254691,143254986,SRX5020211,SMARCA2,295
chr1,143254692,143255036,SRX5075168,SMARCA4,344
chr1,143254738,143254953,SRX5716469,SMARCA4,215
chr1,143254739,143254939,SRX5054309,FOSL2,200
chr1,143254782,143254935,SRX5020208,SMARCA2,153
chr1,143254784,143254909,SRX1424894,POU3F2,125
chr1,143254784,143254939,SRX1424893,POU3F2,155
chr1,143254785,143254926,SRX5075180,SMARCA2,141
chr1,143254794,143254895,SRX1424891,POU3F2,101
chr1,143254794,143254932,SRX1424892,POU3F2,138
chr1,143255294,143255995,SRX20140895,INTS13,701
chr1,143255303,143256015,SRX20140861,SOX2,712
chr1,143255311,143255950,SRX20140879,CPSF3L,639
chr1,143255314,143255961,SRX20140897,INTS13,647
chr1,143255314,143255984,SRX20140868,INTS10,670
chr1,143255315,143255967,SRX20140881,CPSF3L,652
chr1,143255316,143255929,SRX20140860,SOX2,613
chr1,143255318,143256034,SRX20140867,INTS10,716
chr1,143255319,143255992,SRX20140869,INTS10,673
chr1,143255323,143255875,SRX20140870,INTS10,552
chr1,143255336,143255989,SRX20140890,SOX2,653
chr1,143255406,143255916,SRX20140891,SOX2,510
chr1,143255408,143255950,SRX20140880,CPSF3L,542
chr1,143255412,143255911,SRX20140862,SOX2,499
chr1,143255413,143255933,SRX20140894,INTS13,520
chr1,143255436,143256060,SRX16500061,CTCF,624
chr1,143255442,143256069,SRX16500062,CTCF,627
chr1,143255485,143256070,SRX16500059,CTCF,585
chr1,143255488,143255938,SRX20140892,SOX2,450
chr1,143255491,143255912,SRX20140882,CPSF3L,421
chr1,143255551,143256019,SRX4174629,CTCF,468
chr1,143255613,143255909,SRX20140896,INTS13,296
chr1,143255686,143256069,SRX16500060,CTCF,383
chr1,143255757,143256022,SRX5075182,SMARCA2,265
chr1,143255931,143255985,SRX5020208,SMARCA2,54
chr1,143255946,143255988,SRX1424893,POU3F2,42
chr1,143256278,143256523,SRX20140897,INTS13,245
chr1,143256330,143256561,SRX16500060,CTCF,231
chr1,143256358,143256621,SRX9989505,GFP,263
chr1,143256380,143256626,SRX20140867,INTS10,246
chr1,143256380,143256720,SRX20140881,CPSF3L,340
chr1,143256383,143256738,SRX20140860,SOX2,355
chr1,143256389,143256644,SRX20140879,CPSF3L,255
chr1,143256389,143256714,SRX20140894,INTS13,325
chr1,143256397,143256480,SRX1424894,POU3F2,83
chr1,143256397,143256494,SRX5020208,SMARCA2,97
chr1,143256425,143256487,SRX5075180,SMARCA2,62
chr1,143261995,143263049,SRX20140895,INTS13,1054
chr1,143261998,143263076,SRX20140869,INTS10,1078
chr1,143262001,143263077,SRX20140879,CPSF3L,1076
chr1,143262003,143263060,SRX20140897,INTS13,1057
chr1,143262008,143263264,SRX20140882,CPSF3L,1256
chr1,143262011,143263809,SRX20140881,CPSF3L,1798
chr1,143262015,143263068,SRX20140890,SOX2,1053
chr1,143262072,143263036,SRX20140891,SOX2,964
chr1,143262080,143263028,SRX20140870,INTS10,948
chr1,143262088,143263089,SRX20140861,SOX2,1001
chr1,143262090,143263063,SRX20140867,INTS10,973
chr1,143262092,143263090,SRX20140880,CPSF3L,998
chr1,143262093,143262998,SRX20140862,SOX2,905
chr1,143262096,143263090,SRX20140860,SOX2,994
chr1,143262099,143263115,SRX20140894,INTS13,1016
chr1,143262100,143262994,SRX20140868,INTS10,894
chr1,143262100,143263039,SRX20140892,SOX2,939
chr1,143262122,143262943,SRX16500062,CTCF,821
chr1,143262126,143262938,SRX20140896,INTS13,812
chr1,143262131,143263017,SRX9989504,GFP,886
chr1,143262144,143262953,SRX4174629,CTCF,809
chr1,143262147,143262946,SRX16500059,CTCF,799
chr1,143262160,143262961,SRX16500061,CTCF,801
chr1,143262163,143262922,SRX16500060,CTCF,759
chr1,143262216,143262789,SRX5716468,SMARCA2,573
chr1,143262251,143262811,SRX5075181,SMARCA2,560
chr1,143262310,143262769,SRX5075175,SMARCA4,459
chr1,143262324,143262794,SRX5075170,SMARCA4,470
chr1,143262326,143262419,SRX1424893,POU3F2,93
chr1,143262327,143262400,SRX1424894,POU3F2,73
chr1,143262328,143262419,SRX1424892,POU3F2,91
chr1,143262333,143262766,SRX5020214,SMARCA2,433
chr1,143262335,143262394,SRX5075180,SMARCA2,59
chr1,143262356,143262622,SRX5716459,Epitope tags,266
chr1,143262382,143262810,SRX5075182,SMARCA2,428
chr1,143262430,143262751,SRX5075176,SMARCA4,321
chr1,143262433,143262731,SRX5075168,SMARCA4,298
chr1,143262450,143262769,SRX5075174,SMARCA4,319
chr1,143262502,143262755,SRX5716467,SMARCA2,253
chr1,143262532,143263016,SRX9989505,GFP,484
chr1,143263369,143263780,SRX20140882,CPSF3L,411
chr1,143263383,143263745,SRX20140894,INTS13,362
chr1,143263404,143263746,SRX20140869,INTS10,342
chr1,143263405,143263787,SRX20140861,SOX2,382
chr1,143263408,143263772,SRX20140860,SOX2,364
chr1,143263409,143263771,SRX20140880,CPSF3L,362
chr1,143263416,143263788,SRX20140896,INTS13,372
chr1,143263419,143263774,SRX20140879,CPSF3L,355
chr1,143263477,143263824,SRX20140890,SOX2,347
chr1,143263497,143264026,SRX20140870,INTS10,529
chr1,143263498,143263965,SRX20140897,INTS13,467
chr1,143263509,143263789,SRX20140892,SOX2,280
chr1,143263525,143263783,SRX20140895,INTS13,258
chr1,143264014,143264760,SRX20140897,INTS13,746
chr1,143264051,143264753,SRX20140890,SOX2,702
chr1,143264067,143264789,SRX20140879,CPSF3L,722
chr1,143264225,143264763,SRX20140868,INTS10,538
chr1,143264231,143264843,SRX20140881,CPSF3L,612
chr1,143264234,143264783,SRX20140860,SOX2,549
chr1,143264237,143264792,SRX20140869,INTS10,555
chr1,143264333,143264763,SRX20140895,INTS13,430
chr1,143264338,143264771,SRX20140861,SOX2,433
chr1,143264425,143264791,SRX20140894,INTS13,366
chr1,143264429,143264808,SRX20140880,CPSF3L,379
chr1,143264439,143264769,SRX20140867,INTS10,330
chr1,143264440,143264771,SRX20140891,SOX2,331
chr1,143264442,143264852,SRX20140882,CPSF3L,410
chr1,143264443,143264749,SRX20140896,INTS13,306
chr1,143264446,143264771,SRX20140862,SOX2,325
chr1,143264448,143264820,SRX16500061,CTCF,372
chr1,143264452,143264808,SRX16500060,CTCF,356
chr1,143264453,143264774,SRX20140892,SOX2,321
chr1,143264457,143264825,SRX16500062,CTCF,368
chr1,143264463,143264821,SRX16500059,CTCF,358
chr1,143264465,143264791,SRX9989505,GFP,326
chr1,143264467,143264779,SRX9989504,GFP,312
chr1,143264474,143264779,SRX20140870,INTS10,305
chr1,143264475,143264776,SRX4174629,CTCF,301
chr1,143264477,143264776,SRX5075182,SMARCA2,299
chr1,143264483,143264779,SRX5716468,SMARCA2,296
chr1,143264486,143264794,SRX5075175,SMARCA4,308
chr1,143264491,143264761,SRX5020214,SMARCA2,270
chr1,143264494,143264720,SRX5716467,SMARCA2,226
chr1,143264512,143264759,SRX5075168,SMARCA4,247
chr1,143264538,143264789,SRX5075176,SMARCA4,251
chr1,143264549,143264755,SRX5075170,SMARCA4,206
chr1,143264643,143264731,SRX5075180,SMARCA2,88
chr1,143264647,143264727,SRX5020208,SMARCA2,80
chr1,143264660,143264719,SRX1424893,POU3F2,59
chr1,143265639,143265902,SRX20140895,INTS13,263
chr1,143266507,143266860,SRX5075174,SMARCA4,353
chr1,143266512,143266928,SRX16500062,CTCF,416
chr1,143266517,143266610,SRX1424892,POU3F2,93
chr1,143266518,143266616,SRX1424894,POU3F2,98
chr1,143266520,143266617,SRX1424893,POU3F2,97
chr1,143266522,143267036,SRX16500060,CTCF,514
chr1,143266525,143267434,SRX20140895,INTS13,909
chr1,143266531,143266576,SRX1424891,POU3F2,45
chr1,143266536,143267195,SRX16500061,CTCF,659
chr1,143266544,143267454,SRX20140868,INTS10,910
chr1,143266548,143266930,SRX4174629,CTCF,382
chr1,143266554,143267090,SRX20140879,CPSF3L,536
chr1,143266566,143267137,SRX20140894,INTS13,571
chr1,143266576,143267497,SRX20140867,INTS10,921
chr1,143266579,143267479,SRX20140897,INTS13,900
chr1,143266586,143267383,SRX20140880,CPSF3L,797
chr1,143266587,143267477,SRX20140891,SOX2,890
chr1,143266588,143267310,SRX20140881,CPSF3L,722
chr1,143266591,143267450,SRX20140890,SOX2,859
chr1,143266599,143267064,SRX20140861,SOX2,465
chr1,143266603,143267064,SRX20140862,SOX2,461
chr1,143266604,143267372,SRX20140860,SOX2,768
chr1,143266610,143267447,SRX20140869,INTS10,837
chr1,143266611,143266936,SRX20140896,INTS13,325
chr1,143266721,143267055,SRX20140882,CPSF3L,334
chr1,143266738,143267412,SRX20140870,INTS10,674
chr1,143266834,143267074,SRX20140892,SOX2,240
chr1,143267131,143267482,SRX20140861,SOX2,351
chr1,143269593,143269639,SRX1424893,POU3F2,46
chr1,143273094,143273162,SRX5075180,SMARCA2,68
chr1,143273096,143273163,SRX1424893,POU3F2,67
chr1,143273097,143273150,SRX5020208,SMARCA2,53
chr1,143273098,143273161,SRX1424892,POU3F2,63
chr1,143273099,143273162,SRX1424891,POU3F2,63
chr1,143273101,143273163,SRX1424894,POU3F2,62
chr1,143273573,143274104,SRX20140881,CPSF3L,531
chr1,143273595,143273940,SRX20140860,SOX2,345
chr1,143273647,143274052,SRX20140869,INTS10,405
chr1,143273806,143273885,SRX1424892,POU3F2,79
chr1,143273812,143273889,SRX1424894,POU3F2,77
chr1,143273831,143274126,SRX20140890,SOX2,295
chr1,143273850,143273890,SRX1424891,POU3F2,40
chr1,143273857,143274130,SRX20140894,INTS13,273
chr1,143274069,143274112,SRX1424891,POU3F2,43
chr1,143274069,143274113,SRX1424894,POU3F2,44
chr1,143274071,143274120,SRX1424893,POU3F2,49
chr1,143274885,143274930,SRX1424892,POU3F2,45
chr1,143275241,143275307,SRX1424894,POU3F2,66
chr1,143275245,143275308,SRX1424892,POU3F2,63
chr1,143275248,143275306,SRX1424891,POU3F2,58
chr1,143275257,143275309,SRX1424893,POU3F2,52
chr1,143275387,143275921,SRX4174629,CTCF,534
chr1,143275469,143275525,SRX1424894,POU3F2,56
chr1,143275471,143275587,SRX1424893,POU3F2,116
chr1,143275472,143275592,SRX1424891,POU3F2,120
chr1,143275475,143275593,SRX1424892,POU3F2,118
chr1,143275480,143275895,SRX5075175,SMARCA4,415
chr1,143275584,143275763,SRX5075182,SMARCA2,179
chr1,143275630,143275948,SRX16500060,CTCF,318
chr1,143275633,143275937,SRX16500059,CTCF,304
chr1,143275649,143275928,SRX16500062,CTCF,279
chr1,143275703,143275855,SRX1424891,POU3F2,152
chr1,143275705,143275859,SRX1424893,POU3F2,154
chr1,143275708,143275858,SRX1424892,POU3F2,150
chr1,143275709,143275944,SRX16500061,CTCF,235
chr1,143275710,143275914,SRX1424894,POU3F2,204
chr1,143275904,143275949,SRX1424891,POU3F2,45
chr1,143326723,143326926,SRX5075168,SMARCA4,203
chr1,143326731,143327086,SRX20140895,INTS13,355
chr1,143326921,143327135,SRX20140867,INTS10,214
chr1,143334356,143334776,SRX16500060,CTCF,420
chr1,143334372,143334758,SRX16500062,CTCF,386
chr1,143334389,143334807,SRX16500059,CTCF,418
chr1,143334401,143334730,SRX16500061,CTCF,329
chr1,143334468,143334719,SRX4174629,CTCF,251
chr1,143334525,143334717,SRX5075170,SMARCA4,192
chr1,143334531,143334712,SRX5075174,SMARCA4,181
chr1,143391759,143392080,SRX16500059,CTCF,321
chr1,143391763,143392095,SRX16500061,CTCF,332
chr1,143391774,143392081,SRX16500060,CTCF,307
chr1,143391799,143392063,SRX16500062,CTCF,264
chr1,143391810,143392094,SRX4174629,CTCF,284
chr1,143393341,143393650,SRX16500062,CTCF,309
chr1,143393360,143393644,SRX16500060,CTCF,284
chr1,143393377,143393671,SRX16500059,CTCF,294
chr1,143393384,143393661,SRX4174629,CTCF,277
chr1,143395406,143395656,SRX16500059,CTCF,250
chr1,143395423,143395654,SRX16500060,CTCF,231
chr1,143395460,143395679,SRX16500061,CTCF,219
chr1,143421534,143421895,SRX5716470,SMARCA4,361
chr1,143421551,143422076,SRX5075169,SMARCA4,525
chr1,143421561,143422057,SRX5075176,SMARCA4,496
chr1,143421601,143421931,SRX5054308,FOSL2,330
chr1,143421605,143421896,SRX5075174,SMARCA4,291
chr1,143421605,143422017,SRX5716469,SMARCA4,412
chr1,143421618,143422012,SRX5075170,SMARCA4,394
chr1,143421619,143421959,SRX5054309,FOSL2,340
chr1,143421645,143422021,SRX5075175,SMARCA4,376
chr1,143421688,143421929,SRX5075168,SMARCA4,241
chr1,143421727,143421961,SRX5716467,SMARCA2,234
chr1,143540714,143540756,SRX1424892,POU3F2,42
chr1,143540715,143540758,SRX1424894,POU3F2,43
chr1,143540716,143540756,SRX1424891,POU3F2,40
chr1,143540716,143540760,SRX1424893,POU3F2,44
chr1,143698059,143698414,SRX4174629,CTCF,355
chr1,143709609,143709886,SRX4174629,CTCF,277
chr1,143728494,143729655,SRX20140881,CPSF3L,1161
chr1,143728638,143729761,SRX20140869,INTS10,1123
chr1,143728665,143729752,SRX20140895,INTS13,1087
chr1,143728670,143729772,SRX20140896,INTS13,1102
chr1,143728730,143729728,SRX20140867,INTS10,998
chr1,143728779,143729769,SRX20140897,INTS13,990
chr1,143728812,143729635,SRX20140894,INTS13,823
chr1,143728816,143729709,SRX20140879,CPSF3L,893
chr1,143728863,143729769,SRX20140868,INTS10,906
chr1,143728945,143729707,SRX20140870,INTS10,762
chr1,143729038,143729587,SRX20140880,CPSF3L,549
chr1,143729076,143729695,SRX20140882,CPSF3L,619
chr1,143729198,143729594,SRX5075176,SMARCA4,396
chr1,143729244,143729527,SRX20140860,SOX2,283
chr1,143729305,143729568,SRX5075170,SMARCA4,263
chr1,143729311,143729611,SRX5075175,SMARCA4,300
chr1,143729372,143729587,SRX5075174,SMARCA4,215
chr1,143729630,143729686,SRX1424892,POU3F2,56
chr1,143729631,143729685,SRX1424891,POU3F2,54
chr1,143729632,143729687,SRX1424893,POU3F2,55
chr1,143729633,143729684,SRX1424894,POU3F2,51
chr1,143729865,143730090,SRX5075168,SMARCA4,225
chr1,143729913,143730149,SRX5075174,SMARCA4,236
chr1,143729931,143730155,SRX5075170,SMARCA4,224
chr1,143756056,143756235,SRX5075176,SMARCA4,179
chr1,143756069,143756312,SRX5075170,SMARCA4,243
chr1,143756143,143756360,SRX5054309,FOSL2,217
chr1,143760437,143760666,SRX5075176,SMARCA4,229
chr1,143770779,143770972,SRX5075175,SMARCA4,193
chr1,143778247,143778468,SRX16500060,CTCF,221
chr1,143778337,143778628,SRX16500059,CTCF,291
chr1,143803019,143803595,SRX4174629,CTCF,576
chr1,143803110,143803436,SRX16500062,CTCF,326
chr1,143803120,143803447,SRX16500061,CTCF,327
chr1,143803130,143803510,SRX16500060,CTCF,380
chr1,143803136,143803318,SRX5075168,SMARCA4,182
chr1,143803143,143803430,SRX5075170,SMARCA4,287
chr1,143803144,143803369,SRX5075176,SMARCA4,225
chr1,143803148,143803360,SRX5075174,SMARCA4,212
chr1,143803148,143803455,SRX16500059,CTCF,307
chr1,143803157,143803371,SRX5716470,SMARCA4,214
chr1,143803159,143803381,SRX5075175,SMARCA4,222
chr1,143803166,143803347,SRX5075169,SMARCA4,181
chr1,143884389,143885164,SRX4174629,CTCF,775
chr1,143884420,143885319,SRX16500060,CTCF,899
chr1,143884459,143885350,SRX16500062,CTCF,891
chr1,143884462,143885367,SRX16500059,CTCF,905
chr1,143884472,143885340,SRX16500061,CTCF,868
chr1,143884506,143884897,SRX5075168,SMARCA4,391
chr1,143884513,143885068,SRX5075176,SMARCA4,555
chr1,143884522,143884874,SRX5075174,SMARCA4,352
chr1,143884536,143884798,SRX5075175,SMARCA4,262
chr1,143884537,143884955,SRX5075170,SMARCA4,418
chr1,143884554,143885051,SRX5716470,SMARCA4,497
chr1,143884631,143884888,SRX20140867,INTS10,257
chr1,143884675,143885173,SRX20140895,INTS13,498
chr1,143884703,143884978,SRX5716464,SMARCA4,275
chr1,143884703,143885265,SRX5075169,SMARCA4,562
chr1,143884854,143885101,SRX20140897,INTS13,247
chr1,143885010,143885241,SRX5075170,SMARCA4,231
chr1,143905617,143906123,SRX20140895,INTS13,506
chr1,143905687,143906054,SRX20140867,INTS10,367
chr1,143905698,143906144,SRX20140881,CPSF3L,446
chr1,143905717,143906142,SRX20140897,INTS13,425
chr1,143905807,143906092,SRX20140896,INTS13,285
chr1,143921992,143922216,SRX5054308,FOSL2,224
chr1,143936344,143936943,SRX16500060,CTCF,599
chr1,143936345,143936987,SRX4174629,CTCF,642
chr1,143936380,143936892,SRX16500062,CTCF,512
chr1,143936462,143937006,SRX16500059,CTCF,544
chr1,143936472,143936904,SRX16500061,CTCF,432
chr1,143936585,143936798,SRX5075174,SMARCA4,213
chr1,143936585,143936828,SRX5075170,SMARCA4,243
chr1,143936613,143936863,SRX5075168,SMARCA4,250
chr1,143936635,143936810,SRX5075176,SMARCA4,175
chr1,143943621,143943964,SRX16500060,CTCF,343
chr1,143943640,143943989,SRX16500059,CTCF,349
chr1,143943649,143943963,SRX16500062,CTCF,314
chr1,143943700,143944062,SRX4174629,CTCF,362
chr1,143943709,143943985,SRX16500061,CTCF,276
chr1,143945260,143945669,SRX5075169,SMARCA4,409
chr1,143945264,143945633,SRX5054309,FOSL2,369
chr1,143945296,143945659,SRX5075175,SMARCA4,363
chr1,143945312,143945619,SRX5075170,SMARCA4,307
chr1,143945335,143945678,SRX5075176,SMARCA4,343
chr1,143945344,143945567,SRX5716467,SMARCA2,223
chr1,143945364,143945589,SRX5054308,FOSL2,225
chr1,143951431,143951791,SRX5075176,SMARCA4,360
chr1,143951458,143951887,SRX5716470,SMARCA4,429
chr1,143951481,143951907,SRX5075169,SMARCA4,426
chr1,143951484,143951861,SRX5075170,SMARCA4,377
chr1,143951496,143951801,SRX5075175,SMARCA4,305
chr1,143951527,143951750,SRX5716469,SMARCA4,223
chr1,143951529,143951773,SRX5716467,SMARCA2,244
chr1,143951965,143952375,SRX5054309,FOSL2,410
chr1,143951990,143952356,SRX5075169,SMARCA4,366
chr1,143952018,143952223,SRX5020214,SMARCA2,205
chr1,143952020,143952303,SRX5075176,SMARCA4,283
chr1,143952036,143952361,SRX5075170,SMARCA4,325
chr1,143952050,143952363,SRX5054308,FOSL2,313
chr1,143952059,143952411,SRX5075175,SMARCA4,352
chr1,143971659,143971924,SRX20140895,INTS13,265
chr1,143971949,143972622,SRX5054307,FOSL2,673
chr1,143972101,143972485,SRX5054308,FOSL2,384
chr1,143972252,143972461,SRX5716463,SMARCA4,209
chr1,143972274,143972540,SRX5054309,FOSL2,266
chr1,143972340,143972570,SRX5075174,SMARCA4,230
chr1,143972351,143972536,SRX5075168,SMARCA4,185
chr1,143972553,143973028,SRX20140895,INTS13,475
chr1,143985270,143985587,SRX5075168,SMARCA4,317
chr1,143985309,143985500,SRX5075174,SMARCA4,191
chr1,143996112,143996300,SRX5075170,SMARCA4,188
chr1,144004199,144004444,SRX5075170,SMARCA4,245
chr1,144004415,144004603,SRX5075175,SMARCA4,188
chr1,144004422,144004602,SRX5075176,SMARCA4,180
chr1,144019398,144020039,SRX5075174,SMARCA4,641
chr1,144019497,144019908,SRX5075168,SMARCA4,411
chr1,144021471,144022312,SRX5075176,SMARCA4,841
chr1,144021498,144021897,SRX5716467,SMARCA2,399
chr1,144021500,144022265,SRX5075170,SMARCA4,765
chr1,144021524,144022374,SRX5075175,SMARCA4,850
chr1,144021546,144022336,SRX5075169,SMARCA4,790
chr1,144021604,144021784,SRX5054308,FOSL2,180
chr1,144021607,144021858,SRX5054309,FOSL2,251
chr1,144021607,144022218,SRX5716469,SMARCA4,611
chr1,144021649,144022259,SRX5716468,SMARCA2,610
chr1,144021670,144022337,SRX5716470,SMARCA4,667
chr1,144021707,144022028,SRX5020211,SMARCA2,321
chr1,144021811,144022218,SRX5075181,SMARCA2,407
chr1,144021951,144022186,SRX5716467,SMARCA2,235
chr1,144022092,144022317,SRX5020211,SMARCA2,225
chr1,144031682,144031900,SRX5075168,SMARCA4,218
chr1,144031713,144031894,SRX5075169,SMARCA4,181
chr1,144031741,144031966,SRX5054309,FOSL2,225
chr1,144033223,144033436,SRX5716469,SMARCA4,213
chr1,144033927,144034445,SRX5075170,SMARCA4,518
chr1,144033933,144034139,SRX5075176,SMARCA4,206
chr1,144033970,144034519,SRX5075175,SMARCA4,549
chr1,144034107,144034528,SRX5075169,SMARCA4,421
chr1,144034187,144034500,SRX5716469,SMARCA4,313
chr1,144034306,144034513,SRX5075176,SMARCA4,207
chr1,144034313,144034537,SRX5020211,SMARCA2,224
chr1,144046109,144046319,SRX16500062,CTCF,210
chr1,144055510,144055796,SRX5075169,SMARCA4,286
chr1,144055540,144055855,SRX5054309,FOSL2,315
chr1,144055579,144055819,SRX5054308,FOSL2,240
chr1,144065208,144065982,SRX5075170,SMARCA4,774
chr1,144065562,144066344,SRX5075175,SMARCA4,782
chr1,144065578,144066029,SRX5075169,SMARCA4,451
chr1,144065626,144065982,SRX5716469,SMARCA4,356
chr1,144065710,144066049,SRX5075176,SMARCA4,339
chr1,144070031,144070220,SRX5075168,SMARCA4,189
chr1,144077283,144077463,SRX5075174,SMARCA4,180
chr1,144078445,144079017,SRX16500060,CTCF,572
chr1,144078481,144079156,SRX16500059,CTCF,675
chr1,144078571,144079076,SRX16500061,CTCF,505
chr1,144078633,144079070,SRX16500062,CTCF,437
chr1,144078758,144078927,SRX5075170,SMARCA4,169
chr1,144078797,144079135,SRX4174629,CTCF,338
chr1,144104325,144104720,SRX9989504,GFP,395
chr1,144128335,144128555,SRX5054308,FOSL2,220
chr1,144128348,144128562,SRX5054309,FOSL2,214
chr1,144128356,144128554,SRX5075175,SMARCA4,198
chr1,144159934,144160309,SRX16500059,CTCF,375
chr1,144159968,144160353,SRX16500060,CTCF,385
chr1,144159981,144160276,SRX16500062,CTCF,295
chr1,144159996,144160283,SRX4174629,CTCF,287
chr1,144159996,144160312,SRX16500061,CTCF,316
chr1,144160111,144160330,SRX5075174,SMARCA4,219
chr1,144160187,144160360,SRX5075170,SMARCA4,173
chr1,144217325,144217689,SRX16500061,CTCF,364
chr1,144217334,144217661,SRX16500059,CTCF,327
chr1,144217343,144217685,SRX16500060,CTCF,342
chr1,144217381,144217677,SRX16500062,CTCF,296
chr1,144217402,144217632,SRX4174629,CTCF,230
chr1,144218918,144219172,SRX4174629,CTCF,254
chr1,144218930,144219189,SRX16500060,CTCF,259
chr1,144218934,144219271,SRX16500059,CTCF,337
chr1,144218944,144219180,SRX16500061,CTCF,236
chr1,144218979,144219234,SRX16500062,CTCF,255
chr1,144221068,144221278,SRX16500062,CTCF,210
chr1,144247062,144247655,SRX5075170,SMARCA4,593
chr1,144247130,144247739,SRX5075176,SMARCA4,609
chr1,144247157,144247657,SRX5075169,SMARCA4,500
chr1,144247175,144247467,SRX5716467,SMARCA2,292
chr1,144247201,144247626,SRX5716469,SMARCA4,425
chr1,144247208,144247539,SRX5054309,FOSL2,331
chr1,144247230,144247563,SRX5716470,SMARCA4,333
chr1,144247250,144247536,SRX5054308,FOSL2,286
chr1,144247261,144247558,SRX5075174,SMARCA4,297
chr1,144247272,144247529,SRX5716468,SMARCA2,257
chr1,144247285,144247702,SRX5075175,SMARCA4,417
chr1,144247301,144247539,SRX5075168,SMARCA4,238
chr1,144402801,144403209,SRX5075175,SMARCA4,408
chr1,144402813,144403202,SRX5054309,FOSL2,389
chr1,144402838,144403162,SRX5075169,SMARCA4,324
chr1,144402844,144403164,SRX5054308,FOSL2,320
chr1,144402854,144403080,SRX5075168,SMARCA4,226
chr1,144402878,144403121,SRX5075174,SMARCA4,243
chr1,144402880,144403155,SRX5075170,SMARCA4,275
chr1,144402892,144403142,SRX5075176,SMARCA4,250
chr1,144412039,144412245,SRX5716451,SOX2,206
chr1,144412114,144412301,SRX5075170,SMARCA4,187
chr1,144412514,144413546,SRX20140895,INTS13,1032
chr1,144412524,144413419,SRX20140867,INTS10,895
chr1,144412527,144413512,SRX20140879,CPSF3L,985
chr1,144412535,144413193,SRX20140897,INTS13,658
chr1,144412541,144413489,SRX20140881,CPSF3L,948
chr1,144412566,144413416,SRX20140894,INTS13,850
chr1,144412572,144413174,SRX20140868,INTS10,602
chr1,144412574,144413368,SRX20140869,INTS10,794
chr1,144412590,144413451,SRX20140896,INTS13,861
chr1,144412632,144413141,SRX20140880,CPSF3L,509
chr1,144412645,144413079,SRX20140882,CPSF3L,434
chr1,144412653,144412987,SRX20140870,INTS10,334
chr1,144412674,144413182,SRX5075169,SMARCA4,508
chr1,144412683,144412958,SRX5075176,SMARCA4,275
chr1,144412708,144412953,SRX5716467,SMARCA2,245
chr1,144412825,144413002,SRX5075170,SMARCA4,177
chr1,144412834,144413083,SRX5716470,SMARCA4,249
chr1,144418550,144419161,SRX16500059,CTCF,611
chr1,144418558,144419164,SRX16500062,CTCF,606
chr1,144418560,144419029,SRX16500060,CTCF,469
chr1,144418610,144419042,SRX4174629,CTCF,432
chr1,144418615,144419158,SRX16500061,CTCF,543
chr1,144418616,144418827,SRX5716470,SMARCA4,211
chr1,144418637,144418825,SRX5075169,SMARCA4,188
chr1,144418651,144419053,SRX5075170,SMARCA4,402
chr1,144418702,144419004,SRX5075174,SMARCA4,302
chr1,144418712,144418999,SRX5075168,SMARCA4,287
chr1,144418773,144418981,SRX5075176,SMARCA4,208
chr1,144439679,144440123,SRX16500059,CTCF,444
chr1,144439710,144440093,SRX16500061,CTCF,383
chr1,144439722,144440125,SRX16500060,CTCF,403
chr1,144439774,144440127,SRX16500062,CTCF,353
chr1,144439821,144440066,SRX4174629,CTCF,245
chr1,144439823,144440033,SRX5075168,SMARCA4,210
chr1,144444928,144445192,SRX5075174,SMARCA4,264
chr1,144460664,144460886,SRX5075170,SMARCA4,222
chr1,144460775,144460988,SRX5075176,SMARCA4,213
chr1,144461303,144461526,SRX5716470,SMARCA4,223
chr1,144461403,144462025,SRX20140895,INTS13,622
chr1,144461427,144462114,SRX5075174,SMARCA4,687
chr1,144461467,144461993,SRX5075168,SMARCA4,526
chr1,144461523,144462059,SRX20140868,INTS10,536
chr1,144461539,144462129,SRX5075170,SMARCA4,590
chr1,144461617,144462174,SRX5075176,SMARCA4,557
chr1,144461657,144461879,SRX5075175,SMARCA4,222
chr1,144461677,144461901,SRX5075169,SMARCA4,224
chr1,144480113,144480414,SRX5075174,SMARCA4,301
chr1,144485318,144485733,SRX16500060,CTCF,415
chr1,144485321,144485712,SRX16500059,CTCF,391
chr1,144485343,144485668,SRX16500061,CTCF,325
chr1,144485368,144485659,SRX16500062,CTCF,291
chr1,144485387,144485713,SRX5075174,SMARCA4,326
chr1,144485390,144485736,SRX4174629,CTCF,346
chr1,144485408,144485684,SRX5716469,SMARCA4,276
chr1,144485412,144485684,SRX5075168,SMARCA4,272
chr1,144485440,144485697,SRX5075170,SMARCA4,257
chr1,144485454,144485723,SRX5075176,SMARCA4,269
chr1,144485464,144485705,SRX5075169,SMARCA4,241
chr1,144485496,144485683,SRX5075175,SMARCA4,187
chr1,144490106,144490616,SRX4174629,CTCF,510
chr1,144490151,144490498,SRX16500060,CTCF,347
chr1,144490171,144490434,SRX16500059,CTCF,263
chr1,144490188,144490532,SRX16500062,CTCF,344
chr1,144490208,144490527,SRX16500061,CTCF,319
chr1,144490240,144490512,SRX5075170,SMARCA4,272
chr1,144511730,144512012,SRX5054308,FOSL2,282
chr1,144511781,144512000,SRX5054309,FOSL2,219
chr1,144511803,144512018,SRX5075175,SMARCA4,215
chr1,144516433,144516644,SRX5075170,SMARCA4,211
chr1,144516443,144516794,SRX5075169,SMARCA4,351
chr1,144516445,144516691,SRX5716470,SMARCA4,246
chr1,144516484,144516684,SRX5020211,SMARCA2,200
chr1,144516487,144516778,SRX5075176,SMARCA4,291
chr1,144522568,144522819,SRX16500060,CTCF,251
chr1,144523305,144524148,SRX20140881,CPSF3L,843
chr1,144523373,144524099,SRX20140896,INTS13,726
chr1,144523459,144524118,SRX20140867,INTS10,659
chr1,144523470,144524071,SRX20140879,CPSF3L,601
chr1,144523524,144524161,SRX20140895,INTS13,637
chr1,144523557,144524028,SRX20140897,INTS13,471
chr1,144523579,144524012,SRX20140868,INTS10,433
chr1,144523731,144524025,SRX20140869,INTS10,294
chr1,144532015,144532509,SRX16500060,CTCF,494
chr1,144532083,144532463,SRX16500062,CTCF,380
chr1,144532090,144532449,SRX4174629,CTCF,359
chr1,144532101,144532506,SRX16500059,CTCF,405
chr1,144532140,144532475,SRX5075170,SMARCA4,335
chr1,144532147,144532420,SRX5075169,SMARCA4,273
chr1,144532155,144532444,SRX16500061,CTCF,289
chr1,144532159,144532424,SRX5075168,SMARCA4,265
chr1,144532170,144532398,SRX5075175,SMARCA4,228
chr1,144532171,144532415,SRX5075176,SMARCA4,244
chr1,144532201,144532461,SRX5075174,SMARCA4,260
chr1,144532221,144532473,SRX5716470,SMARCA4,252
chr1,144545619,144546797,SRX20140895,INTS13,1178
chr1,144545693,144546750,SRX20140868,INTS10,1057
chr1,144545697,144546688,SRX20140879,CPSF3L,991
chr1,144545746,144546531,SRX20140881,CPSF3L,785
chr1,144545769,144546724,SRX20140867,INTS10,955
chr1,144545774,144546619,SRX20140894,INTS13,845
chr1,144545783,144546280,SRX5075168,SMARCA4,497
chr1,144545794,144546328,SRX5075174,SMARCA4,534
chr1,144545830,144546250,SRX5716463,SMARCA4,420
chr1,144545848,144546203,SRX5716451,SOX2,355
chr1,144545882,144546229,SRX5716464,SMARCA4,347
chr1,144545913,144546713,SRX20140869,INTS10,800
chr1,144545931,144546305,SRX5075170,SMARCA4,374
chr1,144545938,144546742,SRX20140897,INTS13,804
chr1,144545946,144546243,SRX5075175,SMARCA4,297
chr1,144545959,144546253,SRX5075169,SMARCA4,294
chr1,144545978,144546549,SRX20140896,INTS13,571
chr1,144545981,144546397,SRX5075176,SMARCA4,416
chr1,144546597,144547056,SRX5075168,SMARCA4,459
chr1,144546622,144546982,SRX5075170,SMARCA4,360
chr1,144546629,144547003,SRX5075174,SMARCA4,374
chr1,144546682,144546897,SRX5054308,FOSL2,215
chr1,144546721,144547038,SRX5075176,SMARCA4,317
chr1,144546831,144547099,SRX5716470,SMARCA4,268
chr1,144546889,144547081,SRX5075175,SMARCA4,192
chr1,144551184,144552456,SRX20140895,INTS13,1272
chr1,144551209,144552234,SRX20140879,CPSF3L,1025
chr1,144551243,144552077,SRX20140881,CPSF3L,834
chr1,144551273,144552294,SRX20140867,INTS10,1021
chr1,144551417,144552283,SRX20140894,INTS13,866
chr1,144551421,144552077,SRX20140896,INTS13,656
chr1,144551481,144552399,SRX20140868,INTS10,918
chr1,144551547,144552222,SRX20140897,INTS13,675
chr1,144551581,144551893,SRX20140880,CPSF3L,312
chr1,144551595,144552170,SRX20140869,INTS10,575
chr1,144551607,144552054,SRX5075170,SMARCA4,447
chr1,144551679,144551854,SRX5075176,SMARCA4,175
chr1,144552080,144552373,SRX5075168,SMARCA4,293
chr1,144552202,144552429,SRX5075174,SMARCA4,227
chr1,144552213,144552382,SRX5075170,SMARCA4,169
chr1,144559793,144560960,SRX20140881,CPSF3L,1167
chr1,144559896,144560982,SRX20140869,INTS10,1086
chr1,144559933,144561042,SRX20140895,INTS13,1109
chr1,144559937,144561035,SRX20140867,INTS10,1098
chr1,144559938,144561010,SRX20140879,CPSF3L,1072
chr1,144559973,144560976,SRX20140896,INTS13,1003
chr1,144560018,144560956,SRX20140894,INTS13,938
chr1,144560040,144561012,SRX20140868,INTS10,972
chr1,144560071,144560921,SRX20140880,CPSF3L,850
chr1,144560075,144561010,SRX20140897,INTS13,935
chr1,144560148,144560929,SRX20140870,INTS10,781
chr1,144560234,144560414,SRX5075170,SMARCA4,180
chr1,144560316,144560969,SRX20140882,CPSF3L,653
chr1,144561065,144561381,SRX5075174,SMARCA4,316
chr1,144561098,144561299,SRX5075168,SMARCA4,201
chr1,144567640,144568370,SRX16500059,CTCF,730
chr1,144567653,144568290,SRX16500060,CTCF,637
chr1,144567698,144568283,SRX16500061,CTCF,585
chr1,144567713,144568236,SRX4174629,CTCF,523
chr1,144567723,144568242,SRX16500062,CTCF,519
chr1,144718643,144719162,SRX5075176,SMARCA4,519
chr1,144718677,144719290,SRX5075170,SMARCA4,613
chr1,144718710,144719177,SRX5075169,SMARCA4,467
chr1,144718732,144719169,SRX5075175,SMARCA4,437
chr1,144718765,144719297,SRX5716470,SMARCA4,532
chr1,144718810,144719115,SRX5054308,FOSL2,305
chr1,144718811,144719178,SRX5716467,SMARCA2,367
chr1,144718815,144719148,SRX5075174,SMARCA4,333
chr1,144718823,144719034,SRX5716468,SMARCA2,211
chr1,144718839,144719104,SRX5075168,SMARCA4,265
chr1,144718847,144719119,SRX5716469,SMARCA4,272
chr1,144718875,144719129,SRX5054309,FOSL2,254
chr1,144745110,144745366,SRX16500060,CTCF,256
chr1,144745131,144745373,SRX16500059,CTCF,242
chr1,144745132,144745434,SRX16500062,CTCF,302
chr1,144747140,144747363,SRX16500060,CTCF,223
chr1,144747152,144747362,SRX16500062,CTCF,210
chr1,144747162,144747397,SRX16500059,CTCF,235
chr1,144748657,144748968,SRX4174629,CTCF,311
chr1,144748680,144749045,SRX16500059,CTCF,365
chr1,144748702,144749034,SRX16500060,CTCF,332
chr1,144748724,144748969,SRX16500062,CTCF,245
chr1,144748725,144748999,SRX16500061,CTCF,274
chr1,144806019,144806442,SRX16500059,CTCF,423
chr1,144806031,144806419,SRX16500060,CTCF,388
chr1,144806034,144806429,SRX16500062,CTCF,395
chr1,144806049,144806368,SRX16500061,CTCF,319
chr1,144806088,144806261,SRX5075174,SMARCA4,173
chr1,144806130,144806349,SRX4174629,CTCF,219
chr1,144814151,144814459,SRX20140895,INTS13,308
chr1,144836884,144837158,SRX5054309,FOSL2,274
chr1,144836922,144837183,SRX5054308,FOSL2,261
chr1,144881589,144881943,SRX4174629,CTCF,354
chr1,144881652,144882143,SRX16500062,CTCF,491
chr1,144881666,144882154,SRX16500060,CTCF,488
chr1,144881678,144882188,SRX16500059,CTCF,510
chr1,144881710,144882167,SRX16500061,CTCF,457
chr1,144881757,144881984,SRX5075168,SMARCA4,227
chr1,144890263,144890470,SRX5075174,SMARCA4,207
chr1,144894416,144895025,SRX5075176,SMARCA4,609
chr1,144894446,144894785,SRX5716469,SMARCA4,339
chr1,144894524,144894905,SRX5716470,SMARCA4,381
chr1,144894536,144895069,SRX5075170,SMARCA4,533
chr1,144894598,144894926,SRX5075169,SMARCA4,328
chr1,144894624,144894858,SRX5075175,SMARCA4,234
chr1,144895171,144895409,SRX5075170,SMARCA4,238
chr1,144904642,144904944,SRX5075175,SMARCA4,302
chr1,144904644,144904951,SRX5054309,FOSL2,307
chr1,144904647,144904914,SRX5075169,SMARCA4,267
chr1,144904736,144904916,SRX5054308,FOSL2,180
chr1,144914156,144914433,SRX16500061,CTCF,277
chr1,144917170,144917459,SRX5075175,SMARCA4,289
chr1,144917214,144917404,SRX5075168,SMARCA4,190
chr1,144917532,144918463,SRX5075170,SMARCA4,931
chr1,144917584,144918483,SRX5075176,SMARCA4,899
chr1,144917649,144918196,SRX5075168,SMARCA4,547
chr1,144917692,144917989,SRX5075169,SMARCA4,297
chr1,144917742,144918286,SRX5075174,SMARCA4,544
chr1,144917862,144918120,SRX16500062,CTCF,258
chr1,144917961,144918338,SRX5716460,Epitope tags,377
chr1,144917998,144918336,SRX5054308,FOSL2,338
chr1,144918018,144918372,SRX5054309,FOSL2,354
chr1,144918055,144918313,SRX5075169,SMARCA4,258
chr1,144918073,144918442,SRX5075175,SMARCA4,369
chr1,144923585,144923986,SRX5075176,SMARCA4,401
chr1,144923593,144923881,SRX5075168,SMARCA4,288
chr1,144923632,144923962,SRX5075170,SMARCA4,330
chr1,144923638,144923916,SRX5075169,SMARCA4,278
chr1,144923663,144923973,SRX5075175,SMARCA4,310
chr1,144923682,144923933,SRX5716470,SMARCA4,251
chr1,144932105,144932545,SRX5075168,SMARCA4,440
chr1,144932128,144932533,SRX20140881,CPSF3L,405
chr1,144932153,144932531,SRX20140867,INTS10,378
chr1,144932184,144932569,SRX5075174,SMARCA4,385
chr1,144932233,144932450,SRX5716463,SMARCA4,217
chr1,144932250,144932480,SRX5716464,SMARCA4,230
chr1,144941667,144942001,SRX5075174,SMARCA4,334
chr1,144941708,144942039,SRX5075168,SMARCA4,331
chr1,144941766,144942030,SRX5054309,FOSL2,264
chr1,144941767,144942020,SRX5075170,SMARCA4,253
chr1,144941780,144942003,SRX5075175,SMARCA4,223
chr1,144941800,144942047,SRX5075169,SMARCA4,247
chr1,144941824,144942038,SRX5075176,SMARCA4,214
chr1,144948279,144948640,SRX5075176,SMARCA4,361
chr1,144948300,144948653,SRX5075169,SMARCA4,353
chr1,144948341,144948722,SRX5075170,SMARCA4,381
chr1,144948354,144948709,SRX5054308,FOSL2,355
chr1,144948380,144948690,SRX5075175,SMARCA4,310
chr1,144948421,144948624,SRX5054309,FOSL2,203
chr1,144961025,144961308,SRX5075175,SMARCA4,283
chr1,144961035,144961330,SRX5075176,SMARCA4,295
chr1,144961047,144961407,SRX5075174,SMARCA4,360
chr1,144961079,144961274,SRX5075170,SMARCA4,195
chr1,144961089,144961300,SRX5716470,SMARCA4,211
chr1,144971971,144972276,SRX20140881,CPSF3L,305
chr1,144972024,144972202,SRX5075176,SMARCA4,178
chr1,144975349,144975593,SRX5075174,SMARCA4,244
chr1,144975349,144975609,SRX5075168,SMARCA4,260
chr1,144977860,144978203,SRX5054308,FOSL2,343
chr1,144977881,144978255,SRX5054309,FOSL2,374
chr1,144980221,144980390,SRX5075170,SMARCA4,169
chr1,144980925,144981717,SRX5075174,SMARCA4,792
chr1,144981028,144981584,SRX5716463,SMARCA4,556
chr1,144981039,144981722,SRX5075168,SMARCA4,683
chr1,144981082,144981611,SRX5716464,SMARCA4,529
chr1,144981151,144981388,SRX5716451,SOX2,237
chr1,144986201,144986439,SRX5075176,SMARCA4,238
chr1,144986290,144986830,SRX5075174,SMARCA4,540
chr1,144986327,144986762,SRX20140867,INTS10,435
chr1,144986445,144986750,SRX20140868,INTS10,305
chr1,144986472,144986716,SRX20140879,CPSF3L,244
chr1,144986486,144986873,SRX5075168,SMARCA4,387
chr1,144986528,144986809,SRX5716463,SMARCA4,281
chr1,144994005,144994413,SRX5075176,SMARCA4,408
chr1,144994033,144994363,SRX5075170,SMARCA4,330
chr1,144994048,144994321,SRX5716470,SMARCA4,273
chr1,144994070,144994316,SRX5075169,SMARCA4,246
chr1,144994079,144994327,SRX5716469,SMARCA4,248
chr1,144994102,144994330,SRX5716467,SMARCA2,228
chr1,144994124,144994337,SRX5054308,FOSL2,213
chr1,144994129,144994368,SRX5716468,SMARCA2,239
chr1,144994132,144994372,SRX5075175,SMARCA4,240
chr1,144994148,144994365,SRX5020211,SMARCA2,217
chr1,144994151,144994350,SRX5075181,SMARCA2,199
chr1,144998864,144999044,SRX5075174,SMARCA4,180
chr1,145000558,145000745,SRX5075175,SMARCA4,187
chr1,145009906,145010250,SRX5075170,SMARCA4,344
chr1,145009931,145010328,SRX5075176,SMARCA4,397
chr1,145009951,145010230,SRX5075169,SMARCA4,279
chr1,145009953,145010212,SRX5054308,FOSL2,259
chr1,145009956,145010323,SRX5054309,FOSL2,367
chr1,145009970,145010341,SRX5075175,SMARCA4,371
chr1,145015889,145016370,SRX5075170,SMARCA4,481
chr1,145015893,145016315,SRX5075175,SMARCA4,422
chr1,145015925,145016469,SRX5075169,SMARCA4,544
chr1,145015967,145016472,SRX5075176,SMARCA4,505
chr1,145015975,145016287,SRX5716470,SMARCA4,312
chr1,145015980,145016295,SRX5716469,SMARCA4,315
chr1,145015981,145016410,SRX5054309,FOSL2,429
chr1,145016011,145016360,SRX5054308,FOSL2,349
chr1,145016129,145016311,SRX5075168,SMARCA4,182
chr1,145017679,145017858,SRX5075174,SMARCA4,179
chr1,145033416,145033752,SRX5075175,SMARCA4,336
chr1,145033417,145033735,SRX5716470,SMARCA4,318
chr1,145033470,145033699,SRX5075176,SMARCA4,229
chr1,145033504,145033786,SRX5075170,SMARCA4,282
chr1,145033547,145033837,SRX5075169,SMARCA4,290
chr1,145034537,145034763,SRX5075170,SMARCA4,226
chr1,145034555,145034814,SRX5716469,SMARCA4,259
chr1,145035963,145036246,SRX5054309,FOSL2,283
chr1,145035982,145036255,SRX5054308,FOSL2,273
chr1,145035987,145036244,SRX5075169,SMARCA4,257
chr1,145036011,145036213,SRX5075170,SMARCA4,202
chr1,145036013,145036193,SRX5075176,SMARCA4,180
chr1,145045595,145046441,SRX5075169,SMARCA4,846
chr1,145045603,145046503,SRX5075176,SMARCA4,900
chr1,145045617,145046497,SRX5075170,SMARCA4,880
chr1,145045621,145046451,SRX5075175,SMARCA4,830
chr1,145045636,145046333,SRX5716470,SMARCA4,697
chr1,145045646,145046392,SRX5716469,SMARCA4,746
chr1,145045705,145046433,SRX5716467,SMARCA2,728
chr1,145045732,145045912,SRX5054308,FOSL2,180
chr1,145045780,145046351,SRX5716468,SMARCA2,571
chr1,145045913,145046330,SRX5020214,SMARCA2,417
chr1,145046042,145046342,SRX5054309,FOSL2,300
chr1,145046084,145046309,SRX5054308,FOSL2,225
chr1,145046117,145046333,SRX5075181,SMARCA2,216
chr1,145047883,145048371,SRX5075168,SMARCA4,488
chr1,145047954,145048547,SRX5075174,SMARCA4,593
chr1,145048058,145048468,SRX20140895,INTS13,410
chr1,145048092,145048392,SRX20140867,INTS10,300
chr1,145048128,145048420,SRX20140868,INTS10,292
chr1,145063368,145063606,SRX5075176,SMARCA4,238
chr1,145063388,145063578,SRX5075170,SMARCA4,190
chr1,145063407,145063614,SRX5075175,SMARCA4,207
chr1,145065506,145065689,SRX5075170,SMARCA4,183
chr1,145082365,145082600,SRX5075174,SMARCA4,235
chr1,145082435,145082639,SRX5716463,SMARCA4,204
chr1,145082444,145082663,SRX5075168,SMARCA4,219
chr1,145094914,145095388,SRX20140895,INTS13,474
chr1,145095344,145096023,SRX5054307,FOSL2,679
chr1,145095397,145095726,SRX5075168,SMARCA4,329
chr1,145095429,145095982,SRX5054308,FOSL2,553
chr1,145095474,145095788,SRX5075174,SMARCA4,314
chr1,145095648,145095908,SRX5716451,SOX2,260
chr1,145115579,145115934,SRX5054309,FOSL2,355
chr1,145115601,145115940,SRX5075176,SMARCA4,339
chr1,145115610,145115943,SRX5054308,FOSL2,333
chr1,145115625,145115862,SRX5075169,SMARCA4,237
chr1,145115637,145115902,SRX5075175,SMARCA4,265
chr1,145115643,145115879,SRX5075170,SMARCA4,236
chr1,145115662,145115974,SRX5716469,SMARCA4,312
chr1,145115679,145115855,SRX5075174,SMARCA4,176
chr1,145116072,145116322,SRX5716469,SMARCA4,250
chr1,145116073,145116421,SRX5716470,SMARCA4,348
chr1,145116116,145116522,SRX5075170,SMARCA4,406
chr1,145116134,145116535,SRX5075169,SMARCA4,401
chr1,145116139,145116553,SRX5075176,SMARCA4,414
chr1,145116155,145116451,SRX5075175,SMARCA4,296
chr1,145116164,145116521,SRX5716467,SMARCA2,357
chr1,145122294,145122668,SRX5075175,SMARCA4,374
chr1,145122320,145122607,SRX5075176,SMARCA4,287
chr1,145122332,145122676,SRX5075170,SMARCA4,344
chr1,145122346,145122696,SRX5054309,FOSL2,350
chr1,145122347,145122696,SRX5075169,SMARCA4,349
chr1,145122441,145122660,SRX5054308,FOSL2,219
chr1,145123999,145124366,SRX4174629,CTCF,367
chr1,145124037,145124374,SRX16500059,CTCF,337
chr1,145124055,145124360,SRX16500060,CTCF,305
chr1,145124066,145124309,SRX16500062,CTCF,243
chr1,145124137,145124357,SRX16500061,CTCF,220
chr1,145157636,145158274,SRX4174629,CTCF,638
chr1,145157706,145158126,SRX16500060,CTCF,420
chr1,145157756,145158054,SRX16500062,CTCF,298
chr1,145157775,145158141,SRX16500059,CTCF,366
chr1,145157812,145158044,SRX5075176,SMARCA4,232
chr1,145157819,145158087,SRX16500061,CTCF,268
chr1,145182586,145182868,SRX16500060,CTCF,282
chr1,145182642,145182898,SRX16500059,CTCF,256
chr1,145182663,145182924,SRX16500061,CTCF,261
chr1,145182689,145182923,SRX16500062,CTCF,234
chr1,145209016,145209316,SRX5075169,SMARCA4,300
chr1,145214668,145215455,SRX20140895,INTS13,787
chr1,145214721,145215249,SRX5075174,SMARCA4,528
chr1,145214784,145214974,SRX5075168,SMARCA4,190
chr1,145214855,145215168,SRX20140868,INTS10,313
chr1,145214891,145215231,SRX5075175,SMARCA4,340
chr1,145214977,145215283,SRX5075169,SMARCA4,306
chr1,145215012,145215329,SRX5075176,SMARCA4,317
chr1,145215043,145215284,SRX5075168,SMARCA4,241
chr1,145215830,145216123,SRX5075170,SMARCA4,293
chr1,145215995,145216312,SRX5075168,SMARCA4,317
chr1,145216187,145216413,SRX5716470,SMARCA4,226
chr1,145222320,145222691,SRX5075168,SMARCA4,371
chr1,145222324,145222622,SRX5075174,SMARCA4,298
chr1,145232790,145233096,SRX5075174,SMARCA4,306
chr1,145232795,145233098,SRX5075168,SMARCA4,303
chr1,145232806,145233031,SRX5716463,SMARCA4,225
chr1,145232830,145233037,SRX5075169,SMARCA4,207
chr1,145271363,145271734,SRX5054309,FOSL2,371
chr1,145271364,145271668,SRX5075174,SMARCA4,304
chr1,145271371,145271710,SRX5075175,SMARCA4,339
chr1,145271375,145271720,SRX5054308,FOSL2,345
chr1,145271393,145271677,SRX5075170,SMARCA4,284
chr1,145271402,145271696,SRX5075169,SMARCA4,294
chr1,145271417,145271636,SRX5716469,SMARCA4,219
chr1,145271433,145271639,SRX5075176,SMARCA4,206
chr1,145271453,145271667,SRX5075168,SMARCA4,214
chr1,145280660,145280881,SRX5075170,SMARCA4,221
chr1,145280673,145280917,SRX5716454,SOX3,244
chr1,145280677,145280884,SRX5075174,SMARCA4,207
chr1,145280680,145280866,SRX5075168,SMARCA4,186
chr1,145280979,145281825,SRX20140897,INTS13,846
chr1,145281013,145281864,SRX20140868,INTS10,851
chr1,145281031,145282066,SRX20140895,INTS13,1035
chr1,145281056,145282160,SRX20140881,CPSF3L,1104
chr1,145281063,145282041,SRX20140879,CPSF3L,978
chr1,145281076,145282013,SRX20140867,INTS10,937
chr1,145281079,145282049,SRX20140896,INTS13,970
chr1,145281088,145282223,SRX20140869,INTS10,1135
chr1,145281095,145282012,SRX20140894,INTS13,917
chr1,145281138,145281580,SRX5075169,SMARCA4,442
chr1,145281172,145281549,SRX5075176,SMARCA4,377
chr1,145281181,145281441,SRX5716470,SMARCA4,260
chr1,145281184,145281973,SRX20140880,CPSF3L,789
chr1,145281214,145281433,SRX5075174,SMARCA4,219
chr1,145281276,145281621,SRX20140870,INTS10,345
chr1,145281382,145281708,SRX5075170,SMARCA4,326
chr1,145281397,145281600,SRX5075168,SMARCA4,203
chr1,145287022,145287573,SRX16500059,CTCF,551
chr1,145287128,145287594,SRX4174629,CTCF,466
chr1,145287130,145287622,SRX16500060,CTCF,492
chr1,145287174,145287658,SRX16500061,CTCF,484
chr1,145287213,145287495,SRX16500062,CTCF,282
chr1,145287222,145287412,SRX5075176,SMARCA4,190
chr1,145287432,145287658,SRX5075174,SMARCA4,226
chr1,145405053,145405341,SRX16500062,CTCF,288
chr1,145405069,145405336,SRX16500059,CTCF,267
chr1,145405087,145405337,SRX16500060,CTCF,250
chr1,145410098,145410289,SRX5075168,SMARCA4,191
chr1,145425206,145426061,SRX20140895,INTS13,855
chr1,145425233,145425488,SRX5075169,SMARCA4,255
chr1,145425283,145425980,SRX5075174,SMARCA4,697
chr1,145425375,145425593,SRX5075170,SMARCA4,218
chr1,145425425,145425883,SRX5075168,SMARCA4,458
chr1,145425545,145426074,SRX20140868,INTS10,529
chr1,145464898,145465876,SRX20140896,INTS13,978
chr1,145465018,145465919,SRX20140881,CPSF3L,901
chr1,145465045,145465970,SRX20140867,INTS10,925
chr1,145465146,145465871,SRX20140895,INTS13,725
chr1,145465240,145465899,SRX20140897,INTS13,659
chr1,145465267,145465840,SRX20140869,INTS10,573
chr1,145465278,145465714,SRX5075176,SMARCA4,436
chr1,145465335,145465574,SRX5075169,SMARCA4,239
chr1,145465547,145465809,SRX20140879,CPSF3L,262
chr1,145495159,145495447,SRX5054308,FOSL2,288
chr1,145495168,145495444,SRX5054309,FOSL2,276
chr1,145495214,145495479,SRX5716469,SMARCA4,265
chr1,145500282,145500602,SRX5075175,SMARCA4,320
chr1,145500326,145500555,SRX5075169,SMARCA4,229
chr1,145505800,145506014,SRX5075175,SMARCA4,214
chr1,145505861,145506041,SRX5075169,SMARCA4,180
chr1,145505869,145506073,SRX5075174,SMARCA4,204
chr1,145507959,145508457,SRX16500060,CTCF,498
chr1,145507998,145508490,SRX16500059,CTCF,492
chr1,145508015,145508651,SRX4174629,CTCF,636
chr1,145508024,145508464,SRX16500061,CTCF,440
chr1,145508040,145508479,SRX16500062,CTCF,439
chr1,145508047,145508375,SRX5075176,SMARCA4,328
chr1,145508099,145508369,SRX5075174,SMARCA4,270
chr1,145508100,145508353,SRX5075170,SMARCA4,253
chr1,145508101,145508405,SRX5075168,SMARCA4,304
chr1,145508113,145508328,SRX5716470,SMARCA4,215
chr1,145508120,145508311,SRX5075175,SMARCA4,191
chr1,145508132,145508344,SRX5716469,SMARCA4,212
chr1,145535276,145535844,SRX5075174,SMARCA4,568
chr1,145535300,145535890,SRX5075168,SMARCA4,590
chr1,145535353,145535811,SRX5716463,SMARCA4,458
chr1,145535425,145535844,SRX5716464,SMARCA4,419
chr1,145535447,145535764,SRX5716451,SOX2,317
chr1,145535496,145535739,SRX5716470,SMARCA4,243
chr1,145535568,145535786,SRX5716454,SOX3,218
chr1,145540624,145540842,SRX5054308,FOSL2,218
chr1,145540655,145540838,SRX5054309,FOSL2,183
chr1,145541205,145541412,SRX5075168,SMARCA4,207
chr1,145541252,145541469,SRX5054309,FOSL2,217
chr1,145541262,145541482,SRX5054308,FOSL2,220
chr1,145541269,145541472,SRX5075170,SMARCA4,203
chr1,145541269,145541588,SRX5075175,SMARCA4,319
chr1,145541281,145541456,SRX5075176,SMARCA4,175
chr1,145541302,145541570,SRX5075169,SMARCA4,268
chr1,145541820,145542150,SRX5054309,FOSL2,330
chr1,145541821,145542141,SRX5054308,FOSL2,320
chr1,145541823,145542133,SRX5716469,SMARCA4,310
chr1,145541831,145542118,SRX5075170,SMARCA4,287
chr1,145541843,145542101,SRX5075176,SMARCA4,258
chr1,145541854,145542127,SRX5075175,SMARCA4,273
chr1,145590761,145591128,SRX16500060,CTCF,367
chr1,145590777,145591160,SRX16500059,CTCF,383
chr1,145590784,145591167,SRX16500062,CTCF,383
chr1,145590803,145591149,SRX16500061,CTCF,346
chr1,145590830,145591080,SRX5075174,SMARCA4,250
chr1,145590836,145591104,SRX5075168,SMARCA4,268
chr1,145590865,145591123,SRX4174629,CTCF,258
chr1,145590881,145591065,SRX5075170,SMARCA4,184
chr1,145607697,145608151,SRX5075176,SMARCA4,454
chr1,145607710,145608183,SRX5075174,SMARCA4,473
chr1,145607713,145608083,SRX5075168,SMARCA4,370
chr1,145607743,145608084,SRX5716463,SMARCA4,341
chr1,145607747,145608061,SRX5075170,SMARCA4,314
chr1,145607763,145608482,SRX20140895,INTS13,719
chr1,145607814,145608001,SRX5075175,SMARCA4,187
chr1,145607833,145608375,SRX20140897,INTS13,542
chr1,145607835,145608340,SRX20140868,INTS10,505
chr1,145607839,145608071,SRX5716464,SMARCA4,232
chr1,145607846,145608117,SRX5054307,FOSL2,271
chr1,145607846,145608315,SRX20140869,INTS10,469
chr1,145607857,145608286,SRX20140879,CPSF3L,429
chr1,145607860,145608338,SRX20140867,INTS10,478
chr1,145607924,145608283,SRX20140881,CPSF3L,359
chr1,145607944,145608195,SRX5054309,FOSL2,251
chr1,145608365,145608640,SRX5075168,SMARCA4,275
chr1,145608378,145608642,SRX5716469,SMARCA4,264
chr1,145608386,145608597,SRX5075169,SMARCA4,211
chr1,145657948,145658138,SRX5054308,FOSL2,190
chr1,145676097,145676483,SRX5075169,SMARCA4,386
chr1,145676122,145676528,SRX5075176,SMARCA4,406
chr1,145676127,145676519,SRX5716469,SMARCA4,392
chr1,145676152,145676411,SRX5716470,SMARCA4,259
chr1,145676157,145676506,SRX5075175,SMARCA4,349
chr1,145676170,145676526,SRX5054308,FOSL2,356
chr1,145676175,145676443,SRX5716467,SMARCA2,268
chr1,145676179,145676493,SRX5054309,FOSL2,314
chr1,145676191,145676510,SRX5075170,SMARCA4,319
chr1,145690583,145690986,SRX5075170,SMARCA4,403
chr1,145690610,145690834,SRX5716470,SMARCA4,224
chr1,145690612,145690932,SRX5020211,SMARCA2,320
chr1,145690633,145690949,SRX5075169,SMARCA4,316
chr1,145690638,145690937,SRX5075176,SMARCA4,299
chr1,145690696,145690959,SRX5075175,SMARCA4,263
chr1,145691160,145691379,SRX5075176,SMARCA4,219
chr1,145721085,145721623,SRX16500059,CTCF,538
chr1,145721086,145721612,SRX16500060,CTCF,526
chr1,145721107,145721572,SRX16500062,CTCF,465
chr1,145721111,145721613,SRX16500061,CTCF,502
chr1,145721133,145721380,SRX5716463,SMARCA4,247
chr1,145721155,145721536,SRX5075169,SMARCA4,381
chr1,145721156,145721500,SRX4174629,CTCF,344
chr1,145721158,145721411,SRX5716470,SMARCA4,253
chr1,145721173,145721471,SRX5075174,SMARCA4,298
chr1,145721178,145721475,SRX5075175,SMARCA4,297
chr1,145721182,145721437,SRX5075176,SMARCA4,255
chr1,145721189,145721556,SRX5075170,SMARCA4,367
chr1,145721197,145721456,SRX5716469,SMARCA4,259
chr1,145721199,145721489,SRX5075168,SMARCA4,290
chr1,145751525,145752166,SRX5075170,SMARCA4,641
chr1,145751533,145752151,SRX5075169,SMARCA4,618
chr1,145751545,145752133,SRX5075176,SMARCA4,588
chr1,145751588,145752121,SRX5716469,SMARCA4,533
chr1,145751608,145752136,SRX5075175,SMARCA4,528
chr1,145751637,145751950,SRX5054308,FOSL2,313
chr1,145751647,145752034,SRX5054309,FOSL2,387
chr1,145751711,145751890,SRX5054307,FOSL2,179
chr1,145751739,145752001,SRX5716453,SOX2,262
chr1,145751750,145752082,SRX5716467,SMARCA2,332
chr1,145766772,145766827,SRX1424893,POU3F2,55
chr1,145766773,145766826,SRX1424894,POU3F2,53
chr1,145766773,145766828,SRX1424891,POU3F2,55
chr1,145766773,145766828,SRX1424892,POU3F2,55
chr1,145782325,145782858,SRX5075169,SMARCA4,533
chr1,145782336,145782830,SRX5075175,SMARCA4,494
chr1,145782352,145782834,SRX5054309,FOSL2,482
chr1,145782409,145782835,SRX5075176,SMARCA4,426
chr1,145782450,145782841,SRX5054308,FOSL2,391
chr1,145782467,145782862,SRX5075170,SMARCA4,395
chr1,145782497,145782823,SRX5716467,SMARCA2,326
chr1,145782500,145782823,SRX5716469,SMARCA4,323
chr1,145782543,145782795,SRX5716470,SMARCA4,252
chr1,145782553,145782855,SRX5020211,SMARCA2,302
chr1,145805080,145805307,SRX5075176,SMARCA4,227
chr1,145805134,145805350,SRX5075169,SMARCA4,216
chr1,145813025,145813480,SRX5075175,SMARCA4,455
chr1,145813032,145813318,SRX5075169,SMARCA4,286
chr1,145813061,145813350,SRX5054309,FOSL2,289
chr1,145813074,145813385,SRX5716470,SMARCA4,311
chr1,145813089,145813258,SRX5075170,SMARCA4,169
chr1,145813117,145813323,SRX5054308,FOSL2,206
chr1,145813452,145813627,SRX5075176,SMARCA4,175
chr1,145818103,145818451,SRX5716469,SMARCA4,348
chr1,145818114,145818350,SRX5075170,SMARCA4,236
chr1,145818134,145818340,SRX5075176,SMARCA4,206
chr1,145818134,145818476,SRX5075175,SMARCA4,342
chr1,145818134,145818533,SRX5075169,SMARCA4,399
chr1,145818214,145818422,SRX5054308,FOSL2,208
chr1,145823651,145824423,SRX20140895,INTS13,772
chr1,145823708,145824366,SRX20140897,INTS13,658
chr1,145823711,145824405,SRX20140879,CPSF3L,694
chr1,145823712,145824474,SRX20140881,CPSF3L,762
chr1,145823715,145824423,SRX20140868,INTS10,708
chr1,145823717,145824270,SRX5716470,SMARCA4,553
chr1,145823725,145824309,SRX20140867,INTS10,584
chr1,145823757,145824495,SRX20140869,INTS10,738
chr1,145823778,145824210,SRX5075170,SMARCA4,432
chr1,145823779,145824388,SRX5075176,SMARCA4,609
chr1,145823808,145824317,SRX5075174,SMARCA4,509
chr1,145823809,145824205,SRX20140896,INTS13,396
chr1,145823815,145824114,SRX20140870,INTS10,299
chr1,145823821,145824523,SRX5075168,SMARCA4,702
chr1,145823831,145824098,SRX5075175,SMARCA4,267
chr1,145823870,145824085,SRX5020211,SMARCA2,215
chr1,145823922,145824203,SRX5716463,SMARCA4,281
chr1,145845285,145845853,SRX16500059,CTCF,568
chr1,145845307,145845885,SRX16500062,CTCF,578
chr1,145845372,145845898,SRX16500061,CTCF,526
chr1,145845383,145845871,SRX16500060,CTCF,488
chr1,145845439,145845882,SRX4174629,CTCF,443
chr1,145845467,145845838,SRX5075176,SMARCA4,371
chr1,145845469,145845693,SRX5716463,SMARCA4,224
chr1,145845481,145845826,SRX5075174,SMARCA4,345
chr1,145845482,145845782,SRX5075168,SMARCA4,300
chr1,145845489,145845869,SRX5075170,SMARCA4,380
chr1,145845506,145846037,SRX5075169,SMARCA4,531
chr1,145845538,145845792,SRX5716469,SMARCA4,254
chr1,145845538,145845891,SRX20140895,INTS13,353
chr1,145845584,145845845,SRX20140868,INTS10,261
chr1,145845593,145845872,SRX20140897,INTS13,279
chr1,145845628,145845839,SRX5716470,SMARCA4,211
chr1,145846079,145846521,SRX16500060,CTCF,442
chr1,145846126,145846496,SRX16500061,CTCF,370
chr1,145846134,145846502,SRX16500062,CTCF,368
chr1,145846161,145846517,SRX16500059,CTCF,356
chr1,145858792,145859960,SRX20140895,INTS13,1168
chr1,145858835,145859381,SRX20140897,INTS13,546
chr1,145858847,145859306,SRX20140868,INTS10,459
chr1,145858848,145859262,SRX5075174,SMARCA4,414
chr1,145858856,145859247,SRX20140867,INTS10,391
chr1,145858866,145859247,SRX5075176,SMARCA4,381
chr1,145858906,145859151,SRX5075170,SMARCA4,245
chr1,145859095,145859274,SRX5075168,SMARCA4,179
chr1,145859547,145859782,SRX20140879,CPSF3L,235
chr1,145859620,145859883,SRX20140867,INTS10,263
chr1,145859654,145860052,SRX5075168,SMARCA4,398
chr1,145859655,145860006,SRX5075176,SMARCA4,351
chr1,145859693,145860024,SRX5075174,SMARCA4,331
chr1,145859714,145860038,SRX5075170,SMARCA4,324
chr1,145859767,145859989,SRX5075175,SMARCA4,222
chr1,145863401,145863643,SRX5075170,SMARCA4,242
chr1,145885769,145886335,SRX5075174,SMARCA4,566
chr1,145885804,145886074,SRX5075176,SMARCA4,270
chr1,145885808,145886295,SRX5075168,SMARCA4,487
chr1,145885955,145886253,SRX5075170,SMARCA4,298
chr1,145891741,145892365,SRX16500059,CTCF,624
chr1,145891753,145892376,SRX16500061,CTCF,623
chr1,145891755,145892357,SRX16500060,CTCF,602
chr1,145891773,145892360,SRX16500062,CTCF,587
chr1,145891836,145892329,SRX4174629,CTCF,493
chr1,145891859,145892523,SRX5075176,SMARCA4,664
chr1,145891878,145892600,SRX5075169,SMARCA4,722
chr1,145891880,145892360,SRX5716464,SMARCA4,480
chr1,145891892,145892553,SRX5075170,SMARCA4,661
chr1,145891894,145892421,SRX5075168,SMARCA4,527
chr1,145891911,145892303,SRX5716463,SMARCA4,392
chr1,145891911,145892479,SRX5075174,SMARCA4,568
chr1,145891921,145892507,SRX5716470,SMARCA4,586
chr1,145891943,145892489,SRX5075175,SMARCA4,546
chr1,145891985,145892545,SRX5716469,SMARCA4,560
chr1,145891993,145892444,SRX5020211,SMARCA2,451
chr1,145892006,145892420,SRX5075182,SMARCA2,414
chr1,145892015,145892477,SRX5054309,FOSL2,462
chr1,145892026,145892415,SRX5716467,SMARCA2,389
chr1,145892043,145892452,SRX5075181,SMARCA2,409
chr1,145892060,145892443,SRX5020214,SMARCA2,383
chr1,145892060,145892498,SRX5054308,FOSL2,438
chr1,145892100,145892532,SRX5716460,Epitope tags,432
chr1,145892124,145892395,SRX5716459,Epitope tags,271
chr1,145892133,145892393,SRX5716468,SMARCA2,260
chr1,145898844,145899483,SRX20140867,INTS10,639
chr1,145898851,145899277,SRX20140895,INTS13,426
chr1,145898977,145899414,SRX20140894,INTS13,437
chr1,145899018,145899482,SRX20140879,CPSF3L,464
chr1,145899021,145899361,SRX20140868,INTS10,340
chr1,145908712,145908946,SRX5075175,SMARCA4,234
chr1,145908737,145908948,SRX5075170,SMARCA4,211
chr1,145908764,145908969,SRX5054309,FOSL2,205
chr1,145908766,145908952,SRX5075169,SMARCA4,186
chr1,145908796,145908981,SRX5075176,SMARCA4,185
chr1,145909947,145910527,SRX16500059,CTCF,580
chr1,145910001,145910552,SRX16500062,CTCF,551
chr1,145910006,145910620,SRX16500060,CTCF,614
chr1,145910022,145910343,SRX5075170,SMARCA4,321
chr1,145910035,145910365,SRX5075176,SMARCA4,330
chr1,145910037,145910240,SRX5075169,SMARCA4,203
chr1,145910042,145910467,SRX16500061,CTCF,425
chr1,145910055,145910381,SRX5075168,SMARCA4,326
chr1,145910067,145910297,SRX5716470,SMARCA4,230
chr1,145910103,145910323,SRX5075174,SMARCA4,220
chr1,145918538,145918918,SRX20140897,INTS13,380
chr1,145918657,145919166,SRX20140895,INTS13,509
chr1,145918720,145918990,SRX5075168,SMARCA4,270
chr1,145918726,145918905,SRX5054307,FOSL2,179
chr1,145918731,145918959,SRX5716463,SMARCA4,228
chr1,145918743,145918944,SRX5075170,SMARCA4,201
chr1,145918753,145919150,SRX5075174,SMARCA4,397
chr1,145926988,145927531,SRX16500060,CTCF,543
chr1,145926997,145927466,SRX16500059,CTCF,469
chr1,145927021,145927480,SRX16500061,CTCF,459
chr1,145927084,145927493,SRX16500062,CTCF,409
chr1,145927095,145927860,SRX20140869,INTS10,765
chr1,145927109,145927638,SRX20140881,CPSF3L,529
chr1,145927140,145927416,SRX4174629,CTCF,276
chr1,145927151,145927416,SRX5075169,SMARCA4,265
chr1,145927151,145927760,SRX20140895,INTS13,609
chr1,145927164,145927762,SRX20140897,INTS13,598
chr1,145927172,145927772,SRX5075174,SMARCA4,600
chr1,145927185,145927703,SRX20140868,INTS10,518
chr1,145927189,145927793,SRX5075168,SMARCA4,604
chr1,145927199,145927580,SRX20140879,CPSF3L,381
chr1,145927237,145927571,SRX20140896,INTS13,334
chr1,145927253,145927457,SRX5716463,SMARCA4,204
chr1,145927288,145927631,SRX20140867,INTS10,343
chr1,145927426,145927797,SRX5716470,SMARCA4,371
chr1,145927447,145927878,SRX5075170,SMARCA4,431
chr1,145927534,145927846,SRX5075176,SMARCA4,312
chr1,145927545,145927747,SRX5075169,SMARCA4,202
chr1,145927657,145928010,SRX5075175,SMARCA4,353
chr1,145951523,145951989,SRX5075174,SMARCA4,466
chr1,145951567,145951901,SRX5716463,SMARCA4,334
chr1,145951567,145951965,SRX5075168,SMARCA4,398
chr1,145951598,145951901,SRX5716451,SOX2,303
chr1,145951627,145951880,SRX5716454,SOX3,253
chr1,145957355,145957567,SRX5075170,SMARCA4,212
chr1,145957585,145958171,SRX20140895,INTS13,586
chr1,145957886,145958123,SRX20140867,INTS10,237
chr1,145957911,145958350,SRX5075174,SMARCA4,439
chr1,145957939,145958225,SRX5075170,SMARCA4,286
chr1,145957959,145958279,SRX5075168,SMARCA4,320
chr1,145958002,145958236,SRX5075176,SMARCA4,234
chr1,145960450,145960843,SRX16500060,CTCF,393
chr1,145960516,145960753,SRX16500061,CTCF,237
chr1,145960546,145960777,SRX16500062,CTCF,231
chr1,145960573,145960876,SRX16500059,CTCF,303
chr1,145962622,145962663,SRX1424894,POU3F2,41
chr1,145962626,145962667,SRX1424893,POU3F2,41
chr1,145962628,145962669,SRX1424891,POU3F2,41
chr1,145963449,145963629,SRX5054308,FOSL2,180
chr1,145963462,145963635,SRX5075174,SMARCA4,173
chr1,145964389,145964785,SRX5075170,SMARCA4,396
chr1,145964391,145964812,SRX5075174,SMARCA4,421
chr1,145964400,145964803,SRX20140895,INTS13,403
chr1,145964402,145964847,SRX5075168,SMARCA4,445
chr1,145964478,145964926,SRX5075176,SMARCA4,448
chr1,145964565,145964796,SRX5075175,SMARCA4,231
chr1,145977436,145977926,SRX16500059,CTCF,490
chr1,145977437,145977899,SRX16500062,CTCF,462
chr1,145977458,145977904,SRX16500061,CTCF,446
chr1,145977483,145977958,SRX16500060,CTCF,475
chr1,145977519,145978030,SRX4174629,CTCF,511
chr1,145977539,145977779,SRX5075170,SMARCA4,240
chr1,145977600,145977837,SRX5075168,SMARCA4,237
chr1,145977617,145977822,SRX5716464,SMARCA4,205
chr1,145977624,145977847,SRX5075176,SMARCA4,223
chr1,145977629,145977822,SRX5075175,SMARCA4,193
chr1,145977631,145977835,SRX5716463,SMARCA4,204
chr1,145977637,145977858,SRX5075174,SMARCA4,221
chr1,145978864,145979037,SRX5075174,SMARCA4,173
chr1,145978964,145979747,SRX5075176,SMARCA4,783
chr1,145978966,145979145,SRX5075168,SMARCA4,179
chr1,145979171,145979449,SRX20140867,INTS10,278
chr1,145979197,145979465,SRX20140869,INTS10,268
chr1,145979219,145979752,SRX5075175,SMARCA4,533
chr1,145979244,145979930,SRX5075174,SMARCA4,686
chr1,145979260,145979837,SRX5075168,SMARCA4,577
chr1,145979312,145979769,SRX5075169,SMARCA4,457
chr1,145979330,145979733,SRX5075170,SMARCA4,403
chr1,145979339,145979740,SRX5716470,SMARCA4,401
chr1,145979346,145979744,SRX5716469,SMARCA4,398
chr1,145979405,145979777,SRX5054308,FOSL2,372
chr1,145979448,145979788,SRX5054309,FOSL2,340
chr1,145979507,145979736,SRX5054307,FOSL2,229
chr1,145979533,145979832,SRX5716454,SOX3,299
chr1,145979599,145979944,SRX20140867,INTS10,345
chr1,145985669,145986026,SRX5075176,SMARCA4,357
chr1,145985672,145986013,SRX5054309,FOSL2,341
chr1,145985701,145986083,SRX5075170,SMARCA4,382
chr1,145985712,145985921,SRX5075175,SMARCA4,209
chr1,145985732,145986044,SRX5054308,FOSL2,312
chr1,145985776,145985956,SRX5075169,SMARCA4,180
chr1,145985822,145986043,SRX5716469,SMARCA4,221
chr1,145986016,145986474,SRX5075174,SMARCA4,458
chr1,145986031,145986455,SRX5075168,SMARCA4,424
chr1,145986101,145986347,SRX5716451,SOX2,246
chr1,145996277,145996874,SRX20140895,INTS13,597
chr1,145996307,145996875,SRX20140869,INTS10,568
chr1,145996320,145996779,SRX20140879,CPSF3L,459
chr1,145996347,145996858,SRX20140897,INTS13,511
chr1,145996351,145996838,SRX20140868,INTS10,487
chr1,145996353,145996689,SRX20140881,CPSF3L,336
chr1,145996357,145996764,SRX20140894,INTS13,407
chr1,145996363,145996811,SRX20140867,INTS10,448
chr1,145996420,145996770,SRX20140896,INTS13,350
chr1,145996468,145996747,SRX5075170,SMARCA4,279
chr1,145996520,145996749,SRX5075176,SMARCA4,229
chr1,145996525,145996809,SRX5716464,SMARCA4,284
chr1,145996563,145996787,SRX5075169,SMARCA4,224
chr1,145996572,145997034,SRX5075168,SMARCA4,462
chr1,145996588,145996970,SRX5075174,SMARCA4,382
chr1,146007132,146007777,SRX16500059,CTCF,645
chr1,146007173,146007747,SRX16500060,CTCF,574
chr1,146007181,146007590,SRX4174629,CTCF,409
chr1,146007191,146007673,SRX16500061,CTCF,482
chr1,146007203,146007693,SRX16500062,CTCF,490
chr1,146007216,146007477,SRX5075175,SMARCA4,261
chr1,146007226,146007559,SRX5075176,SMARCA4,333
chr1,146007248,146007566,SRX5716470,SMARCA4,318
chr1,146007255,146007572,SRX5075170,SMARCA4,317
chr1,146007275,146007633,SRX5075174,SMARCA4,358
chr1,146007294,146007571,SRX5075168,SMARCA4,277
chr1,146007303,146007599,SRX5075169,SMARCA4,296
chr1,146007346,146007550,SRX5716463,SMARCA4,204
chr1,146012950,146013363,SRX16500060,CTCF,413
chr1,146012962,146013409,SRX16500059,CTCF,447
chr1,146012972,146013305,SRX5075168,SMARCA4,333
chr1,146012985,146013365,SRX16500061,CTCF,380
chr1,146012998,146013235,SRX5716469,SMARCA4,237
chr1,146013008,146013453,SRX16500062,CTCF,445
chr1,146013015,146013319,SRX5075176,SMARCA4,304
chr1,146013017,146013366,SRX5075174,SMARCA4,349
chr1,146013021,146013373,SRX5075169,SMARCA4,352
chr1,146013046,146013301,SRX5716470,SMARCA4,255
chr1,146013068,146013392,SRX5075170,SMARCA4,324
chr1,146013070,146013392,SRX5054309,FOSL2,322
chr1,146013093,146013305,SRX5075175,SMARCA4,212
chr1,146013098,146013332,SRX4174629,CTCF,234
chr1,146013113,146013396,SRX5054308,FOSL2,283
chr1,146029139,146029371,SRX5020211,SMARCA2,232
chr1,146029148,146029522,SRX5075170,SMARCA4,374
chr1,146029153,146029411,SRX5716469,SMARCA4,258
chr1,146029154,146029502,SRX5075176,SMARCA4,348
chr1,146029171,146029463,SRX5075169,SMARCA4,292
chr1,146029180,146029412,SRX5716470,SMARCA4,232
chr1,146029185,146029442,SRX5075175,SMARCA4,257
chr1,146029203,146029491,SRX5716467,SMARCA2,288
chr1,146029207,146029492,SRX5054308,FOSL2,285
chr1,146029258,146029485,SRX5716468,SMARCA2,227
chr1,146032723,146033059,SRX16500061,CTCF,336
chr1,146035507,146035761,SRX5075168,SMARCA4,254
chr1,146035536,146035851,SRX20140868,INTS10,315
chr1,146038675,146039453,SRX20140895,INTS13,778
chr1,146039041,146039373,SRX20140881,CPSF3L,332
chr1,146039127,146039502,SRX20140867,INTS10,375
chr1,146039136,146039509,SRX20140869,INTS10,373
chr1,146039247,146039523,SRX20140868,INTS10,276
chr1,146039374,146039575,SRX5075176,SMARCA4,201
chr1,146051418,146052420,SRX20140881,CPSF3L,1002
chr1,146051435,146052450,SRX20140869,INTS10,1015
chr1,146051451,146052476,SRX20140895,INTS13,1025
chr1,146051506,146052438,SRX20140867,INTS10,932
chr1,146051574,146052422,SRX20140879,CPSF3L,848
chr1,146051604,146052468,SRX20140868,INTS10,864
chr1,146051717,146052339,SRX20140894,INTS13,622
chr1,146051718,146052443,SRX20140897,INTS13,725
chr1,146051723,146052386,SRX20140896,INTS13,663
chr1,146051846,146052316,SRX5075174,SMARCA4,470
chr1,146051849,146052235,SRX5075169,SMARCA4,386
chr1,146051881,146052200,SRX5075176,SMARCA4,319
chr1,146051912,146052253,SRX20140882,CPSF3L,341
chr1,146051940,146052226,SRX5075170,SMARCA4,286
chr1,146051952,146052309,SRX5075168,SMARCA4,357
chr1,146051979,146052315,SRX20140880,CPSF3L,336
chr1,146052047,146052323,SRX5716469,SMARCA4,276
chr1,146052451,146052713,SRX5075174,SMARCA4,262
chr1,146138078,146138532,SRX16500060,CTCF,454
chr1,146138130,146138530,SRX16500059,CTCF,400
chr1,146138143,146138507,SRX16500061,CTCF,364
chr1,146138163,146138520,SRX16500062,CTCF,357
chr1,146138169,146138537,SRX5075170,SMARCA4,368
chr1,146138193,146138562,SRX4174629,CTCF,369
chr1,146138247,146138457,SRX5075174,SMARCA4,210
chr1,146138256,146138460,SRX5716463,SMARCA4,204
chr1,146138279,146138500,SRX5075168,SMARCA4,221
chr1,146144453,146144813,SRX16500060,CTCF,360
chr1,146144458,146144896,SRX16500059,CTCF,438
chr1,146144459,146144854,SRX16500061,CTCF,395
chr1,146144471,146144876,SRX16500062,CTCF,405
chr1,146144527,146144800,SRX5075176,SMARCA4,273
chr1,146144565,146144800,SRX4174629,CTCF,235
chr1,146144589,146144789,SRX5075174,SMARCA4,200
chr1,146153848,146154023,SRX5075176,SMARCA4,175
chr1,146153874,146154079,SRX5075170,SMARCA4,205
chr1,146154239,146154866,SRX5075169,SMARCA4,627
chr1,146154260,146154473,SRX5054309,FOSL2,213
chr1,146154269,146154872,SRX5075170,SMARCA4,603
chr1,146154404,146154957,SRX5075176,SMARCA4,553
chr1,146154408,146154859,SRX5075175,SMARCA4,451
chr1,146154433,146154838,SRX5054308,FOSL2,405
chr1,146154536,146154824,SRX5020211,SMARCA2,288
chr1,146154545,146154769,SRX5716469,SMARCA4,224
chr1,146154554,146154825,SRX5716470,SMARCA4,271
chr1,146154594,146154830,SRX5716467,SMARCA2,236
chr1,146154612,146154852,SRX5075181,SMARCA2,240
chr1,146155472,146155679,SRX5075170,SMARCA4,207
chr1,146167336,146167518,SRX5075176,SMARCA4,182
chr1,146167871,146168060,SRX5075176,SMARCA4,189
chr1,146174131,146174920,SRX5075176,SMARCA4,789
chr1,146174188,146174914,SRX5075170,SMARCA4,726
chr1,146174234,146174934,SRX5075169,SMARCA4,700
chr1,146174305,146174917,SRX5716470,SMARCA4,612
chr1,146174435,146174730,SRX5020214,SMARCA2,295
chr1,146174445,146174912,SRX5716469,SMARCA4,467
chr1,146174454,146174923,SRX5075175,SMARCA4,469
chr1,146174460,146174857,SRX5075174,SMARCA4,397
chr1,146174492,146174820,SRX5716468,SMARCA2,328
chr1,146174497,146174811,SRX5020211,SMARCA2,314
chr1,146174498,146174898,SRX5716467,SMARCA2,400
chr1,146174533,146174840,SRX5075181,SMARCA2,307
chr1,146174592,146174802,SRX5054308,FOSL2,210
chr1,146174594,146174855,SRX5075168,SMARCA4,261
chr1,146196563,146196947,SRX5075175,SMARCA4,384
chr1,146196569,146196738,SRX5075170,SMARCA4,169
chr1,146196616,146197027,SRX5075169,SMARCA4,411
chr1,146196644,146196883,SRX5716470,SMARCA4,239
chr1,146196742,146196954,SRX5716469,SMARCA4,212
chr1,146204104,146204414,SRX5075176,SMARCA4,310
chr1,146204105,146204541,SRX5075175,SMARCA4,436
chr1,146204111,146204594,SRX5075169,SMARCA4,483
chr1,146204121,146204397,SRX5075170,SMARCA4,276
chr1,146204142,146204374,SRX5716469,SMARCA4,232
chr1,146204197,146204440,SRX5054308,FOSL2,243
chr1,146204245,146204435,SRX5054309,FOSL2,190
chr1,146211648,146212012,SRX5075170,SMARCA4,364
chr1,146211659,146211945,SRX5075176,SMARCA4,286
chr1,146211698,146211959,SRX5075175,SMARCA4,261
chr1,146211699,146211890,SRX5054308,FOSL2,191
chr1,146211709,146211991,SRX5075169,SMARCA4,282
chr1,146211753,146211951,SRX5054309,FOSL2,198
chr1,146218070,146218417,SRX16500062,CTCF,347
chr1,146218482,146219051,SRX5716470,SMARCA4,569
chr1,146218483,146219169,SRX20140881,CPSF3L,686
chr1,146218521,146218904,SRX20140896,INTS13,383
chr1,146218523,146219053,SRX5716469,SMARCA4,530
chr1,146218525,146219192,SRX5075170,SMARCA4,667
chr1,146218536,146219085,SRX5716467,SMARCA2,549
chr1,146218546,146219056,SRX5054309,FOSL2,510
chr1,146218553,146219161,SRX5075176,SMARCA4,608
chr1,146218557,146218908,SRX5075181,SMARCA2,351
chr1,146218559,146219202,SRX5075174,SMARCA4,643
chr1,146218568,146219086,SRX5075168,SMARCA4,518
chr1,146218568,146219133,SRX5075175,SMARCA4,565
chr1,146218568,146219194,SRX5075169,SMARCA4,626
chr1,146218577,146218927,SRX5716464,SMARCA4,350
chr1,146218578,146219086,SRX20140867,INTS10,508
chr1,146218602,146219111,SRX5054308,FOSL2,509
chr1,146218610,146218821,SRX5020211,SMARCA2,211
chr1,146218611,146218873,SRX5020214,SMARCA2,262
chr1,146218625,146219066,SRX5716463,SMARCA4,441
chr1,146218629,146218886,SRX5716468,SMARCA2,257
chr1,146218641,146218930,SRX20140869,INTS10,289
chr1,146218657,146218925,SRX20140895,INTS13,268
chr1,146221798,146221991,SRX5054309,FOSL2,193
chr1,146227813,146228064,SRX5075174,SMARCA4,251
chr1,146228678,146229355,SRX20140895,INTS13,677
chr1,146228743,146229291,SRX20140868,INTS10,548
chr1,146228744,146229218,SRX20140881,CPSF3L,474
chr1,146228765,146229206,SRX20140879,CPSF3L,441
chr1,146228796,146229254,SRX20140867,INTS10,458
chr1,146228881,146229200,SRX20140869,INTS10,319
chr1,146228888,146229256,SRX20140897,INTS13,368
chr1,146228892,146229221,SRX20140896,INTS13,329
chr1,146228921,146229236,SRX20140870,INTS10,315
chr1,146228988,146229359,SRX5716470,SMARCA4,371
chr1,146228991,146229233,SRX5075174,SMARCA4,242
chr1,146229019,146229325,SRX5075175,SMARCA4,306
chr1,146229039,146229251,SRX5075170,SMARCA4,212
chr1,146229108,146229291,SRX5054309,FOSL2,183
chr1,146241950,146242179,SRX5075175,SMARCA4,229
chr1,146262487,146262899,SRX5075176,SMARCA4,412
chr1,146262489,146262930,SRX5075170,SMARCA4,441
chr1,146262508,146262888,SRX5716469,SMARCA4,380
chr1,146262518,146262863,SRX5716470,SMARCA4,345
chr1,146262585,146262823,SRX5020211,SMARCA2,238
chr1,146262587,146262863,SRX5716467,SMARCA2,276
chr1,146262591,146262892,SRX5716468,SMARCA2,301
chr1,146262675,146262899,SRX5075169,SMARCA4,224
chr1,146277088,146277439,SRX5075176,SMARCA4,351
chr1,146277129,146277415,SRX5054308,FOSL2,286
chr1,146277142,146277371,SRX5075170,SMARCA4,229
chr1,146277144,146277425,SRX5054309,FOSL2,281
chr1,146277176,146277392,SRX5075169,SMARCA4,216
chr1,146278358,146278692,SRX5075170,SMARCA4,334
chr1,146278407,146278605,SRX5075175,SMARCA4,198
chr1,146278435,146278610,SRX5075176,SMARCA4,175
chr1,146281536,146281781,SRX5075175,SMARCA4,245
chr1,146281539,146281798,SRX5075169,SMARCA4,259
chr1,146281608,146281822,SRX5075176,SMARCA4,214
chr1,146293357,146293926,SRX5075176,SMARCA4,569
chr1,146293374,146293941,SRX5075170,SMARCA4,567
chr1,146293442,146293887,SRX5075175,SMARCA4,445
chr1,146293512,146293760,SRX5716470,SMARCA4,248
chr1,146293521,146293930,SRX5075169,SMARCA4,409
chr1,146297656,146298412,SRX20140895,INTS13,756
chr1,146297780,146297978,SRX5075174,SMARCA4,198
chr1,146297814,146298095,SRX5075169,SMARCA4,281
chr1,146297835,146298122,SRX5075168,SMARCA4,287
chr1,146297889,146298278,SRX20140868,INTS10,389
chr1,146297907,146298279,SRX5716470,SMARCA4,372
chr1,146298029,146298264,SRX5075170,SMARCA4,235
chr1,146298073,146298260,SRX5075175,SMARCA4,187
chr1,146298463,146298901,SRX16500059,CTCF,438
chr1,146298475,146298937,SRX16500060,CTCF,462
chr1,146298494,146298877,SRX16500062,CTCF,383
chr1,146298516,146298853,SRX16500061,CTCF,337
chr1,146298539,146298909,SRX4174629,CTCF,370
chr1,146298572,146298767,SRX5075170,SMARCA4,195
chr1,146298582,146298831,SRX5075174,SMARCA4,249
chr1,146298585,146298811,SRX5075168,SMARCA4,226
chr1,146298615,146298817,SRX5075176,SMARCA4,202
chr1,146307766,146308115,SRX5075169,SMARCA4,349
chr1,146307801,146308155,SRX5075175,SMARCA4,354
chr1,146307823,146308082,SRX5075170,SMARCA4,259
chr1,146307830,146308104,SRX5054309,FOSL2,274
chr1,146307843,146308054,SRX5075176,SMARCA4,211
chr1,146307904,146308095,SRX5054308,FOSL2,191
chr1,146309491,146309724,SRX5075176,SMARCA4,233
chr1,146309492,146309676,SRX5075170,SMARCA4,184
chr1,146310523,146311180,SRX16500061,CTCF,657
chr1,146310529,146311020,SRX16500062,CTCF,491
chr1,146310542,146311074,SRX16500059,CTCF,532
chr1,146310545,146311011,SRX16500060,CTCF,466
chr1,146310638,146310897,SRX5075174,SMARCA4,259
chr1,146310644,146310918,SRX5075168,SMARCA4,274
chr1,146310671,146310865,SRX5075176,SMARCA4,194
chr1,146310680,146310867,SRX5075175,SMARCA4,187
chr1,146310697,146310877,SRX5075169,SMARCA4,180
chr1,146310700,146310869,SRX5075170,SMARCA4,169
chr1,146327533,146328052,SRX5075174,SMARCA4,519
chr1,146327579,146328058,SRX5075168,SMARCA4,479
chr1,146327711,146327936,SRX5716463,SMARCA4,225
chr1,146369376,146369769,SRX5075175,SMARCA4,393
chr1,146369379,146369932,SRX16500060,CTCF,553
chr1,146369392,146369857,SRX16500059,CTCF,465
chr1,146369432,146369875,SRX16500062,CTCF,443
chr1,146369445,146369935,SRX4174629,CTCF,490
chr1,146369448,146369916,SRX16500061,CTCF,468
chr1,146369469,146369701,SRX5716469,SMARCA4,232
chr1,146369497,146369978,SRX5075176,SMARCA4,481
chr1,146369574,146369902,SRX5075169,SMARCA4,328
chr1,146369603,146369919,SRX5075168,SMARCA4,316
chr1,146369604,146369893,SRX5075170,SMARCA4,289
chr1,146369665,146369844,SRX5075174,SMARCA4,179
chr1,146376250,146376591,SRX5075174,SMARCA4,341
chr1,146376302,146376488,SRX5075170,SMARCA4,186
chr1,146376334,146376563,SRX5075168,SMARCA4,229
chr1,146376640,146377709,SRX20140895,INTS13,1069
chr1,146376669,146377705,SRX20140896,INTS13,1036
chr1,146376672,146377185,SRX20140870,INTS10,513
chr1,146376684,146377733,SRX20140881,CPSF3L,1049
chr1,146376690,146377576,SRX20140868,INTS10,886
chr1,146376715,146377613,SRX20140897,INTS13,898
chr1,146376721,146377691,SRX20140867,INTS10,970
chr1,146376732,146377371,SRX20140882,CPSF3L,639
chr1,146376735,146377731,SRX20140879,CPSF3L,996
chr1,146376748,146377755,SRX20140869,INTS10,1007
chr1,146376756,146377587,SRX20140880,CPSF3L,831
chr1,146376757,146377641,SRX20140894,INTS13,884
chr1,146376792,146377304,SRX5075168,SMARCA4,512
chr1,146376796,146377412,SRX5075174,SMARCA4,616
chr1,146376801,146377278,SRX5075175,SMARCA4,477
chr1,146376806,146377260,SRX5075169,SMARCA4,454
chr1,146376808,146377377,SRX5075176,SMARCA4,569
chr1,146376827,146377306,SRX5716469,SMARCA4,479
chr1,146376837,146377052,SRX5716467,SMARCA2,215
chr1,146376844,146377122,SRX5075170,SMARCA4,278
chr1,146376862,146377189,SRX5716470,SMARCA4,327
chr1,146376876,146377214,SRX20140860,SOX2,338
chr1,146376906,146377155,SRX5020214,SMARCA2,249
chr1,146377231,146377403,SRX5075170,SMARCA4,172
chr1,146386855,146387108,SRX5716470,SMARCA4,253
chr1,146386885,146387180,SRX5075170,SMARCA4,295
chr1,146386908,146387149,SRX5075175,SMARCA4,241
chr1,146386909,146387219,SRX5075174,SMARCA4,310
chr1,146386926,146387212,SRX5075176,SMARCA4,286
chr1,146386938,146387267,SRX5075168,SMARCA4,329
chr1,146387031,146387237,SRX5054309,FOSL2,206
chr1,146387041,146387273,SRX5054307,FOSL2,232
chr1,146387230,146388146,SRX20140897,INTS13,916
chr1,146387237,146388312,SRX20140895,INTS13,1075
chr1,146387258,146388116,SRX20140894,INTS13,858
chr1,146387303,146388191,SRX20140869,INTS10,888
chr1,146387311,146388304,SRX20140881,CPSF3L,993
chr1,146387320,146388323,SRX5075174,SMARCA4,1003
chr1,146387325,146388220,SRX20140868,INTS10,895
chr1,146387333,146388242,SRX20140867,INTS10,909
chr1,146387343,146388253,SRX20140879,CPSF3L,910
chr1,146387366,146388019,SRX20140896,INTS13,653
chr1,146387400,146388029,SRX5075170,SMARCA4,629
chr1,146387484,146388074,SRX5075176,SMARCA4,590
chr1,146387492,146387965,SRX20140880,CPSF3L,473
chr1,146387540,146387872,SRX5075169,SMARCA4,332
chr1,146387571,146388238,SRX5075168,SMARCA4,667
chr1,146387591,146387882,SRX5716463,SMARCA4,291
chr1,146387653,146387941,SRX5716469,SMARCA4,288
chr1,146387743,146388015,SRX5716470,SMARCA4,272
chr1,146387785,146388220,SRX5716451,SOX2,435
chr1,146401318,146401827,SRX16500061,CTCF,509
chr1,146401384,146401857,SRX16500062,CTCF,473
chr1,146401387,146401809,SRX16500060,CTCF,422
chr1,146401388,146401842,SRX16500059,CTCF,454
chr1,146401416,146401749,SRX5716470,SMARCA4,333
chr1,146401432,146401830,SRX4174629,CTCF,398
chr1,146401454,146401828,SRX5075174,SMARCA4,374
chr1,146401456,146401747,SRX5075168,SMARCA4,291
chr1,146401459,146401728,SRX5075169,SMARCA4,269
chr1,146401497,146401731,SRX5075176,SMARCA4,234
chr1,146401522,146401745,SRX5075170,SMARCA4,223
chr1,146409718,146410485,SRX20140897,INTS13,767
chr1,146409770,146410578,SRX20140895,INTS13,808
chr1,146409801,146410546,SRX20140896,INTS13,745
chr1,146409802,146410538,SRX20140867,INTS10,736
chr1,146409807,146410393,SRX20140868,INTS10,586
chr1,146409807,146410692,SRX20140881,CPSF3L,885
chr1,146409846,146410519,SRX20140869,INTS10,673
chr1,146417095,146417501,SRX5075176,SMARCA4,406
chr1,146417098,146417455,SRX5075170,SMARCA4,357
chr1,146417145,146417482,SRX5075175,SMARCA4,337
chr1,146417177,146417493,SRX5075169,SMARCA4,316
chr1,146417194,146417460,SRX5716470,SMARCA4,266
chr1,146421850,146422171,SRX5054309,FOSL2,321
chr1,146421874,146422092,SRX5075169,SMARCA4,218
chr1,146421917,146422173,SRX5054308,FOSL2,256
chr1,146443653,146444149,SRX4174629,CTCF,496
chr1,146443718,146443966,SRX5075176,SMARCA4,248
chr1,146443725,146444067,SRX16500059,CTCF,342
chr1,146443734,146443954,SRX5075170,SMARCA4,220
chr1,146443759,146444109,SRX16500060,CTCF,350
chr1,146443787,146443999,SRX5716470,SMARCA4,212
chr1,146448460,146449030,SRX5075176,SMARCA4,570
chr1,146448472,146448889,SRX16500061,CTCF,417
chr1,146448483,146448835,SRX5075168,SMARCA4,352
chr1,146448494,146448856,SRX5075174,SMARCA4,362
chr1,146448497,146448831,SRX5075170,SMARCA4,334
chr1,146448503,146448921,SRX16500059,CTCF,418
chr1,146448516,146448732,SRX5075175,SMARCA4,216
chr1,146448528,146448846,SRX4174629,CTCF,318
chr1,146448538,146448873,SRX16500062,CTCF,335
chr1,146448550,146448757,SRX5075169,SMARCA4,207
chr1,146448557,146448986,SRX16500060,CTCF,429
chr1,146453818,146454070,SRX5075174,SMARCA4,252
chr1,146453846,146454112,SRX5075168,SMARCA4,266
chr1,146472038,146472698,SRX5075176,SMARCA4,660
chr1,146472064,146472294,SRX5075170,SMARCA4,230
chr1,146472079,146472639,SRX20140895,INTS13,560
chr1,146472110,146472734,SRX5075168,SMARCA4,624
chr1,146472130,146472778,SRX5075174,SMARCA4,648
chr1,146472141,146472335,SRX5075175,SMARCA4,194
chr1,146472153,146472619,SRX20140868,INTS10,466
chr1,146472267,146472568,SRX16500062,CTCF,301
chr1,146472270,146472733,SRX5075169,SMARCA4,463
chr1,146472299,146472510,SRX5716470,SMARCA4,211
chr1,146472410,146472693,SRX5716469,SMARCA4,283
chr1,146472465,146472732,SRX5075175,SMARCA4,267
chr1,146472479,146472742,SRX5075170,SMARCA4,263
chr1,146477989,146478520,SRX16500059,CTCF,531
chr1,146478075,146478546,SRX16500060,CTCF,471
chr1,146478081,146478543,SRX16500061,CTCF,462
chr1,146478108,146478567,SRX16500062,CTCF,459
chr1,146478173,146478415,SRX5716463,SMARCA4,242
chr1,146478176,146478411,SRX5075168,SMARCA4,235
chr1,146478178,146478430,SRX4174629,CTCF,252
chr1,146478188,146478466,SRX5075174,SMARCA4,278
chr1,146478191,146478418,SRX5075176,SMARCA4,227
chr1,146478220,146478454,SRX5075170,SMARCA4,234
chr1,146513415,146513808,SRX20140869,INTS10,393
chr1,146513568,146514109,SRX5075176,SMARCA4,541
chr1,146513594,146514137,SRX5075175,SMARCA4,543
chr1,146513620,146514076,SRX5716469,SMARCA4,456
chr1,146513659,146514113,SRX5075170,SMARCA4,454
chr1,146513693,146514097,SRX5075169,SMARCA4,404
chr1,146513699,146514056,SRX5054308,FOSL2,357
chr1,146513705,146514079,SRX5054309,FOSL2,374
chr1,146513711,146513984,SRX5716467,SMARCA2,273
chr1,146513721,146513989,SRX5716470,SMARCA4,268
chr1,146513778,146514057,SRX5020214,SMARCA2,279
chr1,146513796,146514005,SRX5075181,SMARCA2,209
chr1,146521890,146522158,SRX5054309,FOSL2,268
chr1,146642334,146642800,SRX5075176,SMARCA4,466
chr1,146642411,146642836,SRX5075170,SMARCA4,425
chr1,146642466,146642742,SRX5075169,SMARCA4,276
chr1,146656198,146656729,SRX5075176,SMARCA4,531
chr1,146656224,146656906,SRX5075170,SMARCA4,682
chr1,146656370,146656597,SRX5075175,SMARCA4,227
chr1,146672187,146672643,SRX5075174,SMARCA4,456
chr1,146672630,146672941,SRX5075176,SMARCA4,311
chr1,146672631,146672851,SRX5054309,FOSL2,220
chr1,146672647,146672995,SRX5075170,SMARCA4,348
chr1,146682024,146682904,SRX5075176,SMARCA4,880
chr1,146682087,146682327,SRX5075170,SMARCA4,240
chr1,146682443,146682942,SRX5075174,SMARCA4,499
chr1,146682482,146682974,SRX5075170,SMARCA4,492
chr1,146682485,146682822,SRX5716463,SMARCA4,337
chr1,146682491,146682888,SRX5075168,SMARCA4,397
chr1,146701215,146701551,SRX5075174,SMARCA4,336
chr1,146701227,146701647,SRX5075176,SMARCA4,420
chr1,146701230,146701535,SRX5075168,SMARCA4,305
chr1,146701358,146701654,SRX5075170,SMARCA4,296
chr1,146701423,146701704,SRX5054309,FOSL2,281
chr1,146701479,146701716,SRX5054308,FOSL2,237
chr1,146711058,146711439,SRX16500062,CTCF,381
chr1,146711086,146711558,SRX16500060,CTCF,472
chr1,146711088,146711484,SRX16500059,CTCF,396
chr1,146711119,146711515,SRX16500061,CTCF,396
chr1,146729636,146730063,SRX5075176,SMARCA4,427
chr1,146729637,146730103,SRX5054309,FOSL2,466
chr1,146729642,146730113,SRX5075170,SMARCA4,471
chr1,146729675,146730006,SRX5075175,SMARCA4,331
chr1,146729678,146730005,SRX5054308,FOSL2,327
chr1,146729690,146730016,SRX5075169,SMARCA4,326
chr1,146729781,146729981,SRX5020211,SMARCA2,200
chr1,146729811,146730023,SRX5716469,SMARCA4,212
chr1,146729871,146730073,SRX5075174,SMARCA4,202
chr1,146732321,146732556,SRX5075170,SMARCA4,235
chr1,146732338,146732567,SRX5716470,SMARCA4,229
chr1,146732391,146732591,SRX5075176,SMARCA4,200
chr1,146778075,146778482,SRX5075170,SMARCA4,407
chr1,146778076,146778478,SRX5075168,SMARCA4,402
chr1,146778123,146778511,SRX5075176,SMARCA4,388
chr1,146778153,146778480,SRX5075174,SMARCA4,327
chr1,146792621,146793259,SRX5075176,SMARCA4,638
chr1,146792692,146793279,SRX5075170,SMARCA4,587
chr1,146792829,146793097,SRX5716468,SMARCA2,268
chr1,146792936,146793146,SRX5075175,SMARCA4,210
chr1,146793001,146793195,SRX5075169,SMARCA4,194
chr1,146796115,146796294,SRX5075176,SMARCA4,179
chr1,146850490,146850838,SRX5075174,SMARCA4,348
chr1,146850558,146850836,SRX5075168,SMARCA4,278
chr1,146903118,146903379,SRX5075176,SMARCA4,261
chr1,146938103,146938480,SRX5075174,SMARCA4,377
chr1,146938134,146938590,SRX5075168,SMARCA4,456
chr1,146938157,146938542,SRX5075176,SMARCA4,385
chr1,146938176,146938457,SRX5716470,SMARCA4,281
chr1,146938179,146938400,SRX5075170,SMARCA4,221
chr1,146938188,146938884,SRX20140895,INTS13,696
chr1,146938204,146938446,SRX5075169,SMARCA4,242
chr1,146938221,146938435,SRX5716463,SMARCA4,214
chr1,146938307,146938803,SRX20140869,INTS10,496
chr1,146938319,146938876,SRX20140897,INTS13,557
chr1,146938337,146938538,SRX5075175,SMARCA4,201
chr1,146938359,146938910,SRX20140868,INTS10,551
chr1,146938435,146938707,SRX20140867,INTS10,272
chr1,146938448,146938705,SRX20140879,CPSF3L,257
chr1,146955049,146955367,SRX5075168,SMARCA4,318
chr1,146955056,146955326,SRX5075174,SMARCA4,270
chr1,146959989,146960395,SRX16500059,CTCF,406
chr1,146959993,146960452,SRX16500060,CTCF,459
chr1,146960000,146960387,SRX16500062,CTCF,387
chr1,146960000,146960454,SRX16500061,CTCF,454
chr1,146960080,146960333,SRX4174629,CTCF,253
chr1,146966331,146966765,SRX16500060,CTCF,434
chr1,146966348,146966719,SRX4174629,CTCF,371
chr1,146966361,146966800,SRX16500059,CTCF,439
chr1,146966404,146966769,SRX16500061,CTCF,365
chr1,146966412,146966613,SRX5075168,SMARCA4,201
chr1,146966422,146966731,SRX16500062,CTCF,309
chr1,146972605,146972990,SRX16500062,CTCF,385
chr1,146972615,146973032,SRX16500059,CTCF,417
chr1,146972635,146973072,SRX16500061,CTCF,437
chr1,146972678,146973090,SRX16500060,CTCF,412
chr1,146972727,146972982,SRX4174629,CTCF,255
chr1,147030259,147030544,SRX5054308,FOSL2,285
chr1,147030385,147030568,SRX5054309,FOSL2,183
chr1,147046989,147047237,SRX5075175,SMARCA4,248
chr1,147047075,147047257,SRX5075169,SMARCA4,182
chr1,147047172,147047378,SRX5054309,FOSL2,206
chr1,147083974,147084929,SRX20140881,CPSF3L,955
chr1,147084159,147084995,SRX20140867,INTS10,836
chr1,147084218,147084977,SRX20140895,INTS13,759
chr1,147084231,147084929,SRX20140879,CPSF3L,698
chr1,147084257,147085054,SRX20140869,INTS10,797
chr1,147084312,147084972,SRX20140896,INTS13,660
chr1,147084337,147084891,SRX20140897,INTS13,554
chr1,147084351,147084556,SRX5075176,SMARCA4,205
chr1,147084368,147084838,SRX20140894,INTS13,470
chr1,147084426,147084979,SRX20140868,INTS10,553
chr1,147084467,147084814,SRX20140880,CPSF3L,347
chr1,147084515,147084695,SRX5075169,SMARCA4,180
chr1,147084567,147085121,SRX5075170,SMARCA4,554
chr1,147084616,147085129,SRX5075168,SMARCA4,513
chr1,147084633,147085139,SRX5075176,SMARCA4,506
chr1,147084730,147085122,SRX5716470,SMARCA4,392
chr1,147084826,147085066,SRX5075174,SMARCA4,240
chr1,147084889,147085176,SRX5075169,SMARCA4,287
chr1,147084917,147085215,SRX5716469,SMARCA4,298
chr1,147084940,147085141,SRX5075175,SMARCA4,201
chr1,147098311,147098788,SRX16500059,CTCF,477
chr1,147098330,147098803,SRX16500060,CTCF,473
chr1,147098411,147098754,SRX16500062,CTCF,343
chr1,147098412,147098800,SRX16500061,CTCF,388
chr1,147167301,147167716,SRX5075176,SMARCA4,415
chr1,147167327,147167757,SRX5054309,FOSL2,430
chr1,147167332,147167665,SRX5716469,SMARCA4,333
chr1,147167334,147167750,SRX5054308,FOSL2,416
chr1,147167338,147167732,SRX5075169,SMARCA4,394
chr1,147167339,147167703,SRX5075175,SMARCA4,364
chr1,147167372,147167686,SRX5020211,SMARCA2,314
chr1,147167394,147167708,SRX5075170,SMARCA4,314
chr1,147167404,147167660,SRX5020214,SMARCA2,256
chr1,147167405,147167668,SRX5716470,SMARCA4,263
chr1,147167440,147167619,SRX5075182,SMARCA2,179
chr1,147172125,147173052,SRX20140895,INTS13,927
chr1,147172325,147172952,SRX20140897,INTS13,627
chr1,147172325,147173040,SRX20140868,INTS10,715
chr1,147172373,147172826,SRX5075170,SMARCA4,453
chr1,147172387,147172845,SRX5075168,SMARCA4,458
chr1,147172391,147172937,SRX20140867,INTS10,546
chr1,147172435,147173000,SRX16500059,CTCF,565
chr1,147172440,147172940,SRX20140869,INTS10,500
chr1,147172445,147172929,SRX16500060,CTCF,484
chr1,147172446,147172887,SRX5075174,SMARCA4,441
chr1,147172487,147172954,SRX16500061,CTCF,467
chr1,147172498,147172740,SRX5716463,SMARCA4,242
chr1,147172501,147172936,SRX16500062,CTCF,435
chr1,147172514,147172852,SRX5075176,SMARCA4,338
chr1,147172557,147173011,SRX20140879,CPSF3L,454
chr1,147172595,147172931,SRX5716470,SMARCA4,336
chr1,147172637,147172942,SRX5075175,SMARCA4,305
chr1,147172687,147172932,SRX5075169,SMARCA4,245
chr1,147225183,147225396,SRX5716469,SMARCA4,213
chr1,147225191,147225476,SRX5075176,SMARCA4,285
chr1,147225260,147225571,SRX5075175,SMARCA4,311
chr1,147225328,147225677,SRX5075170,SMARCA4,349
chr1,147225335,147225769,SRX5075169,SMARCA4,434
chr1,147242261,147242669,SRX4174629,CTCF,408
chr1,147242318,147243460,SRX16500059,CTCF,1142
chr1,147242342,147243313,SRX16500061,CTCF,971
chr1,147242377,147242723,SRX5075176,SMARCA4,346
chr1,147242380,147243413,SRX16500060,CTCF,1033
chr1,147242393,147242767,SRX5716470,SMARCA4,374
chr1,147242409,147242763,SRX5075174,SMARCA4,354
chr1,147242409,147243254,SRX16500062,CTCF,845
chr1,147242413,147242759,SRX5075168,SMARCA4,346
chr1,147242415,147242729,SRX5075170,SMARCA4,314
chr1,147242438,147242661,SRX5075175,SMARCA4,223
chr1,147242460,147242701,SRX5716463,SMARCA4,241
chr1,147242479,147243317,SRX20140895,INTS13,838
chr1,147242492,147243095,SRX20140867,INTS10,603
chr1,147242499,147242778,SRX5075169,SMARCA4,279
chr1,147242509,147243193,SRX20140868,INTS10,684
chr1,147242652,147242962,SRX20140879,CPSF3L,310
chr1,147242658,147243086,SRX20140897,INTS13,428
chr1,147242807,147243133,SRX20140869,INTS10,326
chr1,147242851,147243116,SRX5075169,SMARCA4,265
chr1,147242940,147243263,SRX5716469,SMARCA4,323
chr1,147242978,147243292,SRX5075168,SMARCA4,314
chr1,147242984,147243177,SRX5075175,SMARCA4,193
chr1,147242987,147243633,SRX5075176,SMARCA4,646
chr1,147243010,147243216,SRX5075170,SMARCA4,206
chr1,147243036,147243312,SRX4174629,CTCF,276
chr1,147273542,147274022,SRX5075176,SMARCA4,480
chr1,147273554,147274022,SRX5716469,SMARCA4,468
chr1,147273560,147274140,SRX16500059,CTCF,580
chr1,147273585,147274136,SRX16500062,CTCF,551
chr1,147273587,147274081,SRX5075175,SMARCA4,494
chr1,147273677,147274129,SRX16500060,CTCF,452
chr1,147273680,147274149,SRX16500061,CTCF,469
chr1,147273682,147274056,SRX5075169,SMARCA4,374
chr1,147273693,147274033,SRX5054308,FOSL2,340
chr1,147273704,147274003,SRX5054309,FOSL2,299
chr1,147273733,147274048,SRX5075174,SMARCA4,315
chr1,147273759,147274030,SRX5075170,SMARCA4,271
chr1,147273811,147274064,SRX5075168,SMARCA4,253
chr1,147273927,147274199,SRX4174629,CTCF,272
chr1,147292094,147292325,SRX5054308,FOSL2,231
chr1,147292102,147292374,SRX5075169,SMARCA4,272
chr1,147292125,147292316,SRX5054309,FOSL2,191
chr1,147292809,147293021,SRX5075175,SMARCA4,212
chr1,147292831,147293158,SRX5054309,FOSL2,327
chr1,147292857,147293192,SRX5075170,SMARCA4,335
chr1,147336960,147337406,SRX5075168,SMARCA4,446
chr1,147337007,147337303,SRX5716463,SMARCA4,296
chr1,147337029,147337351,SRX5075174,SMARCA4,322
chr1,147337065,147337270,SRX5716464,SMARCA4,205
chr1,147389850,147390426,SRX16500059,CTCF,576
chr1,147389858,147390325,SRX16500060,CTCF,467
chr1,147389917,147390308,SRX16500061,CTCF,391
chr1,147389941,147390313,SRX5075168,SMARCA4,372
chr1,147389946,147390264,SRX5075174,SMARCA4,318
chr1,147389962,147390399,SRX16500062,CTCF,437
chr1,147390015,147390204,SRX5075169,SMARCA4,189
chr1,147494937,147495431,SRX16500059,CTCF,494
chr1,147494942,147495393,SRX16500061,CTCF,451
chr1,147494945,147495451,SRX16500060,CTCF,506
chr1,147494954,147495401,SRX4174629,CTCF,447
chr1,147494964,147495401,SRX16500062,CTCF,437
chr1,147495020,147495363,SRX5075174,SMARCA4,343
chr1,147495072,147495315,SRX5075168,SMARCA4,243
chr1,147495150,147495332,SRX5075176,SMARCA4,182
chr1,147496565,147496871,SRX5075169,SMARCA4,306
chr1,147496581,147496988,SRX5075170,SMARCA4,407
chr1,147496629,147497171,SRX5075176,SMARCA4,542
chr1,147497090,147497289,SRX5075170,SMARCA4,199
chr1,147504685,147505340,SRX5075174,SMARCA4,655
chr1,147504697,147505355,SRX5075170,SMARCA4,658
chr1,147504711,147505377,SRX5075168,SMARCA4,666
chr1,147504758,147504996,SRX5075169,SMARCA4,238
chr1,147504784,147505381,SRX5075176,SMARCA4,597
chr1,147504799,147505229,SRX5075175,SMARCA4,430
chr1,147504993,147505216,SRX5716463,SMARCA4,223
chr1,147505041,147505297,SRX5716469,SMARCA4,256
chr1,147505043,147505333,SRX5716470,SMARCA4,290
chr1,147505083,147505271,SRX5075169,SMARCA4,188
chr1,147505138,147505343,SRX5716464,SMARCA4,205
chr1,147515399,147515640,SRX5075176,SMARCA4,241
chr1,147515427,147515615,SRX5054309,FOSL2,188
chr1,147515465,147515710,SRX5075169,SMARCA4,245
chr1,147534480,147534703,SRX5075176,SMARCA4,223
chr1,147534522,147534713,SRX5075170,SMARCA4,191
chr1,147538889,147539377,SRX5075168,SMARCA4,488
chr1,147538978,147539410,SRX5075174,SMARCA4,432
chr1,147539023,147539404,SRX5075169,SMARCA4,381
chr1,147539031,147539361,SRX5716469,SMARCA4,330
chr1,147539038,147539385,SRX5054309,FOSL2,347
chr1,147539044,147539377,SRX5054308,FOSL2,333
chr1,147539051,147539390,SRX5075176,SMARCA4,339
chr1,147539067,147539392,SRX5075175,SMARCA4,325
chr1,147539074,147539403,SRX5075170,SMARCA4,329
chr1,147539076,147539319,SRX5054307,FOSL2,243
chr1,147539105,147539335,SRX5020214,SMARCA2,230
chr1,147539118,147539346,SRX5716470,SMARCA4,228
chr1,147539118,147539363,SRX5716467,SMARCA2,245
chr1,147541229,147541601,SRX5075170,SMARCA4,372
chr1,147541273,147541471,SRX5075176,SMARCA4,198
chr1,147541297,147541553,SRX5075174,SMARCA4,256
chr1,147541297,147541569,SRX5716454,SOX3,272
chr1,147541347,147541616,SRX5075168,SMARCA4,269
chr1,147541408,147541917,SRX20140895,INTS13,509
chr1,147579466,147579845,SRX5075176,SMARCA4,379
chr1,147579600,147579883,SRX5716470,SMARCA4,283
chr1,147579627,147579856,SRX5075170,SMARCA4,229
chr1,147579672,147579910,SRX5716469,SMARCA4,238
chr1,147580249,147580451,SRX5075176,SMARCA4,202
chr1,147586892,147587294,SRX5716469,SMARCA4,402
chr1,147586988,147587223,SRX5075175,SMARCA4,235
chr1,147586998,147587350,SRX5075169,SMARCA4,352
chr1,147587048,147587283,SRX5075168,SMARCA4,235
chr1,147587186,147587359,SRX5075174,SMARCA4,173
chr1,147598977,147599198,SRX5075169,SMARCA4,221
chr1,147599083,147599903,SRX20140895,INTS13,820
chr1,147599246,147599632,SRX20140894,INTS13,386
chr1,147599345,147599737,SRX20140879,CPSF3L,392
chr1,147599373,147599778,SRX20140868,INTS10,405
chr1,147599388,147599654,SRX20140869,INTS10,266
chr1,147599415,147599676,SRX20140881,CPSF3L,261
chr1,147599423,147599702,SRX20140867,INTS10,279
chr1,147599453,147600304,SRX5075176,SMARCA4,851
chr1,147599497,147599737,SRX20140880,CPSF3L,240
chr1,147599515,147600338,SRX5075168,SMARCA4,823
chr1,147599517,147599774,SRX20140897,INTS13,257
chr1,147599546,147600321,SRX5075170,SMARCA4,775
chr1,147599547,147600314,SRX5075174,SMARCA4,767
chr1,147599575,147599841,SRX5054307,FOSL2,266
chr1,147599723,147600162,SRX5716451,SOX2,439
chr1,147599799,147600173,SRX5716463,SMARCA4,374
chr1,147599801,147600167,SRX5716464,SMARCA4,366
chr1,147599866,147600094,SRX5075175,SMARCA4,228
chr1,147599918,147600378,SRX5716470,SMARCA4,460
chr1,147599961,147600318,SRX20140895,INTS13,357
chr1,147600053,147600316,SRX20140867,INTS10,263
chr1,147600160,147600392,SRX5075175,SMARCA4,232
chr1,147627410,147628007,SRX16500059,CTCF,597
chr1,147627416,147627940,SRX16500060,CTCF,524
chr1,147627424,147627760,SRX4174629,CTCF,336
chr1,147627441,147627924,SRX16500061,CTCF,483
chr1,147627477,147627917,SRX16500062,CTCF,440
chr1,147627536,147627710,SRX5075174,SMARCA4,174
chr1,147627574,147627810,SRX5075168,SMARCA4,236
chr1,147640635,147641109,SRX16500061,CTCF,474
chr1,147640681,147641147,SRX16500059,CTCF,466
chr1,147640687,147641103,SRX16500060,CTCF,416
chr1,147640736,147641083,SRX16500062,CTCF,347
chr1,147640808,147640987,SRX5075168,SMARCA4,179
chr1,147640822,147641018,SRX5075174,SMARCA4,196
chr1,147640882,147641062,SRX5075169,SMARCA4,180
chr1,147641938,147642346,SRX16500059,CTCF,408
chr1,147641963,147642343,SRX16500061,CTCF,380
chr1,147641966,147642346,SRX16500062,CTCF,380
chr1,147642006,147642373,SRX16500060,CTCF,367
chr1,147651494,147651890,SRX5075174,SMARCA4,396
chr1,147651659,147651879,SRX5075168,SMARCA4,220
chr1,147670045,147670823,SRX20140895,INTS13,778
chr1,147670497,147670787,SRX5075174,SMARCA4,290
chr1,147670566,147670785,SRX5075170,SMARCA4,219
chr1,147676140,147677057,SRX5075176,SMARCA4,917
chr1,147676177,147677120,SRX5075174,SMARCA4,943
chr1,147676209,147677056,SRX5075169,SMARCA4,847
chr1,147676236,147677175,SRX5075168,SMARCA4,939
chr1,147676261,147677018,SRX5075175,SMARCA4,757
chr1,147676342,147677045,SRX5054309,FOSL2,703
chr1,147676347,147677090,SRX5716463,SMARCA4,743
chr1,147676356,147677022,SRX5075170,SMARCA4,666
chr1,147676392,147677010,SRX5054308,FOSL2,618
chr1,147676402,147676941,SRX5716470,SMARCA4,539
chr1,147676403,147676999,SRX5716469,SMARCA4,596
chr1,147676546,147676957,SRX5716460,Epitope tags,411
chr1,147676638,147676991,SRX5054307,FOSL2,353
chr1,147676711,147677014,SRX5716464,SMARCA4,303
chr1,147676731,147676936,SRX5020214,SMARCA2,205
chr1,147676735,147677000,SRX5716451,SOX2,265
chr1,147676736,147676959,SRX5716454,SOX3,223
chr1,147676759,147676938,SRX5075182,SMARCA2,179
chr1,147699802,147700325,SRX16500062,CTCF,523
chr1,147699804,147700362,SRX16500059,CTCF,558
chr1,147699837,147700410,SRX16500060,CTCF,573
chr1,147699867,147700381,SRX16500061,CTCF,514
chr1,147699942,147700394,SRX5075174,SMARCA4,452
chr1,147699952,147700302,SRX5075170,SMARCA4,350
chr1,147699970,147700562,SRX5075169,SMARCA4,592
chr1,147699978,147700439,SRX5075168,SMARCA4,461
chr1,147699998,147700429,SRX5716470,SMARCA4,431
chr1,147700012,147700238,SRX5075176,SMARCA4,226
chr1,147700266,147700530,SRX5716469,SMARCA4,264
chr1,147723867,147724292,SRX16500059,CTCF,425
chr1,147723913,147724270,SRX16500060,CTCF,357
chr1,147723929,147724304,SRX16500061,CTCF,375
chr1,147723950,147724249,SRX16500062,CTCF,299
chr1,147726148,147726445,SRX5075174,SMARCA4,297
chr1,147726208,147726500,SRX5075168,SMARCA4,292
chr1,147781195,147781400,SRX5075168,SMARCA4,205
chr1,147784995,147785230,SRX5075174,SMARCA4,235
chr1,147849220,147849425,SRX5075168,SMARCA4,205
chr1,147851185,147851552,SRX5075174,SMARCA4,367
chr1,147851262,147851530,SRX5075168,SMARCA4,268
chr1,147890194,147890593,SRX16500059,CTCF,399
chr1,147890208,147890615,SRX16500060,CTCF,407
chr1,147890213,147890591,SRX16500062,CTCF,378
chr1,147890217,147890611,SRX16500061,CTCF,394
chr1,147890223,147890515,SRX5075174,SMARCA4,292
chr1,147890224,147890461,SRX5075176,SMARCA4,237
chr1,147890239,147890512,SRX5075170,SMARCA4,273
chr1,147890241,147890526,SRX5075168,SMARCA4,285
chr1,147890244,147890448,SRX5716463,SMARCA4,204
chr1,147890245,147890510,SRX5075169,SMARCA4,265
chr1,147890249,147890436,SRX5075175,SMARCA4,187
chr1,147892595,147893128,SRX16500060,CTCF,533
chr1,147892630,147893129,SRX16500059,CTCF,499
chr1,147892708,147893110,SRX16500061,CTCF,402
chr1,147892715,147893109,SRX16500062,CTCF,394
chr1,147892738,147892959,SRX5075170,SMARCA4,221
chr1,147892742,147893010,SRX4174629,CTCF,268
chr1,147892746,147892982,SRX5075176,SMARCA4,236
chr1,147892759,147893022,SRX5075174,SMARCA4,263
chr1,147897375,147897631,SRX20140895,INTS13,256
chr1,147897384,147897694,SRX20140868,INTS10,310
chr1,147917291,147917573,SRX20140895,INTS13,282
chr1,147917358,147917588,SRX5075174,SMARCA4,230
chr1,147928134,147929072,SRX5075168,SMARCA4,938
chr1,147928135,147928592,SRX5075174,SMARCA4,457
chr1,147928163,147928452,SRX5716463,SMARCA4,289
chr1,147928178,147928440,SRX5716464,SMARCA4,262
chr1,147928193,147928480,SRX5075170,SMARCA4,287
chr1,147928193,147928500,SRX5075176,SMARCA4,307
chr1,147928200,147928931,SRX20140895,INTS13,731
chr1,147928235,147928776,SRX20140897,INTS13,541
chr1,147928242,147928733,SRX20140869,INTS10,491
chr1,147928266,147928788,SRX20140867,INTS10,522
chr1,147928278,147928703,SRX20140868,INTS10,425
chr1,147928289,147928656,SRX20140879,CPSF3L,367
chr1,147928372,147928729,SRX20140881,CPSF3L,357
chr1,147928444,147928627,SRX5054309,FOSL2,183
chr1,147928600,147929026,SRX5075169,SMARCA4,426
chr1,147928822,147929013,SRX5075176,SMARCA4,191
chr1,147998918,147999383,SRX5075170,SMARCA4,465
chr1,147998979,147999394,SRX5075176,SMARCA4,415
chr1,147999040,147999390,SRX5075169,SMARCA4,350
chr1,147999054,147999366,SRX5054308,FOSL2,312
chr1,147999055,147999372,SRX5054309,FOSL2,317
chr1,147999060,147999319,SRX5716469,SMARCA4,259
chr1,147999065,147999369,SRX5716467,SMARCA2,304
chr1,147999083,147999383,SRX5716470,SMARCA4,300
chr1,147999096,147999334,SRX5020211,SMARCA2,238
chr1,147999117,147999442,SRX5075175,SMARCA4,325
chr1,148038087,148039065,SRX20140881,CPSF3L,978
chr1,148038109,148038992,SRX20140896,INTS13,883
chr1,148038218,148039124,SRX20140867,INTS10,906
chr1,148038269,148039181,SRX20140869,INTS10,912
chr1,148038351,148038553,SRX5075175,SMARCA4,202
chr1,148038397,148039081,SRX20140895,INTS13,684
chr1,148038407,148038883,SRX5075176,SMARCA4,476
chr1,148038408,148038973,SRX20140879,CPSF3L,565
chr1,148038436,148039095,SRX20140897,INTS13,659
chr1,148038581,148038877,SRX20140880,CPSF3L,296
chr1,148038593,148039036,SRX5716470,SMARCA4,443
chr1,148038598,148038902,SRX5075169,SMARCA4,304
chr1,148038598,148039059,SRX20140868,INTS10,461
chr1,148038659,148038880,SRX5075168,SMARCA4,221
chr1,148038674,148038889,SRX5075170,SMARCA4,215
chr1,148048798,148049021,SRX5075170,SMARCA4,223
chr1,148048931,148049368,SRX5075169,SMARCA4,437
chr1,148068316,148068589,SRX5054308,FOSL2,273
chr1,148068326,148068611,SRX5054309,FOSL2,285
chr1,148068549,148068718,SRX5075170,SMARCA4,169
chr1,148073467,148073754,SRX5075175,SMARCA4,287
chr1,148073514,148073696,SRX5075169,SMARCA4,182
chr1,148078953,148079141,SRX5075175,SMARCA4,188
chr1,148078976,148079213,SRX5075176,SMARCA4,237
chr1,148078994,148079174,SRX5075174,SMARCA4,180
chr1,148081126,148081650,SRX16500061,CTCF,524
chr1,148081135,148081597,SRX16500060,CTCF,462
chr1,148081142,148081606,SRX16500059,CTCF,464
chr1,148081184,148081629,SRX16500062,CTCF,445
chr1,148081200,148081811,SRX4174629,CTCF,611
chr1,148081233,148081502,SRX5075169,SMARCA4,269
chr1,148081236,148081529,SRX5075176,SMARCA4,293
chr1,148081244,148081573,SRX5075168,SMARCA4,329
chr1,148081256,148081474,SRX5716470,SMARCA4,218
chr1,148081259,148081493,SRX5075170,SMARCA4,234
chr1,148081284,148081545,SRX5075174,SMARCA4,261
chr1,148120392,148120783,SRX16500060,CTCF,391
chr1,148120405,148120709,SRX16500061,CTCF,304
chr1,148120456,148120770,SRX16500059,CTCF,314
chr1,148120471,148120725,SRX16500062,CTCF,254
chr1,148120493,148120783,SRX4174629,CTCF,290
chr1,148126688,148127164,SRX16500061,CTCF,476
chr1,148126713,148127164,SRX16500060,CTCF,451
chr1,148126777,148127122,SRX16500059,CTCF,345
chr1,148126798,148127059,SRX16500062,CTCF,261
chr1,148126809,148127067,SRX4174629,CTCF,258
chr1,148131686,148132137,SRX5075174,SMARCA4,451
chr1,148131802,148132112,SRX5075168,SMARCA4,310
chr1,148151818,148152466,SRX20140895,INTS13,648
chr1,148151820,148152397,SRX20140897,INTS13,577
chr1,148151894,148152190,SRX20140868,INTS10,296
chr1,148151942,148152539,SRX5075174,SMARCA4,597
chr1,148152006,148152198,SRX5075175,SMARCA4,192
chr1,148152066,148152485,SRX5075168,SMARCA4,419
chr1,148152074,148152537,SRX5075170,SMARCA4,463
chr1,148152135,148152405,SRX5716463,SMARCA4,270
chr1,148152173,148152442,SRX5075169,SMARCA4,269
chr1,148152231,148152497,SRX5075176,SMARCA4,266
chr1,148152257,148152553,SRX5716470,SMARCA4,296
chr1,148211266,148211452,SRX5054308,FOSL2,186
chr1,148219263,148219954,SRX5075170,SMARCA4,691
chr1,148219273,148219710,SRX5075176,SMARCA4,437
chr1,148219296,148219713,SRX5716470,SMARCA4,417
chr1,148219297,148219638,SRX5054308,FOSL2,341
chr1,148219310,148219693,SRX5075169,SMARCA4,383
chr1,148219322,148219660,SRX5054309,FOSL2,338
chr1,148219329,148219727,SRX5075175,SMARCA4,398
chr1,148219339,148219678,SRX5716469,SMARCA4,339
chr1,148219342,148219634,SRX5716467,SMARCA2,292
chr1,148219365,148219617,SRX5020214,SMARCA2,252
chr1,148219397,148219613,SRX5020211,SMARCA2,216
chr1,148254801,148255248,SRX16500060,CTCF,447
chr1,148254817,148255278,SRX16500061,CTCF,461
chr1,148254868,148255268,SRX16500059,CTCF,400
chr1,148254872,148255238,SRX16500062,CTCF,366
chr1,148254915,148255167,SRX5075174,SMARCA4,252
chr1,148254920,148255241,SRX4174629,CTCF,321
chr1,148254921,148255191,SRX5075168,SMARCA4,270
chr1,148254922,148255102,SRX5075169,SMARCA4,180
chr1,148254932,148255120,SRX5075170,SMARCA4,188
chr1,148254949,148255136,SRX5075175,SMARCA4,187
chr1,148263574,148263825,SRX5075170,SMARCA4,251
chr1,148263606,148264029,SRX20140881,CPSF3L,423
chr1,148263667,148263854,SRX5075175,SMARCA4,187
chr1,148280788,148281021,SRX5075176,SMARCA4,233
chr1,148280812,148280999,SRX5075175,SMARCA4,187
chr1,148281060,148281238,SRX5075170,SMARCA4,178
chr1,148302571,148302903,SRX5075170,SMARCA4,332
chr1,148302659,148302839,SRX5054308,FOSL2,180
chr1,148302665,148303038,SRX5075176,SMARCA4,373
chr1,148302668,148302859,SRX5075168,SMARCA4,191
chr1,148302783,148303110,SRX20140869,INTS10,327
chr1,148302811,148303158,SRX20140867,INTS10,347
chr1,148303201,148303522,SRX5075169,SMARCA4,321
chr1,148303300,148303538,SRX5075176,SMARCA4,238
chr1,148303389,148303646,SRX5075170,SMARCA4,257
chr1,148315040,148315240,SRX5075176,SMARCA4,200
chr1,148315067,148315319,SRX5075169,SMARCA4,252
chr1,148334206,148334846,SRX20140881,CPSF3L,640
chr1,148334248,148334976,SRX20140895,INTS13,728
chr1,148334274,148334829,SRX20140896,INTS13,555
chr1,148334276,148335035,SRX20140867,INTS10,759
chr1,148334290,148334550,SRX5075175,SMARCA4,260
chr1,148334367,148334969,SRX20140868,INTS10,602
chr1,148334368,148334651,SRX5075170,SMARCA4,283
chr1,148334368,148334840,SRX20140879,CPSF3L,472
chr1,148334380,148334931,SRX20140869,INTS10,551
chr1,148334466,148334813,SRX5075176,SMARCA4,347
chr1,148334625,148334943,SRX5716470,SMARCA4,318
chr1,148334782,148335120,SRX5075168,SMARCA4,338
chr1,148334994,148335210,SRX5075169,SMARCA4,216
chr1,148345570,148346005,SRX16500059,CTCF,435
chr1,148345649,148346005,SRX16500060,CTCF,356
chr1,148345705,148345975,SRX16500061,CTCF,270
chr1,148345709,148345979,SRX5075170,SMARCA4,270
chr1,148345716,148345932,SRX16500062,CTCF,216
chr1,148345728,148345964,SRX4174629,CTCF,236
chr1,148345731,148345955,SRX5075174,SMARCA4,224
chr1,148345732,148346061,SRX5075169,SMARCA4,329
chr1,148345743,148345961,SRX5075168,SMARCA4,218
chr1,148345750,148346031,SRX5716470,SMARCA4,281
chr1,148345754,148346068,SRX5075176,SMARCA4,314
chr1,148345836,148346051,SRX5716469,SMARCA4,215
chr1,148361319,148361740,SRX4174629,CTCF,421
chr1,148361370,148361763,SRX16500062,CTCF,393
chr1,148361416,148361806,SRX16500060,CTCF,390
chr1,148361420,148361749,SRX16500061,CTCF,329
chr1,148361446,148361850,SRX16500059,CTCF,404
chr1,148371383,148371956,SRX16500061,CTCF,573
chr1,148371425,148371953,SRX16500062,CTCF,528
chr1,148371442,148371965,SRX16500059,CTCF,523
chr1,148371459,148372034,SRX16500060,CTCF,575
chr1,148371481,148371871,SRX4174629,CTCF,390
chr1,148371584,148371823,SRX5075174,SMARCA4,239
chr1,148371588,148371862,SRX5075168,SMARCA4,274
chr1,148371642,148371817,SRX5075176,SMARCA4,175
chr1,148388272,148388622,SRX20140881,CPSF3L,350
chr1,148402200,148402629,SRX5075174,SMARCA4,429
chr1,148402221,148402708,SRX5716470,SMARCA4,487
chr1,148402226,148402930,SRX20140895,INTS13,704
chr1,148402247,148402464,SRX5716463,SMARCA4,217
chr1,148402255,148402801,SRX5075169,SMARCA4,546
chr1,148402289,148402759,SRX5075170,SMARCA4,470
chr1,148402296,148402534,SRX5075175,SMARCA4,238
chr1,148402311,148402526,SRX5716469,SMARCA4,215
chr1,148402347,148402631,SRX5075168,SMARCA4,284
chr1,148402412,148402702,SRX5075176,SMARCA4,290
chr1,148402439,148402672,SRX5716467,SMARCA2,233
chr1,148402643,148402951,SRX20140869,INTS10,308
chr1,148402830,148403290,SRX20140881,CPSF3L,460
chr1,148417745,148417928,SRX5054309,FOSL2,183
chr1,148424150,148424521,SRX5075174,SMARCA4,371
chr1,148424198,148424462,SRX5075175,SMARCA4,264
chr1,148424205,148424557,SRX5075176,SMARCA4,352
chr1,148424213,148424597,SRX5075170,SMARCA4,384
chr1,148424215,148424545,SRX5075169,SMARCA4,330
chr1,148424215,148424550,SRX5075168,SMARCA4,335
chr1,148424236,148424533,SRX5054308,FOSL2,297
chr1,148424280,148424558,SRX5054309,FOSL2,278
chr1,148445052,148445347,SRX5054309,FOSL2,295
chr1,148452889,148453246,SRX5075175,SMARCA4,357
chr1,148453021,148453201,SRX5075169,SMARCA4,180
chr1,148458630,148459448,SRX20140895,INTS13,818
chr1,148458663,148459191,SRX20140868,INTS10,528
chr1,148458714,148459028,SRX5075168,SMARCA4,314
chr1,148458812,148459042,SRX5075174,SMARCA4,230
chr1,148458957,148459193,SRX5075175,SMARCA4,236
chr1,148459860,148460374,SRX5075170,SMARCA4,514
chr1,148459893,148460094,SRX5075176,SMARCA4,201
chr1,148459990,148460327,SRX5075169,SMARCA4,337
chr1,148460029,148460290,SRX5075175,SMARCA4,261
chr1,148460041,148460249,SRX5075174,SMARCA4,208
chr1,148460047,148460315,SRX5075168,SMARCA4,268
chr1,148466297,148466527,SRX5075174,SMARCA4,230
chr1,148466316,148466512,SRX5075168,SMARCA4,196
chr1,148512840,148513227,SRX5054309,FOSL2,387
chr1,148512860,148513168,SRX5075174,SMARCA4,308
chr1,148512878,148513178,SRX5054308,FOSL2,300
chr1,148512878,148513232,SRX5075169,SMARCA4,354
chr1,148512880,148513250,SRX5075175,SMARCA4,370
chr1,148512905,148513110,SRX5020214,SMARCA2,205
chr1,148512909,148513210,SRX5075170,SMARCA4,301
chr1,148512917,148513105,SRX5075176,SMARCA4,188
chr1,148522137,148522365,SRX5075170,SMARCA4,228
chr1,148522165,148522357,SRX5075174,SMARCA4,192
chr1,148522484,148522535,SRX1424893,POU3F2,51
chr1,148522485,148522533,SRX1424891,POU3F2,48
chr1,148522485,148522533,SRX1424892,POU3F2,48
chr1,148522486,148522534,SRX1424894,POU3F2,48
chr1,148522554,148523561,SRX20140895,INTS13,1007
chr1,148522558,148523584,SRX20140896,INTS13,1026
chr1,148522570,148523590,SRX20140867,INTS10,1020
chr1,148522577,148523630,SRX20140881,CPSF3L,1053
chr1,148522586,148523319,SRX20140897,INTS13,733
chr1,148522587,148522988,SRX20140882,CPSF3L,401
chr1,148522605,148523568,SRX20140879,CPSF3L,963
chr1,148522612,148523553,SRX20140869,INTS10,941
chr1,148522623,148523440,SRX20140868,INTS10,817
chr1,148522666,148523523,SRX20140880,CPSF3L,857
chr1,148522741,148523463,SRX20140894,INTS13,722
chr1,148522753,148523101,SRX5716469,SMARCA4,348
chr1,148522809,148523058,SRX5075169,SMARCA4,249
chr1,148528530,148529040,SRX16500059,CTCF,510
chr1,148528586,148529094,SRX16500060,CTCF,508
chr1,148528589,148529062,SRX16500062,CTCF,473
chr1,148528600,148529107,SRX16500061,CTCF,507
chr1,148528603,148528809,SRX5075169,SMARCA4,206
chr1,148528614,148529159,SRX4174629,CTCF,545
chr1,148528676,148528874,SRX5075176,SMARCA4,198
chr1,148528700,148528982,SRX5075170,SMARCA4,282
chr1,148589054,148589482,SRX16500059,CTCF,428
chr1,148589077,148589476,SRX16500061,CTCF,399
chr1,148589078,148589458,SRX16500062,CTCF,380
chr1,148589099,148589508,SRX16500060,CTCF,409
chr1,148589141,148589475,SRX4174629,CTCF,334
chr1,148589174,148589424,SRX5075174,SMARCA4,250
chr1,148589176,148589485,SRX5075170,SMARCA4,309
chr1,148589213,148589402,SRX5075169,SMARCA4,189
chr1,148589227,148589441,SRX5075176,SMARCA4,214
chr1,148595435,148595856,SRX16500059,CTCF,421
chr1,148595450,148595854,SRX16500061,CTCF,404
chr1,148595455,148595857,SRX16500062,CTCF,402
chr1,148595462,148595875,SRX16500060,CTCF,413
chr1,148595511,148595779,SRX5075176,SMARCA4,268
chr1,148595511,148595799,SRX4174629,CTCF,288
chr1,148595566,148595828,SRX5075168,SMARCA4,262
chr1,148595587,148595768,SRX5075169,SMARCA4,181
chr1,148605122,148605851,SRX5075170,SMARCA4,729
chr1,148605156,148605825,SRX5075176,SMARCA4,669
chr1,148605160,148605468,SRX5054309,FOSL2,308
chr1,148605450,148605805,SRX5075175,SMARCA4,355
chr1,148605454,148605779,SRX5716469,SMARCA4,325
chr1,148605480,148605691,SRX5020211,SMARCA2,211
chr1,148605481,148605776,SRX5716467,SMARCA2,295
chr1,148605513,148605776,SRX5716470,SMARCA4,263
chr1,148605572,148605767,SRX5075169,SMARCA4,195
chr1,148605576,148605793,SRX5054308,FOSL2,217
chr1,148625162,148625872,SRX5075176,SMARCA4,710
chr1,148625345,148625920,SRX5075175,SMARCA4,575
chr1,148625409,148625768,SRX5716470,SMARCA4,359
chr1,148625410,148625879,SRX5075170,SMARCA4,469
chr1,148625419,148625800,SRX5075169,SMARCA4,381
chr1,148625427,148625829,SRX5716467,SMARCA2,402
chr1,148625510,148625743,SRX5716469,SMARCA4,233
chr1,148625547,148625781,SRX5716468,SMARCA2,234
chr1,148647272,148647684,SRX5075169,SMARCA4,412
chr1,148647313,148647524,SRX5716470,SMARCA4,211
chr1,148647369,148647736,SRX5075176,SMARCA4,367
chr1,148647422,148647701,SRX5075175,SMARCA4,279
chr1,148654858,148655145,SRX5075169,SMARCA4,287
chr1,148654859,148655275,SRX5075175,SMARCA4,416
chr1,148654874,148655253,SRX5716469,SMARCA4,379
chr1,148654876,148655408,SRX5075170,SMARCA4,532
chr1,148654890,148655179,SRX5075176,SMARCA4,289
chr1,148654890,148655193,SRX5054308,FOSL2,303
chr1,148654921,148655338,SRX5054309,FOSL2,417
chr1,148662434,148662759,SRX5075176,SMARCA4,325
chr1,148662439,148662631,SRX5054308,FOSL2,192
chr1,148662441,148662763,SRX5075169,SMARCA4,322
chr1,148662446,148662760,SRX5075170,SMARCA4,314
chr1,148662468,148662720,SRX5075175,SMARCA4,252
chr1,148662478,148662690,SRX5054309,FOSL2,212
chr1,148669153,148669841,SRX5075168,SMARCA4,688
chr1,148669183,148669837,SRX5075174,SMARCA4,654
chr1,148669206,148669893,SRX5716470,SMARCA4,687
chr1,148669218,148669929,SRX5075170,SMARCA4,711
chr1,148669240,148669713,SRX5716469,SMARCA4,473
chr1,148669257,148669832,SRX20140881,CPSF3L,575
chr1,148669278,148669636,SRX5716468,SMARCA2,358
chr1,148669289,148669901,SRX5075176,SMARCA4,612
chr1,148669295,148669597,SRX5054309,FOSL2,302
chr1,148669299,148669791,SRX5054308,FOSL2,492
chr1,148669301,148669947,SRX5075169,SMARCA4,646
chr1,148669308,148669617,SRX5020211,SMARCA2,309
chr1,148669311,148669546,SRX5716463,SMARCA4,235
chr1,148669312,148669658,SRX20140869,INTS10,346
chr1,148669314,148669644,SRX5716467,SMARCA2,330
chr1,148669328,148669919,SRX5075175,SMARCA4,591
chr1,148669344,148669813,SRX20140867,INTS10,469
chr1,148669348,148669650,SRX5716464,SMARCA4,302
chr1,148669388,148669646,SRX20140897,INTS13,258
chr1,148669391,148669677,SRX20140896,INTS13,286
chr1,148669663,148669888,SRX5054309,FOSL2,225
chr1,148679232,148680112,SRX20140895,INTS13,880
chr1,148679536,148680024,SRX20140868,INTS10,488
chr1,148679564,148679985,SRX20140881,CPSF3L,421
chr1,148679616,148680021,SRX20140867,INTS10,405
chr1,148679632,148679874,SRX20140879,CPSF3L,242
chr1,148679655,148680022,SRX5075170,SMARCA4,367
chr1,148679763,148680115,SRX5075168,SMARCA4,352
chr1,148679767,148680096,SRX5075174,SMARCA4,329
chr1,148679785,148680018,SRX5075175,SMARCA4,233
chr1,148679854,148680045,SRX5075176,SMARCA4,191
chr1,148692760,148692972,SRX5075175,SMARCA4,212
chr1,148713241,148713713,SRX5075170,SMARCA4,472
chr1,148713326,148713634,SRX5075176,SMARCA4,308
chr1,148713329,148713632,SRX5716470,SMARCA4,303
chr1,148713367,148713659,SRX5716467,SMARCA2,292
chr1,148713387,148713634,SRX5716469,SMARCA4,247
chr1,148713392,148713632,SRX5716468,SMARCA2,240
chr1,148713410,148713611,SRX5020211,SMARCA2,201
chr1,148713411,148713667,SRX5075169,SMARCA4,256
chr1,148727917,148728177,SRX5054308,FOSL2,260
chr1,148727957,148728193,SRX5075175,SMARCA4,236
chr1,148727962,148728214,SRX5054309,FOSL2,252
chr1,148727963,148728195,SRX5075170,SMARCA4,232
chr1,148727987,148728179,SRX5075176,SMARCA4,192
chr1,148729097,148729367,SRX5716470,SMARCA4,270
chr1,148729160,148729376,SRX5716468,SMARCA2,216
chr1,148729172,148729464,SRX5075170,SMARCA4,292
chr1,148732340,148732527,SRX5075175,SMARCA4,187
chr1,148732353,148732638,SRX5716470,SMARCA4,285
chr1,148744153,148744748,SRX5075176,SMARCA4,595
chr1,148744208,148744676,SRX5075170,SMARCA4,468
chr1,148744251,148744586,SRX5075175,SMARCA4,335
chr1,148744334,148744545,SRX5716470,SMARCA4,211
chr1,148744406,148744629,SRX5075169,SMARCA4,223
chr1,148748461,148749177,SRX20140895,INTS13,716
chr1,148748542,148748897,SRX5075174,SMARCA4,355
chr1,148748734,148749059,SRX5075169,SMARCA4,325
chr1,148748762,148748974,SRX5716469,SMARCA4,212
chr1,148748820,148749091,SRX5075175,SMARCA4,271
chr1,148748841,148749028,SRX5075176,SMARCA4,187
chr1,148749220,148749668,SRX16500060,CTCF,448
chr1,148749228,148749693,SRX16500059,CTCF,465
chr1,148749297,148749674,SRX16500061,CTCF,377
chr1,148749318,148749689,SRX4174629,CTCF,371
chr1,148749330,148749536,SRX5075176,SMARCA4,206
chr1,148749332,148749726,SRX16500062,CTCF,394
chr1,148749336,148749614,SRX5075174,SMARCA4,278
chr1,148749341,148749565,SRX5075168,SMARCA4,224
chr1,148758542,148758861,SRX5075175,SMARCA4,319
chr1,148758546,148758918,SRX5075169,SMARCA4,372
chr1,148758559,148758848,SRX5716470,SMARCA4,289
chr1,148758578,148758890,SRX5054309,FOSL2,312
chr1,148760254,148760485,SRX5075170,SMARCA4,231
chr1,148761283,148761824,SRX16500062,CTCF,541
chr1,148761297,148761870,SRX16500059,CTCF,573
chr1,148761332,148761868,SRX16500060,CTCF,536
chr1,148761336,148761868,SRX16500061,CTCF,532
chr1,148761395,148761705,SRX5075174,SMARCA4,310
chr1,148761420,148761686,SRX5075168,SMARCA4,266
chr1,148761421,148761685,SRX4174629,CTCF,264
chr1,148761458,148761667,SRX5075175,SMARCA4,209
chr1,148761472,148761646,SRX5075170,SMARCA4,174
chr1,148761472,148761670,SRX5075176,SMARCA4,198
chr1,148778338,148778859,SRX5075174,SMARCA4,521
chr1,148778379,148778752,SRX5075168,SMARCA4,373
chr1,148778460,148778716,SRX5716463,SMARCA4,256
chr1,148791331,148791930,SRX5716469,SMARCA4,599
chr1,148791370,148791960,SRX5075176,SMARCA4,590
chr1,148791375,148791944,SRX5716460,Epitope tags,569
chr1,148791403,148792071,SRX5075170,SMARCA4,668
chr1,148791422,148791892,SRX5716470,SMARCA4,470
chr1,148791433,148791944,SRX5075169,SMARCA4,511
chr1,148791445,148791695,SRX5716453,SOX2,250
chr1,148791445,148791964,SRX5075175,SMARCA4,519
chr1,148791471,148791781,SRX5075182,SMARCA2,310
chr1,148791478,148791861,SRX5716468,SMARCA2,383
chr1,148791479,148791829,SRX5054309,FOSL2,350
chr1,148791485,148791834,SRX5075181,SMARCA2,349
chr1,148791495,148791884,SRX5716467,SMARCA2,389
chr1,148791499,148791849,SRX5020214,SMARCA2,350
chr1,148791518,148791889,SRX5020211,SMARCA2,371
chr1,148791523,148791884,SRX5075174,SMARCA4,361
chr1,148791525,148791803,SRX5054308,FOSL2,278
chr1,148791529,148791857,SRX5075168,SMARCA4,328
chr1,148791548,148791900,SRX5716459,Epitope tags,352
chr1,148793719,148794149,SRX5054309,FOSL2,430
chr1,148793758,148794001,SRX5054308,FOSL2,243
chr1,148799988,148800346,SRX5075175,SMARCA4,358
chr1,148799991,148800361,SRX5716467,SMARCA2,370
chr1,148800003,148800407,SRX5075169,SMARCA4,404
chr1,148800042,148800431,SRX5075176,SMARCA4,389
chr1,148800046,148800403,SRX5716469,SMARCA4,357
chr1,148800059,148800460,SRX5075170,SMARCA4,401
chr1,148800061,148800426,SRX5716470,SMARCA4,365
chr1,148800086,148800382,SRX5716468,SMARCA2,296
chr1,148800525,148800752,SRX5075169,SMARCA4,227
chr1,148800676,148800858,SRX5054308,FOSL2,182
chr1,148818932,148819232,SRX5716469,SMARCA4,300
chr1,148825055,148825408,SRX16500060,CTCF,353
chr1,148825060,148825392,SRX16500062,CTCF,332
chr1,148825069,148825402,SRX16500059,CTCF,333
chr1,148825095,148825399,SRX16500061,CTCF,304
chr1,148829000,148829552,SRX5075176,SMARCA4,552
chr1,148829008,148829381,SRX5075169,SMARCA4,373
chr1,148829016,148829391,SRX5716470,SMARCA4,375
chr1,148829016,148829396,SRX5716469,SMARCA4,380
chr1,148829028,148829313,SRX5020211,SMARCA2,285
chr1,148829031,148829407,SRX5716467,SMARCA2,376
chr1,148829035,148829389,SRX5075170,SMARCA4,354
chr1,148829057,148829391,SRX5075181,SMARCA2,334
chr1,148829067,148829383,SRX5075175,SMARCA4,316
chr1,148829072,148829422,SRX5716468,SMARCA2,350
chr1,148829101,148829405,SRX5054308,FOSL2,304
chr1,148829111,148829358,SRX5054309,FOSL2,247
chr1,148841264,148841584,SRX5075169,SMARCA4,320
chr1,148841275,148841508,SRX5075170,SMARCA4,233
chr1,148841290,148841562,SRX5075176,SMARCA4,272
chr1,148841319,148841629,SRX5054309,FOSL2,310
chr1,148841321,148841625,SRX5054308,FOSL2,304
chr1,148841326,148841548,SRX5075175,SMARCA4,222
chr1,148844354,148844720,SRX5075176,SMARCA4,366
chr1,148844358,148844561,SRX5075175,SMARCA4,203
chr1,148844368,148844682,SRX5075170,SMARCA4,314
chr1,148844411,148844653,SRX5075174,SMARCA4,242
chr1,148844449,148844866,SRX5716470,SMARCA4,417
chr1,148851716,148852099,SRX5075175,SMARCA4,383
chr1,148851755,148852078,SRX5716469,SMARCA4,323
chr1,148851770,148852106,SRX5054309,FOSL2,336
chr1,148851787,148852047,SRX5054308,FOSL2,260
chr1,148851796,148852131,SRX5075169,SMARCA4,335
chr1,148851837,148852022,SRX5075170,SMARCA4,185
chr1,148851846,148852081,SRX5716467,SMARCA2,235
chr1,148855455,148855726,SRX5075176,SMARCA4,271
chr1,148855468,148855795,SRX5075170,SMARCA4,327
chr1,148855493,148855730,SRX5075169,SMARCA4,237
chr1,148859493,148859744,SRX5054309,FOSL2,251
chr1,148859544,148859787,SRX5054308,FOSL2,243
chr1,148860912,148861148,SRX5075168,SMARCA4,236
chr1,148869574,148869831,SRX5716469,SMARCA4,257
chr1,148869593,148869932,SRX5075169,SMARCA4,339
chr1,148869614,148869926,SRX5075170,SMARCA4,312
chr1,148869617,148870034,SRX16500061,CTCF,417
chr1,148869620,148870050,SRX16500060,CTCF,430
chr1,148869631,148869935,SRX5075175,SMARCA4,304
chr1,148869633,148869904,SRX5075176,SMARCA4,271
chr1,148869647,148869913,SRX5716470,SMARCA4,266
chr1,148869649,148870074,SRX16500059,CTCF,425
chr1,148869677,148869921,SRX5075174,SMARCA4,244
chr1,148869679,148869985,SRX5075168,SMARCA4,306
chr1,148869699,148869992,SRX16500062,CTCF,293
chr1,148874598,148875130,SRX5075176,SMARCA4,532
chr1,148874600,148875054,SRX5075170,SMARCA4,454
chr1,148874627,148875168,SRX5075175,SMARCA4,541
chr1,148874631,148875272,SRX5075169,SMARCA4,641
chr1,148874632,148875024,SRX5020211,SMARCA2,392
chr1,148874632,148875032,SRX5716469,SMARCA4,400
chr1,148874635,148875404,SRX5716470,SMARCA4,769
chr1,148874650,148874984,SRX5716468,SMARCA2,334
chr1,148874663,148875018,SRX5054309,FOSL2,355
chr1,148874670,148875161,SRX5716467,SMARCA2,491
chr1,148874687,148875058,SRX5054308,FOSL2,371
chr1,148874721,148874959,SRX5020214,SMARCA2,238
chr1,148874732,148875014,SRX5075181,SMARCA2,282
chr1,148874938,148875240,SRX5716460,Epitope tags,302
chr1,148881209,148881564,SRX5054309,FOSL2,355
chr1,148881213,148881544,SRX5054308,FOSL2,331
chr1,148881215,148881512,SRX5075169,SMARCA4,297
chr1,148881252,148881581,SRX5075170,SMARCA4,329
chr1,148881271,148881590,SRX5075176,SMARCA4,319
chr1,148881301,148881540,SRX5075175,SMARCA4,239
chr1,148881324,148881546,SRX5716470,SMARCA4,222
chr1,148894647,148895042,SRX5075175,SMARCA4,395
chr1,148894677,148895009,SRX5075169,SMARCA4,332
chr1,148894702,148895035,SRX5716470,SMARCA4,333
chr1,148894704,148894883,SRX5075170,SMARCA4,179
chr1,148894712,148895020,SRX5075176,SMARCA4,308
chr1,148894722,148894930,SRX5054309,FOSL2,208
chr1,148894723,148894945,SRX5716469,SMARCA4,222
chr1,148900821,148901312,SRX5075170,SMARCA4,491
chr1,148900895,148901136,SRX5075169,SMARCA4,241
chr1,148900970,148901170,SRX5075176,SMARCA4,200
chr1,148901115,148901534,SRX5075175,SMARCA4,419
chr1,148901243,148901487,SRX5075169,SMARCA4,244
chr1,148901250,148901447,SRX5075176,SMARCA4,197
chr1,148909288,148909648,SRX5075174,SMARCA4,360
chr1,148909324,148909629,SRX5075168,SMARCA4,305
chr1,148911386,148911633,SRX16500060,CTCF,247
chr1,148916849,148917306,SRX5075170,SMARCA4,457
chr1,148916911,148917190,SRX20140897,INTS13,279
chr1,148916912,148917359,SRX5075176,SMARCA4,447
chr1,148916922,148917345,SRX5075169,SMARCA4,423
chr1,148916941,148917372,SRX5075175,SMARCA4,431
chr1,148916944,148917337,SRX5716470,SMARCA4,393
chr1,148916974,148917506,SRX5716469,SMARCA4,532
chr1,148942707,148943441,SRX5716470,SMARCA4,734
chr1,148942719,148943546,SRX5075168,SMARCA4,827
chr1,148942737,148943499,SRX5075174,SMARCA4,762
chr1,148942744,148943439,SRX5075176,SMARCA4,695
chr1,148942803,148943366,SRX5716469,SMARCA4,563
chr1,148942804,148943428,SRX5075169,SMARCA4,624
chr1,148942840,148943467,SRX5716464,SMARCA4,627
chr1,148942853,148943343,SRX5716467,SMARCA2,490
chr1,148942860,148943363,SRX20140881,CPSF3L,503
chr1,148942861,148943182,SRX20140869,INTS10,321
chr1,148942868,148943390,SRX5716463,SMARCA4,522
chr1,148942871,148943444,SRX5075170,SMARCA4,573
chr1,148942885,148943441,SRX5075175,SMARCA4,556
chr1,148942894,148943164,SRX5075182,SMARCA2,270
chr1,148942906,148943319,SRX5716468,SMARCA2,413
chr1,148942909,148943311,SRX5054309,FOSL2,402
chr1,148942933,148943272,SRX5020211,SMARCA2,339
chr1,148942939,148943280,SRX5054308,FOSL2,341
chr1,148942940,148943190,SRX5075181,SMARCA2,250
chr1,148942969,148943247,SRX5716451,SOX2,278
chr1,148942998,148943220,SRX20140867,INTS10,222
chr1,148943011,148943226,SRX5020214,SMARCA2,215
chr1,148947210,148947602,SRX5075169,SMARCA4,392
chr1,148947214,148947558,SRX5075176,SMARCA4,344
chr1,148947218,148947542,SRX5716467,SMARCA2,324
chr1,148947242,148947548,SRX5020214,SMARCA2,306
chr1,148947256,148947576,SRX5020211,SMARCA2,320
chr1,148947271,148947548,SRX5075175,SMARCA4,277
chr1,148947291,148947660,SRX5075170,SMARCA4,369
chr1,148947308,148947576,SRX5716468,SMARCA2,268
chr1,148947314,148947562,SRX5054308,FOSL2,248
chr1,148947316,148947518,SRX5054309,FOSL2,202
chr1,148947347,148947567,SRX5716470,SMARCA4,220
chr1,148951817,148952646,SRX5075174,SMARCA4,829
chr1,148951829,148952051,SRX5075175,SMARCA4,222
chr1,148951844,148952127,SRX5075170,SMARCA4,283
chr1,148951899,148952793,SRX20140895,INTS13,894
chr1,148951901,148952627,SRX5075168,SMARCA4,726
chr1,148952299,148952577,SRX20140867,INTS10,278
chr1,148952323,148952584,SRX5075170,SMARCA4,261
chr1,148952405,148952622,SRX5716470,SMARCA4,217
chr1,148952428,148952892,SRX20140868,INTS10,464
chr1,148952486,148952677,SRX5075175,SMARCA4,191
chr1,148952491,148952697,SRX5075169,SMARCA4,206
chr1,148960593,148960855,SRX5075170,SMARCA4,262
chr1,148965966,148966717,SRX4174629,CTCF,751
chr1,148966002,148966550,SRX16500059,CTCF,548
chr1,148966018,148966565,SRX16500061,CTCF,547
chr1,148966032,148966645,SRX16500062,CTCF,613
chr1,148966044,148966528,SRX16500060,CTCF,484
chr1,148966060,148966415,SRX5075174,SMARCA4,355
chr1,148966103,148966466,SRX5075168,SMARCA4,363
chr1,148966106,148966382,SRX5716469,SMARCA4,276
chr1,148966112,148966423,SRX5075176,SMARCA4,311
chr1,148966135,148966412,SRX5075170,SMARCA4,277
chr1,148966138,148966378,SRX5075175,SMARCA4,240
chr1,148966159,148966394,SRX5716470,SMARCA4,235
chr1,148966169,148966404,SRX5075169,SMARCA4,235
chr1,148966203,148966433,SRX5716463,SMARCA4,230
chr1,148975330,148975686,SRX5054309,FOSL2,356
chr1,148975359,148975735,SRX5075175,SMARCA4,376
chr1,148975363,148975657,SRX5054308,FOSL2,294
chr1,148975377,148975731,SRX5075170,SMARCA4,354
chr1,148975394,148975690,SRX5075176,SMARCA4,296
chr1,148975406,148975672,SRX5716469,SMARCA4,266
chr1,148975410,148975760,SRX5075169,SMARCA4,350
chr1,148992307,148992809,SRX5075175,SMARCA4,502
chr1,148992372,148992876,SRX5075170,SMARCA4,504
chr1,148992376,148992864,SRX5054309,FOSL2,488
chr1,148992386,148992860,SRX5054308,FOSL2,474
chr1,148992394,148992605,SRX5020211,SMARCA2,211
chr1,148992419,148992829,SRX5075169,SMARCA4,410
chr1,148992424,148992675,SRX5716469,SMARCA4,251
chr1,148992443,148992809,SRX5075176,SMARCA4,366
chr1,149007306,149007640,SRX16500060,CTCF,334
chr1,149007309,149007620,SRX16500061,CTCF,311
chr1,149007313,149007657,SRX16500059,CTCF,344
chr1,149007375,149007895,SRX5075174,SMARCA4,520
chr1,149007381,149007806,SRX5716463,SMARCA4,425
chr1,149007406,149007666,SRX16500062,CTCF,260
chr1,149007450,149007792,SRX5075168,SMARCA4,342
chr1,149007523,149007823,SRX5716464,SMARCA4,300
chr1,149007545,149007812,SRX20140867,INTS10,267
chr1,149075506,149075952,SRX16500060,CTCF,446
chr1,149075535,149075933,SRX16500062,CTCF,398
chr1,149075554,149075960,SRX16500061,CTCF,406
chr1,149075565,149075974,SRX16500059,CTCF,409
chr1,149075609,149075861,SRX5075174,SMARCA4,252
chr1,149075617,149075937,SRX4174629,CTCF,320
chr1,149075638,149075838,SRX5075168,SMARCA4,200
chr1,149075639,149075866,SRX5075170,SMARCA4,227
chr1,149075676,149075902,SRX5075175,SMARCA4,226
chr1,149081918,149082232,SRX16500060,CTCF,314
chr1,149086851,149087245,SRX5075174,SMARCA4,394
chr1,149086932,149087216,SRX5075168,SMARCA4,284
chr1,149102588,149102826,SRX5075169,SMARCA4,238
chr1,149103304,149103508,SRX5716463,SMARCA4,204
chr1,149103309,149103489,SRX5075169,SMARCA4,180
chr1,149103314,149103990,SRX20140895,INTS13,676
chr1,149103433,149103770,SRX5075168,SMARCA4,337
chr1,149103436,149103968,SRX20140868,INTS10,532
chr1,149103447,149103966,SRX5075174,SMARCA4,519
chr1,149103454,149103623,SRX5075170,SMARCA4,169
chr1,149103647,149103983,SRX5716470,SMARCA4,336
chr1,149103711,149104074,SRX5075176,SMARCA4,363
chr1,149103795,149104030,SRX5075170,SMARCA4,235
chr1,149119123,149119354,SRX5075174,SMARCA4,231
chr1,149119128,149119366,SRX5075168,SMARCA4,238
chr1,149124174,149124648,SRX16500061,CTCF,474
chr1,149124242,149124625,SRX16500059,CTCF,383
chr1,149124244,149124634,SRX16500060,CTCF,390
chr1,149124260,149124604,SRX5075168,SMARCA4,344
chr1,149124287,149124632,SRX16500062,CTCF,345
chr1,149124307,149124645,SRX4174629,CTCF,338
chr1,149124307,149124645,SRX5075174,SMARCA4,338
chr1,149124331,149124579,SRX5075176,SMARCA4,248
chr1,149124357,149124653,SRX5075170,SMARCA4,296
chr1,149124425,149124649,SRX5716469,SMARCA4,224
chr1,149129016,149129498,SRX4174629,CTCF,482
chr1,149129104,149129366,SRX16500061,CTCF,262
chr1,149129104,149129432,SRX16500060,CTCF,328
chr1,149129106,149129355,SRX16500059,CTCF,249
chr1,149129113,149129394,SRX16500062,CTCF,281
chr1,149129119,149129345,SRX5075175,SMARCA4,226
chr1,149129142,149129336,SRX5075176,SMARCA4,194
chr1,149129191,149129419,SRX5075170,SMARCA4,228
chr1,149150630,149150941,SRX5054308,FOSL2,311
chr1,149150657,149150927,SRX5075176,SMARCA4,270
chr1,149150686,149150958,SRX5054309,FOSL2,272
chr1,149150775,149150974,SRX5075175,SMARCA4,199
chr1,149155290,149155519,SRX5716469,SMARCA4,229
chr1,149155302,149155682,SRX5075170,SMARCA4,380
chr1,149155313,149155578,SRX5075176,SMARCA4,265
chr1,149155354,149155601,SRX5075175,SMARCA4,247
chr1,149155429,149155743,SRX5075169,SMARCA4,314
chr1,149161497,149161757,SRX16500062,CTCF,260
chr1,149162398,149162915,SRX20140881,CPSF3L,517
chr1,149162409,149162922,SRX20140896,INTS13,513
chr1,149162445,149162872,SRX20140867,INTS10,427
chr1,149162546,149163083,SRX20140895,INTS13,537
chr1,149175609,149175949,SRX5075175,SMARCA4,340
chr1,149175744,149176086,SRX5075176,SMARCA4,342
chr1,149175825,149176130,SRX5075170,SMARCA4,305
chr1,149176465,149177165,SRX20140895,INTS13,700
chr1,149176605,149177136,SRX5075169,SMARCA4,531
chr1,149176608,149177144,SRX5075168,SMARCA4,536
chr1,149176626,149177056,SRX5716469,SMARCA4,430
chr1,149176660,149177071,SRX5075174,SMARCA4,411
chr1,149176675,149177106,SRX5716470,SMARCA4,431
chr1,149176693,149176955,SRX5075175,SMARCA4,262
chr1,149176742,149177010,SRX5075170,SMARCA4,268
chr1,149176766,149177029,SRX20140868,INTS10,263
chr1,149182618,149182952,SRX5075169,SMARCA4,334
chr1,149182631,149182971,SRX5075175,SMARCA4,340
chr1,149190698,149190961,SRX5054309,FOSL2,263
chr1,149200685,149200966,SRX5054309,FOSL2,281
chr1,149200721,149200907,SRX5075170,SMARCA4,186
chr1,149200751,149201017,SRX5075176,SMARCA4,266
chr1,149212081,149212256,SRX5075176,SMARCA4,175
chr1,149212907,149213225,SRX5716469,SMARCA4,318
chr1,149212947,149213345,SRX5075175,SMARCA4,398
chr1,149212949,149213240,SRX5075176,SMARCA4,291
chr1,149212951,149213194,SRX5716470,SMARCA4,243
chr1,149212957,149213314,SRX5075169,SMARCA4,357
chr1,149212969,149213404,SRX5075170,SMARCA4,435
chr1,149212986,149213215,SRX5054309,FOSL2,229
chr1,149218609,149218971,SRX16500060,CTCF,362
chr1,149218735,149218966,SRX16500062,CTCF,231
chr1,149220679,149220930,SRX5075174,SMARCA4,251
chr1,149220686,149220968,SRX5075168,SMARCA4,282
chr1,149228718,149229141,SRX5075175,SMARCA4,423
chr1,149228797,149229032,SRX5075169,SMARCA4,235
chr1,149228803,149229380,SRX5075176,SMARCA4,577
chr1,149228818,149229379,SRX5075170,SMARCA4,561
chr1,149228819,149229312,SRX5716470,SMARCA4,493
chr1,149228822,149229272,SRX5716469,SMARCA4,450
chr1,149229087,149229287,SRX5075169,SMARCA4,200
chr1,149235228,149235712,SRX5075169,SMARCA4,484
chr1,149235242,149235534,SRX5075170,SMARCA4,292
chr1,149235244,149235618,SRX5020211,SMARCA2,374
chr1,149235248,149235704,SRX5716469,SMARCA4,456
chr1,149235259,149235562,SRX5716467,SMARCA2,303
chr1,149235264,149235524,SRX5716470,SMARCA4,260
chr1,149235276,149235562,SRX5054309,FOSL2,286
chr1,149235295,149235583,SRX5075175,SMARCA4,288
chr1,149235329,149235674,SRX5075176,SMARCA4,345
chr1,149248684,149248991,SRX5075170,SMARCA4,307
chr1,149248691,149249016,SRX5075176,SMARCA4,325
chr1,149248693,149248978,SRX5054309,FOSL2,285
chr1,149248715,149248986,SRX5054308,FOSL2,271
chr1,149248741,149248953,SRX5075175,SMARCA4,212
chr1,149248776,149248978,SRX5075169,SMARCA4,202
chr1,149255039,149255652,SRX5075176,SMARCA4,613
chr1,149255111,149255643,SRX5075175,SMARCA4,532
chr1,149255127,149255654,SRX5716469,SMARCA4,527
chr1,149255129,149255587,SRX5716468,SMARCA2,458
chr1,149255147,149255621,SRX5075169,SMARCA4,474
chr1,149255150,149255640,SRX5716467,SMARCA2,490
chr1,149255154,149255532,SRX5075181,SMARCA2,378
chr1,149255159,149255618,SRX5054308,FOSL2,459
chr1,149255164,149255524,SRX5020214,SMARCA2,360
chr1,149255171,149255596,SRX5716470,SMARCA4,425
chr1,149255190,149255490,SRX5716459,Epitope tags,300
chr1,149255198,149255578,SRX5054309,FOSL2,380
chr1,149255209,149255630,SRX5075170,SMARCA4,421
chr1,149255229,149255619,SRX5020211,SMARCA2,390
chr1,149255288,149255484,SRX5075182,SMARCA2,196
chr1,149255309,149255488,SRX5054307,FOSL2,179
chr1,149260142,149260629,SRX16500062,CTCF,487
chr1,149260176,149260659,SRX16500060,CTCF,483
chr1,149260225,149260557,SRX16500061,CTCF,332
chr1,149260245,149260615,SRX16500059,CTCF,370
chr1,149260271,149260559,SRX5075168,SMARCA4,288
chr1,149260287,149260574,SRX5075174,SMARCA4,287
chr1,149260321,149260624,SRX5075176,SMARCA4,303
chr1,149260324,149260657,SRX5075170,SMARCA4,333
chr1,149260337,149260663,SRX5716470,SMARCA4,326
chr1,149260346,149260597,SRX5716469,SMARCA4,251
chr1,149260348,149260591,SRX5075169,SMARCA4,243
chr1,149260358,149260669,SRX5075175,SMARCA4,311
chr1,149269253,149269514,SRX5075168,SMARCA4,261
chr1,149270438,149270717,SRX5054309,FOSL2,279
chr1,149270456,149270732,SRX5054308,FOSL2,276
chr1,149270495,149270675,SRX5075170,SMARCA4,180
chr1,149270540,149270720,SRX5075176,SMARCA4,180
chr1,149274495,149274771,SRX5075169,SMARCA4,276
chr1,149274505,149274886,SRX5075176,SMARCA4,381
chr1,149274583,149274794,SRX5075170,SMARCA4,211
chr1,149278157,149278473,SRX5075169,SMARCA4,316
chr1,149278166,149278527,SRX5054309,FOSL2,361
chr1,149278172,149278549,SRX5075175,SMARCA4,377
chr1,149278188,149278431,SRX5075176,SMARCA4,243
chr1,149278191,149278496,SRX5054308,FOSL2,305
chr1,149278217,149278459,SRX5075170,SMARCA4,242
chr1,149285531,149285904,SRX5075174,SMARCA4,373
chr1,149285546,149285955,SRX5075168,SMARCA4,409
chr1,149285554,149285993,SRX5075176,SMARCA4,439
chr1,149285564,149285875,SRX5075170,SMARCA4,311
chr1,149285565,149285881,SRX5716470,SMARCA4,316
chr1,149285574,149285866,SRX5075175,SMARCA4,292
chr1,149285661,149285967,SRX5075169,SMARCA4,306
chr1,149288613,149288951,SRX5054309,FOSL2,338
chr1,149288624,149288961,SRX5054308,FOSL2,337
chr1,149288631,149288954,SRX5075176,SMARCA4,323
chr1,149288650,149288911,SRX5075175,SMARCA4,261
chr1,149288671,149288969,SRX5075169,SMARCA4,298
chr1,149288674,149289013,SRX5075170,SMARCA4,339
chr1,149300764,149301206,SRX5075169,SMARCA4,442
chr1,149300784,149301246,SRX5716467,SMARCA2,462
chr1,149300789,149301225,SRX5716469,SMARCA4,436
chr1,149300794,149301194,SRX5716470,SMARCA4,400
chr1,149300830,149301175,SRX5075175,SMARCA4,345
chr1,149300833,149301219,SRX5075170,SMARCA4,386
chr1,149300838,149301260,SRX5075176,SMARCA4,422
chr1,149300861,149301203,SRX5054308,FOSL2,342
chr1,149300869,149301245,SRX5716468,SMARCA2,376
chr1,149300887,149301162,SRX5020211,SMARCA2,275
chr1,149300902,149301107,SRX5020214,SMARCA2,205
chr1,149300907,149301157,SRX5075181,SMARCA2,250
chr1,149300925,149301178,SRX5054309,FOSL2,253
chr1,149304820,149305095,SRX16500061,CTCF,275
chr1,149304829,149305180,SRX16500060,CTCF,351
chr1,149304871,149305141,SRX16500062,CTCF,270
chr1,149304907,149305142,SRX16500059,CTCF,235
chr1,149321428,149321673,SRX5075170,SMARCA4,245
chr1,149321457,149321655,SRX5075175,SMARCA4,198
chr1,149329329,149329577,SRX5054308,FOSL2,248
chr1,149329433,149329629,SRX5075170,SMARCA4,196
chr1,149329701,149330200,SRX5075176,SMARCA4,499
chr1,149329716,149330194,SRX5716470,SMARCA4,478
chr1,149329802,149330253,SRX5716467,SMARCA2,451
chr1,149329822,149330240,SRX5075169,SMARCA4,418
chr1,149329831,149330211,SRX5716468,SMARCA2,380
chr1,149329837,149330221,SRX5716469,SMARCA4,384
chr1,149329851,149330223,SRX5075170,SMARCA4,372
chr1,149329854,149330244,SRX5075175,SMARCA4,390
chr1,149329868,149330096,SRX5020211,SMARCA2,228
chr1,149336210,149336494,SRX5054309,FOSL2,284
chr1,149338218,149338814,SRX5075176,SMARCA4,596
chr1,149338245,149338822,SRX5075175,SMARCA4,577
chr1,149338305,149338896,SRX5075170,SMARCA4,591
chr1,149338309,149338581,SRX20140895,INTS13,272
chr1,149338316,149338798,SRX5716470,SMARCA4,482
chr1,149338329,149338828,SRX5075169,SMARCA4,499
chr1,149338345,149338714,SRX5075174,SMARCA4,369
chr1,149338351,149338805,SRX5716460,Epitope tags,454
chr1,149338359,149338757,SRX5020214,SMARCA2,398
chr1,149338375,149338792,SRX5716467,SMARCA2,417
chr1,149338376,149338707,SRX5075168,SMARCA4,331
chr1,149338383,149338771,SRX5054309,FOSL2,388
chr1,149338390,149338722,SRX5716468,SMARCA2,332
chr1,149338392,149338626,SRX5716463,SMARCA4,234
chr1,149338399,149338610,SRX5716464,SMARCA4,211
chr1,149338406,149338758,SRX5716469,SMARCA4,352
chr1,149338411,149338734,SRX5020211,SMARCA2,323
chr1,149338420,149338781,SRX5054308,FOSL2,361
chr1,149338424,149338757,SRX5075181,SMARCA2,333
chr1,149338458,149338663,SRX5075182,SMARCA2,205
chr1,149351329,149351899,SRX5075168,SMARCA4,570
chr1,149351513,149351931,SRX5075174,SMARCA4,418
chr1,149369116,149369342,SRX5054309,FOSL2,226
chr1,149369135,149369331,SRX5054308,FOSL2,196
chr1,149378822,149379009,SRX5075175,SMARCA4,187
chr1,149378823,149379002,SRX5075168,SMARCA4,179
chr1,149390194,149390619,SRX5075168,SMARCA4,425
chr1,149390228,149390544,SRX5716470,SMARCA4,316
chr1,149390246,149390607,SRX5075174,SMARCA4,361
chr1,149390271,149390645,SRX5075170,SMARCA4,374
chr1,149390282,149390659,SRX5075175,SMARCA4,377
chr1,149390284,149391003,SRX20140895,INTS13,719
chr1,149390306,149390635,SRX5075176,SMARCA4,329
chr1,149390324,149390865,SRX20140868,INTS10,541
chr1,149390334,149390846,SRX20140867,INTS10,512
chr1,149390355,149390754,SRX5075169,SMARCA4,399
chr1,149390356,149390879,SRX20140881,CPSF3L,523
chr1,149390358,149390800,SRX20140879,CPSF3L,442
chr1,149390384,149390735,SRX20140894,INTS13,351
chr1,149390385,149390576,SRX5054308,FOSL2,191
chr1,149390389,149390803,SRX20140896,INTS13,414
chr1,149390390,149390797,SRX20140869,INTS10,407
chr1,149390396,149390810,SRX20140897,INTS13,414
chr1,149390457,149390768,SRX20140870,INTS10,311
chr1,149400753,149401455,SRX5075175,SMARCA4,702
chr1,149400765,149401392,SRX5075169,SMARCA4,627
chr1,149400778,149401417,SRX5075170,SMARCA4,639
chr1,149400801,149401493,SRX5075168,SMARCA4,692
chr1,149400803,149401406,SRX5075174,SMARCA4,603
chr1,149400807,149401325,SRX5716469,SMARCA4,518
chr1,149400828,149401399,SRX5054309,FOSL2,571
chr1,149400830,149401424,SRX5716470,SMARCA4,594
chr1,149400831,149401328,SRX5054308,FOSL2,497
chr1,149400831,149401354,SRX20140867,INTS10,523
chr1,149400839,149401383,SRX20140881,CPSF3L,544
chr1,149400901,149401469,SRX5075176,SMARCA4,568
chr1,149400906,149401404,SRX20140896,INTS13,498
chr1,149400915,149401392,SRX20140869,INTS10,477
chr1,149400931,149401298,SRX5020211,SMARCA2,367
chr1,149400959,149401316,SRX5716463,SMARCA4,357
chr1,149401007,149401279,SRX20140862,SOX2,272
chr1,149401033,149401238,SRX5716464,SMARCA4,205
chr1,149401046,149401353,SRX5716467,SMARCA2,307
chr1,149401048,149401326,SRX5716468,SMARCA2,278
chr1,149401055,149401348,SRX20140897,INTS13,293
chr1,149401113,149401331,SRX5020214,SMARCA2,218
chr1,149407939,149408234,SRX5075170,SMARCA4,295
chr1,149407962,149408293,SRX5075175,SMARCA4,331
chr1,149407963,149408165,SRX5075169,SMARCA4,202
chr1,149407969,149408202,SRX5075176,SMARCA4,233
chr1,149408014,149408242,SRX5054308,FOSL2,228
chr1,149408081,149408254,SRX5075174,SMARCA4,173
chr1,149415320,149415768,SRX5054308,FOSL2,448
chr1,149415351,149415821,SRX5075170,SMARCA4,470
chr1,149415362,149415806,SRX5075176,SMARCA4,444
chr1,149415394,149415829,SRX5075169,SMARCA4,435
chr1,149415414,149415871,SRX5075175,SMARCA4,457
chr1,149415563,149415770,SRX5054309,FOSL2,207
chr1,149415579,149415860,SRX5716469,SMARCA4,281
chr1,149423241,149423414,SRX5075170,SMARCA4,173
chr1,149423253,149423560,SRX5075169,SMARCA4,307
chr1,149423441,149423625,SRX5075176,SMARCA4,184
chr1,149423504,149423682,SRX5075170,SMARCA4,178
chr1,149445313,149446048,SRX5075176,SMARCA4,735
chr1,149445342,149446117,SRX5075170,SMARCA4,775
chr1,149445378,149445845,SRX5716469,SMARCA4,467
chr1,149445399,149445819,SRX5716468,SMARCA2,420
chr1,149445403,149445901,SRX5075175,SMARCA4,498
chr1,149445434,149445964,SRX5716470,SMARCA4,530
chr1,149445458,149446124,SRX5075169,SMARCA4,666
chr1,149445499,149445834,SRX5020211,SMARCA2,335
chr1,149445528,149445842,SRX5716467,SMARCA2,314
chr1,149445538,149445860,SRX5075181,SMARCA2,322
chr1,149445566,149445846,SRX5075168,SMARCA4,280
chr1,149464603,149464802,SRX5075170,SMARCA4,199
chr1,149465361,149466005,SRX5075170,SMARCA4,644
chr1,149465380,149465986,SRX5075176,SMARCA4,606
chr1,149465404,149465758,SRX5716469,SMARCA4,354
chr1,149465425,149465815,SRX5716470,SMARCA4,390
chr1,149465444,149465835,SRX5075175,SMARCA4,391
chr1,149465453,149465823,SRX5075169,SMARCA4,370
chr1,149465458,149465707,SRX5020211,SMARCA2,249
chr1,149465498,149465736,SRX5054308,FOSL2,238
chr1,149465503,149465891,SRX5716467,SMARCA2,388
chr1,149465750,149466081,SRX5054309,FOSL2,331
chr1,149475734,149476217,SRX16500059,CTCF,483
chr1,149475799,149476273,SRX16500061,CTCF,474
chr1,149475811,149476170,SRX16500062,CTCF,359
chr1,149475831,149476230,SRX16500060,CTCF,399
chr1,149475850,149476157,SRX4174629,CTCF,307
chr1,149475881,149476101,SRX5075174,SMARCA4,220
chr1,149475882,149476168,SRX5075170,SMARCA4,286
chr1,149475889,149476187,SRX5075169,SMARCA4,298
chr1,149475908,149476105,SRX5075168,SMARCA4,197
chr1,149475909,149476094,SRX5075176,SMARCA4,185
chr1,149558664,149559221,SRX4174629,CTCF,557
chr1,149558669,149559143,SRX16500059,CTCF,474
chr1,149558679,149559146,SRX16500061,CTCF,467
chr1,149558693,149559196,SRX16500060,CTCF,503
chr1,149558702,149558913,SRX5716470,SMARCA4,211
chr1,149558734,149559176,SRX16500062,CTCF,442
chr1,149558765,149559081,SRX5075170,SMARCA4,316
chr1,149558860,149559160,SRX5075175,SMARCA4,300
chr1,149600650,149600840,SRX5075174,SMARCA4,190
chr1,149606816,149607108,SRX5075176,SMARCA4,292
chr1,149606842,149607052,SRX5075169,SMARCA4,210
chr1,149607726,149608491,SRX20140895,INTS13,765
chr1,149607929,149608410,SRX20140868,INTS10,481
chr1,149607987,149608417,SRX5075168,SMARCA4,430
chr1,149607995,149608164,SRX5075170,SMARCA4,169
chr1,149608001,149608464,SRX5075174,SMARCA4,463
chr1,149608119,149608306,SRX5075175,SMARCA4,187
chr1,149613897,149614116,SRX5075169,SMARCA4,219
chr1,149613917,149614186,SRX5075175,SMARCA4,269
chr1,149636160,149636633,SRX5075174,SMARCA4,473
chr1,149636210,149636889,SRX5075176,SMARCA4,679
chr1,149636215,149636729,SRX5075168,SMARCA4,514
chr1,149636224,149636562,SRX5716470,SMARCA4,338
chr1,149636250,149637404,SRX20140895,INTS13,1154
chr1,149636292,149636931,SRX5075170,SMARCA4,639
chr1,149636294,149636562,SRX5075169,SMARCA4,268
chr1,149636299,149636546,SRX5075175,SMARCA4,247
chr1,149636349,149636613,SRX5716463,SMARCA4,264
chr1,149636529,149637163,SRX20140868,INTS10,634
chr1,149636534,149637156,SRX20140897,INTS13,622
chr1,149636541,149637265,SRX20140879,CPSF3L,724
chr1,149636554,149637501,SRX20140867,INTS10,947
chr1,149636561,149637244,SRX20140869,INTS10,683
chr1,149636577,149637473,SRX20140881,CPSF3L,896
chr1,149636601,149637313,SRX20140894,INTS13,712
chr1,149636689,149637399,SRX20140896,INTS13,710
chr1,149658299,149658496,SRX5075176,SMARCA4,197
chr1,149664694,149664948,SRX5075176,SMARCA4,254
chr1,149664729,149664974,SRX5054309,FOSL2,245
chr1,149664763,149664934,SRX5075170,SMARCA4,171
chr1,149669072,149669392,SRX5075176,SMARCA4,320
chr1,149669087,149669389,SRX5075170,SMARCA4,302
chr1,149669108,149669336,SRX5075169,SMARCA4,228
chr1,149669127,149669307,SRX5054308,FOSL2,180
chr1,149679428,149679738,SRX5075175,SMARCA4,310
chr1,149679451,149679726,SRX5075170,SMARCA4,275
chr1,149679456,149679645,SRX5075176,SMARCA4,189
chr1,149686857,149687179,SRX16500059,CTCF,322
chr1,149686879,149687203,SRX16500060,CTCF,324
chr1,149686889,149687110,SRX16500061,CTCF,221
chr1,149686896,149687168,SRX16500062,CTCF,272
chr1,149708510,149708786,SRX20140897,INTS13,276
chr1,149708560,149708930,SRX20140869,INTS10,370
chr1,149708572,149708878,SRX20140894,INTS13,306
chr1,149708619,149708884,SRX20140868,INTS10,265
chr1,149711589,149712064,SRX4174629,CTCF,475
chr1,149711626,149712027,SRX16500060,CTCF,401
chr1,149711684,149711967,SRX16500062,CTCF,283
chr1,149711688,149711942,SRX5075168,SMARCA4,254
chr1,149711689,149711924,SRX5075176,SMARCA4,235
chr1,149711693,149712024,SRX16500059,CTCF,331
chr1,149711706,149712021,SRX16500061,CTCF,315
chr1,149711708,149711894,SRX5075169,SMARCA4,186
chr1,149711718,149711954,SRX5075170,SMARCA4,236
chr1,149712505,149712777,SRX20140869,INTS10,272
chr1,149792275,149793032,SRX4174629,CTCF,757
chr1,149792395,149793270,SRX16500061,CTCF,875
chr1,149792396,149793308,SRX16500060,CTCF,912
chr1,149792401,149793305,SRX16500062,CTCF,904
chr1,149792407,149793294,SRX16500059,CTCF,887
chr1,149792468,149793229,SRX5075168,SMARCA4,761
chr1,149792480,149792814,SRX5075174,SMARCA4,334
chr1,149792494,149792828,SRX5075175,SMARCA4,334
chr1,149792501,149793173,SRX5075169,SMARCA4,672
chr1,149792502,149793235,SRX5075176,SMARCA4,733
chr1,149792504,149792822,SRX5075170,SMARCA4,318
chr1,149792597,149793234,SRX20140895,INTS13,637
chr1,149792607,149792820,SRX5716470,SMARCA4,213
chr1,149792647,149793139,SRX20140867,INTS10,492
chr1,149792648,149793019,SRX20140868,INTS10,371
chr1,149792719,149792931,SRX5716469,SMARCA4,212
chr1,149792903,149793196,SRX5075170,SMARCA4,293
chr1,149792934,149793265,SRX5075174,SMARCA4,331
chr1,149811972,149812707,SRX20140895,INTS13,735
chr1,149812035,149812482,SRX20140867,INTS10,447
chr1,149812045,149812479,SRX20140868,INTS10,434
chr1,149812100,149812481,SRX20140881,CPSF3L,381
chr1,149812124,149812570,SRX20140879,CPSF3L,446
chr1,149812132,149812406,SRX20140869,INTS10,274
chr1,149812134,149812493,SRX20140897,INTS13,359
chr1,149813192,149813909,SRX20140895,INTS13,717
chr1,149813239,149813859,SRX20140867,INTS10,620
chr1,149813339,149813865,SRX20140897,INTS13,526
chr1,149813340,149813849,SRX20140879,CPSF3L,509
chr1,149813352,149813893,SRX20140881,CPSF3L,541
chr1,149813365,149813842,SRX20140868,INTS10,477
chr1,149813393,149813813,SRX20140894,INTS13,420
chr1,149813399,149813840,SRX20140896,INTS13,441
chr1,149813402,149813794,SRX20140869,INTS10,392
chr1,149813444,149813815,SRX20140880,CPSF3L,371
chr1,149832077,149833166,SRX20140895,INTS13,1089
chr1,149832142,149832954,SRX20140897,INTS13,812
chr1,149832192,149832871,SRX20140869,INTS10,679
chr1,149832220,149833205,SRX20140867,INTS10,985
chr1,149832289,149833182,SRX20140881,CPSF3L,893
chr1,149832291,149833080,SRX20140879,CPSF3L,789
chr1,149832300,149833095,SRX20140868,INTS10,795
chr1,149832322,149832548,SRX5075176,SMARCA4,226
chr1,149832368,149832998,SRX20140896,INTS13,630
chr1,149832420,149833078,SRX20140894,INTS13,658
chr1,149832470,149832778,SRX5075174,SMARCA4,308
chr1,149832476,149832950,SRX20140880,CPSF3L,474
chr1,149832481,149832689,SRX5716454,SOX3,208
chr1,149832566,149833031,SRX4174629,CTCF,465
chr1,149832612,149833110,SRX16500059,CTCF,498
chr1,149832635,149833097,SRX16500062,CTCF,462
chr1,149832648,149833168,SRX16500060,CTCF,520
chr1,149832682,149833162,SRX16500061,CTCF,480
chr1,149840179,149841438,SRX20140895,INTS13,1259
chr1,149840776,149841483,SRX20140867,INTS10,707
chr1,149840777,149841438,SRX20140868,INTS10,661
chr1,149840801,149841329,SRX20140879,CPSF3L,528
chr1,149840858,149841374,SRX20140881,CPSF3L,516
chr1,149840895,149841181,SRX20140894,INTS13,286
chr1,149840941,149841486,SRX20140896,INTS13,545
chr1,149841540,149841986,SRX20140868,INTS10,446
chr1,149841556,149841964,SRX20140867,INTS10,408
chr1,149841556,149842001,SRX20140895,INTS13,445
chr1,149841628,149841863,SRX16500059,CTCF,235
chr1,149842312,149842994,SRX20140881,CPSF3L,682
chr1,149842318,149842994,SRX20140895,INTS13,676
chr1,149842323,149842917,SRX20140867,INTS10,594
chr1,149842359,149842849,SRX20140894,INTS13,490
chr1,149842369,149842988,SRX20140897,INTS13,619
chr1,149842394,149842981,SRX20140869,INTS10,587
chr1,149842420,149842889,SRX20140879,CPSF3L,469
chr1,149842426,149842879,SRX20140868,INTS10,453
chr1,149842454,149842824,SRX20140880,CPSF3L,370
chr1,149842466,149842980,SRX20140896,INTS13,514
chr1,149842479,149842943,SRX20140882,CPSF3L,464
chr1,149842636,149842849,SRX5716454,SOX3,213
chr1,149842690,149842966,SRX5716451,SOX2,276
chr1,149850803,149851525,SRX20140895,INTS13,722
chr1,149850814,149851518,SRX20140881,CPSF3L,704
chr1,149850823,149851389,SRX20140897,INTS13,566
chr1,149850831,149851365,SRX20140869,INTS10,534
chr1,149850859,149851507,SRX20140867,INTS10,648
chr1,149850864,149851400,SRX20140868,INTS10,536
chr1,149850866,149851342,SRX20140896,INTS13,476
chr1,149850881,149851172,SRX5716454,SOX3,291
chr1,149850882,149851127,SRX5716451,SOX2,245
chr1,149850892,149851312,SRX20140894,INTS13,420
chr1,149850893,149851252,SRX20140882,CPSF3L,359
chr1,149850911,149851363,SRX20140879,CPSF3L,452
chr1,149850924,149851525,SRX20140880,CPSF3L,601
chr1,149851801,149853591,SRX20140895,INTS13,1790
chr1,149851804,149852068,SRX20140881,CPSF3L,264
chr1,149851823,149852226,SRX20140868,INTS10,403
chr1,149851848,149852287,SRX20140867,INTS10,439
chr1,149852257,149852432,SRX5075176,SMARCA4,175
chr1,149852357,149852953,SRX20140868,INTS10,596
chr1,149852384,149853032,SRX20140881,CPSF3L,648
chr1,149852395,149853006,SRX20140867,INTS10,611
chr1,149852401,149852923,SRX20140896,INTS13,522
chr1,149852497,149853016,SRX20140879,CPSF3L,519
chr1,149860291,149861666,SRX20140895,INTS13,1375
chr1,149860600,149861168,SRX16500059,CTCF,568
chr1,149860635,149861142,SRX16500061,CTCF,507
chr1,149860689,149861630,SRX20140881,CPSF3L,941
chr1,149860690,149861180,SRX16500060,CTCF,490
chr1,149860690,149861703,SRX20140868,INTS10,1013
chr1,149860696,149861583,SRX20140867,INTS10,887
chr1,149860716,149861249,SRX4174629,CTCF,533
chr1,149860721,149861166,SRX16500062,CTCF,445
chr1,149860751,149861383,SRX20140879,CPSF3L,632
chr1,149860751,149861601,SRX20140897,INTS13,850
chr1,149860803,149861454,SRX20140894,INTS13,651
chr1,149860805,149861404,SRX20140896,INTS13,599
chr1,149860849,149861726,SRX20140869,INTS10,877
chr1,149860879,149861517,SRX20140880,CPSF3L,638
chr1,149861002,149861364,SRX20140860,SOX2,362
chr1,149861126,149861356,SRX5716454,SOX3,230
chr1,149861186,149861400,SRX5075170,SMARCA4,214
chr1,149861298,149861590,SRX5075174,SMARCA4,292
chr1,149861384,149861666,SRX5716470,SMARCA4,282
chr1,149885666,149888135,SRX20140895,INTS13,2469
chr1,149885677,149885905,SRX20140867,INTS10,228
chr1,149886179,149888010,SRX20140867,INTS10,1831
chr1,149886263,149887611,SRX20140881,CPSF3L,1348
chr1,149886294,149886690,SRX20140896,INTS13,396
chr1,149886301,149887214,SRX20140897,INTS13,913
chr1,149886349,149888020,SRX20140868,INTS10,1671
chr1,149886433,149887282,SRX20140869,INTS10,849
chr1,149886438,149887424,SRX20140879,CPSF3L,986
chr1,149886477,149887203,SRX20140894,INTS13,726
chr1,149886733,149887312,SRX20140896,INTS13,579
chr1,149886802,149887141,SRX20140880,CPSF3L,339
chr1,149887684,149887962,SRX20140881,CPSF3L,278
chr1,149887717,149887998,SRX20140879,CPSF3L,281
chr1,149888345,149888875,SRX16500060,CTCF,530
chr1,149888349,149888910,SRX16500062,CTCF,561
chr1,149888372,149888903,SRX16500059,CTCF,531
chr1,149888376,149888833,SRX16500061,CTCF,457
chr1,149888397,149888570,SRX5075174,SMARCA4,173
chr1,149888408,149888780,SRX5075176,SMARCA4,372
chr1,149888477,149888772,SRX4174629,CTCF,295
chr1,149888527,149888712,SRX5075168,SMARCA4,185
chr1,149888531,149888720,SRX5075170,SMARCA4,189
chr1,149899295,149899826,SRX20140895,INTS13,531
chr1,149899361,149899749,SRX20140897,INTS13,388
chr1,149899371,149899664,SRX20140896,INTS13,293
chr1,149899396,149899730,SRX5075174,SMARCA4,334
chr1,149899451,149899747,SRX5075168,SMARCA4,296
chr1,149899492,149899724,SRX5075176,SMARCA4,232
chr1,149899512,149899783,SRX20140879,CPSF3L,271
chr1,149899526,149899744,SRX5716463,SMARCA4,218
chr1,149917600,149918016,SRX20140895,INTS13,416
chr1,149917700,149918053,SRX5075174,SMARCA4,353
chr1,149917705,149918062,SRX5075168,SMARCA4,357
chr1,149917766,149918066,SRX5075176,SMARCA4,300
chr1,149927584,149928108,SRX20140869,INTS10,524
chr1,149927609,149928139,SRX5075168,SMARCA4,530
chr1,149927653,149928226,SRX20140881,CPSF3L,573
chr1,149927664,149928346,SRX20140895,INTS13,682
chr1,149927702,149928056,SRX5075176,SMARCA4,354
chr1,149927740,149928056,SRX20140894,INTS13,316
chr1,149927749,149928204,SRX20140897,INTS13,455
chr1,149927752,149928094,SRX5075174,SMARCA4,342
chr1,149927757,149928364,SRX5075170,SMARCA4,607
chr1,149927776,149928154,SRX20140879,CPSF3L,378
chr1,149927779,149928293,SRX20140867,INTS10,514
chr1,149927784,149928231,SRX20140868,INTS10,447
chr1,149927794,149928221,SRX5075169,SMARCA4,427
chr1,149927857,149928077,SRX5716463,SMARCA4,220
chr1,149927865,149928389,SRX5716470,SMARCA4,524
chr1,149927873,149928165,SRX5075175,SMARCA4,292
chr1,149927876,149928087,SRX5716464,SMARCA4,211
chr1,149928023,149928331,SRX5716469,SMARCA4,308
chr1,149928190,149928397,SRX5075176,SMARCA4,207
chr1,149928231,149928481,SRX5075168,SMARCA4,250
chr1,149928281,149928505,SRX5075174,SMARCA4,224
chr1,149939014,149939605,SRX5075174,SMARCA4,591
chr1,149939033,149939514,SRX5075175,SMARCA4,481
chr1,149939044,149939579,SRX5075169,SMARCA4,535
chr1,149939048,149939595,SRX5075170,SMARCA4,547
chr1,149939048,149939617,SRX5075168,SMARCA4,569
chr1,149939054,149939661,SRX5075176,SMARCA4,607
chr1,149939064,149939613,SRX5054308,FOSL2,549
chr1,149939082,149939552,SRX5716469,SMARCA4,470
chr1,149939082,149939638,SRX5054309,FOSL2,556
chr1,149939095,149939579,SRX5054307,FOSL2,484
chr1,149939104,149939548,SRX5716470,SMARCA4,444
chr1,149939109,149939415,SRX5716468,SMARCA2,306
chr1,149939115,149939474,SRX5716467,SMARCA2,359
chr1,149939131,149939458,SRX5020211,SMARCA2,327
chr1,149939137,149939344,SRX5075182,SMARCA2,207
chr1,149939212,149939511,SRX5716459,Epitope tags,299
chr1,149939221,149939492,SRX5020214,SMARCA2,271
chr1,149939227,149939509,SRX5716460,Epitope tags,282
chr1,149939281,149939497,SRX5075181,SMARCA2,216
chr1,149942316,149942675,SRX16500059,CTCF,359
chr1,149942339,149942560,SRX16500060,CTCF,221
chr1,149942341,149942565,SRX5075168,SMARCA4,224
chr1,149961872,149962457,SRX16500060,CTCF,585
chr1,149961968,149962600,SRX16500059,CTCF,632
chr1,149961998,149962512,SRX16500061,CTCF,514
chr1,149962022,149962481,SRX16500062,CTCF,459
chr1,149962057,149962429,SRX4174629,CTCF,372
chr1,149962079,149962438,SRX5075174,SMARCA4,359
chr1,149962096,149962310,SRX5075170,SMARCA4,214
chr1,149962102,149962343,SRX5716463,SMARCA4,241
chr1,149962103,149962370,SRX5075176,SMARCA4,267
chr1,149962115,149962447,SRX5075168,SMARCA4,332
chr1,149962145,149962410,SRX5075169,SMARCA4,265
chr1,149986396,149986903,SRX5075170,SMARCA4,507
chr1,149986406,149986875,SRX5716470,SMARCA4,469
chr1,149986419,149986910,SRX5716467,SMARCA2,491
chr1,149986445,149986822,SRX5716469,SMARCA4,377
chr1,149986446,149986890,SRX5075169,SMARCA4,444
chr1,149986503,149986850,SRX5075181,SMARCA2,347
chr1,149986516,149986819,SRX5020214,SMARCA2,303
chr1,149986518,149986894,SRX5075175,SMARCA4,376
chr1,149986522,149986826,SRX5020211,SMARCA2,304
chr1,149986525,149986880,SRX5054309,FOSL2,355
chr1,149986526,149986875,SRX5075176,SMARCA4,349
chr1,149986552,149986816,SRX5716460,Epitope tags,264
chr1,149986557,149986835,SRX5054308,FOSL2,278
chr1,149986596,149986850,SRX5075182,SMARCA2,254
chr1,150009664,150009999,SRX5075176,SMARCA4,335
chr1,150009681,150009869,SRX5075175,SMARCA4,188
chr1,150009719,150009888,SRX5075170,SMARCA4,169
chr1,150009725,150009948,SRX5054309,FOSL2,223
chr1,150010374,150010903,SRX20140867,INTS10,529
chr1,150010377,150011046,SRX20140895,INTS13,669
chr1,150010447,150010776,SRX20140881,CPSF3L,329
chr1,150010456,150010875,SRX20140897,INTS13,419
chr1,150010540,150011012,SRX5075175,SMARCA4,472
chr1,150010560,150010909,SRX20140868,INTS10,349
chr1,150010589,150010915,SRX20140869,INTS10,326
chr1,150010603,150011031,SRX5075174,SMARCA4,428
chr1,150010605,150011017,SRX5075170,SMARCA4,412
chr1,150010612,150011004,SRX5716463,SMARCA4,392
chr1,150010624,150010990,SRX5075168,SMARCA4,366
chr1,150010662,150010950,SRX5075169,SMARCA4,288
chr1,150010736,150011019,SRX5075176,SMARCA4,283
chr1,150050579,150051017,SRX16500060,CTCF,438
chr1,150050588,150050925,SRX5075176,SMARCA4,337
chr1,150050603,150050911,SRX16500061,CTCF,308
chr1,150050608,150051080,SRX16500059,CTCF,472
chr1,150050622,150050899,SRX5716464,SMARCA4,277
chr1,150050623,150050903,SRX5075174,SMARCA4,280
chr1,150050625,150050914,SRX5075169,SMARCA4,289
chr1,150050628,150050941,SRX16500062,CTCF,313
chr1,150050629,150050876,SRX5075168,SMARCA4,247
chr1,150050644,150050912,SRX5075170,SMARCA4,268
chr1,150050646,150050889,SRX5716463,SMARCA4,243
chr1,150061539,150061879,SRX5716459,Epitope tags,340
chr1,150061546,150061976,SRX5716469,SMARCA4,430
chr1,150061550,150061975,SRX5716470,SMARCA4,425
chr1,150061571,150061939,SRX5075170,SMARCA4,368
chr1,150061584,150061976,SRX5075176,SMARCA4,392
chr1,150061615,150061901,SRX5020211,SMARCA2,286
chr1,150061624,150061948,SRX5075169,SMARCA4,324
chr1,150061626,150061879,SRX5054309,FOSL2,253
chr1,150061633,150061967,SRX5075175,SMARCA4,334
chr1,150061647,150061915,SRX5716467,SMARCA2,268
chr1,150061651,150061875,SRX5054308,FOSL2,224
chr1,150061720,150061914,SRX5075181,SMARCA2,194
chr1,150065471,150065762,SRX5054309,FOSL2,291
chr1,150065519,150065789,SRX5054308,FOSL2,270
chr1,150066806,150067384,SRX5075174,SMARCA4,578
chr1,150066851,150067065,SRX5716464,SMARCA4,214
chr1,150066873,150067180,SRX5075176,SMARCA4,307
chr1,150066887,150067348,SRX5075170,SMARCA4,461
chr1,150066909,150067882,SRX20140895,INTS13,973
chr1,150066942,150067130,SRX5075175,SMARCA4,188
chr1,150066983,150067808,SRX20140868,INTS10,825
chr1,150067019,150067781,SRX20140867,INTS10,762
chr1,150067077,150067308,SRX5075168,SMARCA4,231
chr1,150067344,150067677,SRX20140869,INTS10,333
chr1,150067391,150067733,SRX20140881,CPSF3L,342
chr1,150067535,150067902,SRX5075168,SMARCA4,367
chr1,150067562,150067908,SRX5075174,SMARCA4,346
chr1,150067724,150067918,SRX5075176,SMARCA4,194
chr1,150072935,150073369,SRX16500061,CTCF,434
chr1,150073039,150073393,SRX16500059,CTCF,354
chr1,150073086,150073315,SRX16500060,CTCF,229
chr1,150103064,150103241,SRX5075174,SMARCA4,177
chr1,150103078,150103368,SRX5075168,SMARCA4,290
chr1,150121568,150121776,SRX5054309,FOSL2,208
chr1,150149452,150150291,SRX20140895,INTS13,839
chr1,150149552,150149798,SRX5075174,SMARCA4,246
chr1,150149578,150149917,SRX5075176,SMARCA4,339
chr1,150149590,150150264,SRX20140868,INTS10,674
chr1,150149600,150149940,SRX5075169,SMARCA4,340
chr1,150149610,150150022,SRX5075175,SMARCA4,412
chr1,150149623,150150081,SRX5716469,SMARCA4,458
chr1,150149629,150149920,SRX5054309,FOSL2,291
chr1,150149652,150149969,SRX5716470,SMARCA4,317
chr1,150149682,150149937,SRX5054308,FOSL2,255
chr1,150149840,150150583,SRX20140867,INTS10,743
chr1,150149861,150150194,SRX5075170,SMARCA4,333
chr1,150149884,150150063,SRX5075168,SMARCA4,179
chr1,150159128,150159421,SRX5075169,SMARCA4,293
chr1,150159130,150159431,SRX5075176,SMARCA4,301
chr1,150159135,150159480,SRX5075175,SMARCA4,345
chr1,150159136,150159473,SRX5075170,SMARCA4,337
chr1,150159142,150159407,SRX5716467,SMARCA2,265
chr1,150159188,150159448,SRX5054308,FOSL2,260
chr1,150159242,150159425,SRX5054309,FOSL2,183
chr1,150162846,150163642,SRX5716469,SMARCA4,796
chr1,150162870,150163105,SRX16500060,CTCF,235
chr1,150162878,150163700,SRX20140895,INTS13,822
chr1,150162896,150163569,SRX5075169,SMARCA4,673
chr1,150162936,150163634,SRX5716470,SMARCA4,698
chr1,150162944,150163315,SRX20140881,CPSF3L,371
chr1,150162957,150163641,SRX5075175,SMARCA4,684
chr1,150162979,150163693,SRX5075168,SMARCA4,714
chr1,150162985,150163365,SRX20140869,INTS10,380
chr1,150162994,150163662,SRX5075174,SMARCA4,668
chr1,150163009,150163671,SRX5075176,SMARCA4,662
chr1,150163017,150163354,SRX20140897,INTS13,337
chr1,150163028,150163664,SRX5075170,SMARCA4,636
chr1,150163165,150163556,SRX5054309,FOSL2,391
chr1,150163191,150163529,SRX5716454,SOX3,338
chr1,150163208,150163561,SRX5054308,FOSL2,353
chr1,150163226,150163551,SRX5716451,SOX2,325
chr1,150163232,150163519,SRX5054307,FOSL2,287
chr1,150163306,150163511,SRX5716464,SMARCA4,205
chr1,150163418,150163627,SRX5075181,SMARCA2,209
chr1,150166022,150166283,SRX16500062,CTCF,261
chr1,150166048,150166391,SRX16500060,CTCF,343
chr1,150166049,150166284,SRX16500059,CTCF,235
chr1,150168946,150169401,SRX16500059,CTCF,455
chr1,150168957,150169381,SRX16500060,CTCF,424
chr1,150168970,150169350,SRX16500062,CTCF,380
chr1,150168982,150169355,SRX16500061,CTCF,373
chr1,150168994,150169334,SRX4174629,CTCF,340
chr1,150173178,150173755,SRX5075168,SMARCA4,577
chr1,150173217,150173810,SRX5075174,SMARCA4,593
chr1,150173225,150173715,SRX5716463,SMARCA4,490
chr1,150173238,150173745,SRX5716464,SMARCA4,507
chr1,150173258,150173745,SRX20140867,INTS10,487
chr1,150173272,150173641,SRX20140881,CPSF3L,369
chr1,150173309,150173787,SRX20140895,INTS13,478
chr1,150173345,150173655,SRX20140879,CPSF3L,310
chr1,150173348,150173564,SRX5716451,SOX2,216
chr1,150173360,150173606,SRX5075170,SMARCA4,246
chr1,150182176,150182652,SRX20140895,INTS13,476
chr1,150182296,150182666,SRX5075174,SMARCA4,370
chr1,150182325,150182712,SRX5075168,SMARCA4,387
chr1,150187230,150187738,SRX16500062,CTCF,508
chr1,150187241,150187810,SRX16500060,CTCF,569
chr1,150187258,150187814,SRX16500059,CTCF,556
chr1,150187262,150187730,SRX16500061,CTCF,468
chr1,150187300,150187597,SRX5075170,SMARCA4,297
chr1,150187313,150187549,SRX5075174,SMARCA4,236
chr1,150187331,150187627,SRX5075176,SMARCA4,296
chr1,150192024,150192388,SRX5075169,SMARCA4,364
chr1,150192039,150192486,SRX5054309,FOSL2,447
chr1,150192047,150192364,SRX5020214,SMARCA2,317
chr1,150192051,150192406,SRX5716470,SMARCA4,355
chr1,150192064,150192422,SRX5054308,FOSL2,358
chr1,150192068,150192411,SRX5075175,SMARCA4,343
chr1,150192070,150192369,SRX5716469,SMARCA4,299
chr1,150192092,150192293,SRX5075181,SMARCA2,201
chr1,150192092,150192402,SRX5020211,SMARCA2,310
chr1,150213448,150213987,SRX5075174,SMARCA4,539
chr1,150213492,150214136,SRX5075170,SMARCA4,644
chr1,150213506,150214126,SRX5075176,SMARCA4,620
chr1,150213508,150213945,SRX5075168,SMARCA4,437
chr1,150213513,150213940,SRX20140895,INTS13,427
chr1,150213557,150213801,SRX20140897,INTS13,244
chr1,150213693,150213899,SRX5075175,SMARCA4,206
chr1,150213712,150214234,SRX5075169,SMARCA4,522
chr1,150213715,150214211,SRX5716470,SMARCA4,496
chr1,150213748,150214131,SRX5716469,SMARCA4,383
chr1,150213870,150214146,SRX16500060,CTCF,276
chr1,150213879,150214173,SRX16500059,CTCF,294
chr1,150213971,150214182,SRX5075175,SMARCA4,211
chr1,150221603,150221859,SRX16500059,CTCF,256
chr1,150221615,150221912,SRX16500062,CTCF,297
chr1,150221619,150221946,SRX16500060,CTCF,327
chr1,150221620,150221864,SRX16500061,CTCF,244
chr1,150234549,150234724,SRX5075176,SMARCA4,175
chr1,150234611,150234790,SRX5075170,SMARCA4,179
chr1,150235290,150235477,SRX5075175,SMARCA4,187
chr1,150235902,150236699,SRX20140895,INTS13,797
chr1,150235912,150236115,SRX5075169,SMARCA4,203
chr1,150235928,150236139,SRX5716470,SMARCA4,211
chr1,150235932,150236275,SRX20140867,INTS10,343
chr1,150235947,150236279,SRX20140897,INTS13,332
chr1,150235948,150236173,SRX5075170,SMARCA4,225
chr1,150235956,150236310,SRX20140881,CPSF3L,354
chr1,150235959,150236301,SRX20140868,INTS10,342
chr1,150236090,150236416,SRX5054308,FOSL2,326
chr1,150236093,150236515,SRX5716451,SOX2,422
chr1,150236096,150236737,SRX5075174,SMARCA4,641
chr1,150236104,150236381,SRX5054307,FOSL2,277
chr1,150236149,150236662,SRX5075168,SMARCA4,513
chr1,150236229,150236693,SRX5716463,SMARCA4,464
chr1,150236333,150236668,SRX16500062,CTCF,335
chr1,150236392,150236655,SRX16500061,CTCF,263
chr1,150236412,150236739,SRX16500060,CTCF,327
chr1,150236440,150236723,SRX16500059,CTCF,283
chr1,150236446,150236723,SRX5075176,SMARCA4,277
chr1,150236473,150236732,SRX5075170,SMARCA4,259
chr1,150255324,150256274,SRX16500060,CTCF,950
chr1,150255327,150256257,SRX16500061,CTCF,930
chr1,150255329,150256304,SRX16500059,CTCF,975
chr1,150255392,150256271,SRX16500062,CTCF,879
chr1,150255460,150255676,SRX5075168,SMARCA4,216
chr1,150255471,150255680,SRX5075174,SMARCA4,209
chr1,150255511,150256276,SRX4174629,CTCF,765
chr1,150255871,150256591,SRX5075168,SMARCA4,720
chr1,150255950,150256244,SRX5075169,SMARCA4,294
chr1,150255987,150256275,SRX5075176,SMARCA4,288
chr1,150255997,150256267,SRX5075170,SMARCA4,270
chr1,150256023,150256224,SRX5075175,SMARCA4,201
chr1,150256040,150256251,SRX5716470,SMARCA4,211
chr1,150256137,150256651,SRX5075174,SMARCA4,514
chr1,150256335,150256737,SRX20140879,CPSF3L,402
chr1,150256645,150257240,SRX20140895,INTS13,595
chr1,150268764,150269354,SRX20140895,INTS13,590
chr1,150268822,150269337,SRX5075168,SMARCA4,515
chr1,150268967,150269437,SRX5075174,SMARCA4,470
chr1,150268974,150269247,SRX20140869,INTS10,273
chr1,150269147,150269322,SRX5075170,SMARCA4,175
chr1,150272453,150272729,SRX5716469,SMARCA4,276
chr1,150272468,150272794,SRX5075174,SMARCA4,326
chr1,150272545,150272876,SRX5075176,SMARCA4,331
chr1,150272564,150272788,SRX5075168,SMARCA4,224
chr1,150272570,150272757,SRX5075169,SMARCA4,187
chr1,150272572,150272869,SRX5075170,SMARCA4,297
chr1,150272578,150272873,SRX5075175,SMARCA4,295
chr1,150281130,150281689,SRX16500061,CTCF,559
chr1,150281130,150281719,SRX16500060,CTCF,589
chr1,150281133,150281696,SRX16500059,CTCF,563
chr1,150281175,150281663,SRX16500062,CTCF,488
chr1,150281258,150281535,SRX5075170,SMARCA4,277
chr1,150281263,150281568,SRX5075174,SMARCA4,305
chr1,150281264,150281480,SRX5075169,SMARCA4,216
chr1,150281277,150281471,SRX5075176,SMARCA4,194
chr1,150281280,150281488,SRX5075168,SMARCA4,208
chr1,150281295,150281551,SRX4174629,CTCF,256
chr1,150282256,150282712,SRX20140895,INTS13,456
chr1,150282258,150282452,SRX5054308,FOSL2,194
chr1,150282335,150282667,SRX20140897,INTS13,332
chr1,150293465,150294052,SRX20140869,INTS10,587
chr1,150293472,150293759,SRX5075169,SMARCA4,287
chr1,150293547,150294057,SRX5075170,SMARCA4,510
chr1,150293563,150293889,SRX5075176,SMARCA4,326
chr1,150293565,150294046,SRX5075174,SMARCA4,481
chr1,150293580,150294180,SRX5075168,SMARCA4,600
chr1,150293660,150294021,SRX5716463,SMARCA4,361
chr1,150293670,150293901,SRX5075175,SMARCA4,231
chr1,150293686,150294090,SRX20140895,INTS13,404
chr1,150293752,150294133,SRX5716469,SMARCA4,381
chr1,150293953,150294247,SRX5075169,SMARCA4,294
chr1,150294000,150294211,SRX5716470,SMARCA4,211
chr1,150321180,150321746,SRX20140895,INTS13,566
chr1,150321213,150321696,SRX20140897,INTS13,483
chr1,150321243,150321722,SRX5075168,SMARCA4,479
chr1,150321272,150321809,SRX5075174,SMARCA4,537
chr1,150321283,150321723,SRX5075176,SMARCA4,440
chr1,150321288,150321811,SRX5716470,SMARCA4,523
chr1,150321291,150321614,SRX20140867,INTS10,323
chr1,150321306,150321641,SRX20140894,INTS13,335
chr1,150321318,150321523,SRX5716464,SMARCA4,205
chr1,150321338,150321710,SRX20140869,INTS10,372
chr1,150321345,150321647,SRX20140896,INTS13,302
chr1,150321372,150321702,SRX5075170,SMARCA4,330
chr1,150321554,150321796,SRX5716463,SMARCA4,242
chr1,150363511,150364098,SRX5075174,SMARCA4,587
chr1,150363519,150363975,SRX20140895,INTS13,456
chr1,150363560,150363807,SRX5716454,SOX3,247
chr1,150363581,150363933,SRX20140867,INTS10,352
chr1,150363583,150363912,SRX5075168,SMARCA4,329
chr1,150363592,150363968,SRX20140869,INTS10,376
chr1,150363596,150363857,SRX20140897,INTS13,261
chr1,150363604,150363937,SRX20140881,CPSF3L,333
chr1,150363605,150364059,SRX20140868,INTS10,454
chr1,150363643,150364029,SRX5716451,SOX2,386
chr1,150363798,150364045,SRX5075176,SMARCA4,247
chr1,150364027,150364291,SRX5075168,SMARCA4,264
chr1,150364336,150364944,SRX20140895,INTS13,608
chr1,150364509,150364898,SRX20140868,INTS10,389
chr1,150364534,150364790,SRX5075174,SMARCA4,256
chr1,150364569,150364790,SRX20140867,INTS10,221
chr1,150375882,150376063,SRX5075176,SMARCA4,181
chr1,150464236,150464833,SRX16500059,CTCF,597
chr1,150464251,150464843,SRX16500060,CTCF,592
chr1,150464288,150464777,SRX16500062,CTCF,489
chr1,150464305,150464833,SRX16500061,CTCF,528
chr1,150464402,150464620,SRX5075168,SMARCA4,218
chr1,150464430,150464791,SRX4174629,CTCF,361
chr1,150464468,150464695,SRX5716463,SMARCA4,227
chr1,150464481,150464692,SRX5075174,SMARCA4,211
chr1,150487004,150487468,SRX5075170,SMARCA4,464
chr1,150487024,150487326,SRX5716469,SMARCA4,302
chr1,150487033,150487250,SRX5075175,SMARCA4,217
chr1,150487046,150487464,SRX5075176,SMARCA4,418
chr1,150487047,150487337,SRX5716470,SMARCA4,290
chr1,150487054,150487335,SRX5075169,SMARCA4,281
chr1,150487070,150487557,SRX5075174,SMARCA4,487
chr1,150487082,150487415,SRX5075168,SMARCA4,333
chr1,150487086,150487405,SRX16500059,CTCF,319
chr1,150487087,150487636,SRX20140895,INTS13,549
chr1,150487122,150487463,SRX16500060,CTCF,341
chr1,150487132,150487490,SRX20140869,INTS10,358
chr1,150487141,150487457,SRX16500061,CTCF,316
chr1,150487190,150487470,SRX5054307,FOSL2,280
chr1,150487232,150487508,SRX16500062,CTCF,276
chr1,150487249,150487463,SRX20140867,INTS10,214
chr1,150487264,150487526,SRX20140881,CPSF3L,262
chr1,150507830,150508241,SRX5075175,SMARCA4,411
chr1,150507853,150508192,SRX5075170,SMARCA4,339
chr1,150507856,150508202,SRX5075169,SMARCA4,346
chr1,150507856,150508221,SRX5075176,SMARCA4,365
chr1,150507868,150508156,SRX5054308,FOSL2,288
chr1,150507892,150508158,SRX5054309,FOSL2,266
chr1,150507935,150508137,SRX5075174,SMARCA4,202
chr1,150515214,150516066,SRX20140895,INTS13,852
chr1,150515299,150515630,SRX5075175,SMARCA4,331
chr1,150515305,150515869,SRX5075168,SMARCA4,564
chr1,150515329,150515948,SRX5075174,SMARCA4,619
chr1,150515336,150515885,SRX5075176,SMARCA4,549
chr1,150515355,150515652,SRX5716470,SMARCA4,297
chr1,150515391,150515673,SRX5075169,SMARCA4,282
chr1,150515426,150515789,SRX5716463,SMARCA4,363
chr1,150515435,150515931,SRX5075170,SMARCA4,496
chr1,150515575,150515897,SRX20140869,INTS10,322
chr1,150529103,150529315,SRX5075176,SMARCA4,212
chr1,150529120,150529320,SRX5075170,SMARCA4,200
chr1,150532301,150532470,SRX5075170,SMARCA4,169
chr1,150532371,150532946,SRX16500059,CTCF,575
chr1,150532448,150532989,SRX16500060,CTCF,541
chr1,150532458,150533052,SRX16500061,CTCF,594
chr1,150532466,150533000,SRX16500062,CTCF,534
chr1,150532542,150532802,SRX5716463,SMARCA4,260
chr1,150532544,150532877,SRX4174629,CTCF,333
chr1,150532553,150532850,SRX5075170,SMARCA4,297
chr1,150532554,150532878,SRX5075174,SMARCA4,324
chr1,150532568,150532755,SRX5075175,SMARCA4,187
chr1,150532577,150532837,SRX5075168,SMARCA4,260
chr1,150532607,150532803,SRX5075176,SMARCA4,196
chr1,150538010,150538400,SRX20140869,INTS10,390
chr1,150538034,150538284,SRX20140897,INTS13,250
chr1,150538058,150538290,SRX5075169,SMARCA4,232
chr1,150538088,150538310,SRX5716470,SMARCA4,222
chr1,150538131,150538336,SRX5075170,SMARCA4,205
chr1,150548785,150549261,SRX5075174,SMARCA4,476
chr1,150548794,150549436,SRX5075170,SMARCA4,642
chr1,150548821,150549438,SRX20140895,INTS13,617
chr1,150548832,150549240,SRX20140868,INTS10,408
chr1,150548845,150549276,SRX5075169,SMARCA4,431
chr1,150548885,150549118,SRX5075176,SMARCA4,233
chr1,150548923,150549242,SRX5075168,SMARCA4,319
chr1,150548932,150549223,SRX5716470,SMARCA4,291
chr1,150549039,150549286,SRX5075175,SMARCA4,247
chr1,150559908,150560292,SRX16500061,CTCF,384
chr1,150559937,150560365,SRX16500060,CTCF,428
chr1,150559944,150560327,SRX16500059,CTCF,383
chr1,150559959,150560356,SRX16500062,CTCF,397
chr1,150560010,150560307,SRX4174629,CTCF,297
chr1,150560812,150561307,SRX16500062,CTCF,495
chr1,150560838,150561372,SRX16500059,CTCF,534
chr1,150560878,150561218,SRX4174629,CTCF,340
chr1,150560888,150561399,SRX16500060,CTCF,511
chr1,150560907,150561352,SRX16500061,CTCF,445
chr1,150560969,150561784,SRX5075175,SMARCA4,815
chr1,150560988,150561692,SRX5075174,SMARCA4,704
chr1,150561017,150561736,SRX5075168,SMARCA4,719
chr1,150561026,150561742,SRX5075169,SMARCA4,716
chr1,150561035,150561316,SRX5716463,SMARCA4,281
chr1,150561046,150561792,SRX5075170,SMARCA4,746
chr1,150561065,150561752,SRX5075176,SMARCA4,687
chr1,150561109,150562367,SRX20140895,INTS13,1258
chr1,150561110,150561468,SRX5716464,SMARCA4,358
chr1,150561180,150561899,SRX20140879,CPSF3L,719
chr1,150561199,150561808,SRX5716470,SMARCA4,609
chr1,150561239,150561803,SRX5716469,SMARCA4,564
chr1,150561245,150561603,SRX5020211,SMARCA2,358
chr1,150561245,150562231,SRX20140881,CPSF3L,986
chr1,150561309,150561668,SRX5054308,FOSL2,359
chr1,150561316,150562237,SRX20140867,INTS10,921
chr1,150561320,150562248,SRX20140897,INTS13,928
chr1,150561323,150561667,SRX5054309,FOSL2,344
chr1,150561334,150561569,SRX5075181,SMARCA2,235
chr1,150561346,150561664,SRX5054307,FOSL2,318
chr1,150561366,150561681,SRX5716467,SMARCA2,315
chr1,150561399,150561769,SRX20140896,INTS13,370
chr1,150561405,150562110,SRX20140869,INTS10,705
chr1,150561489,150561977,SRX20140868,INTS10,488
chr1,150561909,150562189,SRX5716470,SMARCA4,280
chr1,150561988,150562328,SRX5075170,SMARCA4,340
chr1,150561999,150562272,SRX5075176,SMARCA4,273
chr1,150562049,150562236,SRX5075169,SMARCA4,187
chr1,150562053,150562261,SRX5075174,SMARCA4,208
chr1,150567637,150567947,SRX5075176,SMARCA4,310
chr1,150567651,150568008,SRX5075170,SMARCA4,357
chr1,150567686,150567934,SRX5716469,SMARCA4,248
chr1,150567693,150568023,SRX5075168,SMARCA4,330
chr1,150567713,150568023,SRX5075174,SMARCA4,310
chr1,150567809,150568416,SRX20140895,INTS13,607
chr1,150567980,150568593,SRX5716463,SMARCA4,613
chr1,150568129,150568615,SRX5075169,SMARCA4,486
chr1,150568150,150568708,SRX5075176,SMARCA4,558
chr1,150568160,150568690,SRX5716470,SMARCA4,530
chr1,150568165,150568593,SRX5716469,SMARCA4,428
chr1,150568171,150568630,SRX5075175,SMARCA4,459
chr1,150568186,150568673,SRX5075174,SMARCA4,487
chr1,150568207,150568758,SRX5075170,SMARCA4,551
chr1,150568217,150568544,SRX5054309,FOSL2,327
chr1,150568221,150568555,SRX5020211,SMARCA2,334
chr1,150568229,150568504,SRX20140869,INTS10,275
chr1,150568241,150568573,SRX5716464,SMARCA4,332
chr1,150568253,150568669,SRX5075168,SMARCA4,416
chr1,150568256,150568575,SRX5716468,SMARCA2,319
chr1,150568279,150568561,SRX5054308,FOSL2,282
chr1,150568279,150568581,SRX20140867,INTS10,302
chr1,150568279,150568617,SRX5716467,SMARCA2,338
chr1,150568286,150568597,SRX5075181,SMARCA2,311
chr1,150568293,150568633,SRX5716451,SOX2,340
chr1,150568314,150568519,SRX5020214,SMARCA2,205
chr1,150578516,150578842,SRX5054309,FOSL2,326
chr1,150578520,150578826,SRX5054308,FOSL2,306
chr1,150578535,150578758,SRX5075169,SMARCA4,223
chr1,150578584,150578790,SRX5075176,SMARCA4,206
chr1,150578943,150580097,SRX20140895,INTS13,1154
chr1,150579000,150580046,SRX20140867,INTS10,1046
chr1,150579006,150579927,SRX20140868,INTS10,921
chr1,150579026,150580002,SRX20140897,INTS13,976
chr1,150579061,150579952,SRX20140869,INTS10,891
chr1,150579096,150579800,SRX20140881,CPSF3L,704
chr1,150579154,150579777,SRX20140879,CPSF3L,623
chr1,150579221,150580001,SRX20140896,INTS13,780
chr1,150579336,150579623,SRX20140894,INTS13,287
chr1,150579357,150579595,SRX5716470,SMARCA4,238
chr1,150579400,150580065,SRX5075174,SMARCA4,665
chr1,150579423,150579681,SRX20140880,CPSF3L,258
chr1,150579456,150579720,SRX5716463,SMARCA4,264
chr1,150579507,150579722,SRX5716467,SMARCA2,215
chr1,150579510,150579998,SRX5075168,SMARCA4,488
chr1,150579515,150579874,SRX5054307,FOSL2,359
chr1,150579519,150580002,SRX5075170,SMARCA4,483
chr1,150579527,150579838,SRX5054309,FOSL2,311
chr1,150579566,150579977,SRX5075176,SMARCA4,411
chr1,150579579,150579859,SRX5054308,FOSL2,280
chr1,150579739,150580042,SRX5075175,SMARCA4,303
chr1,150579784,150580029,SRX5716470,SMARCA4,245
chr1,150579793,150579997,SRX5716463,SMARCA4,204
chr1,150597002,150597287,SRX5075174,SMARCA4,285
chr1,150597006,150597235,SRX5075168,SMARCA4,229
chr1,150597028,150597257,SRX5716463,SMARCA4,229
chr1,150597079,150597296,SRX5716451,SOX2,217
chr1,150604416,150605090,SRX5075176,SMARCA4,674
chr1,150604459,150605085,SRX5716470,SMARCA4,626
chr1,150604462,150605133,SRX5075168,SMARCA4,671
chr1,150604499,150605089,SRX5075169,SMARCA4,590
chr1,150604519,150605107,SRX5075170,SMARCA4,588
chr1,150604523,150605100,SRX5716469,SMARCA4,577
chr1,150604564,150605099,SRX20140869,INTS10,535
chr1,150604588,150605125,SRX5075175,SMARCA4,537
chr1,150604603,150605147,SRX5075174,SMARCA4,544
chr1,150604664,150605134,SRX5054309,FOSL2,470
chr1,150604710,150605077,SRX5020211,SMARCA2,367
chr1,150604712,150605002,SRX5716467,SMARCA2,290
chr1,150604714,150605131,SRX5054308,FOSL2,417
chr1,150604719,150604975,SRX5020214,SMARCA2,256
chr1,150604774,150605078,SRX5716463,SMARCA4,304
chr1,150604781,150604963,SRX5075182,SMARCA2,182
chr1,150604791,150605082,SRX5054307,FOSL2,291
chr1,150609785,150610091,SRX5075168,SMARCA4,306
chr1,150609795,150609999,SRX5716463,SMARCA4,204
chr1,150609804,150610093,SRX5075174,SMARCA4,289
chr1,150609815,150610044,SRX20140867,INTS10,229
chr1,150609837,150610060,SRX5075170,SMARCA4,223
chr1,150609886,150610084,SRX5075176,SMARCA4,198
chr1,150611467,150611740,SRX5716469,SMARCA4,273
chr1,150611494,150611753,SRX5716467,SMARCA2,259
chr1,150611508,150611809,SRX5075170,SMARCA4,301
chr1,150611522,150611785,SRX5075175,SMARCA4,263
chr1,150611543,150611824,SRX5054308,FOSL2,281
chr1,150611548,150611825,SRX5075176,SMARCA4,277
chr1,150611568,150611950,SRX5075174,SMARCA4,382
chr1,150611623,150611897,SRX5075168,SMARCA4,274
chr1,150613421,150613859,SRX5075175,SMARCA4,438
chr1,150613450,150613931,SRX5075169,SMARCA4,481
chr1,150613491,150613913,SRX5075176,SMARCA4,422
chr1,150613498,150613878,SRX5075170,SMARCA4,380
chr1,150613519,150613856,SRX5054308,FOSL2,337
chr1,150613534,150613879,SRX5054309,FOSL2,345
chr1,150621448,150621938,SRX16500059,CTCF,490
chr1,150621463,150621926,SRX16500060,CTCF,463
chr1,150621487,150621918,SRX16500061,CTCF,431
chr1,150621501,150621908,SRX16500062,CTCF,407
chr1,150621536,150621766,SRX4174629,CTCF,230
chr1,150621566,150621837,SRX5075174,SMARCA4,271
chr1,150621575,150621792,SRX5075170,SMARCA4,217
chr1,150621582,150621764,SRX5075168,SMARCA4,182
chr1,150621597,150621800,SRX5075176,SMARCA4,203
chr1,150628970,150629212,SRX5716463,SMARCA4,242
chr1,150629030,150629229,SRX5075174,SMARCA4,199
chr1,150629083,150629262,SRX5075168,SMARCA4,179
chr1,150629116,150630077,SRX20140895,INTS13,961
chr1,150629176,150629385,SRX5054307,FOSL2,209
chr1,150629205,150629626,SRX20140867,INTS10,421
chr1,150629205,150630053,SRX20140897,INTS13,848
chr1,150629209,150629904,SRX20140868,INTS10,695
chr1,150629214,150629766,SRX20140881,CPSF3L,552
chr1,150629305,150629677,SRX20140869,INTS10,372
chr1,150629348,150629615,SRX20140879,CPSF3L,267
chr1,150629583,150629851,SRX5054307,FOSL2,268
chr1,150629621,150629817,SRX5716451,SOX2,196
chr1,150629641,150630026,SRX5075174,SMARCA4,385
chr1,150629680,150630008,SRX5716463,SMARCA4,328
chr1,150629686,150629937,SRX5075170,SMARCA4,251
chr1,150629787,150630066,SRX20140867,INTS10,279
chr1,150629792,150629979,SRX5075175,SMARCA4,187
chr1,150629794,150629996,SRX5075176,SMARCA4,202
chr1,150697094,150697582,SRX5075174,SMARCA4,488
chr1,150697104,150697408,SRX5716463,SMARCA4,304
chr1,150697121,150697651,SRX5075168,SMARCA4,530
chr1,150697131,150697455,SRX20140895,INTS13,324
chr1,150697153,150697467,SRX5054307,FOSL2,314
chr1,150697175,150697396,SRX16500060,CTCF,221
chr1,150697200,150697440,SRX5054308,FOSL2,240
chr1,150697222,150697476,SRX5716454,SOX3,254
chr1,150697235,150697592,SRX5075170,SMARCA4,357
chr1,150697239,150697461,SRX5716451,SOX2,222
chr1,150697247,150697430,SRX5054309,FOSL2,183
chr1,150697269,150697559,SRX5075176,SMARCA4,290
chr1,150764674,150765118,SRX5075170,SMARCA4,444
chr1,150764696,150765539,SRX5075176,SMARCA4,843
chr1,150764709,150765115,SRX5075175,SMARCA4,406
chr1,150764713,150765155,SRX5716470,SMARCA4,442
chr1,150764719,150765018,SRX5716469,SMARCA4,299
chr1,150764737,150765287,SRX5075169,SMARCA4,550
chr1,150764758,150765060,SRX5054308,FOSL2,302
chr1,150764769,150765036,SRX5054309,FOSL2,267
chr1,150765360,150765544,SRX5075170,SMARCA4,184
chr1,150798450,150798816,SRX5075168,SMARCA4,366
chr1,150798513,150798740,SRX5075174,SMARCA4,227
chr1,150798515,150798820,SRX5716463,SMARCA4,305
chr1,150798613,150798823,SRX5716464,SMARCA4,210
chr1,150798774,150799030,SRX20140895,INTS13,256
chr1,150805207,150805247,SRX1424891,POU3F2,40
chr1,150807339,150807669,SRX5075176,SMARCA4,330
chr1,150807374,150807636,SRX5075170,SMARCA4,262
chr1,150813057,150813541,SRX16500061,CTCF,484
chr1,150813088,150813498,SRX16500060,CTCF,410
chr1,150813095,150813482,SRX16500062,CTCF,387
chr1,150813107,150813600,SRX16500059,CTCF,493
chr1,150813149,150813377,SRX5075174,SMARCA4,228
chr1,150813164,150813406,SRX5075176,SMARCA4,242
chr1,150813201,150813370,SRX5075170,SMARCA4,169
chr1,150821051,150821260,SRX5075175,SMARCA4,209
chr1,150821051,150821285,SRX5075169,SMARCA4,234
chr1,150821051,150821308,SRX5054308,FOSL2,257
chr1,150821060,150821306,SRX5054309,FOSL2,246
chr1,150829735,150830136,SRX16500062,CTCF,401
chr1,150829779,150830172,SRX16500059,CTCF,393
chr1,150829815,150830073,SRX16500061,CTCF,258
chr1,150829830,150830119,SRX16500060,CTCF,289
chr1,150847749,150847940,SRX5075176,SMARCA4,191
chr1,150876219,150876711,SRX20140897,INTS13,492
chr1,150876240,150877142,SRX20140895,INTS13,902
chr1,150876469,150876697,SRX20140867,INTS10,228
chr1,150876508,150877055,SRX5075174,SMARCA4,547
chr1,150876510,150877043,SRX5075169,SMARCA4,533
chr1,150876566,150877062,SRX5075176,SMARCA4,496
chr1,150876609,150877050,SRX5075170,SMARCA4,441
chr1,150876628,150877039,SRX5075168,SMARCA4,411
chr1,150876644,150876987,SRX5054308,FOSL2,343
chr1,150876645,150876924,SRX5054307,FOSL2,279
chr1,150876685,150876984,SRX5054309,FOSL2,299
chr1,150876716,150876935,SRX5716463,SMARCA4,219
chr1,150876738,150877025,SRX5716470,SMARCA4,287
chr1,150876739,150877008,SRX5716464,SMARCA4,269
chr1,150876746,150876951,SRX5716454,SOX3,205
chr1,150876773,150877081,SRX5716469,SMARCA4,308
chr1,150876799,150877057,SRX5075175,SMARCA4,258
chr1,150881751,150881957,SRX5054309,FOSL2,206
chr1,150922394,150922933,SRX16500062,CTCF,539
chr1,150922402,150922921,SRX16500061,CTCF,519
chr1,150922431,150922871,SRX16500060,CTCF,440
chr1,150922435,150922922,SRX16500059,CTCF,487
chr1,150922501,150922850,SRX5075175,SMARCA4,349
chr1,150922502,150922787,SRX5075168,SMARCA4,285
chr1,150922504,150922813,SRX5075174,SMARCA4,309
chr1,150922512,150922842,SRX5075169,SMARCA4,330
chr1,150922524,150922852,SRX5075176,SMARCA4,328
chr1,150922541,150922791,SRX5075170,SMARCA4,250
chr1,150922563,150922818,SRX5054308,FOSL2,255
chr1,150922573,150922858,SRX5054309,FOSL2,285
chr1,150926016,150926521,SRX5075174,SMARCA4,505
chr1,150926042,150926271,SRX5716463,SMARCA4,229
chr1,150926046,150926515,SRX5075168,SMARCA4,469
chr1,150926048,150926846,SRX20140895,INTS13,798
chr1,150926053,150926483,SRX5075176,SMARCA4,430
chr1,150926080,150926372,SRX5716464,SMARCA4,292
chr1,150926113,150926531,SRX5075170,SMARCA4,418
chr1,150926161,150926435,SRX20140897,INTS13,274
chr1,150926231,150926432,SRX5716451,SOX2,201
chr1,150926274,150926694,SRX20140869,INTS10,420
chr1,150974216,150975262,SRX20140895,INTS13,1046
chr1,150974431,150975072,SRX20140868,INTS10,641
chr1,150974524,150974969,SRX5716470,SMARCA4,445
chr1,150974704,150975041,SRX5075170,SMARCA4,337
chr1,150974726,150975068,SRX5075174,SMARCA4,342
chr1,150974741,150974996,SRX5075169,SMARCA4,255
chr1,150974747,150975023,SRX5075176,SMARCA4,276
chr1,150974775,150975068,SRX20140867,INTS10,293
chr1,150974844,150975042,SRX5075175,SMARCA4,198
chr1,150979304,150980089,SRX4174629,CTCF,785
chr1,150979347,150980008,SRX16500059,CTCF,661
chr1,150979380,150979910,SRX16500062,CTCF,530
chr1,150979380,150979974,SRX16500060,CTCF,594
chr1,150979430,150980047,SRX16500061,CTCF,617
chr1,150979493,150979809,SRX5075174,SMARCA4,316
chr1,150979537,150979764,SRX5075170,SMARCA4,227
chr1,150979543,150979808,SRX5075168,SMARCA4,265
chr1,150979547,150979783,SRX5716469,SMARCA4,236
chr1,150979553,150979772,SRX5075169,SMARCA4,219
chr1,150979565,150979794,SRX5075176,SMARCA4,229
chr1,150979612,150979893,SRX5716470,SMARCA4,281
chr1,150995764,150996294,SRX16500061,CTCF,530
chr1,150995779,150996357,SRX16500059,CTCF,578
chr1,150995810,150996318,SRX16500062,CTCF,508
chr1,150995815,150996329,SRX16500060,CTCF,514
chr1,150995920,150996276,SRX5075170,SMARCA4,356
chr1,150995929,150996207,SRX5716463,SMARCA4,278
chr1,150995932,150996254,SRX5716470,SMARCA4,322
chr1,150995934,150996176,SRX5716464,SMARCA4,242
chr1,150995940,150996258,SRX5075168,SMARCA4,318
chr1,150995947,150996251,SRX5075174,SMARCA4,304
chr1,150995949,150996241,SRX5075176,SMARCA4,292
chr1,150995997,150996207,SRX4174629,CTCF,210
chr1,150999106,150999386,SRX5075175,SMARCA4,280
chr1,150999123,150999528,SRX5075169,SMARCA4,405
chr1,150999212,150999403,SRX5054308,FOSL2,191
chr1,150999292,150999512,SRX5054309,FOSL2,220
chr1,151006598,151007009,SRX5075174,SMARCA4,411
chr1,151006651,151007035,SRX5075168,SMARCA4,384
chr1,151006658,151006969,SRX5075175,SMARCA4,311
chr1,151006668,151007133,SRX16500059,CTCF,465
chr1,151006671,151006948,SRX5075176,SMARCA4,277
chr1,151006676,151006959,SRX20140895,INTS13,283
chr1,151006700,151006998,SRX5075170,SMARCA4,298
chr1,151006701,151007120,SRX16500060,CTCF,419
chr1,151006713,151006975,SRX5075169,SMARCA4,262
chr1,151006714,151007034,SRX16500062,CTCF,320
chr1,151006718,151006963,SRX5716469,SMARCA4,245
chr1,151006753,151007023,SRX16500061,CTCF,270
chr1,151006835,151007045,SRX4174629,CTCF,210
chr1,151008023,151008306,SRX5716469,SMARCA4,283
chr1,151008122,151008500,SRX5075176,SMARCA4,378
chr1,151008132,151008376,SRX5054308,FOSL2,244
chr1,151008145,151008471,SRX5075170,SMARCA4,326
chr1,151008161,151008631,SRX5075174,SMARCA4,470
chr1,151008187,151008587,SRX5075168,SMARCA4,400
chr1,151008194,151008490,SRX5054309,FOSL2,296
chr1,151008223,151008442,SRX5054307,FOSL2,219
chr1,151008229,151008449,SRX5716451,SOX2,220
chr1,151008249,151008600,SRX5716463,SMARCA4,351
chr1,151008416,151008692,SRX20140895,INTS13,276
chr1,151022756,151023090,SRX5075170,SMARCA4,334
chr1,151022772,151023148,SRX5075176,SMARCA4,376
chr1,151022813,151023135,SRX5716469,SMARCA4,322
chr1,151022818,151023116,SRX5075169,SMARCA4,298
chr1,151022848,151023063,SRX5716467,SMARCA2,215
chr1,151022865,151023123,SRX5075175,SMARCA4,258
chr1,151022869,151023148,SRX5716470,SMARCA4,279
chr1,151024535,151024966,SRX16500060,CTCF,431
chr1,151024542,151024997,SRX16500059,CTCF,455
chr1,151024585,151024889,SRX16500062,CTCF,304
chr1,151024605,151024962,SRX16500061,CTCF,357
chr1,151024621,151024850,SRX5075174,SMARCA4,229
chr1,151024732,151024920,SRX5075168,SMARCA4,188
chr1,151047511,151047862,SRX5075170,SMARCA4,351
chr1,151047559,151047943,SRX5075168,SMARCA4,384
chr1,151047571,151047881,SRX5075175,SMARCA4,310
chr1,151047590,151047886,SRX5075176,SMARCA4,296
chr1,151047602,151047992,SRX5075174,SMARCA4,390
chr1,151047609,151048198,SRX20140895,INTS13,589
chr1,151047727,151047990,SRX5716469,SMARCA4,263
chr1,151047748,151047992,SRX5716470,SMARCA4,244
chr1,151047987,151048216,SRX5075169,SMARCA4,229
chr1,151048005,151048241,SRX5075170,SMARCA4,236
chr1,151048104,151048323,SRX5716469,SMARCA4,219
chr1,151048142,151048329,SRX5075175,SMARCA4,187
chr1,151048243,151048733,SRX16500061,CTCF,490
chr1,151048295,151048791,SRX16500062,CTCF,496
chr1,151048390,151048809,SRX16500060,CTCF,419
chr1,151048419,151048883,SRX16500059,CTCF,464
chr1,151048563,151048736,SRX5075174,SMARCA4,173
chr1,151048632,151048857,SRX4174629,CTCF,225
chr1,151059324,151060105,SRX16500059,CTCF,781
chr1,151059422,151060108,SRX16500060,CTCF,686
chr1,151059447,151059879,SRX5075168,SMARCA4,432
chr1,151059448,151059726,SRX5075170,SMARCA4,278
chr1,151059478,151059728,SRX5075175,SMARCA4,250
chr1,151059495,151059822,SRX5075174,SMARCA4,327
chr1,151059504,151059972,SRX16500062,CTCF,468
chr1,151059522,151059992,SRX16500061,CTCF,470
chr1,151059734,151059997,SRX4174629,CTCF,263
chr1,151060148,151060727,SRX20140895,INTS13,579
chr1,151060191,151060505,SRX20140868,INTS10,314
chr1,151060246,151060515,SRX5075174,SMARCA4,269
chr1,151060252,151060633,SRX20140867,INTS10,381
chr1,151070444,151071134,SRX20140895,INTS13,690
chr1,151070459,151070729,SRX20140897,INTS13,270
chr1,151070557,151071107,SRX20140868,INTS10,550
chr1,151070568,151070946,SRX20140879,CPSF3L,378
chr1,151070663,151071441,SRX16500060,CTCF,778
chr1,151070667,151071458,SRX16500059,CTCF,791
chr1,151070687,151071454,SRX16500062,CTCF,767
chr1,151070705,151071455,SRX16500061,CTCF,750
chr1,151070941,151071381,SRX4174629,CTCF,440
chr1,151071065,151071357,SRX5075176,SMARCA4,292
chr1,151071092,151071322,SRX5716463,SMARCA4,230
chr1,151071123,151071402,SRX5075174,SMARCA4,279
chr1,151071128,151071352,SRX5075170,SMARCA4,224
chr1,151071132,151071355,SRX5075168,SMARCA4,223
chr1,151071163,151071385,SRX5075169,SMARCA4,222
chr1,151071198,151071391,SRX5075175,SMARCA4,193
chr1,151099708,151100220,SRX16500059,CTCF,512
chr1,151099723,151100226,SRX16500060,CTCF,503
chr1,151099755,151100154,SRX16500061,CTCF,399
chr1,151099782,151100193,SRX16500062,CTCF,411
chr1,151099843,151100073,SRX5075174,SMARCA4,230
chr1,151106877,151107220,SRX5075170,SMARCA4,343
chr1,151106891,151107197,SRX5075169,SMARCA4,306
chr1,151106923,151107181,SRX5716469,SMARCA4,258
chr1,151106941,151107235,SRX5054309,FOSL2,294
chr1,151106942,151107236,SRX5054308,FOSL2,294
chr1,151106945,151107225,SRX5075175,SMARCA4,280
chr1,151106945,151107300,SRX5075176,SMARCA4,355
chr1,151106958,151107269,SRX5075168,SMARCA4,311
chr1,151106978,151107196,SRX5716467,SMARCA2,218
chr1,151106982,151107246,SRX5075174,SMARCA4,264
chr1,151146329,151146916,SRX20140895,INTS13,587
chr1,151146427,151146774,SRX5075169,SMARCA4,347
chr1,151146465,151146975,SRX5075168,SMARCA4,510
chr1,151146471,151146814,SRX5075170,SMARCA4,343
chr1,151146481,151146955,SRX5075174,SMARCA4,474
chr1,151146485,151146966,SRX5075176,SMARCA4,481
chr1,151146506,151146717,SRX5716470,SMARCA4,211
chr1,151146508,151146905,SRX5075175,SMARCA4,397
chr1,151146541,151146784,SRX20140867,INTS10,243
chr1,151146547,151146835,SRX20140868,INTS10,288
chr1,151155929,151156444,SRX16500061,CTCF,515
chr1,151155941,151156421,SRX16500060,CTCF,480
chr1,151155957,151156443,SRX16500059,CTCF,486
chr1,151155973,151156365,SRX4174629,CTCF,392
chr1,151156003,151156439,SRX16500062,CTCF,436
chr1,151156047,151156272,SRX5075168,SMARCA4,225
chr1,151156052,151156290,SRX5075174,SMARCA4,238
chr1,151165176,151165357,SRX5075174,SMARCA4,181
chr1,151165565,151166201,SRX20140895,INTS13,636
chr1,151165611,151166317,SRX20140869,INTS10,706
chr1,151165735,151166175,SRX5075168,SMARCA4,440
chr1,151165756,151166065,SRX20140879,CPSF3L,309
chr1,151165778,151166066,SRX20140894,INTS13,288
chr1,151165798,151166133,SRX20140868,INTS10,335
chr1,151165811,151166152,SRX20140881,CPSF3L,341
chr1,151165827,151166119,SRX20140867,INTS10,292
chr1,151165827,151166221,SRX5075174,SMARCA4,394
chr1,151165858,151166062,SRX5716451,SOX2,204
chr1,151165889,151166220,SRX5075170,SMARCA4,331
chr1,151165945,151166145,SRX5075176,SMARCA4,200
chr1,151165996,151166181,SRX5075169,SMARCA4,185
chr1,151166147,151166394,SRX5075175,SMARCA4,247
chr1,151175840,151176332,SRX16500059,CTCF,492
chr1,151175877,151176181,SRX16500061,CTCF,304
chr1,151175903,151176299,SRX16500060,CTCF,396
chr1,151175949,151176316,SRX16500062,CTCF,367
chr1,151189776,151190141,SRX5075175,SMARCA4,365
chr1,151189916,151190313,SRX20140897,INTS13,397
chr1,151189937,151190463,SRX20140895,INTS13,526
chr1,151189944,151190421,SRX5075170,SMARCA4,477
chr1,151189959,151190178,SRX5716463,SMARCA4,219
chr1,151189972,151190383,SRX5716464,SMARCA4,411
chr1,151189990,151190361,SRX20140869,INTS10,371
chr1,151189990,151190439,SRX5075168,SMARCA4,449
chr1,151189995,151190437,SRX5075174,SMARCA4,442
chr1,151190004,151190406,SRX5075176,SMARCA4,402
chr1,151190033,151190322,SRX5075169,SMARCA4,289
chr1,151190057,151190287,SRX5716470,SMARCA4,230
chr1,151190064,151190307,SRX20140867,INTS10,243
chr1,151190084,151190351,SRX20140868,INTS10,267
chr1,151196224,151196599,SRX16500059,CTCF,375
chr1,151196269,151196652,SRX16500060,CTCF,383
chr1,151196277,151196570,SRX16500061,CTCF,293
chr1,151196322,151196553,SRX16500062,CTCF,231
chr1,151196333,151196565,SRX5075170,SMARCA4,232
chr1,151198198,151198733,SRX20140895,INTS13,535
chr1,151198287,151198736,SRX20140897,INTS13,449
chr1,151198333,151198502,SRX5075170,SMARCA4,169
chr1,151198333,151198524,SRX5075174,SMARCA4,191
chr1,151198389,151198568,SRX5075168,SMARCA4,179
chr1,151200169,151200560,SRX5054309,FOSL2,391
chr1,151200216,151200569,SRX5075169,SMARCA4,353
chr1,151200221,151200531,SRX5054308,FOSL2,310
chr1,151200256,151200531,SRX5075175,SMARCA4,275
chr1,151200323,151200600,SRX5075170,SMARCA4,277
chr1,151238266,151238749,SRX5075169,SMARCA4,483
chr1,151238281,151238768,SRX5075170,SMARCA4,487
chr1,151238332,151238838,SRX5075176,SMARCA4,506
chr1,151238336,151238684,SRX5716469,SMARCA4,348
chr1,151238353,151238808,SRX5075175,SMARCA4,455
chr1,151238381,151238767,SRX5054309,FOSL2,386
chr1,151238405,151238712,SRX5716460,Epitope tags,307
chr1,151238421,151238681,SRX5716467,SMARCA2,260
chr1,151238427,151238673,SRX5020214,SMARCA2,246
chr1,151238445,151238754,SRX5054308,FOSL2,309
chr1,151251643,151252171,SRX16500062,CTCF,528
chr1,151251646,151252158,SRX16500060,CTCF,512
chr1,151251651,151252123,SRX16500061,CTCF,472
chr1,151251673,151252136,SRX16500059,CTCF,463
chr1,151251733,151252045,SRX5075168,SMARCA4,312
chr1,151251760,151251969,SRX5075174,SMARCA4,209
chr1,151251773,151251946,SRX5075170,SMARCA4,173
chr1,151251776,151251978,SRX5075176,SMARCA4,202
chr1,151254358,151254619,SRX20140868,INTS10,261
chr1,151254537,151255093,SRX20140895,INTS13,556
chr1,151254538,151254790,SRX5075168,SMARCA4,252
chr1,151254551,151254941,SRX5075174,SMARCA4,390
chr1,151254580,151255054,SRX5716469,SMARCA4,474
chr1,151254584,151254829,SRX5054307,FOSL2,245
chr1,151254587,151254977,SRX20140869,INTS10,390
chr1,151254649,151255026,SRX5054309,FOSL2,377
chr1,151254666,151255022,SRX5075175,SMARCA4,356
chr1,151254730,151255004,SRX20140867,INTS10,274
chr1,151254769,151255009,SRX5075170,SMARCA4,240
chr1,151254780,151255021,SRX5054308,FOSL2,241
chr1,151254858,151255038,SRX5075169,SMARCA4,180
chr1,151281078,151282120,SRX20140895,INTS13,1042
chr1,151281096,151281425,SRX16500061,CTCF,329
chr1,151281113,151281477,SRX5075174,SMARCA4,364
chr1,151281115,151281374,SRX5075176,SMARCA4,259
chr1,151281145,151281461,SRX16500059,CTCF,316
chr1,151281163,151281383,SRX5075170,SMARCA4,220
chr1,151281171,151281521,SRX5075168,SMARCA4,350
chr1,151281175,151281492,SRX16500062,CTCF,317
chr1,151281204,151281898,SRX20140881,CPSF3L,694
chr1,151281215,151281997,SRX20140867,INTS10,782
chr1,151281277,151281524,SRX5716463,SMARCA4,247
chr1,151281289,151281481,SRX5054307,FOSL2,192
chr1,151281376,151281931,SRX20140868,INTS10,555
chr1,151281421,151281601,SRX5075169,SMARCA4,180
chr1,151281432,151281712,SRX20140879,CPSF3L,280
chr1,151281446,151281927,SRX20140869,INTS10,481
chr1,151281546,151281983,SRX20140897,INTS13,437
chr1,151281626,151281902,SRX20140880,CPSF3L,276
chr1,151281777,151282029,SRX5075174,SMARCA4,252
chr1,151281825,151282035,SRX5075176,SMARCA4,210
chr1,151281952,151282350,SRX5054307,FOSL2,398
chr1,151282164,151282613,SRX20140895,INTS13,449
chr1,151282268,151282498,SRX5075174,SMARCA4,230
chr1,151282321,151282547,SRX5075168,SMARCA4,226
chr1,151282364,151282563,SRX5075169,SMARCA4,199
chr1,151300787,151301302,SRX16500061,CTCF,515
chr1,151300794,151301341,SRX16500060,CTCF,547
chr1,151300818,151301287,SRX16500059,CTCF,469
chr1,151300854,151301364,SRX16500062,CTCF,510
chr1,151300921,151301252,SRX5075169,SMARCA4,331
chr1,151300925,151301207,SRX4174629,CTCF,282
chr1,151300928,151301253,SRX5075168,SMARCA4,325
chr1,151300948,151301258,SRX5075176,SMARCA4,310
chr1,151300959,151301302,SRX5075170,SMARCA4,343
chr1,151300961,151301268,SRX5075174,SMARCA4,307
chr1,151300964,151301236,SRX5716463,SMARCA4,272
chr1,151300981,151301214,SRX5716469,SMARCA4,233
chr1,151300982,151301222,SRX5716470,SMARCA4,240
chr1,151301003,151301277,SRX5075175,SMARCA4,274
chr1,151309758,151310069,SRX5075170,SMARCA4,311
chr1,151309803,151310076,SRX5075176,SMARCA4,273
chr1,151311522,151311914,SRX5054309,FOSL2,392
chr1,151311566,151311883,SRX5075175,SMARCA4,317
chr1,151311569,151311903,SRX5054308,FOSL2,334
chr1,151311581,151311883,SRX5075170,SMARCA4,302
chr1,151311596,151311884,SRX5075169,SMARCA4,288
chr1,151311599,151311926,SRX5075176,SMARCA4,327
chr1,151311616,151311825,SRX5020214,SMARCA2,209
chr1,151314086,151314523,SRX5075176,SMARCA4,437
chr1,151314130,151314498,SRX5075169,SMARCA4,368
chr1,151314143,151314514,SRX5075170,SMARCA4,371
chr1,151314179,151314424,SRX5716470,SMARCA4,245
chr1,151314193,151314458,SRX5075175,SMARCA4,265
chr1,151314208,151314503,SRX5716469,SMARCA4,295
chr1,151314272,151314458,SRX5054308,FOSL2,186
chr1,151327154,151327392,SRX5716469,SMARCA4,238
chr1,151327225,151327960,SRX5075168,SMARCA4,735
chr1,151327243,151327780,SRX20140895,INTS13,537
chr1,151327267,151328022,SRX5075174,SMARCA4,755
chr1,151327343,151327621,SRX5716470,SMARCA4,278
chr1,151327357,151327591,SRX20140867,INTS10,234
chr1,151327377,151327689,SRX20140869,INTS10,312
chr1,151327433,151327700,SRX20140881,CPSF3L,267
chr1,151327530,151327735,SRX5716464,SMARCA4,205
chr1,151327532,151327953,SRX5075176,SMARCA4,421
chr1,151327584,151327945,SRX5075170,SMARCA4,361
chr1,151340768,151341086,SRX5716469,SMARCA4,318
chr1,151340794,151341155,SRX5716470,SMARCA4,361
chr1,151340796,151341330,SRX16500060,CTCF,534
chr1,151340797,151341119,SRX4174629,CTCF,322
chr1,151340803,151341206,SRX5075176,SMARCA4,403
chr1,151340812,151341250,SRX16500061,CTCF,438
chr1,151340822,151341189,SRX5075169,SMARCA4,367
chr1,151340825,151341218,SRX5075168,SMARCA4,393
chr1,151340828,151341181,SRX5075174,SMARCA4,353
chr1,151340830,151341263,SRX16500062,CTCF,433
chr1,151340831,151341176,SRX5075170,SMARCA4,345
chr1,151340837,151341296,SRX16500059,CTCF,459
chr1,151340842,151341151,SRX5075175,SMARCA4,309
chr1,151340848,151341063,SRX5716468,SMARCA2,215
chr1,151340860,151341140,SRX5716463,SMARCA4,280
chr1,151340864,151341130,SRX5054308,FOSL2,266
chr1,151340865,151341091,SRX5716467,SMARCA2,226
chr1,151340876,151341184,SRX5716464,SMARCA4,308
chr1,151340913,151341096,SRX5054309,FOSL2,183
chr1,151346676,151347110,SRX5075168,SMARCA4,434
chr1,151346744,151347508,SRX20140895,INTS13,764
chr1,151346746,151347079,SRX20140869,INTS10,333
chr1,151346749,151347106,SRX5075174,SMARCA4,357
chr1,151346757,151347004,SRX5075176,SMARCA4,247
chr1,151346766,151347563,SRX5075170,SMARCA4,797
chr1,151346797,151347090,SRX5075169,SMARCA4,293
chr1,151346825,151347274,SRX20140897,INTS13,449
chr1,151346896,151347466,SRX20140868,INTS10,570
chr1,151346902,151347266,SRX20140881,CPSF3L,364
chr1,151346905,151347242,SRX20140879,CPSF3L,337
chr1,151347006,151347304,SRX20140867,INTS10,298
chr1,151347279,151347723,SRX5075174,SMARCA4,444
chr1,151347280,151347459,SRX5054307,FOSL2,179
chr1,151347285,151347623,SRX5075168,SMARCA4,338
chr1,151347429,151347691,SRX5075176,SMARCA4,262
chr1,151348040,151348220,SRX5054308,FOSL2,180
chr1,151352151,151352344,SRX5054309,FOSL2,193
chr1,151372508,151372836,SRX5075168,SMARCA4,328
chr1,151372524,151372910,SRX5075176,SMARCA4,386
chr1,151372577,151372878,SRX5075175,SMARCA4,301
chr1,151372583,151372847,SRX5075174,SMARCA4,264
chr1,151372583,151372855,SRX5075170,SMARCA4,272
chr1,151372617,151372884,SRX5075169,SMARCA4,267
chr1,151372698,151372914,SRX5716469,SMARCA4,216
chr1,151399186,151399525,SRX20140869,INTS10,339
chr1,151399229,151399558,SRX5075176,SMARCA4,329
chr1,151399230,151399648,SRX5716463,SMARCA4,418
chr1,151399237,151399503,SRX5075169,SMARCA4,266
chr1,151399255,151399814,SRX20140895,INTS13,559
chr1,151399283,151399513,SRX5716469,SMARCA4,230
chr1,151399284,151399647,SRX5075168,SMARCA4,363
chr1,151399321,151399599,SRX5075170,SMARCA4,278
chr1,151399332,151399822,SRX20140897,INTS13,490
chr1,151399340,151399783,SRX5075174,SMARCA4,443
chr1,151399350,151399582,SRX16500060,CTCF,232
chr1,151399392,151399627,SRX20140867,INTS10,235
chr1,151399404,151399665,SRX20140881,CPSF3L,261
chr1,151443734,151444196,SRX16500061,CTCF,462
chr1,151443759,151444196,SRX16500059,CTCF,437
chr1,151443768,151444289,SRX16500060,CTCF,521
chr1,151443841,151444246,SRX5075175,SMARCA4,405
chr1,151443859,151444237,SRX16500062,CTCF,378
chr1,151443869,151444218,SRX5075176,SMARCA4,349
chr1,151443872,151444253,SRX5075168,SMARCA4,381
chr1,151443885,151444229,SRX5716470,SMARCA4,344
chr1,151443885,151444236,SRX5075170,SMARCA4,351
chr1,151443885,151444239,SRX5075174,SMARCA4,354
chr1,151443918,151444237,SRX5054308,FOSL2,319
chr1,151443918,151444275,SRX5075169,SMARCA4,357
chr1,151443919,151444228,SRX5716463,SMARCA4,309
chr1,151443940,151444236,SRX5054309,FOSL2,296
chr1,151443946,151444161,SRX5716464,SMARCA4,215
chr1,151443973,151444152,SRX5054307,FOSL2,179
chr1,151443995,151444224,SRX5716469,SMARCA4,229
chr1,151444011,151444216,SRX5020214,SMARCA2,205
chr1,151444034,151444260,SRX5716467,SMARCA2,226
chr1,151458173,151458562,SRX5075176,SMARCA4,389
chr1,151458205,151458529,SRX20140895,INTS13,324
chr1,151458421,151458639,SRX5075170,SMARCA4,218
chr1,151458500,151459121,SRX20140867,INTS10,621
chr1,151459055,151459853,SRX20140895,INTS13,798
chr1,151459150,151459411,SRX20140868,INTS10,261
chr1,151459268,151459567,SRX5716469,SMARCA4,299
chr1,151459407,151459760,SRX5075174,SMARCA4,353
chr1,151459410,151459675,SRX5075170,SMARCA4,265
chr1,151459418,151459630,SRX5075176,SMARCA4,212
chr1,151459521,151459754,SRX5075168,SMARCA4,233
chr1,151494679,151495282,SRX5716470,SMARCA4,603
chr1,151494688,151495264,SRX5075170,SMARCA4,576
chr1,151494696,151495200,SRX5075168,SMARCA4,504
chr1,151494710,151495263,SRX5075169,SMARCA4,553
chr1,151494715,151495148,SRX5075174,SMARCA4,433
chr1,151494730,151495198,SRX5716459,Epitope tags,468
chr1,151494739,151495228,SRX5075176,SMARCA4,489
chr1,151494746,151495229,SRX5716469,SMARCA4,483
chr1,151494750,151495005,SRX5716463,SMARCA4,255
chr1,151494752,151495147,SRX5716467,SMARCA2,395
chr1,151494761,151495316,SRX5075175,SMARCA4,555
chr1,151494770,151495149,SRX5716468,SMARCA2,379
chr1,151494772,151495119,SRX5020214,SMARCA2,347
chr1,151494800,151495031,SRX5075181,SMARCA2,231
chr1,151494806,151495193,SRX5054309,FOSL2,387
chr1,151494848,151495163,SRX5054308,FOSL2,315
chr1,151510851,151511125,SRX20140879,CPSF3L,274
chr1,151510904,151511302,SRX20140881,CPSF3L,398
chr1,151510911,151511627,SRX20140895,INTS13,716
chr1,151510933,151511262,SRX20140868,INTS10,329
chr1,151510964,151511509,SRX5075170,SMARCA4,545
chr1,151511011,151511300,SRX20140867,INTS10,289
chr1,151511022,151511370,SRX5716470,SMARCA4,348
chr1,151511026,151511455,SRX5075168,SMARCA4,429
chr1,151511030,151511489,SRX5075174,SMARCA4,459
chr1,151511046,151511560,SRX5075176,SMARCA4,514
chr1,151511060,151511354,SRX5716469,SMARCA4,294
chr1,151511062,151511442,SRX5075169,SMARCA4,380
chr1,151511068,151511425,SRX5716463,SMARCA4,357
chr1,151511162,151511443,SRX5075175,SMARCA4,281
chr1,151511202,151511384,SRX5054307,FOSL2,182
chr1,151533897,151534274,SRX20140867,INTS10,377
chr1,151533901,151534205,SRX5075174,SMARCA4,304
chr1,151534002,151534297,SRX5716463,SMARCA4,295
chr1,151534014,151534205,SRX5075168,SMARCA4,191
chr1,151534480,151535098,SRX16500059,CTCF,618
chr1,151534624,151535065,SRX16500060,CTCF,441
chr1,151534637,151535054,SRX16500061,CTCF,417
chr1,151534645,151535072,SRX16500062,CTCF,427
chr1,151534685,151535025,SRX4174629,CTCF,340
chr1,151534778,151534971,SRX5075168,SMARCA4,193
chr1,151534787,151534960,SRX5075174,SMARCA4,173
chr1,151537000,151537397,SRX5054309,FOSL2,397
chr1,151537044,151537385,SRX5054308,FOSL2,341
chr1,151537045,151537403,SRX5075169,SMARCA4,358
chr1,151537057,151537444,SRX5075170,SMARCA4,387
chr1,151537064,151537317,SRX5075175,SMARCA4,253
chr1,151537109,151537394,SRX5075176,SMARCA4,285
chr1,151537112,151537326,SRX5716470,SMARCA4,214
chr1,151537116,151537385,SRX5716469,SMARCA4,269
chr1,151540032,151540397,SRX5075168,SMARCA4,365
chr1,151540047,151540420,SRX5075174,SMARCA4,373
chr1,151540095,151540717,SRX20140895,INTS13,622
chr1,151540097,151540370,SRX5716463,SMARCA4,273
chr1,151540121,151540490,SRX20140881,CPSF3L,369
chr1,151540127,151540495,SRX20140879,CPSF3L,368
chr1,151540141,151540526,SRX20140867,INTS10,385
chr1,151540195,151540574,SRX20140897,INTS13,379
chr1,151540205,151540474,SRX20140868,INTS10,269
chr1,151540218,151540511,SRX5716464,SMARCA4,293
chr1,151540284,151540574,SRX20140896,INTS13,290
chr1,151540311,151540739,SRX20140869,INTS10,428
chr1,151547000,151547510,SRX5075174,SMARCA4,510
chr1,151547005,151547471,SRX5716463,SMARCA4,466
chr1,151547019,151547397,SRX5716464,SMARCA4,378
chr1,151547019,151547467,SRX5075168,SMARCA4,448
chr1,151547048,151547430,SRX5716470,SMARCA4,382
chr1,151547053,151547444,SRX5716469,SMARCA4,391
chr1,151547072,151547473,SRX5075170,SMARCA4,401
chr1,151547075,151547290,SRX5716467,SMARCA2,215
chr1,151547097,151547356,SRX5075175,SMARCA4,259
chr1,151547105,151547443,SRX5075176,SMARCA4,338
chr1,151547112,151547392,SRX5054309,FOSL2,280
chr1,151547117,151547414,SRX5075169,SMARCA4,297
chr1,151547138,151547338,SRX5054308,FOSL2,200
chr1,151547164,151547446,SRX5716468,SMARCA2,282
chr1,151548909,151549120,SRX5054309,FOSL2,211
chr1,151565358,151565949,SRX5075174,SMARCA4,591
chr1,151565442,151565984,SRX5075168,SMARCA4,542
chr1,151565670,151565867,SRX5075176,SMARCA4,197
chr1,151575036,151575286,SRX5075169,SMARCA4,250
chr1,151579486,151579697,SRX5054308,FOSL2,211
chr1,151585640,151586193,SRX5075176,SMARCA4,553
chr1,151585658,151585950,SRX5075169,SMARCA4,292
chr1,151585672,151585909,SRX5054309,FOSL2,237
chr1,151585677,151586085,SRX5075170,SMARCA4,408
chr1,151585679,151585980,SRX5054308,FOSL2,301
chr1,151585685,151585947,SRX5020211,SMARCA2,262
chr1,151585694,151585908,SRX5716469,SMARCA4,214
chr1,151585726,151586023,SRX5716467,SMARCA2,297
chr1,151585746,151585998,SRX5075175,SMARCA4,252
chr1,151594055,151594566,SRX16500062,CTCF,511
chr1,151594060,151594617,SRX16500060,CTCF,557
chr1,151594066,151594597,SRX16500059,CTCF,531
chr1,151594079,151594590,SRX16500061,CTCF,511
chr1,151594154,151594435,SRX4174629,CTCF,281
chr1,151594167,151594492,SRX5075168,SMARCA4,325
chr1,151594188,151594472,SRX5075170,SMARCA4,284
chr1,151594209,151594491,SRX5075174,SMARCA4,282
chr1,151594219,151594471,SRX5075176,SMARCA4,252
chr1,151608263,151608625,SRX5716470,SMARCA4,362
chr1,151608275,151608596,SRX5716469,SMARCA4,321
chr1,151608286,151608656,SRX5075175,SMARCA4,370
chr1,151608288,151608702,SRX5075176,SMARCA4,414
chr1,151608307,151608653,SRX5054308,FOSL2,346
chr1,151608310,151608631,SRX5075169,SMARCA4,321
chr1,151608315,151608682,SRX5054309,FOSL2,367
chr1,151608327,151608705,SRX5075170,SMARCA4,378
chr1,151608361,151608640,SRX5075168,SMARCA4,279
chr1,151608373,151608627,SRX5054307,FOSL2,254
chr1,151608412,151608651,SRX5075174,SMARCA4,239
chr1,151611867,151612208,SRX5716454,SOX3,341
chr1,151611870,151612201,SRX5075174,SMARCA4,331
chr1,151611909,151612230,SRX5075168,SMARCA4,321
chr1,151611914,151612495,SRX20140895,INTS13,581
chr1,151611929,151612185,SRX5716463,SMARCA4,256
chr1,151611952,151612364,SRX20140867,INTS10,412
chr1,151612004,151612367,SRX20140868,INTS10,363
chr1,151619699,151619962,SRX5054308,FOSL2,263
chr1,151619710,151619957,SRX5075169,SMARCA4,247
chr1,151619731,151619975,SRX5075176,SMARCA4,244
chr1,151619744,151619931,SRX5075175,SMARCA4,187
chr1,151619746,151619971,SRX5054309,FOSL2,225
chr1,151619778,151619951,SRX5075170,SMARCA4,173
chr1,151619779,151619991,SRX5716469,SMARCA4,212
chr1,151637583,151637884,SRX5075169,SMARCA4,301
chr1,151637679,151637848,SRX5075170,SMARCA4,169
chr1,151637813,151638004,SRX5075175,SMARCA4,191
chr1,151644065,151644296,SRX5054308,FOSL2,231
chr1,151644082,151644265,SRX5054309,FOSL2,183
chr1,151680719,151681132,SRX5716469,SMARCA4,413
chr1,151680802,151681189,SRX5075175,SMARCA4,387
chr1,151680810,151681131,SRX5075169,SMARCA4,321
chr1,151680815,151681143,SRX5054309,FOSL2,328
chr1,151680826,151681117,SRX5075176,SMARCA4,291
chr1,151680894,151681142,SRX5054308,FOSL2,248
chr1,151680900,151681079,SRX5075170,SMARCA4,179
chr1,151693039,151693507,SRX16500059,CTCF,468
chr1,151693042,151693456,SRX16500062,CTCF,414
chr1,151693046,151693450,SRX16500060,CTCF,404
chr1,151693069,151693443,SRX16500061,CTCF,374
chr1,151693092,151693379,SRX5716463,SMARCA4,287
chr1,151693110,151693508,SRX4174629,CTCF,398
chr1,151693113,151693463,SRX5075174,SMARCA4,350
chr1,151693133,151693345,SRX5075169,SMARCA4,212
chr1,151693134,151693421,SRX5075168,SMARCA4,287
chr1,151693152,151693360,SRX5075170,SMARCA4,208
chr1,151693155,151693362,SRX5716464,SMARCA4,207
chr1,151693166,151693349,SRX5075176,SMARCA4,183
chr1,151693167,151693355,SRX5075175,SMARCA4,188
chr1,151693193,151693415,SRX5716470,SMARCA4,222
chr1,151710137,151710658,SRX5716463,SMARCA4,521
chr1,151710143,151710518,SRX5075168,SMARCA4,375
chr1,151710172,151710669,SRX5075174,SMARCA4,497
chr1,151710246,151710481,SRX5716454,SOX3,235
chr1,151710261,151710489,SRX5716464,SMARCA4,228
chr1,151710269,151710466,SRX5716451,SOX2,197
chr1,151710628,151710807,SRX5075168,SMARCA4,179
chr1,151716061,151716413,SRX16500060,CTCF,352
chr1,151716110,151716397,SRX16500062,CTCF,287
chr1,151716851,151717207,SRX5075174,SMARCA4,356
chr1,151716866,151717070,SRX5716451,SOX2,204
chr1,151716873,151717129,SRX20140895,INTS13,256
chr1,151716881,151717162,SRX5716463,SMARCA4,281
chr1,151716887,151717193,SRX5075168,SMARCA4,306
chr1,151716920,151717159,SRX5075170,SMARCA4,239
chr1,151716969,151717228,SRX5075169,SMARCA4,259
chr1,151716976,151717272,SRX5716470,SMARCA4,296
chr1,151721340,151721717,SRX5075174,SMARCA4,377
chr1,151721348,151721663,SRX5075168,SMARCA4,315
chr1,151721480,151721688,SRX5075169,SMARCA4,208
chr1,151721526,151721717,SRX5075175,SMARCA4,191
chr1,151734972,151735432,SRX16500061,CTCF,460
chr1,151734989,151735479,SRX16500059,CTCF,490
chr1,151735007,151735421,SRX4174629,CTCF,414
chr1,151735020,151735456,SRX16500060,CTCF,436
chr1,151735024,151735458,SRX16500062,CTCF,434
chr1,151735064,151735402,SRX5075176,SMARCA4,338
chr1,151735065,151735359,SRX5075168,SMARCA4,294
chr1,151735066,151735308,SRX5075169,SMARCA4,242
chr1,151735069,151735344,SRX5716463,SMARCA4,275
chr1,151735071,151735347,SRX5075174,SMARCA4,276
chr1,151735136,151735412,SRX5075170,SMARCA4,276
chr1,151735168,151735348,SRX5054308,FOSL2,180
chr1,151763174,151763823,SRX20140895,INTS13,649
chr1,151763219,151763795,SRX20140869,INTS10,576
chr1,151763253,151763757,SRX20140897,INTS13,504
chr1,151763258,151763755,SRX20140868,INTS10,497
chr1,151763269,151763650,SRX20140879,CPSF3L,381
chr1,151763282,151763807,SRX5716470,SMARCA4,525
chr1,151763329,151763617,SRX20140894,INTS13,288
chr1,151763332,151763889,SRX5075174,SMARCA4,557
chr1,151763342,151763550,SRX5716464,SMARCA4,208
chr1,151763343,151763665,SRX20140867,INTS10,322
chr1,151763388,151763784,SRX5716469,SMARCA4,396
chr1,151763393,151763806,SRX5075170,SMARCA4,413
chr1,151763400,151763885,SRX5075175,SMARCA4,485
chr1,151763422,151763764,SRX5075176,SMARCA4,342
chr1,151763447,151763744,SRX5075168,SMARCA4,297
chr1,151763526,151763779,SRX5716463,SMARCA4,253
chr1,151763571,151763794,SRX5075169,SMARCA4,223
chr1,151790114,151790455,SRX16500060,CTCF,341
chr1,151790129,151790505,SRX16500062,CTCF,376
chr1,151790153,151790456,SRX5075176,SMARCA4,303
chr1,151790174,151790518,SRX16500059,CTCF,344
chr1,151790177,151790551,SRX5075169,SMARCA4,374
chr1,151790214,151790627,SRX5075174,SMARCA4,413
chr1,151790217,151790657,SRX20140895,INTS13,440
chr1,151790234,151790628,SRX5075168,SMARCA4,394
chr1,151790294,151790544,SRX5075175,SMARCA4,250
chr1,151790506,151790843,SRX5054307,FOSL2,337
chr1,151790535,151790728,SRX5716451,SOX2,193
chr1,151828945,151829350,SRX5075168,SMARCA4,405
chr1,151828986,151829180,SRX5075174,SMARCA4,194
chr1,151836377,151836720,SRX16500059,CTCF,343
chr1,151836399,151836729,SRX16500062,CTCF,330
chr1,151836400,151836719,SRX16500061,CTCF,319
chr1,151836435,151836721,SRX16500060,CTCF,286
chr1,151836515,151836752,SRX4174629,CTCF,237
chr1,151841215,151841398,SRX5054309,FOSL2,183
chr1,151841264,151841456,SRX5075174,SMARCA4,192
chr1,151867779,151868073,SRX5054309,FOSL2,294
chr1,151868340,151868785,SRX5716470,SMARCA4,445
chr1,151868347,151868713,SRX5075169,SMARCA4,366
chr1,151868415,151868658,SRX5716469,SMARCA4,243
chr1,151868442,151868661,SRX5075170,SMARCA4,219
chr1,151886908,151887455,SRX5075170,SMARCA4,547
chr1,151886940,151887416,SRX5075176,SMARCA4,476
chr1,151886958,151887194,SRX5075169,SMARCA4,236
chr1,151887027,151887254,SRX5054308,FOSL2,227
chr1,151887041,151887280,SRX5075175,SMARCA4,239
chr1,151888910,151889305,SRX16500061,CTCF,395
chr1,151888941,151889406,SRX16500059,CTCF,465
chr1,151888964,151889369,SRX16500060,CTCF,405
chr1,151889064,151889287,SRX16500062,CTCF,223
chr1,151909114,151909949,SRX20140895,INTS13,835
chr1,151909176,151909676,SRX5075168,SMARCA4,500
chr1,151909199,151909846,SRX20140868,INTS10,647
chr1,151909201,151909882,SRX5716470,SMARCA4,681
chr1,151909213,151909617,SRX5075175,SMARCA4,404
chr1,151909214,151909940,SRX5075174,SMARCA4,726
chr1,151909242,151909676,SRX5075176,SMARCA4,434
chr1,151909242,151909733,SRX5075169,SMARCA4,491
chr1,151909244,151909764,SRX20140869,INTS10,520
chr1,151909267,151909745,SRX5075170,SMARCA4,478
chr1,151909335,151909570,SRX20140879,CPSF3L,235
chr1,151909361,151909702,SRX5716463,SMARCA4,341
chr1,151909369,151909822,SRX5716469,SMARCA4,453
chr1,151909414,151909878,SRX20140897,INTS13,464
chr1,151909436,151909721,SRX5716464,SMARCA4,285
chr1,151933843,151934373,SRX16500062,CTCF,530
chr1,151933849,151934411,SRX16500061,CTCF,562
chr1,151933853,151934411,SRX16500060,CTCF,558
chr1,151933899,151934489,SRX16500059,CTCF,590
chr1,151934076,151934305,SRX5075168,SMARCA4,229
chr1,151934106,151934392,SRX4174629,CTCF,286
chr1,151934107,151934303,SRX5075176,SMARCA4,196
chr1,151934139,151934332,SRX5075170,SMARCA4,193
chr1,151935062,151935538,SRX5075174,SMARCA4,476
chr1,151935157,151935400,SRX5054309,FOSL2,243
chr1,151935160,151935484,SRX5075176,SMARCA4,324
chr1,151935167,151935516,SRX5075168,SMARCA4,349
chr1,151935177,151935495,SRX5075170,SMARCA4,318
chr1,151935185,151935512,SRX5075175,SMARCA4,327
chr1,151935189,151935443,SRX5054308,FOSL2,254
chr1,151935198,151935463,SRX5716469,SMARCA4,265
chr1,151935210,151935461,SRX5075169,SMARCA4,251
chr1,151935229,151935459,SRX5716463,SMARCA4,230
chr1,151936672,151936969,SRX20140881,CPSF3L,297
chr1,151936802,151937016,SRX5075174,SMARCA4,214
chr1,151941187,151941765,SRX5075169,SMARCA4,578
chr1,151941198,151941709,SRX5075176,SMARCA4,511
chr1,151941233,151941816,SRX5716470,SMARCA4,583
chr1,151941307,151941763,SRX5075175,SMARCA4,456
chr1,151941406,151941715,SRX5054308,FOSL2,309
chr1,151941417,151941689,SRX5054309,FOSL2,272
chr1,151941422,151941763,SRX5075170,SMARCA4,341
chr1,151941430,151941750,SRX5716469,SMARCA4,320
chr1,151941450,151941675,SRX5020211,SMARCA2,225
chr1,151945741,151946111,SRX5075176,SMARCA4,370
chr1,151945746,151946152,SRX5075174,SMARCA4,406
chr1,151945764,151946030,SRX5716469,SMARCA4,266
chr1,151945765,151946045,SRX5716470,SMARCA4,280
chr1,151945771,151946098,SRX5075169,SMARCA4,327
chr1,151945777,151946045,SRX5054309,FOSL2,268
chr1,151945796,151946100,SRX5075175,SMARCA4,304
chr1,151945798,151946011,SRX5020211,SMARCA2,213
chr1,151945802,151946141,SRX5075170,SMARCA4,339
chr1,151945804,151946179,SRX5075168,SMARCA4,375
chr1,151945806,151946044,SRX5716467,SMARCA2,238
chr1,151945807,151946066,SRX5054307,FOSL2,259
chr1,151945809,151946068,SRX5054308,FOSL2,259
chr1,151961843,151962226,SRX5075176,SMARCA4,383
chr1,151961912,151962194,SRX5075170,SMARCA4,282
chr1,151972832,151973302,SRX5075176,SMARCA4,470
chr1,151972896,151973299,SRX5075170,SMARCA4,403
chr1,151972928,151973267,SRX5075169,SMARCA4,339
chr1,151972932,151973250,SRX5075174,SMARCA4,318
chr1,151972936,151973343,SRX5716469,SMARCA4,407
chr1,151972945,151973295,SRX5054308,FOSL2,350
chr1,151972971,151973284,SRX5054309,FOSL2,313
chr1,151972971,151973293,SRX5075175,SMARCA4,322
chr1,151972978,151973291,SRX5075168,SMARCA4,313
chr1,151972998,151973209,SRX5716470,SMARCA4,211
chr1,151973039,151973259,SRX5020211,SMARCA2,220
chr1,151973060,151973287,SRX5716467,SMARCA2,227
chr1,151976869,151977135,SRX5075176,SMARCA4,266
chr1,151976874,151977171,SRX5054309,FOSL2,297
chr1,151976884,151977151,SRX5075169,SMARCA4,267
chr1,151976888,151977164,SRX5075170,SMARCA4,276
chr1,151976892,151977145,SRX5075175,SMARCA4,253
chr1,151976895,151977104,SRX5054308,FOSL2,209
chr1,151980260,151980982,SRX5075176,SMARCA4,722
chr1,151980278,151980936,SRX5075170,SMARCA4,658
chr1,151980279,151980901,SRX5075169,SMARCA4,622
chr1,151980326,151980798,SRX5075181,SMARCA2,472
chr1,151980332,151980806,SRX5716467,SMARCA2,474
chr1,151980335,151980877,SRX5075175,SMARCA4,542
chr1,151980341,151980687,SRX5716470,SMARCA4,346
chr1,151980364,151980684,SRX5716468,SMARCA2,320
chr1,151980382,151980587,SRX5020214,SMARCA2,205
chr1,151980389,151980691,SRX5716469,SMARCA4,302
chr1,151980402,151980729,SRX5054308,FOSL2,327
chr1,151980458,151980751,SRX5054309,FOSL2,293
chr1,151988429,151988778,SRX5054309,FOSL2,349
chr1,151988430,151988880,SRX5075169,SMARCA4,450
chr1,151988494,151988753,SRX5054308,FOSL2,259
chr1,151988517,151988736,SRX5075175,SMARCA4,219
chr1,151988523,151988741,SRX5075170,SMARCA4,218
chr1,151992489,151992693,SRX5075175,SMARCA4,204
chr1,151992558,151992738,SRX5054308,FOSL2,180
chr1,151994922,151995269,SRX5075169,SMARCA4,347
chr1,151994934,151995287,SRX5054309,FOSL2,353
chr1,151994940,151995295,SRX5075175,SMARCA4,355
chr1,151994952,151995252,SRX5075170,SMARCA4,300
chr1,151994975,151995275,SRX5054308,FOSL2,300
chr1,151994977,151995216,SRX5020214,SMARCA2,239
chr1,151994985,151995302,SRX5075176,SMARCA4,317
chr1,151996712,151997114,SRX16500061,CTCF,402
chr1,151996755,151997133,SRX16500060,CTCF,378
chr1,151996785,151997163,SRX16500062,CTCF,378
chr1,151996809,151997158,SRX16500059,CTCF,349
chr1,152001445,152002003,SRX5075175,SMARCA4,558
chr1,152001489,152002060,SRX5075170,SMARCA4,571
chr1,152001510,152002015,SRX5075169,SMARCA4,505
chr1,152001516,152001913,SRX5054309,FOSL2,397
chr1,152001520,152002031,SRX5716470,SMARCA4,511
chr1,152001566,152001805,SRX5054308,FOSL2,239
chr1,152001566,152001848,SRX5020214,SMARCA2,282
chr1,152001586,152001960,SRX5716469,SMARCA4,374
chr1,152001598,152001862,SRX5716467,SMARCA2,264
chr1,152001607,152001790,SRX5075182,SMARCA2,183
chr1,152001631,152002118,SRX16500059,CTCF,487
chr1,152001646,152002042,SRX5075174,SMARCA4,396
chr1,152001646,152002111,SRX16500060,CTCF,465
chr1,152001648,152002039,SRX5075168,SMARCA4,391
chr1,152001659,152002038,SRX5075176,SMARCA4,379
chr1,152001687,152002092,SRX16500062,CTCF,405
chr1,152001689,152002100,SRX16500061,CTCF,411
chr1,152001697,152001946,SRX5020211,SMARCA2,249
chr1,152001735,152002162,SRX4174629,CTCF,427
chr1,152013645,152014020,SRX16500060,CTCF,375
chr1,152013718,152013963,SRX16500059,CTCF,245
chr1,152013752,152013934,SRX5075174,SMARCA4,182
chr1,152013774,152013984,SRX16500062,CTCF,210
chr1,152018582,152018801,SRX16500061,CTCF,219
chr1,152029087,152029327,SRX5054309,FOSL2,240
chr1,152029118,152029587,SRX5075169,SMARCA4,469
chr1,152029135,152029495,SRX5075170,SMARCA4,360
chr1,152029190,152029435,SRX5075175,SMARCA4,245
chr1,152034406,152034989,SRX16500059,CTCF,583
chr1,152034438,152034914,SRX16500062,CTCF,476
chr1,152034459,152034954,SRX16500061,CTCF,495
chr1,152034465,152034986,SRX16500060,CTCF,521
chr1,152034582,152034991,SRX5075170,SMARCA4,409
chr1,152034597,152034821,SRX5075169,SMARCA4,224
chr1,152034622,152034900,SRX5075176,SMARCA4,278
chr1,152036664,152036946,SRX20140869,INTS10,282
chr1,152036888,152037210,SRX5075169,SMARCA4,322
chr1,152036890,152037196,SRX5075176,SMARCA4,306
chr1,152036895,152037171,SRX5075170,SMARCA4,276
chr1,152036960,152037239,SRX5075175,SMARCA4,279
chr1,152036991,152037171,SRX5054308,FOSL2,180
chr1,152047626,152048395,SRX5716469,SMARCA4,769
chr1,152047645,152048518,SRX5075176,SMARCA4,873
chr1,152047663,152048534,SRX5075175,SMARCA4,871
chr1,152047818,152048518,SRX5075170,SMARCA4,700
chr1,152047836,152048510,SRX5075169,SMARCA4,674
chr1,152047868,152048447,SRX5716470,SMARCA4,579
chr1,152047897,152048447,SRX5075174,SMARCA4,550
chr1,152047900,152048153,SRX16500062,CTCF,253
chr1,152047906,152048125,SRX5716463,SMARCA4,219
chr1,152047910,152048148,SRX16500060,CTCF,238
chr1,152047916,152048558,SRX5075168,SMARCA4,642
chr1,152047917,152048177,SRX16500059,CTCF,260
chr1,152047999,152048410,SRX5716467,SMARCA2,411
chr1,152048029,152048303,SRX5020211,SMARCA2,274
chr1,152048040,152048425,SRX5054309,FOSL2,385
chr1,152048059,152048441,SRX5054308,FOSL2,382
chr1,152048080,152048369,SRX5075182,SMARCA2,289
chr1,152048102,152048346,SRX5020214,SMARCA2,244
chr1,152048126,152048399,SRX5054307,FOSL2,273
chr1,152052512,152052980,SRX16500059,CTCF,468
chr1,152052522,152053003,SRX16500060,CTCF,481
chr1,152052523,152052948,SRX16500061,CTCF,425
chr1,152052552,152052946,SRX16500062,CTCF,394
chr1,152052611,152052927,SRX4174629,CTCF,316
chr1,152052655,152052851,SRX5075168,SMARCA4,196
chr1,152052694,152052883,SRX5075174,SMARCA4,189
chr1,152141926,152142351,SRX16500061,CTCF,425
chr1,152141938,152142364,SRX16500062,CTCF,426
chr1,152141951,152142395,SRX16500059,CTCF,444
chr1,152141961,152142334,SRX16500060,CTCF,373
chr1,152142026,152142304,SRX4174629,CTCF,278
chr1,152185557,152185981,SRX16500060,CTCF,424
chr1,152185586,152185942,SRX16500062,CTCF,356
chr1,152185594,152185983,SRX16500059,CTCF,389
chr1,152185610,152185963,SRX16500061,CTCF,353
chr1,152347111,152347545,SRX16500059,CTCF,434
chr1,152347124,152347530,SRX16500062,CTCF,406
chr1,152347127,152347502,SRX16500061,CTCF,375
chr1,152347131,152347567,SRX16500060,CTCF,436
chr1,152347229,152347505,SRX4174629,CTCF,276
chr1,152440871,152441262,SRX16500060,CTCF,391
chr1,152440889,152441234,SRX16500059,CTCF,345
chr1,152440897,152441211,SRX4174629,CTCF,314
chr1,152440957,152441176,SRX16500061,CTCF,219
chr1,152458408,152458715,SRX16500059,CTCF,307
chr1,152458434,152458773,SRX16500060,CTCF,339
chr1,152458449,152458697,SRX5075174,SMARCA4,248
chr1,152458477,152458727,SRX16500062,CTCF,250
chr1,152458490,152458678,SRX5075168,SMARCA4,188
chr1,152653990,152654338,SRX16500059,CTCF,348
chr1,152654030,152654302,SRX16500060,CTCF,272
chr1,152654092,152654311,SRX16500062,CTCF,219
chr1,152869736,152870222,SRX16500060,CTCF,486
chr1,152869785,152870263,SRX16500061,CTCF,478
chr1,152869823,152870261,SRX16500059,CTCF,438
chr1,152869826,152870228,SRX16500062,CTCF,402
chr1,152869903,152870188,SRX4174629,CTCF,285
chr1,152917829,152918076,SRX16500059,CTCF,247
chr1,152917865,152918155,SRX4174629,CTCF,290
chr1,152917892,152918128,SRX16500060,CTCF,236
chr1,153192776,153193044,SRX16500059,CTCF,268
chr1,153222990,153223493,SRX16500059,CTCF,503
chr1,153223030,153223470,SRX16500060,CTCF,440
chr1,153223031,153223516,SRX16500061,CTCF,485
chr1,153223047,153223474,SRX16500062,CTCF,427
chr1,153223095,153223434,SRX4174629,CTCF,339
chr1,153223108,153223359,SRX5075174,SMARCA4,251
chr1,153229211,153229643,SRX16500061,CTCF,432
chr1,153229231,153229680,SRX16500060,CTCF,449
chr1,153229250,153229666,SRX16500059,CTCF,416
chr1,153229302,153229639,SRX4174629,CTCF,337
chr1,153229307,153229524,SRX5075168,SMARCA4,217
chr1,153229334,153229633,SRX16500062,CTCF,299
chr1,153229361,153229537,SRX5075174,SMARCA4,176
chr1,153277863,153278233,SRX16500059,CTCF,370
chr1,153277873,153278198,SRX16500062,CTCF,325
chr1,153277873,153278207,SRX16500061,CTCF,334
chr1,153277904,153278245,SRX16500060,CTCF,341
chr1,153288772,153289069,SRX16500059,CTCF,297
chr1,153352279,153352829,SRX16500062,CTCF,550
chr1,153352366,153352837,SRX16500061,CTCF,471
chr1,153352370,153352833,SRX16500059,CTCF,463
chr1,153352373,153352801,SRX16500060,CTCF,428
chr1,153352469,153352820,SRX4174629,CTCF,351
chr1,153352519,153352758,SRX5075174,SMARCA4,239
chr1,153352528,153352816,SRX5075168,SMARCA4,288
chr1,153404742,153405079,SRX16500059,CTCF,337
chr1,153404792,153405080,SRX16500061,CTCF,288
chr1,153404822,153405091,SRX16500060,CTCF,269
chr1,153422410,153422822,SRX5075168,SMARCA4,412
chr1,153422429,153422829,SRX5075174,SMARCA4,400
chr1,153422430,153422795,SRX5716470,SMARCA4,365
chr1,153422453,153422769,SRX5716469,SMARCA4,316
chr1,153422458,153422789,SRX5716463,SMARCA4,331
chr1,153422465,153422806,SRX5075175,SMARCA4,341
chr1,153422474,153422776,SRX5075169,SMARCA4,302
chr1,153422474,153422831,SRX5716464,SMARCA4,357
chr1,153422478,153422812,SRX5075170,SMARCA4,334
chr1,153422483,153422797,SRX5075176,SMARCA4,314
chr1,153452436,153452648,SRX5716469,SMARCA4,212
chr1,153452438,153452683,SRX5716470,SMARCA4,245
chr1,153452465,153452657,SRX5075168,SMARCA4,192
chr1,153452481,153452687,SRX5075169,SMARCA4,206
chr1,153452484,153452720,SRX5075176,SMARCA4,236
chr1,153452512,153452710,SRX5075170,SMARCA4,198
chr1,153465678,153466251,SRX16500060,CTCF,573
chr1,153465679,153466154,SRX16500061,CTCF,475
chr1,153465684,153466071,SRX16500062,CTCF,387
chr1,153465685,153466212,SRX16500059,CTCF,527
chr1,153465775,153466056,SRX5075168,SMARCA4,281
chr1,153465814,153466019,SRX5716464,SMARCA4,205
chr1,153465867,153466049,SRX5075174,SMARCA4,182
chr1,153465872,153466090,SRX5716463,SMARCA4,218
chr1,153465884,153466118,SRX4174629,CTCF,234
chr1,153490225,153490533,SRX5075176,SMARCA4,308
chr1,153490248,153490922,SRX5075170,SMARCA4,674
chr1,153490403,153490719,SRX5075169,SMARCA4,316
chr1,153490477,153490786,SRX5716469,SMARCA4,309
chr1,153490608,153490891,SRX5075176,SMARCA4,283
chr1,153494796,153495354,SRX16500060,CTCF,558
chr1,153494832,153495310,SRX16500062,CTCF,478
chr1,153494834,153495321,SRX16500059,CTCF,487
chr1,153494843,153495302,SRX16500061,CTCF,459
chr1,153494906,153495184,SRX4174629,CTCF,278
chr1,153494953,153495184,SRX5075176,SMARCA4,231
chr1,153494968,153495169,SRX5075174,SMARCA4,201
chr1,153495000,153495213,SRX5075168,SMARCA4,213
chr1,153506758,153507221,SRX5075175,SMARCA4,463
chr1,153506764,153507128,SRX5075170,SMARCA4,364
chr1,153506773,153507195,SRX5075176,SMARCA4,422
chr1,153506777,153507143,SRX5716469,SMARCA4,366
chr1,153506792,153507160,SRX5716470,SMARCA4,368
chr1,153506798,153507141,SRX5075169,SMARCA4,343
chr1,153506809,153507118,SRX5054309,FOSL2,309
chr1,153506837,153507122,SRX5716467,SMARCA2,285
chr1,153506842,153507141,SRX5054308,FOSL2,299
chr1,153510847,153511342,SRX16500061,CTCF,495
chr1,153510848,153511324,SRX16500060,CTCF,476
chr1,153510855,153511362,SRX16500059,CTCF,507
chr1,153510871,153511319,SRX16500062,CTCF,448
chr1,153510910,153511165,SRX4174629,CTCF,255
chr1,153510932,153511249,SRX5075174,SMARCA4,317
chr1,153510972,153511279,SRX5075168,SMARCA4,307
chr1,153510973,153511264,SRX5075170,SMARCA4,291
chr1,153510999,153511338,SRX20140895,INTS13,339
chr1,153511010,153511266,SRX5075176,SMARCA4,256
chr1,153511024,153511271,SRX5716469,SMARCA4,247
chr1,153511039,153511229,SRX5075175,SMARCA4,190
chr1,153511041,153511321,SRX5075169,SMARCA4,280
chr1,153525409,153525607,SRX5075176,SMARCA4,198
chr1,153533030,153533592,SRX16500060,CTCF,562
chr1,153533034,153533601,SRX16500059,CTCF,567
chr1,153533035,153533496,SRX16500062,CTCF,461
chr1,153533045,153533528,SRX16500061,CTCF,483
chr1,153533197,153533511,SRX4174629,CTCF,314
chr1,153533229,153533402,SRX5075174,SMARCA4,173
chr1,153533231,153533432,SRX5075170,SMARCA4,201
chr1,153533652,153534058,SRX5075169,SMARCA4,406
chr1,153533673,153534060,SRX5075176,SMARCA4,387
chr1,153533682,153534165,SRX5075170,SMARCA4,483
chr1,153533724,153534024,SRX5054309,FOSL2,300
chr1,153533729,153534093,SRX5075175,SMARCA4,364
chr1,153533790,153534004,SRX5054308,FOSL2,214
chr1,153540822,153541133,SRX5054308,FOSL2,311
chr1,153544937,153545322,SRX20140895,INTS13,385
chr1,153544973,153545341,SRX5716470,SMARCA4,368
chr1,153544975,153545418,SRX5075176,SMARCA4,443
chr1,153544976,153545370,SRX5075170,SMARCA4,394
chr1,153544981,153545401,SRX5075168,SMARCA4,420
chr1,153545000,153545353,SRX5075174,SMARCA4,353
chr1,153545027,153545286,SRX5075169,SMARCA4,259
chr1,153545062,153545340,SRX20140868,INTS10,278
chr1,153545063,153545343,SRX5716469,SMARCA4,280
chr1,153545111,153545311,SRX5075175,SMARCA4,200
chr1,153545564,153545782,SRX5075170,SMARCA4,218
chr1,153549293,153549668,SRX5075169,SMARCA4,375
chr1,153549324,153549626,SRX5075175,SMARCA4,302
chr1,153549324,153549649,SRX5054309,FOSL2,325
chr1,153549326,153549608,SRX5075170,SMARCA4,282
chr1,153549347,153549619,SRX5075176,SMARCA4,272
chr1,153549373,153549629,SRX5054308,FOSL2,256
chr1,153549381,153549652,SRX5716469,SMARCA4,271
chr1,153565762,153565983,SRX5075169,SMARCA4,221
chr1,153565776,153565951,SRX5075176,SMARCA4,175
chr1,153565799,153565982,SRX5054309,FOSL2,183
chr1,153566399,153566941,SRX5075176,SMARCA4,542
chr1,153566436,153566874,SRX5075174,SMARCA4,438
chr1,153566441,153566902,SRX5075169,SMARCA4,461
chr1,153566457,153566919,SRX5075170,SMARCA4,462
chr1,153566466,153566944,SRX5075175,SMARCA4,478
chr1,153566467,153566903,SRX5054309,FOSL2,436
chr1,153566470,153566890,SRX5716470,SMARCA4,420
chr1,153566488,153566868,SRX5075168,SMARCA4,380
chr1,153566522,153566908,SRX5716469,SMARCA4,386
chr1,153566531,153566862,SRX5054308,FOSL2,331
chr1,153566535,153566897,SRX5020214,SMARCA2,362
chr1,153566536,153566775,SRX5020211,SMARCA2,239
chr1,153566545,153566782,SRX5054307,FOSL2,237
chr1,153566563,153566820,SRX5716467,SMARCA2,257
chr1,153568435,153568937,SRX16500059,CTCF,502
chr1,153568457,153568949,SRX16500060,CTCF,492
chr1,153568480,153568941,SRX16500062,CTCF,461
chr1,153568484,153568956,SRX16500061,CTCF,472
chr1,153568518,153568831,SRX5075170,SMARCA4,313
chr1,153568520,153568814,SRX5716463,SMARCA4,294
chr1,153568520,153568842,SRX5075176,SMARCA4,322
chr1,153568528,153568873,SRX5075174,SMARCA4,345
chr1,153568557,153568902,SRX5075168,SMARCA4,345
chr1,153568570,153568760,SRX5075169,SMARCA4,190
chr1,153568631,153568926,SRX5716464,SMARCA4,295
chr1,153568638,153568929,SRX4174629,CTCF,291
chr1,153572569,153572850,SRX5075170,SMARCA4,281
chr1,153572572,153572804,SRX16500060,CTCF,232
chr1,153572579,153572979,SRX5075176,SMARCA4,400
chr1,153572615,153573027,SRX5075169,SMARCA4,412
chr1,153572617,153572863,SRX5716469,SMARCA4,246
chr1,153572670,153572904,SRX5075175,SMARCA4,234
chr1,153572757,153573004,SRX5054309,FOSL2,247
chr1,153572773,153573024,SRX5054308,FOSL2,251
chr1,153578594,153578783,SRX5075174,SMARCA4,189
chr1,153592636,153593062,SRX5075174,SMARCA4,426
chr1,153592692,153593028,SRX5075168,SMARCA4,336
chr1,153592696,153592990,SRX20140895,INTS13,294
chr1,153592737,153593031,SRX5716451,SOX2,294
chr1,153592770,153593063,SRX5716463,SMARCA4,293
chr1,153592840,153593101,SRX20140868,INTS10,261
chr1,153598732,153599228,SRX5075174,SMARCA4,496
chr1,153598773,153599180,SRX5075168,SMARCA4,407
chr1,153598791,153599137,SRX5075170,SMARCA4,346
chr1,153598792,153599139,SRX5075176,SMARCA4,347
chr1,153598802,153599192,SRX5075169,SMARCA4,390
chr1,153598844,153599108,SRX5716470,SMARCA4,264
chr1,153598857,153599098,SRX5075175,SMARCA4,241
chr1,153608782,153609166,SRX5075176,SMARCA4,384
chr1,153608793,153609341,SRX5075174,SMARCA4,548
chr1,153608819,153609541,SRX5075168,SMARCA4,722
chr1,153608837,153609198,SRX5075170,SMARCA4,361
chr1,153608840,153609297,SRX5075169,SMARCA4,457
chr1,153608890,153609149,SRX5075175,SMARCA4,259
chr1,153608894,153609159,SRX5054307,FOSL2,265
chr1,153608926,153609157,SRX5054308,FOSL2,231
chr1,153609000,153609196,SRX5054309,FOSL2,196
chr1,153617576,153617932,SRX16500060,CTCF,356
chr1,153617602,153617956,SRX16500059,CTCF,354
chr1,153617621,153617922,SRX16500062,CTCF,301
chr1,153617650,153617995,SRX16500061,CTCF,345
chr1,153627076,153627721,SRX5075169,SMARCA4,645
chr1,153627079,153627564,SRX5075175,SMARCA4,485
chr1,153627192,153627808,SRX5716470,SMARCA4,616
chr1,153627195,153627771,SRX5075170,SMARCA4,576
chr1,153627200,153627831,SRX5075168,SMARCA4,631
chr1,153627208,153627618,SRX20140881,CPSF3L,410
chr1,153627213,153627627,SRX20140879,CPSF3L,414
chr1,153627232,153627795,SRX5075176,SMARCA4,563
chr1,153627250,153627635,SRX20140894,INTS13,385
chr1,153627261,153627728,SRX20140895,INTS13,467
chr1,153627277,153627574,SRX20140897,INTS13,297
chr1,153627278,153627665,SRX20140867,INTS10,387
chr1,153627294,153627771,SRX5716469,SMARCA4,477
chr1,153627331,153627602,SRX20140896,INTS13,271
chr1,153627372,153627645,SRX5054309,FOSL2,273
chr1,153627405,153627758,SRX5075174,SMARCA4,353
chr1,153627418,153627779,SRX5716464,SMARCA4,361
chr1,153627427,153627758,SRX5716463,SMARCA4,331
chr1,153627435,153627912,SRX16500059,CTCF,477
chr1,153627435,153627939,SRX16500060,CTCF,504
chr1,153627468,153627683,SRX5716467,SMARCA2,215
chr1,153627472,153627914,SRX16500061,CTCF,442
chr1,153627484,153627783,SRX4174629,CTCF,299
chr1,153627507,153627932,SRX16500062,CTCF,425
chr1,153633720,153634118,SRX5075174,SMARCA4,398
chr1,153633749,153633994,SRX5716463,SMARCA4,245
chr1,153633759,153634449,SRX5075168,SMARCA4,690
chr1,153633778,153634155,SRX5075176,SMARCA4,377
chr1,153633841,153634082,SRX5075170,SMARCA4,241
chr1,153633848,153634113,SRX5716464,SMARCA4,265
chr1,153633878,153634071,SRX5054307,FOSL2,193
chr1,153633895,153634076,SRX5054308,FOSL2,181
chr1,153633918,153634633,SRX20140895,INTS13,715
chr1,153633936,153634556,SRX20140867,INTS10,620
chr1,153633957,153634650,SRX20140897,INTS13,693
chr1,153633984,153634481,SRX20140869,INTS10,497
chr1,153634008,153634480,SRX20140868,INTS10,472
chr1,153634027,153634504,SRX20140881,CPSF3L,477
chr1,153634071,153634430,SRX20140879,CPSF3L,359
chr1,153634071,153634497,SRX20140896,INTS13,426
chr1,153634104,153634368,SRX20140880,CPSF3L,264
chr1,153634212,153634641,SRX5075169,SMARCA4,429
chr1,153634213,153634547,SRX5716470,SMARCA4,334
chr1,153634274,153634560,SRX5716469,SMARCA4,286
chr1,153634300,153634624,SRX5075170,SMARCA4,324
chr1,153634357,153634679,SRX5075174,SMARCA4,322
chr1,153634406,153634670,SRX5075176,SMARCA4,264
chr1,153658424,153658932,SRX5075174,SMARCA4,508
chr1,153658450,153658950,SRX5075168,SMARCA4,500
chr1,153658464,153659004,SRX20140895,INTS13,540
chr1,153658481,153658829,SRX20140869,INTS10,348
chr1,153658482,153658922,SRX20140897,INTS13,440
chr1,153658487,153658921,SRX5716470,SMARCA4,434
chr1,153658489,153658819,SRX5075170,SMARCA4,330
chr1,153658502,153658863,SRX5075176,SMARCA4,361
chr1,153658513,153658885,SRX20140868,INTS10,372
chr1,153658515,153658872,SRX5716463,SMARCA4,357
chr1,153658517,153658871,SRX16500059,CTCF,354
chr1,153658569,153658906,SRX20140894,INTS13,337
chr1,153658599,153658953,SRX5716469,SMARCA4,354
chr1,153658603,153658926,SRX5075169,SMARCA4,323
chr1,153658671,153658904,SRX20140867,INTS10,233
chr1,153670774,153671585,SRX20140895,INTS13,811
chr1,153670802,153671545,SRX20140867,INTS10,743
chr1,153670851,153671472,SRX20140868,INTS10,621
chr1,153670907,153671288,SRX5075168,SMARCA4,381
chr1,153670914,153671328,SRX5716451,SOX2,414
chr1,153670932,153671543,SRX20140869,INTS10,611
chr1,153670939,153671317,SRX5054307,FOSL2,378
chr1,153670977,153671225,SRX5054309,FOSL2,248
chr1,153670986,153671241,SRX5716463,SMARCA4,255
chr1,153671031,153671489,SRX5075174,SMARCA4,458
chr1,153671050,153671230,SRX5054308,FOSL2,180
chr1,153671070,153671343,SRX20140881,CPSF3L,273
chr1,153671086,153671353,SRX16500062,CTCF,267
chr1,153671098,153671330,SRX16500060,CTCF,232
chr1,153671098,153671469,SRX20140894,INTS13,371
chr1,153671105,153671342,SRX16500059,CTCF,237
chr1,153671146,153671372,SRX16500061,CTCF,226
chr1,153671168,153671491,SRX20140860,SOX2,323
chr1,153671276,153671639,SRX5716470,SMARCA4,363
chr1,153671309,153671521,SRX5075169,SMARCA4,212
chr1,153671312,153671710,SRX5075170,SMARCA4,398
chr1,153671356,153671703,SRX5716469,SMARCA4,347
chr1,153671376,153671789,SRX5716467,SMARCA2,413
chr1,153677482,153678108,SRX4174629,CTCF,626
chr1,153677580,153678208,SRX16500059,CTCF,628
chr1,153677607,153678161,SRX16500061,CTCF,554
chr1,153677624,153678203,SRX16500060,CTCF,579
chr1,153677643,153678086,SRX16500062,CTCF,443
chr1,153677666,153678053,SRX5075174,SMARCA4,387
chr1,153677731,153677980,SRX5075168,SMARCA4,249
chr1,153677737,153678049,SRX5075176,SMARCA4,312
chr1,153677770,153677966,SRX5075170,SMARCA4,196
chr1,153697315,153697491,SRX5075174,SMARCA4,176
chr1,153698291,153698497,SRX5075169,SMARCA4,206
chr1,153698382,153698649,SRX5075168,SMARCA4,267
chr1,153698403,153698698,SRX5075176,SMARCA4,295
chr1,153698460,153698705,SRX5075174,SMARCA4,245
chr1,153698504,153698675,SRX5075170,SMARCA4,171
chr1,153727628,153727840,SRX5716469,SMARCA4,212
chr1,153727637,153727982,SRX5075168,SMARCA4,345
chr1,153727665,153727987,SRX5075174,SMARCA4,322
chr1,153727722,153727948,SRX5716454,SOX3,226
chr1,153727764,153728016,SRX5054307,FOSL2,252
chr1,153727809,153728025,SRX5075176,SMARCA4,216
chr1,153728053,153728375,SRX16500061,CTCF,322
chr1,153728066,153728287,SRX16500060,CTCF,221
chr1,153728147,153728484,SRX20140869,INTS10,337
chr1,153728641,153728956,SRX5075176,SMARCA4,315
chr1,153749324,153749849,SRX16500059,CTCF,525
chr1,153749366,153749851,SRX16500060,CTCF,485
chr1,153749370,153749808,SRX16500061,CTCF,438
chr1,153749394,153749790,SRX4174629,CTCF,396
chr1,153749434,153749725,SRX5075174,SMARCA4,291
chr1,153749435,153749837,SRX16500062,CTCF,402
chr1,153749439,153749735,SRX5075170,SMARCA4,296
chr1,153749450,153749713,SRX5075168,SMARCA4,263
chr1,153749478,153749679,SRX5075169,SMARCA4,201
chr1,153749485,153749703,SRX5075176,SMARCA4,218
chr1,153749487,153749717,SRX5075175,SMARCA4,230
chr1,153763721,153763922,SRX5075170,SMARCA4,201
chr1,153771865,153772317,SRX16500061,CTCF,452
chr1,153771892,153772373,SRX16500059,CTCF,481
chr1,153771899,153772286,SRX16500062,CTCF,387
chr1,153771904,153772383,SRX16500060,CTCF,479
chr1,153775373,153776179,SRX20140895,INTS13,806
chr1,153775481,153775822,SRX5075176,SMARCA4,341
chr1,153775512,153775786,SRX5075170,SMARCA4,274
chr1,153775536,153775775,SRX5075169,SMARCA4,239
chr1,153775576,153775793,SRX5075168,SMARCA4,217
chr1,153775636,153775814,SRX5075174,SMARCA4,178
chr1,153783091,153783977,SRX5075176,SMARCA4,886
chr1,153783145,153783419,SRX5075175,SMARCA4,274
chr1,153783198,153783752,SRX5716470,SMARCA4,554
chr1,153783209,153783879,SRX5075169,SMARCA4,670
chr1,153783291,153783979,SRX5075168,SMARCA4,688
chr1,153783293,153783947,SRX20140895,INTS13,654
chr1,153783302,153784017,SRX5075170,SMARCA4,715
chr1,153783307,153783761,SRX5716469,SMARCA4,454
chr1,153783316,153783770,SRX20140869,INTS10,454
chr1,153783331,153783962,SRX5075174,SMARCA4,631
chr1,153783343,153783857,SRX20140897,INTS13,514
chr1,153783416,153783776,SRX20140867,INTS10,360
chr1,153783416,153783869,SRX20140868,INTS10,453
chr1,153783472,153783806,SRX5075175,SMARCA4,334
chr1,153783491,153783726,SRX20140879,CPSF3L,235
chr1,153793319,153793543,SRX5716451,SOX2,224
chr1,153793336,153793531,SRX5075174,SMARCA4,195
chr1,153794615,153795532,SRX20140895,INTS13,917
chr1,153794761,153795387,SRX5075168,SMARCA4,626
chr1,153794814,153795411,SRX20140868,INTS10,597
chr1,153794830,153795391,SRX5075174,SMARCA4,561
chr1,153794880,153795264,SRX20140879,CPSF3L,384
chr1,153794900,153795357,SRX5716463,SMARCA4,457
chr1,153794907,153795237,SRX20140867,INTS10,330
chr1,153794942,153795276,SRX5716454,SOX3,334
chr1,153794966,153795227,SRX5716451,SOX2,261
chr1,153794976,153795328,SRX5716464,SMARCA4,352
chr1,153794994,153795205,SRX5716470,SMARCA4,211
chr1,153797127,153797697,SRX16500059,CTCF,570
chr1,153797132,153797616,SRX16500062,CTCF,484
chr1,153797132,153797682,SRX16500060,CTCF,550
chr1,153797164,153797692,SRX16500061,CTCF,528
chr1,153797363,153797559,SRX5075176,SMARCA4,196
chr1,153821075,153821116,SRX1424892,POU3F2,41
chr1,153821078,153821120,SRX1424891,POU3F2,42
chr1,153821239,153821623,SRX16500062,CTCF,384
chr1,153821291,153821676,SRX16500060,CTCF,385
chr1,153821299,153821726,SRX16500059,CTCF,427
chr1,153821330,153821668,SRX16500061,CTCF,338
chr1,153821385,153821624,SRX5075176,SMARCA4,239
chr1,153821412,153821581,SRX5075170,SMARCA4,169
chr1,153866365,153866771,SRX5075176,SMARCA4,406
chr1,153866378,153866672,SRX5716470,SMARCA4,294
chr1,153866391,153866706,SRX5075169,SMARCA4,315
chr1,153866407,153866776,SRX5075170,SMARCA4,369
chr1,153866417,153866780,SRX5716469,SMARCA4,363
chr1,153866427,153866648,SRX5075175,SMARCA4,221
chr1,153866437,153866720,SRX5716467,SMARCA2,283
chr1,153866441,153866689,SRX5716468,SMARCA2,248
chr1,153880856,153881362,SRX5075168,SMARCA4,506
chr1,153880905,153881456,SRX5075174,SMARCA4,551
chr1,153880941,153881425,SRX5075176,SMARCA4,484
chr1,153880959,153881367,SRX5075175,SMARCA4,408
chr1,153880967,153881456,SRX5075170,SMARCA4,489
chr1,153880977,153881383,SRX5716470,SMARCA4,406
chr1,153880998,153881258,SRX5054309,FOSL2,260
chr1,153881005,153881423,SRX5716469,SMARCA4,418
chr1,153881017,153881303,SRX5075169,SMARCA4,286
chr1,153881028,153881300,SRX5054308,FOSL2,272
chr1,153881065,153881271,SRX5020211,SMARCA2,206
chr1,153881833,153882249,SRX5075170,SMARCA4,416
chr1,153881896,153882155,SRX5075168,SMARCA4,259
chr1,153881911,153882185,SRX5075169,SMARCA4,274
chr1,153882000,153882184,SRX5075176,SMARCA4,184
chr1,153899520,153899866,SRX5075168,SMARCA4,346
chr1,153899526,153899859,SRX5075174,SMARCA4,333
chr1,153922990,153923210,SRX5054307,FOSL2,220
chr1,153923029,153923271,SRX5716451,SOX2,242
chr1,153923154,153923636,SRX20140895,INTS13,482
chr1,153946222,153946914,SRX20140895,INTS13,692
chr1,153946311,153946835,SRX5075175,SMARCA4,524
chr1,153946383,153946958,SRX16500062,CTCF,575
chr1,153946389,153947071,SRX16500060,CTCF,682
chr1,153946414,153947103,SRX16500059,CTCF,689
chr1,153946423,153946979,SRX16500061,CTCF,556
chr1,153946431,153946819,SRX5716470,SMARCA4,388
chr1,153946493,153946918,SRX5075168,SMARCA4,425
chr1,153946541,153946909,SRX5075174,SMARCA4,368
chr1,153946542,153946899,SRX5075176,SMARCA4,357
chr1,153946556,153946847,SRX5075170,SMARCA4,291
chr1,153946576,153946861,SRX5075169,SMARCA4,285
chr1,153946671,153946978,SRX4174629,CTCF,307
chr1,153958208,153958793,SRX20140895,INTS13,585
chr1,153958265,153958793,SRX20140868,INTS10,528
chr1,153958315,153958646,SRX20140869,INTS10,331
chr1,153958402,153958650,SRX20140897,INTS13,248
chr1,153958407,153958740,SRX20140867,INTS10,333
chr1,153958443,153958789,SRX5075174,SMARCA4,346
chr1,153958608,153958969,SRX5075168,SMARCA4,361
chr1,153963405,153963672,SRX20140897,INTS13,267
chr1,153963526,153963811,SRX20140895,INTS13,285
chr1,153967054,153967765,SRX20140895,INTS13,711
chr1,153967097,153967515,SRX5075168,SMARCA4,418
chr1,153967109,153967517,SRX5075174,SMARCA4,408
chr1,153967135,153967395,SRX5075170,SMARCA4,260
chr1,153967159,153967704,SRX20140868,INTS10,545
chr1,153967165,153967404,SRX5075175,SMARCA4,239
chr1,153967172,153967492,SRX5075176,SMARCA4,320
chr1,153967191,153967405,SRX20140867,INTS10,214
chr1,153967260,153967636,SRX20140897,INTS13,376
chr1,153967602,153968060,SRX16500060,CTCF,458
chr1,153967681,153968004,SRX16500061,CTCF,323
chr1,153967708,153968073,SRX16500059,CTCF,365
chr1,153967716,153968013,SRX16500062,CTCF,297
chr1,153967730,153967940,SRX5075176,SMARCA4,210
chr1,153967743,153967987,SRX5075174,SMARCA4,244
chr1,153967779,153968018,SRX5075170,SMARCA4,239
chr1,153977307,153977887,SRX20140895,INTS13,580
chr1,153977423,153977930,SRX5075174,SMARCA4,507
chr1,153977455,153977725,SRX20140868,INTS10,270
chr1,153977474,153977687,SRX5075170,SMARCA4,213
chr1,153977474,153977708,SRX20140867,INTS10,234
chr1,153977490,153977771,SRX20140897,INTS13,281
chr1,153977534,153977730,SRX5075168,SMARCA4,196
chr1,153977741,153977972,SRX5075176,SMARCA4,231
chr1,153977812,153978070,SRX5075168,SMARCA4,258
chr1,153985299,153985611,SRX5075170,SMARCA4,312
chr1,153985300,153985673,SRX5075176,SMARCA4,373
chr1,153985307,153985592,SRX5075169,SMARCA4,285
chr1,153985307,153985664,SRX5054309,FOSL2,357
chr1,153985358,153985598,SRX5075175,SMARCA4,240
chr1,153985371,153985591,SRX5075174,SMARCA4,220
chr1,153985378,153985629,SRX5054308,FOSL2,251
chr1,153986255,153986565,SRX5075176,SMARCA4,310
chr1,153986265,153986463,SRX5075168,SMARCA4,198
chr1,153986273,153986509,SRX5075170,SMARCA4,236
chr1,153986287,153986538,SRX5075174,SMARCA4,251
chr1,153986536,153987169,SRX16500059,CTCF,633
chr1,153986585,153987130,SRX16500061,CTCF,545
chr1,153986604,153987007,SRX4174629,CTCF,403
chr1,153986623,153987124,SRX16500060,CTCF,501
chr1,153986668,153987110,SRX16500062,CTCF,442
chr1,153986695,153986922,SRX5075176,SMARCA4,227
chr1,153986772,153986958,SRX5075169,SMARCA4,186
chr1,153986779,153987080,SRX5075168,SMARCA4,301
chr1,153986783,153986997,SRX5075170,SMARCA4,214
chr1,153990399,153991047,SRX20140868,INTS10,648
chr1,153990432,153991179,SRX20140895,INTS13,747
chr1,153990483,153991028,SRX20140867,INTS10,545
chr1,153990509,153991052,SRX20140869,INTS10,543
chr1,153990521,153990996,SRX20140896,INTS13,475
chr1,153990521,153991057,SRX20140897,INTS13,536
chr1,153990528,153990921,SRX5075174,SMARCA4,393
chr1,153990545,153990742,SRX5075168,SMARCA4,197
chr1,153990556,153990725,SRX5075170,SMARCA4,169
chr1,153990574,153991091,SRX20140894,INTS13,517
chr1,153990578,153991099,SRX20140879,CPSF3L,521
chr1,153990590,153991062,SRX20140881,CPSF3L,472
chr1,153990609,153990963,SRX20140882,CPSF3L,354
chr1,153990615,153990805,SRX5054309,FOSL2,190
chr1,153990658,153990990,SRX20140880,CPSF3L,332
chr1,154001674,154002017,SRX5075174,SMARCA4,343
chr1,154001794,154001982,SRX5075168,SMARCA4,188
chr1,154006234,154006414,SRX5075169,SMARCA4,180
chr1,154115255,154115444,SRX5075174,SMARCA4,189
chr1,154129424,154129620,SRX5054309,FOSL2,196
chr1,154145917,154146352,SRX16500062,CTCF,435
chr1,154146014,154146399,SRX16500059,CTCF,385
chr1,154146042,154146395,SRX16500061,CTCF,353
chr1,154146057,154146446,SRX16500060,CTCF,389
chr1,154151375,154151672,SRX5075176,SMARCA4,297
chr1,154151388,154151742,SRX5075170,SMARCA4,354
chr1,154151396,154151639,SRX5716467,SMARCA2,243
chr1,154151407,154151706,SRX5054308,FOSL2,299
chr1,154151418,154151682,SRX5075169,SMARCA4,264
chr1,154151429,154151650,SRX5054309,FOSL2,221
chr1,154151435,154151653,SRX5075175,SMARCA4,218
chr1,154151475,154151709,SRX5020211,SMARCA2,234
chr1,154176400,154176653,SRX5075176,SMARCA4,253
chr1,154182927,154183612,SRX20140895,INTS13,685
chr1,154182964,154183392,SRX20140881,CPSF3L,428
chr1,154182982,154183451,SRX20140869,INTS10,469
chr1,154182991,154183475,SRX20140868,INTS10,484
chr1,154183013,154183420,SRX20140897,INTS13,407
chr1,154183020,154183473,SRX20140867,INTS10,453
chr1,154183109,154183583,SRX20140879,CPSF3L,474
chr1,154183165,154183593,SRX5075174,SMARCA4,428
chr1,154183215,154183553,SRX5075168,SMARCA4,338
chr1,154183216,154183486,SRX5716464,SMARCA4,270
chr1,154183223,154183457,SRX5075176,SMARCA4,234
chr1,154183246,154183547,SRX5075170,SMARCA4,301
chr1,154183278,154183602,SRX5716463,SMARCA4,324
chr1,154183309,154183562,SRX5075175,SMARCA4,253
chr1,154198940,154199438,SRX16500061,CTCF,498
chr1,154198967,154199513,SRX16500060,CTCF,546
chr1,154199007,154199453,SRX16500059,CTCF,446
chr1,154199016,154199427,SRX16500062,CTCF,411
chr1,154199075,154199438,SRX5075168,SMARCA4,363
chr1,154199092,154199390,SRX5075176,SMARCA4,298
chr1,154199101,154199338,SRX5716463,SMARCA4,237
chr1,154199110,154199413,SRX5075170,SMARCA4,303
chr1,154199114,154199405,SRX5716470,SMARCA4,291
chr1,154199151,154199393,SRX5075175,SMARCA4,242
chr1,154199152,154199455,SRX5075169,SMARCA4,303
chr1,154199169,154199355,SRX5075174,SMARCA4,186
chr1,154199173,154199539,SRX4174629,CTCF,366
chr1,154206136,154206616,SRX5075174,SMARCA4,480
chr1,154206164,154206635,SRX5075168,SMARCA4,471
chr1,154206215,154206552,SRX5716451,SOX2,337
chr1,154206244,154206526,SRX5716463,SMARCA4,282
chr1,154206249,154206527,SRX5716454,SOX3,278
chr1,154220260,154220625,SRX20140868,INTS10,365
chr1,154220289,154221034,SRX20140897,INTS13,745
chr1,154220313,154220639,SRX20140867,INTS10,326
chr1,154220315,154220616,SRX20140869,INTS10,301
chr1,154220323,154221259,SRX20140895,INTS13,936
chr1,154220372,154220732,SRX20140894,INTS13,360
chr1,154220406,154221003,SRX20140896,INTS13,597
chr1,154220470,154220952,SRX5075170,SMARCA4,482
chr1,154220492,154220954,SRX5075176,SMARCA4,462
chr1,154220519,154221019,SRX5075174,SMARCA4,500
chr1,154220533,154220964,SRX5716463,SMARCA4,431
chr1,154220546,154220991,SRX5075168,SMARCA4,445
chr1,154220644,154220834,SRX5054309,FOSL2,190
chr1,154220683,154220884,SRX5054307,FOSL2,201
chr1,154220689,154220995,SRX5716464,SMARCA4,306
chr1,154220755,154221072,SRX20140867,INTS10,317
chr1,154272095,154272715,SRX5075168,SMARCA4,620
chr1,154272099,154272839,SRX5075176,SMARCA4,740
chr1,154272125,154272759,SRX5716469,SMARCA4,634
chr1,154272128,154272712,SRX5075170,SMARCA4,584
chr1,154272130,154272632,SRX16500060,CTCF,502
chr1,154272144,154272781,SRX5075174,SMARCA4,637
chr1,154272162,154272568,SRX16500062,CTCF,406
chr1,154272166,154272545,SRX5075175,SMARCA4,379
chr1,154272166,154272698,SRX20140895,INTS13,532
chr1,154272176,154272636,SRX16500059,CTCF,460
chr1,154272177,154272586,SRX16500061,CTCF,409
chr1,154272196,154272582,SRX5716464,SMARCA4,386
chr1,154272205,154272563,SRX4174629,CTCF,358
chr1,154272205,154272985,SRX5075169,SMARCA4,780
chr1,154272227,154272783,SRX5716470,SMARCA4,556
chr1,154272318,154272572,SRX5716463,SMARCA4,254
chr1,154272353,154272586,SRX5054309,FOSL2,233
chr1,154272408,154272618,SRX5054308,FOSL2,210
chr1,154304969,154305274,SRX5075174,SMARCA4,305
chr1,154324547,154325091,SRX16500059,CTCF,544
chr1,154324549,154325008,SRX16500061,CTCF,459
chr1,154324552,154325009,SRX16500062,CTCF,457
chr1,154324555,154325054,SRX16500060,CTCF,499
chr1,154324622,154324875,SRX4174629,CTCF,253
chr1,154324626,154324894,SRX5075174,SMARCA4,268
chr1,154324638,154324843,SRX5075168,SMARCA4,205
chr1,154325409,154325891,SRX20140895,INTS13,482
chr1,154326185,154326644,SRX16500062,CTCF,459
chr1,154326213,154326650,SRX16500060,CTCF,437
chr1,154326238,154326655,SRX16500061,CTCF,417
chr1,154326238,154326669,SRX16500059,CTCF,431
chr1,154326269,154326580,SRX5075168,SMARCA4,311
chr1,154326275,154326555,SRX5075176,SMARCA4,280
chr1,154326294,154326502,SRX5075174,SMARCA4,208
chr1,154326310,154326638,SRX5075170,SMARCA4,328
chr1,154326320,154326578,SRX5716469,SMARCA4,258
chr1,154326777,154326961,SRX5075169,SMARCA4,184
chr1,154328579,154328761,SRX5075168,SMARCA4,182
chr1,154329310,154329494,SRX5075169,SMARCA4,184
chr1,154334831,154335331,SRX5075176,SMARCA4,500
chr1,154334910,154335366,SRX5075170,SMARCA4,456
chr1,154334979,154335508,SRX16500059,CTCF,529
chr1,154335005,154335557,SRX16500060,CTCF,552
chr1,154335011,154335295,SRX5716470,SMARCA4,284
chr1,154335049,154335505,SRX16500062,CTCF,456
chr1,154335061,154335401,SRX5075168,SMARCA4,340
chr1,154335066,154335405,SRX5075174,SMARCA4,339
chr1,154335072,154335414,SRX4174629,CTCF,342
chr1,154335073,154335517,SRX16500061,CTCF,444
chr1,154335133,154335361,SRX5075169,SMARCA4,228
chr1,154335170,154335421,SRX5716463,SMARCA4,251
chr1,154335186,154335428,SRX5075175,SMARCA4,242
chr1,154345195,154345629,SRX16500059,CTCF,434
chr1,154345234,154345545,SRX16500061,CTCF,311
chr1,154345243,154345554,SRX16500062,CTCF,311
chr1,154345253,154345672,SRX16500060,CTCF,419
chr1,154352898,154353335,SRX20140895,INTS13,437
chr1,154352902,154353466,SRX5075168,SMARCA4,564
chr1,154352912,154353465,SRX5075174,SMARCA4,553
chr1,154352917,154353515,SRX5716463,SMARCA4,598
chr1,154352920,154353389,SRX5075176,SMARCA4,469
chr1,154352961,154353297,SRX5716464,SMARCA4,336
chr1,154352989,154353158,SRX5075170,SMARCA4,169
chr1,154352993,154353358,SRX20140881,CPSF3L,365
chr1,154353001,154353320,SRX20140867,INTS10,319
chr1,154353020,154353320,SRX5716470,SMARCA4,300
chr1,154404938,154405311,SRX16500059,CTCF,373
chr1,154405034,154405428,SRX16500060,CTCF,394
chr1,154405089,154405543,SRX5075175,SMARCA4,454
chr1,154405122,154405388,SRX16500062,CTCF,266
chr1,154405131,154405980,SRX5075174,SMARCA4,849
chr1,154405156,154405487,SRX5075168,SMARCA4,331
chr1,154405161,154405519,SRX16500061,CTCF,358
chr1,154405174,154405413,SRX4174629,CTCF,239
chr1,154405179,154405521,SRX5075176,SMARCA4,342
chr1,154405189,154405513,SRX5716470,SMARCA4,324
chr1,154405212,154405505,SRX5716469,SMARCA4,293
chr1,154405219,154405641,SRX5075170,SMARCA4,422
chr1,154405229,154405488,SRX5075169,SMARCA4,259
chr1,154405238,154405465,SRX5054308,FOSL2,227
chr1,154405242,154405572,SRX5054309,FOSL2,330
chr1,154419591,154419989,SRX5075169,SMARCA4,398
chr1,154419593,154419834,SRX5075170,SMARCA4,241
chr1,154419597,154419950,SRX5716470,SMARCA4,353
chr1,154419609,154419810,SRX5075176,SMARCA4,201
chr1,154420195,154420491,SRX5075169,SMARCA4,296
chr1,154420210,154420517,SRX5075176,SMARCA4,307
chr1,154420302,154420530,SRX5054308,FOSL2,228
chr1,154420338,154420516,SRX5075170,SMARCA4,178
chr1,154423485,154424063,SRX5075170,SMARCA4,578
chr1,154423554,154424125,SRX5075174,SMARCA4,571
chr1,154423582,154423896,SRX5054309,FOSL2,314
chr1,154423584,154423955,SRX5075169,SMARCA4,371
chr1,154423592,154424043,SRX5075176,SMARCA4,451
chr1,154423600,154424006,SRX5075175,SMARCA4,406
chr1,154423607,154423986,SRX5716469,SMARCA4,379
chr1,154423648,154424138,SRX5075168,SMARCA4,490
chr1,154423663,154423880,SRX5716470,SMARCA4,217
chr1,154423665,154423857,SRX5054308,FOSL2,192
chr1,154430901,154431300,SRX5075168,SMARCA4,399
chr1,154430925,154431496,SRX5075174,SMARCA4,571
chr1,154431553,154431843,SRX5054309,FOSL2,290
chr1,154431593,154431968,SRX5054308,FOSL2,375
chr1,154442444,154442713,SRX16500060,CTCF,269
chr1,154444949,154445234,SRX5075170,SMARCA4,285
chr1,154444973,154445240,SRX5054308,FOSL2,267
chr1,154445014,154445240,SRX5075169,SMARCA4,226
chr1,154445015,154445220,SRX5075176,SMARCA4,205
chr1,154446191,154446608,SRX5075169,SMARCA4,417
chr1,154446283,154446587,SRX5075176,SMARCA4,304
chr1,154446288,154446522,SRX5054309,FOSL2,234
chr1,154446288,154446548,SRX5075175,SMARCA4,260
chr1,154446305,154446544,SRX5716470,SMARCA4,239
chr1,154446309,154446495,SRX5075170,SMARCA4,186
chr1,154446356,154446580,SRX5716469,SMARCA4,224
chr1,154453505,154453790,SRX5716470,SMARCA4,285
chr1,154453556,154453911,SRX5075176,SMARCA4,355
chr1,154453582,154453780,SRX5075169,SMARCA4,198
chr1,154453585,154453918,SRX5075170,SMARCA4,333
chr1,154459169,154459433,SRX5075176,SMARCA4,264
chr1,154459212,154459423,SRX5716470,SMARCA4,211
chr1,154459228,154459443,SRX5716467,SMARCA2,215
chr1,154459241,154459445,SRX5075170,SMARCA4,204
chr1,154463075,154463572,SRX5075169,SMARCA4,497
chr1,154463077,154463562,SRX5075170,SMARCA4,485
chr1,154463091,154463496,SRX5075175,SMARCA4,405
chr1,154463096,154463423,SRX5716470,SMARCA4,327
chr1,154463099,154463484,SRX5716469,SMARCA4,385
chr1,154463104,154463437,SRX5716467,SMARCA2,333
chr1,154463104,154463474,SRX5054309,FOSL2,370
chr1,154463106,154463378,SRX20140869,INTS10,272
chr1,154463109,154463429,SRX5020211,SMARCA2,320
chr1,154463116,154463446,SRX5054308,FOSL2,330
chr1,154463134,154463545,SRX5075176,SMARCA4,411
chr1,154463150,154463446,SRX5020214,SMARCA2,296
chr1,154463162,154463364,SRX5075168,SMARCA4,202
chr1,154463170,154463369,SRX5075182,SMARCA2,199
chr1,154463172,154463572,SRX5716460,Epitope tags,400
chr1,154463175,154463392,SRX5716468,SMARCA2,217
chr1,154463185,154463418,SRX5075174,SMARCA4,233
chr1,154474800,154475117,SRX5075170,SMARCA4,317
chr1,154474805,154475102,SRX5716469,SMARCA4,297
chr1,154474829,154475152,SRX5075176,SMARCA4,323
chr1,154474843,154475141,SRX5075169,SMARCA4,298
chr1,154474856,154475096,SRX5075175,SMARCA4,240
chr1,154474860,154475121,SRX5054309,FOSL2,261
chr1,154474863,154475076,SRX5716470,SMARCA4,213
chr1,154474922,154475102,SRX5054308,FOSL2,180
chr1,154479705,154480250,SRX16500060,CTCF,545
chr1,154479766,154480191,SRX16500061,CTCF,425
chr1,154479770,154480277,SRX16500059,CTCF,507
chr1,154479808,154480109,SRX5716469,SMARCA4,301
chr1,154479823,154480264,SRX16500062,CTCF,441
chr1,154479828,154480162,SRX5075175,SMARCA4,334
chr1,154479835,154480229,SRX5075168,SMARCA4,394
chr1,154479849,154480140,SRX5075169,SMARCA4,291
chr1,154479851,154480163,SRX5075170,SMARCA4,312
chr1,154479852,154480189,SRX5075174,SMARCA4,337
chr1,154479868,154480156,SRX5075176,SMARCA4,288
chr1,154479870,154480233,SRX4174629,CTCF,363
chr1,154479876,154480112,SRX5716470,SMARCA4,236
chr1,154479885,154480124,SRX5716464,SMARCA4,239
chr1,154479886,154480211,SRX5716463,SMARCA4,325
chr1,154534219,154534615,SRX16500060,CTCF,396
chr1,154534237,154534528,SRX16500062,CTCF,291
chr1,154534241,154534628,SRX16500059,CTCF,387
chr1,154534242,154534622,SRX16500061,CTCF,380
chr1,154534354,154534676,SRX5075174,SMARCA4,322
chr1,154546350,154546812,SRX16500059,CTCF,462
chr1,154546360,154546810,SRX16500061,CTCF,450
chr1,154546389,154546791,SRX16500060,CTCF,402
chr1,154546399,154546701,SRX4174629,CTCF,302
chr1,154546413,154546839,SRX16500062,CTCF,426
chr1,154546453,154546705,SRX5075168,SMARCA4,252
chr1,154546477,154546655,SRX5075174,SMARCA4,178
chr1,154546484,154546671,SRX5075175,SMARCA4,187
chr1,154558556,154559302,SRX20140895,INTS13,746
chr1,154558607,154559123,SRX20140896,INTS13,516
chr1,154558607,154559230,SRX20140897,INTS13,623
chr1,154558625,154559116,SRX5075174,SMARCA4,491
chr1,154558736,154559263,SRX20140894,INTS13,527
chr1,154558739,154558970,SRX5716454,SOX3,231
chr1,154558746,154558936,SRX5716451,SOX2,190
chr1,154558758,154558977,SRX5716463,SMARCA4,219
chr1,154558760,154559171,SRX5075168,SMARCA4,411
chr1,154558799,154559010,SRX5716470,SMARCA4,211
chr1,154558816,154559372,SRX20140868,INTS10,556
chr1,154558831,154559092,SRX5075176,SMARCA4,261
chr1,154558898,154559310,SRX20140867,INTS10,412
chr1,154558938,154559393,SRX20140869,INTS10,455
chr1,154559349,154559954,SRX16500060,CTCF,605
chr1,154559363,154559928,SRX16500059,CTCF,565
chr1,154559399,154559932,SRX16500061,CTCF,533
chr1,154559453,154559902,SRX16500062,CTCF,449
chr1,154559470,154559942,SRX4174629,CTCF,472
chr1,154559548,154559782,SRX5075169,SMARCA4,234
chr1,154559558,154559889,SRX5075170,SMARCA4,331
chr1,154559583,154559831,SRX5075175,SMARCA4,248
chr1,154559587,154559882,SRX5075174,SMARCA4,295
chr1,154559592,154559846,SRX5075168,SMARCA4,254
chr1,154559595,154559824,SRX5075176,SMARCA4,229
chr1,154567674,154568179,SRX5075174,SMARCA4,505
chr1,154567800,154568176,SRX5075168,SMARCA4,376
chr1,154567819,154568157,SRX5075175,SMARCA4,338
chr1,154567820,154568175,SRX5716470,SMARCA4,355
chr1,154567824,154568123,SRX5075170,SMARCA4,299
chr1,154567832,154568171,SRX5716469,SMARCA4,339
chr1,154567836,154568140,SRX5075169,SMARCA4,304
chr1,154567843,154568145,SRX5075176,SMARCA4,302
chr1,154567858,154568116,SRX5716464,SMARCA4,258
chr1,154567885,154568092,SRX5716463,SMARCA4,207
chr1,154607793,154608771,SRX20140895,INTS13,978
chr1,154607848,154608443,SRX20140869,INTS10,595
chr1,154607850,154608539,SRX20140897,INTS13,689
chr1,154607906,154608304,SRX5075175,SMARCA4,398
chr1,154608008,154608490,SRX20140868,INTS10,482
chr1,154608053,154608347,SRX5075169,SMARCA4,294
chr1,154608058,154608321,SRX5075170,SMARCA4,263
chr1,154608147,154608389,SRX5075176,SMARCA4,242
chr1,154608160,154608371,SRX5716470,SMARCA4,211
chr1,154608460,154608704,SRX20140867,INTS10,244
chr1,154608653,154608910,SRX5075168,SMARCA4,257
chr1,154621875,154622177,SRX5075170,SMARCA4,302
chr1,154621885,154622127,SRX5075181,SMARCA2,242
chr1,154621901,154622178,SRX5075176,SMARCA4,277
chr1,154621906,154622100,SRX5075169,SMARCA4,194
chr1,154621916,154622172,SRX5716470,SMARCA4,256
chr1,154627481,154628196,SRX20140895,INTS13,715
chr1,154627625,154628315,SRX20140869,INTS10,690
chr1,154627732,154628049,SRX20140867,INTS10,317
chr1,154627782,154628230,SRX20140897,INTS13,448
chr1,154627788,154628200,SRX20140868,INTS10,412
chr1,154627796,154628148,SRX5716464,SMARCA4,352
chr1,154627881,154628244,SRX5075174,SMARCA4,363
chr1,154627923,154628156,SRX5716451,SOX2,233
chr1,154627938,154628250,SRX5075168,SMARCA4,312
chr1,154627965,154628189,SRX5075176,SMARCA4,224
chr1,154664093,154664301,SRX5054309,FOSL2,208
chr1,154669603,154670083,SRX4174629,CTCF,480
chr1,154669609,154670070,SRX16500060,CTCF,461
chr1,154669630,154670101,SRX16500059,CTCF,471
chr1,154669631,154670077,SRX16500061,CTCF,446
chr1,154669633,154670053,SRX16500062,CTCF,420
chr1,154669816,154670014,SRX5075168,SMARCA4,198
chr1,154669883,154670059,SRX5075174,SMARCA4,176
chr1,154696117,154696375,SRX16500060,CTCF,258
chr1,154697690,154698029,SRX5075176,SMARCA4,339
chr1,154697729,154698036,SRX5075170,SMARCA4,307
chr1,154697730,154698079,SRX5054308,FOSL2,349
chr1,154697749,154698061,SRX5054309,FOSL2,312
chr1,154697789,154698016,SRX5075169,SMARCA4,227
chr1,154698271,154698521,SRX20140867,INTS10,250
chr1,154698273,154698523,SRX5716463,SMARCA4,250
chr1,154698287,154698498,SRX5075168,SMARCA4,211
chr1,154698296,154698493,SRX5075174,SMARCA4,197
chr1,154703271,154703515,SRX5075170,SMARCA4,244
chr1,154703281,154703532,SRX5075169,SMARCA4,251
chr1,154729131,154729362,SRX5054309,FOSL2,231
chr1,154729137,154729374,SRX5075176,SMARCA4,237
chr1,154729178,154729383,SRX5075170,SMARCA4,205
chr1,154730223,154730690,SRX5075169,SMARCA4,467
chr1,154730255,154730554,SRX5716469,SMARCA4,299
chr1,154730329,154730591,SRX5054308,FOSL2,262
chr1,154730331,154730597,SRX5075170,SMARCA4,266
chr1,154730357,154730653,SRX5075175,SMARCA4,296
chr1,154730406,154730646,SRX5075174,SMARCA4,240
chr1,154751704,154751957,SRX5075174,SMARCA4,253
chr1,154751818,154751994,SRX5075170,SMARCA4,176
chr1,154760354,154760900,SRX16500061,CTCF,546
chr1,154760358,154760910,SRX16500059,CTCF,552
chr1,154760367,154760842,SRX16500062,CTCF,475
chr1,154760390,154760863,SRX16500060,CTCF,473
chr1,154767606,154767786,SRX5075169,SMARCA4,180
chr1,154767706,154767918,SRX5075176,SMARCA4,212
chr1,154775725,154776015,SRX5075174,SMARCA4,290
chr1,154775775,154776030,SRX5075168,SMARCA4,255
chr1,154775832,154776146,SRX20140895,INTS13,314
chr1,154791659,154791979,SRX5075175,SMARCA4,320
chr1,154791690,154791964,SRX5075170,SMARCA4,274
chr1,154791715,154791945,SRX5075169,SMARCA4,230
chr1,154791717,154791950,SRX5075176,SMARCA4,233
chr1,154813294,154813579,SRX5075168,SMARCA4,285
chr1,154819601,154820045,SRX16500059,CTCF,444
chr1,154819661,154819943,SRX16500061,CTCF,282
chr1,154819662,154820022,SRX16500062,CTCF,360
chr1,154819676,154819994,SRX16500060,CTCF,318
chr1,154840486,154840895,SRX5075168,SMARCA4,409
chr1,154840521,154840915,SRX5075174,SMARCA4,394
chr1,154840547,154840805,SRX5075170,SMARCA4,258
chr1,154840548,154840852,SRX5075176,SMARCA4,304
chr1,154847921,154848204,SRX5075170,SMARCA4,283
chr1,154848006,154848181,SRX5075176,SMARCA4,175
chr1,154849615,154849803,SRX5054308,FOSL2,188
chr1,154849651,154849865,SRX5075176,SMARCA4,214
chr1,154849686,154849903,SRX5054309,FOSL2,217
chr1,154849688,154849886,SRX5075168,SMARCA4,198
chr1,154863545,154864037,SRX16500059,CTCF,492
chr1,154863550,154864032,SRX16500061,CTCF,482
chr1,154863578,154864052,SRX16500060,CTCF,474
chr1,154863594,154864059,SRX16500062,CTCF,465
chr1,154863663,154863842,SRX5075168,SMARCA4,179
chr1,154863682,154863906,SRX5075174,SMARCA4,224
chr1,154863721,154863902,SRX5075176,SMARCA4,181
chr1,154867136,154867398,SRX5075170,SMARCA4,262
chr1,154867166,154867464,SRX5075176,SMARCA4,298
chr1,154867188,154867391,SRX5075169,SMARCA4,203
chr1,154867205,154867480,SRX5075175,SMARCA4,275
chr1,154867215,154867427,SRX5716469,SMARCA4,212
chr1,154867225,154867427,SRX5054309,FOSL2,202
chr1,154869950,154870423,SRX20140895,INTS13,473
chr1,154870017,154870506,SRX5716463,SMARCA4,489
chr1,154870060,154870565,SRX5075174,SMARCA4,505
chr1,154870081,154870561,SRX5075168,SMARCA4,480
chr1,154870173,154870363,SRX5716451,SOX2,190
chr1,154870211,154870439,SRX5075176,SMARCA4,228
chr1,154870226,154870480,SRX5075170,SMARCA4,254
chr1,154870295,154870488,SRX5054307,FOSL2,193
chr1,154878427,154878919,SRX16500061,CTCF,492
chr1,154878427,154879002,SRX16500059,CTCF,575
chr1,154878445,154878933,SRX16500060,CTCF,488
chr1,154878451,154878926,SRX16500062,CTCF,475
chr1,154878464,154878762,SRX5075168,SMARCA4,298
chr1,154878466,154878929,SRX4174629,CTCF,463
chr1,154878527,154878810,SRX5075174,SMARCA4,283
chr1,154878598,154878774,SRX5075170,SMARCA4,176
chr1,154895826,154896296,SRX5075170,SMARCA4,470
chr1,154895850,154896265,SRX5075176,SMARCA4,415
chr1,154895901,154896106,SRX5075169,SMARCA4,205
chr1,154895922,154896192,SRX5716470,SMARCA4,270
chr1,154895928,154896184,SRX5075175,SMARCA4,256
chr1,154895942,154896145,SRX5020211,SMARCA2,203
chr1,154895965,154896187,SRX5716467,SMARCA2,222
chr1,154895968,154896211,SRX5716468,SMARCA2,243
chr1,154895996,154896269,SRX5716469,SMARCA4,273
chr1,154936311,154937028,SRX20140895,INTS13,717
chr1,154936418,154936906,SRX20140897,INTS13,488
chr1,154936423,154936774,SRX5075168,SMARCA4,351
chr1,154936476,154936795,SRX5075176,SMARCA4,319
chr1,154936499,154936921,SRX5075169,SMARCA4,422
chr1,154936505,154936784,SRX5075170,SMARCA4,279
chr1,154936512,154936778,SRX20140879,CPSF3L,266
chr1,154936522,154936943,SRX5075174,SMARCA4,421
chr1,154936538,154936943,SRX20140896,INTS13,405
chr1,154936550,154936941,SRX20140867,INTS10,391
chr1,154936567,154936759,SRX5075175,SMARCA4,192
chr1,154936578,154936910,SRX20140868,INTS10,332
chr1,154937099,154937418,SRX5716451,SOX2,319
chr1,154937342,154937535,SRX5075174,SMARCA4,193
chr1,154937365,154937870,SRX5075176,SMARCA4,505
chr1,154937373,154937738,SRX5075169,SMARCA4,365
chr1,154937373,154937815,SRX5075170,SMARCA4,442
chr1,154937374,154937836,SRX5716470,SMARCA4,462
chr1,154937387,154937618,SRX5716469,SMARCA4,231
chr1,154937510,154937764,SRX5075175,SMARCA4,254
chr1,154941319,154941784,SRX5075174,SMARCA4,465
chr1,154941324,154941817,SRX5075168,SMARCA4,493
chr1,154941397,154941778,SRX5716463,SMARCA4,381
chr1,154941399,154941748,SRX5716464,SMARCA4,349
chr1,154943657,154944136,SRX16500061,CTCF,479
chr1,154943677,154944114,SRX4174629,CTCF,437
chr1,154943689,154944190,SRX16500059,CTCF,501
chr1,154943709,154944174,SRX16500062,CTCF,465
chr1,154943710,154944178,SRX16500060,CTCF,468
chr1,154943896,154944086,SRX5075175,SMARCA4,190
chr1,154955146,154955755,SRX5075168,SMARCA4,609
chr1,154955181,154955968,SRX5075174,SMARCA4,787
chr1,154955533,154956090,SRX5075176,SMARCA4,557
chr1,154955607,154956022,SRX16500059,CTCF,415
chr1,154955640,154955944,SRX16500060,CTCF,304
chr1,154955699,154955931,SRX16500062,CTCF,232
chr1,154955711,154955957,SRX16500061,CTCF,246
chr1,154955729,154956132,SRX5075170,SMARCA4,403
chr1,154955742,154956021,SRX5716469,SMARCA4,279
chr1,154955755,154955975,SRX5716470,SMARCA4,220
chr1,154955768,154956347,SRX20140895,INTS13,579
chr1,154955773,154956012,SRX5075175,SMARCA4,239
chr1,154955809,154956019,SRX4174629,CTCF,210
chr1,154955935,154956212,SRX5075168,SMARCA4,277
chr1,154956081,154956262,SRX5075174,SMARCA4,181
chr1,154961410,154962308,SRX20140895,INTS13,898
chr1,154961430,154962136,SRX5075174,SMARCA4,706
chr1,154961457,154961867,SRX20140879,CPSF3L,410
chr1,154961546,154962345,SRX20140868,INTS10,799
chr1,154961645,154962003,SRX5075170,SMARCA4,358
chr1,154961711,154962236,SRX16500059,CTCF,525
chr1,154961736,154961993,SRX5716463,SMARCA4,257
chr1,154961758,154962018,SRX5075168,SMARCA4,260
chr1,154961776,154962090,SRX16500061,CTCF,314
chr1,154961781,154962079,SRX16500062,CTCF,298
chr1,154961804,154962113,SRX5075169,SMARCA4,309
chr1,154961804,154962200,SRX16500060,CTCF,396
chr1,154961811,154962168,SRX5075176,SMARCA4,357
chr1,154961823,154962121,SRX5075175,SMARCA4,298
chr1,154961838,154962085,SRX20140867,INTS10,247
chr1,154970704,154970998,SRX5075174,SMARCA4,294
chr1,154970709,154971061,SRX5075168,SMARCA4,352
chr1,154970710,154971056,SRX5054309,FOSL2,346
chr1,154970728,154970995,SRX5054308,FOSL2,267
chr1,154970734,154971010,SRX5054307,FOSL2,276
chr1,154970737,154971297,SRX5075176,SMARCA4,560
chr1,154970741,154970989,SRX5075169,SMARCA4,248
chr1,154970822,154971392,SRX5075170,SMARCA4,570
chr1,154972594,154972886,SRX5075168,SMARCA4,292
chr1,154972596,154972873,SRX5716470,SMARCA4,277
chr1,154972602,154972850,SRX5075174,SMARCA4,248
chr1,154972604,154972943,SRX5075176,SMARCA4,339
chr1,154972627,154972899,SRX5075170,SMARCA4,272
chr1,154972672,154972910,SRX5075169,SMARCA4,238
chr1,154972697,154972916,SRX5716469,SMARCA4,219
chr1,154973463,154973712,SRX16500062,CTCF,249
chr1,154973685,154973986,SRX5075174,SMARCA4,301
chr1,154974176,154974424,SRX5054308,FOSL2,248
chr1,154974203,154974501,SRX5054309,FOSL2,298
chr1,154974343,154974660,SRX5716454,SOX3,317
chr1,154974347,154974876,SRX20140895,INTS13,529
chr1,154974415,154974674,SRX5716451,SOX2,259
chr1,154974616,154974905,SRX20140867,INTS10,289
chr1,154982907,154983089,SRX5075168,SMARCA4,182
chr1,154982936,154983538,SRX5075174,SMARCA4,602
chr1,154982991,154983620,SRX20140895,INTS13,629
chr1,154983056,154983327,SRX5716451,SOX2,271
chr1,154983083,154983434,SRX20140869,INTS10,351
chr1,154983113,154983345,SRX5716454,SOX3,232
chr1,154983123,154983432,SRX20140897,INTS13,309
chr1,154983152,154983340,SRX5075168,SMARCA4,188
chr1,154983172,154983355,SRX5054307,FOSL2,183
chr1,154993372,154993552,SRX5075169,SMARCA4,180
chr1,154999014,154999522,SRX16500060,CTCF,508
chr1,154999022,154999518,SRX16500062,CTCF,496
chr1,154999090,154999503,SRX4174629,CTCF,413
chr1,154999090,154999647,SRX16500059,CTCF,557
chr1,154999091,154999574,SRX16500061,CTCF,483
chr1,154999108,154999321,SRX5075174,SMARCA4,213
chr1,154999148,154999398,SRX5075168,SMARCA4,250
chr1,154999159,154999353,SRX5075176,SMARCA4,194
chr1,155000785,155001192,SRX5075169,SMARCA4,407
chr1,155000794,155001078,SRX20140879,CPSF3L,284
chr1,155000795,155001151,SRX5075170,SMARCA4,356
chr1,155000810,155001073,SRX5075174,SMARCA4,263
chr1,155000816,155001077,SRX20140868,INTS10,261
chr1,155000829,155001166,SRX5054309,FOSL2,337
chr1,155000845,155001196,SRX5054308,FOSL2,351
chr1,155000855,155001187,SRX20140895,INTS13,332
chr1,155000869,155001121,SRX5075168,SMARCA4,252
chr1,155000881,155001080,SRX5075175,SMARCA4,199
chr1,155000907,155001138,SRX5716469,SMARCA4,231
chr1,155002090,155002299,SRX5054307,FOSL2,209
chr1,155017139,155017810,SRX5075170,SMARCA4,671
chr1,155017142,155017634,SRX5054308,FOSL2,492
chr1,155017154,155017683,SRX5054309,FOSL2,529
chr1,155017160,155017739,SRX5075169,SMARCA4,579
chr1,155017160,155017799,SRX5075175,SMARCA4,639
chr1,155017165,155017849,SRX5075174,SMARCA4,684
chr1,155017170,155017922,SRX5075168,SMARCA4,752
chr1,155017180,155017853,SRX5075176,SMARCA4,673
chr1,155017260,155017571,SRX5716468,SMARCA2,311
chr1,155017292,155017728,SRX5716469,SMARCA4,436
chr1,155017292,155017934,SRX16500062,CTCF,642
chr1,155017322,155017995,SRX4174629,CTCF,673
chr1,155017348,155017965,SRX16500059,CTCF,617
chr1,155017380,155017806,SRX5716470,SMARCA4,426
chr1,155017389,155017994,SRX16500060,CTCF,605
chr1,155017403,155017698,SRX5716467,SMARCA2,295
chr1,155017420,155017978,SRX16500061,CTCF,558
chr1,155017455,155017805,SRX20140895,INTS13,350
chr1,155017470,155017692,SRX20140867,INTS10,222
chr1,155044863,155045195,SRX5075170,SMARCA4,332
chr1,155044892,155045198,SRX5075174,SMARCA4,306
chr1,155044907,155045231,SRX5075168,SMARCA4,324
chr1,155044915,155045313,SRX16500059,CTCF,398
chr1,155044932,155045264,SRX16500062,CTCF,332
chr1,155044936,155045396,SRX16500060,CTCF,460
chr1,155044939,155045256,SRX16500061,CTCF,317
chr1,155044947,155045141,SRX5075169,SMARCA4,194
chr1,155044974,155045236,SRX5075176,SMARCA4,262
chr1,155050354,155050897,SRX16500059,CTCF,543
chr1,155050375,155050944,SRX16500061,CTCF,569
chr1,155050380,155050969,SRX16500060,CTCF,589
chr1,155050382,155050741,SRX5075174,SMARCA4,359
chr1,155050416,155050767,SRX5075168,SMARCA4,351
chr1,155050424,155050895,SRX16500062,CTCF,471
chr1,155050431,155050795,SRX5075176,SMARCA4,364
chr1,155050451,155050785,SRX5075175,SMARCA4,334
chr1,155050460,155050800,SRX5716463,SMARCA4,340
chr1,155050462,155050737,SRX4174629,CTCF,275
chr1,155050471,155050742,SRX5716470,SMARCA4,271
chr1,155050474,155050953,SRX5075169,SMARCA4,479
chr1,155050485,155051493,SRX20140895,INTS13,1008
chr1,155050486,155050780,SRX5075170,SMARCA4,294
chr1,155050581,155050838,SRX5716469,SMARCA4,257
chr1,155050960,155051440,SRX20140867,INTS10,480
chr1,155051003,155051488,SRX5075174,SMARCA4,485
chr1,155051012,155051192,SRX5075169,SMARCA4,180
chr1,155051048,155051478,SRX5075168,SMARCA4,430
chr1,155051058,155051311,SRX5075175,SMARCA4,253
chr1,155051070,155051429,SRX5075170,SMARCA4,359
chr1,155051084,155051430,SRX5075176,SMARCA4,346
chr1,155061434,155061978,SRX16500059,CTCF,544
chr1,155061445,155061982,SRX16500060,CTCF,537
chr1,155061460,155061970,SRX16500061,CTCF,510
chr1,155061470,155061918,SRX16500062,CTCF,448
chr1,155061551,155061977,SRX4174629,CTCF,426
chr1,155061554,155061832,SRX5075170,SMARCA4,278
chr1,155061604,155061794,SRX5075176,SMARCA4,190
chr1,155061643,155061873,SRX5075169,SMARCA4,230
chr1,155062217,155062459,SRX16500060,CTCF,242
chr1,155062467,155063070,SRX16500059,CTCF,603
chr1,155062543,155063014,SRX16500060,CTCF,471
chr1,155062583,155062889,SRX4174629,CTCF,306
chr1,155062596,155063029,SRX16500061,CTCF,433
chr1,155062610,155063026,SRX16500062,CTCF,416
chr1,155062703,155063005,SRX5075174,SMARCA4,302
chr1,155062757,155062936,SRX5075168,SMARCA4,179
chr1,155063532,155063930,SRX5075174,SMARCA4,398
chr1,155063656,155064152,SRX20140867,INTS10,496
chr1,155063670,155064380,SRX20140895,INTS13,710
chr1,155063681,155064074,SRX5075168,SMARCA4,393
chr1,155063815,155064216,SRX5075175,SMARCA4,401
chr1,155063989,155064218,SRX5075170,SMARCA4,229
chr1,155070831,155071416,SRX16500059,CTCF,585
chr1,155070849,155071263,SRX5075174,SMARCA4,414
chr1,155070851,155071262,SRX5075168,SMARCA4,411
chr1,155070867,155071228,SRX5716463,SMARCA4,361
chr1,155070902,155071336,SRX16500061,CTCF,434
chr1,155070906,155071271,SRX5716470,SMARCA4,365
chr1,155070913,155071370,SRX16500062,CTCF,457
chr1,155070918,155071352,SRX16500060,CTCF,434
chr1,155070972,155071160,SRX5075170,SMARCA4,188
chr1,155071001,155071206,SRX5075176,SMARCA4,205
chr1,155078631,155078834,SRX5075176,SMARCA4,203
chr1,155078634,155078912,SRX5075174,SMARCA4,278
chr1,155078638,155078916,SRX5075168,SMARCA4,278
chr1,155078644,155078857,SRX5075170,SMARCA4,213
chr1,155078648,155078835,SRX5075175,SMARCA4,187
chr1,155080699,155081341,SRX20140895,INTS13,642
chr1,155080853,155081282,SRX20140894,INTS13,429
chr1,155080879,155081281,SRX20140896,INTS13,402
chr1,155080890,155081285,SRX20140897,INTS13,395
chr1,155084629,155085097,SRX5075168,SMARCA4,468
chr1,155084632,155085097,SRX16500060,CTCF,465
chr1,155084645,155085082,SRX5075174,SMARCA4,437
chr1,155084662,155085141,SRX16500059,CTCF,479
chr1,155084666,155084915,SRX5716454,SOX3,249
chr1,155084666,155085006,SRX4174629,CTCF,340
chr1,155084673,155085094,SRX16500062,CTCF,421
chr1,155084696,155085080,SRX16500061,CTCF,384
chr1,155084722,155085161,SRX5075176,SMARCA4,439
chr1,155084723,155084904,SRX5075169,SMARCA4,181
chr1,155084726,155084992,SRX5075170,SMARCA4,266
chr1,155084727,155085035,SRX5716464,SMARCA4,308
chr1,155084736,155084960,SRX5075175,SMARCA4,224
chr1,155084749,155085090,SRX5716470,SMARCA4,341
chr1,155084820,155085086,SRX20140869,INTS10,266
chr1,155085949,155086448,SRX16500062,CTCF,499
chr1,155085970,155086477,SRX16500061,CTCF,507
chr1,155085978,155086474,SRX16500059,CTCF,496
chr1,155086006,155086459,SRX16500060,CTCF,453
chr1,155086156,155086389,SRX4174629,CTCF,233
chr1,155091361,155091879,SRX16500059,CTCF,518
chr1,155091363,155091865,SRX16500061,CTCF,502
chr1,155091365,155091850,SRX16500060,CTCF,485
chr1,155091368,155091859,SRX16500062,CTCF,491
chr1,155091378,155091711,SRX20140895,INTS13,333
chr1,155091399,155091768,SRX5075174,SMARCA4,369
chr1,155091457,155091720,SRX5075168,SMARCA4,263
chr1,155091462,155091765,SRX4174629,CTCF,303
chr1,155091464,155091738,SRX5075170,SMARCA4,274
chr1,155091476,155091714,SRX5716463,SMARCA4,238
chr1,155094462,155094640,SRX5075170,SMARCA4,178
chr1,155094566,155094754,SRX5075176,SMARCA4,188
chr1,155127664,155127927,SRX5075176,SMARCA4,263
chr1,155127719,155127901,SRX5075169,SMARCA4,182
chr1,155134955,155135319,SRX5716470,SMARCA4,364
chr1,155135008,155135264,SRX5716469,SMARCA4,256
chr1,155135034,155135310,SRX5075169,SMARCA4,276
chr1,155135038,155135325,SRX5075170,SMARCA4,287
chr1,155135053,155135284,SRX5054309,FOSL2,231
chr1,155135075,155135250,SRX5075176,SMARCA4,175
chr1,155135076,155135313,SRX5054308,FOSL2,237
chr1,155135466,155135762,SRX20140897,INTS13,296
chr1,155135554,155135964,SRX5075168,SMARCA4,410
chr1,155135555,155136086,SRX5075174,SMARCA4,531
chr1,155135559,155135934,SRX5075176,SMARCA4,375
chr1,155135576,155136122,SRX20140895,INTS13,546
chr1,155135598,155135978,SRX5716464,SMARCA4,380
chr1,155135727,155136020,SRX5075170,SMARCA4,293
chr1,155135832,155136046,SRX20140867,INTS10,214
chr1,155167329,155168246,SRX16500060,CTCF,917
chr1,155167330,155168260,SRX16500061,CTCF,930
chr1,155167367,155168251,SRX16500062,CTCF,884
chr1,155167372,155168264,SRX16500059,CTCF,892
chr1,155167594,155168138,SRX4174629,CTCF,544
chr1,155167657,155168020,SRX5054309,FOSL2,363
chr1,155167660,155167869,SRX5054308,FOSL2,209
chr1,155167732,155168147,SRX5075170,SMARCA4,415
chr1,155167743,155168116,SRX5075169,SMARCA4,373
chr1,155167841,155168144,SRX5075174,SMARCA4,303
chr1,155167846,155168060,SRX5716469,SMARCA4,214
chr1,155167856,155168053,SRX5075175,SMARCA4,197
chr1,155167894,155168139,SRX5075168,SMARCA4,245
chr1,155173052,155173327,SRX20140897,INTS13,275
chr1,155173094,155173455,SRX20140895,INTS13,361
chr1,155173101,155173485,SRX5075176,SMARCA4,384
chr1,155173165,155173523,SRX5075168,SMARCA4,358
chr1,155173184,155173608,SRX16500059,CTCF,424
chr1,155173185,155173644,SRX16500060,CTCF,459
chr1,155173189,155173614,SRX16500061,CTCF,425
chr1,155173212,155173622,SRX16500062,CTCF,410
chr1,155173226,155173456,SRX5716464,SMARCA4,230
chr1,155173230,155173524,SRX5075174,SMARCA4,294
chr1,155173233,155173523,SRX5075170,SMARCA4,290
chr1,155173242,155173489,SRX4174629,CTCF,247
chr1,155176501,155176989,SRX16500061,CTCF,488
chr1,155176507,155176992,SRX16500060,CTCF,485
chr1,155176529,155176987,SRX16500059,CTCF,458
chr1,155176633,155177007,SRX16500062,CTCF,374
chr1,155176657,155176934,SRX5075174,SMARCA4,277
chr1,155176660,155176915,SRX4174629,CTCF,255
chr1,155176687,155176922,SRX5075176,SMARCA4,235
chr1,155176690,155176945,SRX5075170,SMARCA4,255
chr1,155176724,155176925,SRX5075169,SMARCA4,201
chr1,155176729,155176909,SRX5075168,SMARCA4,180
chr1,155193315,155193910,SRX16500061,CTCF,595
chr1,155193333,155194004,SRX16500059,CTCF,671
chr1,155193359,155193904,SRX16500060,CTCF,545
chr1,155193385,155193936,SRX16500062,CTCF,551
chr1,155193392,155193629,SRX5075169,SMARCA4,237
chr1,155193399,155193831,SRX4174629,CTCF,432
chr1,155193418,155193895,SRX5716470,SMARCA4,477
chr1,155193439,155193822,SRX5075170,SMARCA4,383
chr1,155193444,155193711,SRX5716469,SMARCA4,267
chr1,155193444,155193793,SRX5075176,SMARCA4,349
chr1,155193497,155193695,SRX5075174,SMARCA4,198
chr1,155193559,155193843,SRX5075175,SMARCA4,284
chr1,155194490,155195322,SRX20140895,INTS13,832
chr1,155194558,155195016,SRX5075168,SMARCA4,458
chr1,155194576,155195249,SRX20140868,INTS10,673
chr1,155194577,155195018,SRX5075174,SMARCA4,441
chr1,155194584,155194925,SRX5075176,SMARCA4,341
chr1,155194597,155195046,SRX5075170,SMARCA4,449
chr1,155194608,155195187,SRX20140867,INTS10,579
chr1,155194649,155195005,SRX5716463,SMARCA4,356
chr1,155194651,155194910,SRX5716469,SMARCA4,259
chr1,155194654,155194868,SRX5075175,SMARCA4,214
chr1,155194662,155194876,SRX5054309,FOSL2,214
chr1,155194685,155194952,SRX5716464,SMARCA4,267
chr1,155194712,155195032,SRX5716451,SOX2,320
chr1,155194718,155194946,SRX5716468,SMARCA2,228
chr1,155194743,155195216,SRX20140879,CPSF3L,473
chr1,155194774,155194986,SRX5716454,SOX3,212
chr1,155194796,155195185,SRX20140897,INTS13,389
chr1,155194797,155195237,SRX20140894,INTS13,440
chr1,155194838,155195207,SRX20140881,CPSF3L,369
chr1,155196125,155196406,SRX20140895,INTS13,281
chr1,155196138,155196609,SRX5075174,SMARCA4,471
chr1,155196194,155196617,SRX5075168,SMARCA4,423
chr1,155196253,155196525,SRX5716451,SOX2,272
chr1,155196266,155196483,SRX5716464,SMARCA4,217
chr1,155196272,155196553,SRX5716454,SOX3,281
chr1,155196301,155196569,SRX20140867,INTS10,268
chr1,155196322,155196616,SRX5716463,SMARCA4,294
chr1,155206737,155207229,SRX16500059,CTCF,492
chr1,155206758,155207276,SRX16500060,CTCF,518
chr1,155206766,155207208,SRX16500062,CTCF,442
chr1,155206778,155207241,SRX16500061,CTCF,463
chr1,155206921,155207280,SRX4174629,CTCF,359
chr1,155208460,155208839,SRX5075168,SMARCA4,379
chr1,155208492,155208904,SRX5075170,SMARCA4,412
chr1,155208502,155208959,SRX5075174,SMARCA4,457
chr1,155208513,155208926,SRX5075176,SMARCA4,413
chr1,155208560,155208921,SRX5075175,SMARCA4,361
chr1,155208575,155209180,SRX5716469,SMARCA4,605
chr1,155208592,155209219,SRX5716470,SMARCA4,627
chr1,155208627,155209486,SRX20140895,INTS13,859
chr1,155208683,155208900,SRX5075169,SMARCA4,217
chr1,155208764,155209022,SRX20140897,INTS13,258
chr1,155208764,155209281,SRX20140869,INTS10,517
chr1,155208877,155209273,SRX20140868,INTS10,396
chr1,155208962,155209224,SRX5075169,SMARCA4,262
chr1,155209043,155209222,SRX5075170,SMARCA4,179
chr1,155209066,155209310,SRX20140897,INTS13,244
chr1,155218788,155219300,SRX20140895,INTS13,512
chr1,155218831,155219278,SRX20140897,INTS13,447
chr1,155224711,155225003,SRX5054308,FOSL2,292
chr1,155224720,155225032,SRX5054309,FOSL2,312
chr1,155224776,155224960,SRX5075169,SMARCA4,184
chr1,155226560,155227071,SRX16500061,CTCF,511
chr1,155226572,155227057,SRX16500059,CTCF,485
chr1,155226603,155226966,SRX16500062,CTCF,363
chr1,155226617,155227007,SRX5075176,SMARCA4,390
chr1,155226623,155227125,SRX16500060,CTCF,502
chr1,155226624,155226836,SRX5716469,SMARCA4,212
chr1,155226625,155226845,SRX5075174,SMARCA4,220
chr1,155226649,155226845,SRX5075170,SMARCA4,196
chr1,155226660,155226897,SRX5075175,SMARCA4,237
chr1,155226670,155226910,SRX4174629,CTCF,240
chr1,155226873,155227747,SRX20140895,INTS13,874
chr1,155226916,155227182,SRX20140894,INTS13,266
chr1,155226957,155227682,SRX20140867,INTS10,725
chr1,155226984,155227625,SRX20140881,CPSF3L,641
chr1,155227081,155227573,SRX20140868,INTS10,492
chr1,155227160,155227613,SRX5075174,SMARCA4,453
chr1,155227182,155227609,SRX20140879,CPSF3L,427
chr1,155227232,155227567,SRX5075169,SMARCA4,335
chr1,155227256,155227494,SRX5716470,SMARCA4,238
chr1,155227274,155227607,SRX20140869,INTS10,333
chr1,155227299,155227503,SRX5075175,SMARCA4,204
chr1,155227342,155227620,SRX5075168,SMARCA4,278
chr1,155227355,155227585,SRX5075176,SMARCA4,230
chr1,155227363,155227615,SRX5075170,SMARCA4,252
chr1,155227370,155227697,SRX5716454,SOX3,327
chr1,155227487,155227781,SRX5716451,SOX2,294
chr1,155227505,155227684,SRX5054307,FOSL2,179
chr1,155227690,155228037,SRX5075174,SMARCA4,347
chr1,155227774,155228002,SRX5075168,SMARCA4,228
chr1,155232405,155232633,SRX5075175,SMARCA4,228
chr1,155232409,155232767,SRX5716470,SMARCA4,358
chr1,155232410,155232713,SRX5075176,SMARCA4,303
chr1,155232437,155232702,SRX5716468,SMARCA2,265
chr1,155232449,155232697,SRX5075170,SMARCA4,248
chr1,155232491,155232717,SRX5075169,SMARCA4,226
chr1,155241032,155241535,SRX20140895,INTS13,503
chr1,155241062,155241518,SRX20140897,INTS13,456
chr1,155241095,155241403,SRX20140896,INTS13,308
chr1,155244278,155244636,SRX16500061,CTCF,358
chr1,155244368,155245006,SRX20140868,INTS10,638
chr1,155244380,155245094,SRX5075176,SMARCA4,714
chr1,155244393,155244914,SRX5716470,SMARCA4,521
chr1,155244404,155245249,SRX5075168,SMARCA4,845
chr1,155244408,155244989,SRX20140879,CPSF3L,581
chr1,155244413,155244908,SRX5075175,SMARCA4,495
chr1,155244417,155244978,SRX5075170,SMARCA4,561
chr1,155244417,155245053,SRX20140895,INTS13,636
chr1,155244422,155245244,SRX5075174,SMARCA4,822
chr1,155244455,155244962,SRX5716469,SMARCA4,507
chr1,155244515,155244877,SRX5075181,SMARCA2,362
chr1,155244520,155245065,SRX5075169,SMARCA4,545
chr1,155244591,155244828,SRX5716453,SOX2,237
chr1,155244592,155245048,SRX20140881,CPSF3L,456
chr1,155244618,155244847,SRX5716463,SMARCA4,229
chr1,155244628,155244987,SRX20140894,INTS13,359
chr1,155244632,155245085,SRX20140867,INTS10,453
chr1,155244644,155244966,SRX5716454,SOX3,322
chr1,155244668,155244904,SRX5716451,SOX2,236
chr1,155244686,155244957,SRX20140860,SOX2,271
chr1,155244707,155245015,SRX5716464,SMARCA4,308
chr1,155244709,155245005,SRX20140869,INTS10,296
chr1,155250506,155251101,SRX16500061,CTCF,595
chr1,155250553,155251157,SRX16500059,CTCF,604
chr1,155250577,155251139,SRX16500060,CTCF,562
chr1,155250581,155251104,SRX16500062,CTCF,523
chr1,155250616,155251159,SRX4174629,CTCF,543
chr1,155250668,155251042,SRX5075174,SMARCA4,374
chr1,155250676,155251014,SRX5075176,SMARCA4,338
chr1,155250676,155251055,SRX5075168,SMARCA4,379
chr1,155250695,155250959,SRX5716464,SMARCA4,264
chr1,155250697,155251032,SRX5075170,SMARCA4,335
chr1,155250719,155250978,SRX5716463,SMARCA4,259
chr1,155250742,155250984,SRX5075169,SMARCA4,242
chr1,155250744,155251000,SRX5716470,SMARCA4,256
chr1,155250746,155251008,SRX5075175,SMARCA4,262
chr1,155255220,155255648,SRX20140895,INTS13,428
chr1,155255319,155255625,SRX5075168,SMARCA4,306
chr1,155255341,155255665,SRX5075174,SMARCA4,324
chr1,155255384,155255577,SRX5075170,SMARCA4,193
chr1,155261928,155262388,SRX20140867,INTS10,460
chr1,155261964,155262427,SRX20140881,CPSF3L,463
chr1,155261964,155262586,SRX20140897,INTS13,622
chr1,155261966,155262382,SRX20140879,CPSF3L,416
chr1,155261976,155262612,SRX20140895,INTS13,636
chr1,155261999,155262439,SRX20140868,INTS10,440
chr1,155262011,155262448,SRX20140869,INTS10,437
chr1,155262034,155262646,SRX5075176,SMARCA4,612
chr1,155262046,155262402,SRX20140894,INTS13,356
chr1,155262084,155262305,SRX5716469,SMARCA4,221
chr1,155262089,155262500,SRX5075170,SMARCA4,411
chr1,155262112,155262494,SRX20140896,INTS13,382
chr1,155262121,155262638,SRX5075174,SMARCA4,517
chr1,155262172,155262654,SRX5075168,SMARCA4,482
chr1,155262244,155262585,SRX5716463,SMARCA4,341
chr1,155262344,155262604,SRX5716464,SMARCA4,260
chr1,155273096,155273770,SRX20140895,INTS13,674
chr1,155273197,155273654,SRX20140868,INTS10,457
chr1,155273224,155273611,SRX20140867,INTS10,387
chr1,155273335,155273609,SRX20140896,INTS13,274
chr1,155273351,155273697,SRX20140897,INTS13,346
chr1,155273375,155273653,SRX20140869,INTS10,278
chr1,155273425,155273614,SRX5054307,FOSL2,189
chr1,155273432,155273815,SRX5075170,SMARCA4,383
chr1,155273457,155273799,SRX5075176,SMARCA4,342
chr1,155273460,155273742,SRX5075174,SMARCA4,282
chr1,155273475,155273696,SRX5075175,SMARCA4,221
chr1,155273483,155273745,SRX5075168,SMARCA4,262
chr1,155273503,155273795,SRX5075169,SMARCA4,292
chr1,155273507,155273758,SRX5716470,SMARCA4,251
chr1,155277112,155277574,SRX5075168,SMARCA4,462
chr1,155277133,155277572,SRX5075174,SMARCA4,439
chr1,155277179,155277535,SRX5075176,SMARCA4,356
chr1,155277213,155277644,SRX16500059,CTCF,431
chr1,155277229,155277615,SRX16500062,CTCF,386
chr1,155277240,155277637,SRX16500061,CTCF,397
chr1,155277241,155277537,SRX5075170,SMARCA4,296
chr1,155277308,155277525,SRX5716463,SMARCA4,217
chr1,155277311,155277609,SRX16500060,CTCF,298
chr1,155277319,155277592,SRX5075169,SMARCA4,273
chr1,155278429,155278663,SRX16500060,CTCF,234
chr1,155308321,155308987,SRX20140869,INTS10,666
chr1,155308422,155308693,SRX5075176,SMARCA4,271
chr1,155308431,155308708,SRX5075170,SMARCA4,277
chr1,155308435,155309056,SRX5075174,SMARCA4,621
chr1,155308437,155308712,SRX5075169,SMARCA4,275
chr1,155308463,155308670,SRX5075175,SMARCA4,207
chr1,155308481,155308831,SRX5075168,SMARCA4,350
chr1,155308501,155308724,SRX5716470,SMARCA4,223
chr1,155308510,155309056,SRX20140895,INTS13,546
chr1,155308526,155309015,SRX20140867,INTS10,489
chr1,155308548,155308728,SRX5054308,FOSL2,180
chr1,155308604,155308880,SRX20140897,INTS13,276
chr1,155308609,155308835,SRX5716454,SOX3,226
chr1,155308626,155308831,SRX5716464,SMARCA4,205
chr1,155308665,155308979,SRX20140881,CPSF3L,314
chr1,155323169,155323644,SRX5075168,SMARCA4,475
chr1,155323181,155323583,SRX5075174,SMARCA4,402
chr1,155323195,155323723,SRX16500060,CTCF,528
chr1,155323204,155323587,SRX5075176,SMARCA4,383
chr1,155323237,155323733,SRX16500059,CTCF,496
chr1,155323244,155323724,SRX16500062,CTCF,480
chr1,155323252,155323707,SRX16500061,CTCF,455
chr1,155323259,155323579,SRX5075170,SMARCA4,320
chr1,155323291,155323583,SRX5075169,SMARCA4,292
chr1,155323307,155323559,SRX5075175,SMARCA4,252
chr1,155323340,155323567,SRX5716470,SMARCA4,227
chr1,155323364,155323605,SRX5716469,SMARCA4,241
chr1,155324113,155324766,SRX20140895,INTS13,653
chr1,155324230,155324684,SRX20140897,INTS13,454
chr1,155324336,155324661,SRX5075168,SMARCA4,325
chr1,155324468,155324708,SRX20140879,CPSF3L,240
chr1,155324473,155324646,SRX5075174,SMARCA4,173
chr1,155335047,155335270,SRX5716470,SMARCA4,223
chr1,155379426,155380044,SRX5075176,SMARCA4,618
chr1,155379456,155379966,SRX5075175,SMARCA4,510
chr1,155379514,155379968,SRX5075170,SMARCA4,454
chr1,155379541,155379917,SRX5020211,SMARCA2,376
chr1,155379543,155379983,SRX5716470,SMARCA4,440
chr1,155379566,155379896,SRX5716469,SMARCA4,330
chr1,155379576,155379894,SRX5075169,SMARCA4,318
chr1,155379583,155379851,SRX5716467,SMARCA2,268
chr1,155379583,155379863,SRX5716468,SMARCA2,280
chr1,155379646,155379840,SRX5075181,SMARCA2,194
chr1,155379684,155379872,SRX5054309,FOSL2,188
chr1,155416399,155416608,SRX5054309,FOSL2,209
chr1,155463966,155464193,SRX5075169,SMARCA4,227
chr1,155467013,155467323,SRX5075170,SMARCA4,310
chr1,155467031,155467368,SRX5054309,FOSL2,337
chr1,155467068,155467322,SRX5075175,SMARCA4,254
chr1,155467070,155467385,SRX5716469,SMARCA4,315
chr1,155467071,155467378,SRX5075176,SMARCA4,307
chr1,155467092,155467352,SRX5075169,SMARCA4,260
chr1,155467107,155467321,SRX5054308,FOSL2,214
chr1,155467122,155467338,SRX5716470,SMARCA4,216
chr1,155472559,155472898,SRX5075176,SMARCA4,339
chr1,155472571,155472835,SRX5075170,SMARCA4,264
chr1,155472588,155472826,SRX5075175,SMARCA4,238
chr1,155472620,155472868,SRX5716470,SMARCA4,248
chr1,155472625,155472840,SRX5716467,SMARCA2,215
chr1,155472672,155472857,SRX5075169,SMARCA4,185
chr1,155479286,155479563,SRX5054309,FOSL2,277
chr1,155479320,155479531,SRX5054308,FOSL2,211
chr1,155481804,155482079,SRX5075170,SMARCA4,275
chr1,155481822,155482041,SRX5075176,SMARCA4,219
chr1,155500213,155500456,SRX5075170,SMARCA4,243
chr1,155500231,155500442,SRX5716470,SMARCA4,211
chr1,155544504,155544547,SRX1424893,POU3F2,43
chr1,155544504,155544548,SRX1424891,POU3F2,44
chr1,155544506,155544547,SRX1424892,POU3F2,41
chr1,155562352,155563540,SRX20140895,INTS13,1188
chr1,155562932,155563530,SRX20140867,INTS10,598
chr1,155562940,155563535,SRX20140868,INTS10,595
chr1,155562950,155563522,SRX20140897,INTS13,572
chr1,155562952,155563544,SRX20140869,INTS10,592
chr1,155562958,155563145,SRX5075174,SMARCA4,187
chr1,155562987,155563515,SRX20140879,CPSF3L,528
chr1,155562996,155563580,SRX20140881,CPSF3L,584
chr1,155562999,155563536,SRX20140896,INTS13,537
chr1,155563032,155563504,SRX20140894,INTS13,472
chr1,155563060,155563497,SRX20140880,CPSF3L,437
chr1,155563163,155563490,SRX20140882,CPSF3L,327
chr1,155591773,155592200,SRX16500059,CTCF,427
chr1,155591776,155592293,SRX16500060,CTCF,517
chr1,155591796,155592204,SRX16500062,CTCF,408
chr1,155591858,155592237,SRX16500061,CTCF,379
chr1,155591891,155592080,SRX5075174,SMARCA4,189
chr1,155591930,155592105,SRX5075176,SMARCA4,175
chr1,155595993,155596566,SRX5075168,SMARCA4,573
chr1,155596076,155596465,SRX5075174,SMARCA4,389
chr1,155596085,155596506,SRX5716463,SMARCA4,421
chr1,155596085,155596598,SRX20140895,INTS13,513
chr1,155596102,155596389,SRX5716451,SOX2,287
chr1,155596177,155596395,SRX5716464,SMARCA4,218
chr1,155609656,155610461,SRX20140895,INTS13,805
chr1,155609725,155610072,SRX20140881,CPSF3L,347
chr1,155609778,155610059,SRX5075169,SMARCA4,281
chr1,155609788,155610211,SRX5075170,SMARCA4,423
chr1,155609808,155610297,SRX5075176,SMARCA4,489
chr1,155609820,155610401,SRX20140868,INTS10,581
chr1,155609821,155610341,SRX5075168,SMARCA4,520
chr1,155609823,155610124,SRX20140879,CPSF3L,301
chr1,155609841,155610412,SRX5075174,SMARCA4,571
chr1,155609860,155610122,SRX5075175,SMARCA4,262
chr1,155609937,155610341,SRX20140867,INTS10,404
chr1,155609944,155610204,SRX5716470,SMARCA4,260
chr1,155609996,155610415,SRX5716463,SMARCA4,419
chr1,155610002,155610299,SRX20140897,INTS13,297
chr1,155610037,155610264,SRX5054307,FOSL2,227
chr1,155610041,155610295,SRX5716451,SOX2,254
chr1,155610304,155610581,SRX5716469,SMARCA4,277
chr1,155633839,155634125,SRX16500061,CTCF,286
chr1,155648349,155648924,SRX5075168,SMARCA4,575
chr1,155648365,155648872,SRX5075169,SMARCA4,507
chr1,155648394,155648924,SRX5075174,SMARCA4,530
chr1,155648431,155648839,SRX5075176,SMARCA4,408
chr1,155648453,155648820,SRX5075170,SMARCA4,367
chr1,155648464,155648844,SRX5716469,SMARCA4,380
chr1,155648475,155648853,SRX16500060,CTCF,378
chr1,155648483,155648848,SRX16500062,CTCF,365
chr1,155648484,155648838,SRX5054309,FOSL2,354
chr1,155648495,155648819,SRX5075175,SMARCA4,324
chr1,155648501,155648922,SRX16500059,CTCF,421
chr1,155648507,155648868,SRX5716470,SMARCA4,361
chr1,155648546,155648754,SRX5054308,FOSL2,208
chr1,155648569,155648843,SRX16500061,CTCF,274
chr1,155648582,155648835,SRX5716451,SOX2,253
chr1,155648616,155648842,SRX5716463,SMARCA4,226
chr1,155648668,155648882,SRX5716464,SMARCA4,214
chr1,155688161,155689269,SRX20140895,INTS13,1108
chr1,155688168,155688483,SRX20140869,INTS10,315
chr1,155688178,155688416,SRX5716470,SMARCA4,238
chr1,155688188,155688685,SRX20140897,INTS13,497
chr1,155688715,155689100,SRX16500059,CTCF,385
chr1,155688774,155689075,SRX16500060,CTCF,301
chr1,155688782,155689105,SRX16500061,CTCF,323
chr1,155688782,155689230,SRX5075174,SMARCA4,448
chr1,155688831,155689057,SRX16500062,CTCF,226
chr1,155688841,155689229,SRX20140867,INTS10,388
chr1,155688854,155689286,SRX5075168,SMARCA4,432
chr1,155688872,155689133,SRX20140881,CPSF3L,261
chr1,155698437,155698721,SRX5054309,FOSL2,284
chr1,155698459,155698658,SRX5075170,SMARCA4,199
chr1,155706198,155706429,SRX5054309,FOSL2,231
chr1,155706207,155706396,SRX5054308,FOSL2,189
chr1,155712682,155712917,SRX16500059,CTCF,235
chr1,155712684,155712914,SRX16500062,CTCF,230
chr1,155718611,155719142,SRX5075174,SMARCA4,531
chr1,155718679,155719162,SRX5075168,SMARCA4,483
chr1,155718687,155719112,SRX5716463,SMARCA4,425
chr1,155718719,155719174,SRX20140895,INTS13,455
chr1,155718754,155719062,SRX5716451,SOX2,308
chr1,155718770,155719026,SRX5716454,SOX3,256
chr1,155718779,155718989,SRX5716464,SMARCA4,210
chr1,155728965,155729545,SRX16500060,CTCF,580
chr1,155728988,155729546,SRX16500059,CTCF,558
chr1,155729015,155729505,SRX16500062,CTCF,490
chr1,155729058,155729506,SRX16500061,CTCF,448
chr1,155729090,155729382,SRX5075174,SMARCA4,292
chr1,155729152,155729434,SRX5075168,SMARCA4,282
chr1,155729159,155729362,SRX5075169,SMARCA4,203
chr1,155729198,155729408,SRX4174629,CTCF,210
chr1,155745278,155745870,SRX20140879,CPSF3L,592
chr1,155745316,155746080,SRX20140895,INTS13,764
chr1,155745361,155745893,SRX5075170,SMARCA4,532
chr1,155745379,155745977,SRX20140868,INTS10,598
chr1,155745393,155745934,SRX5075176,SMARCA4,541
chr1,155745397,155745701,SRX20140881,CPSF3L,304
chr1,155745402,155745997,SRX5075174,SMARCA4,595
chr1,155745432,155745780,SRX5716464,SMARCA4,348
chr1,155745435,155745869,SRX20140867,INTS10,434
chr1,155745438,155745887,SRX20140897,INTS13,449
chr1,155745456,155745966,SRX5075168,SMARCA4,510
chr1,155745466,155745805,SRX5716463,SMARCA4,339
chr1,155745471,155746004,SRX5716470,SMARCA4,533
chr1,155745625,155745836,SRX5054307,FOSL2,211
chr1,155745834,155746030,SRX5075175,SMARCA4,196
chr1,155763361,155763702,SRX5075169,SMARCA4,341
chr1,155763369,155763691,SRX5075168,SMARCA4,322
chr1,155763371,155763666,SRX5054309,FOSL2,295
chr1,155763373,155763687,SRX5075170,SMARCA4,314
chr1,155763377,155763715,SRX5075176,SMARCA4,338
chr1,155763378,155763679,SRX5075175,SMARCA4,301
chr1,155763397,155763679,SRX5716469,SMARCA4,282
chr1,155763417,155763674,SRX5075174,SMARCA4,257
chr1,155763466,155763646,SRX5054308,FOSL2,180
chr1,155801192,155801445,SRX5075169,SMARCA4,253
chr1,155801211,155801434,SRX5075175,SMARCA4,223
chr1,155801266,155801481,SRX5054309,FOSL2,215
chr1,155834267,155834833,SRX5075168,SMARCA4,566
chr1,155834320,155834820,SRX5075174,SMARCA4,500
chr1,155834323,155834682,SRX5054309,FOSL2,359
chr1,155834336,155834607,SRX5075175,SMARCA4,271
chr1,155834338,155834715,SRX5075169,SMARCA4,377
chr1,155834344,155834762,SRX5075176,SMARCA4,418
chr1,155834357,155834666,SRX5716469,SMARCA4,309
chr1,155834360,155834540,SRX5054308,FOSL2,180
chr1,155834378,155834589,SRX5716470,SMARCA4,211
chr1,155834395,155834862,SRX20140881,CPSF3L,467
chr1,155834395,155835028,SRX20140867,INTS10,633
chr1,155834408,155835074,SRX20140895,INTS13,666
chr1,155834414,155834733,SRX5054307,FOSL2,319
chr1,155834415,155834738,SRX5716463,SMARCA4,323
chr1,155834456,155834997,SRX20140879,CPSF3L,541
chr1,155834571,155834821,SRX5716451,SOX2,250
chr1,155857104,155857459,SRX5075174,SMARCA4,355
chr1,155857107,155857391,SRX5075168,SMARCA4,284
chr1,155857157,155857326,SRX5075170,SMARCA4,169
chr1,155857171,155857425,SRX5054309,FOSL2,254
chr1,155857187,155857376,SRX5054307,FOSL2,189
chr1,155857206,155857429,SRX5054308,FOSL2,223
chr1,155857234,155857409,SRX5075176,SMARCA4,175
chr1,155859195,155859604,SRX5075168,SMARCA4,409
chr1,155859202,155859531,SRX5075170,SMARCA4,329
chr1,155859208,155859636,SRX5075174,SMARCA4,428
chr1,155859547,155860761,SRX20140895,INTS13,1214
chr1,155859563,155859866,SRX20140867,INTS10,303
chr1,155859991,155860881,SRX20140868,INTS10,890
chr1,155860084,155860858,SRX20140867,INTS10,774
chr1,155860141,155860887,SRX20140897,INTS13,746
chr1,155860194,155860983,SRX20140869,INTS10,789
chr1,155860227,155860678,SRX20140881,CPSF3L,451
chr1,155860377,155860879,SRX5716470,SMARCA4,502
chr1,155860428,155860758,SRX5716469,SMARCA4,330
chr1,155860452,155860787,SRX5075170,SMARCA4,335
chr1,155860468,155860852,SRX5075175,SMARCA4,384
chr1,155860486,155860804,SRX5075168,SMARCA4,318
chr1,155860492,155860799,SRX5075174,SMARCA4,307
chr1,155860567,155860872,SRX5075169,SMARCA4,305
chr1,155860691,155860890,SRX5075176,SMARCA4,199
chr1,155871410,155871595,SRX5075170,SMARCA4,185
chr1,155873835,155874162,SRX5716469,SMARCA4,327
chr1,155873842,155874239,SRX5075175,SMARCA4,397
chr1,155873859,155874250,SRX5075169,SMARCA4,391
chr1,155888509,155888775,SRX5075175,SMARCA4,266
chr1,155888521,155888854,SRX5075176,SMARCA4,333
chr1,155888534,155888796,SRX5716470,SMARCA4,262
chr1,155888539,155888831,SRX5075170,SMARCA4,292
chr1,155888555,155888849,SRX5716467,SMARCA2,294
chr1,155888572,155888813,SRX5054308,FOSL2,241
chr1,155888582,155888803,SRX5054309,FOSL2,221
chr1,155888584,155888839,SRX5075169,SMARCA4,255
chr1,155892812,155893078,SRX5054309,FOSL2,266
chr1,155892819,155893088,SRX5054308,FOSL2,269
chr1,155892865,155893078,SRX5075175,SMARCA4,213
chr1,155892875,155893205,SRX5075169,SMARCA4,330
chr1,155893526,155893786,SRX5716460,Epitope tags,260
chr1,155893557,155893985,SRX5075170,SMARCA4,428
chr1,155893624,155893948,SRX5716470,SMARCA4,324
chr1,155893630,155893901,SRX5075169,SMARCA4,271
chr1,155893636,155893930,SRX5075176,SMARCA4,294
chr1,155893645,155893973,SRX5075174,SMARCA4,328
chr1,155893652,155893959,SRX5075175,SMARCA4,307
chr1,155893659,155893949,SRX5075168,SMARCA4,290
chr1,155910890,155911345,SRX20140895,INTS13,455
chr1,155911208,155911608,SRX5075168,SMARCA4,400
chr1,155911211,155911416,SRX5716464,SMARCA4,205
chr1,155911218,155911493,SRX5716470,SMARCA4,275
chr1,155911249,155911701,SRX5075170,SMARCA4,452
chr1,155911254,155911586,SRX5075174,SMARCA4,332
chr1,155911315,155911510,SRX5075176,SMARCA4,195
chr1,155911351,155911606,SRX5716469,SMARCA4,255
chr1,155911416,155911604,SRX5075175,SMARCA4,188
chr1,155913964,155914223,SRX5075174,SMARCA4,259
chr1,155914018,155914197,SRX5075168,SMARCA4,179
chr1,155934118,155934857,SRX20140879,CPSF3L,739
chr1,155934159,155934837,SRX20140895,INTS13,678
chr1,155934172,155934765,SRX20140867,INTS10,593
chr1,155934198,155934861,SRX20140881,CPSF3L,663
chr1,155934207,155934798,SRX20140897,INTS13,591
chr1,155934208,155934767,SRX20140868,INTS10,559
chr1,155934209,155934753,SRX20140896,INTS13,544
chr1,155934222,155934738,SRX5075174,SMARCA4,516
chr1,155934238,155934616,SRX20140894,INTS13,378
chr1,155934238,155934760,SRX20140869,INTS10,522
chr1,155934313,155934595,SRX5075168,SMARCA4,282
chr1,155938131,155938561,SRX16500060,CTCF,430
chr1,155938136,155938561,SRX16500059,CTCF,425
chr1,155938171,155938502,SRX16500062,CTCF,331
chr1,155938191,155938510,SRX16500061,CTCF,319
chr1,155938212,155938542,SRX5075170,SMARCA4,330
chr1,155938217,155938611,SRX5075176,SMARCA4,394
chr1,155938222,155938448,SRX5075168,SMARCA4,226
chr1,155938235,155938549,SRX4174629,CTCF,314
chr1,155938247,155938663,SRX5075175,SMARCA4,416
chr1,155938307,155938670,SRX5020211,SMARCA2,363
chr1,155938320,155938579,SRX5716469,SMARCA4,259
chr1,155938332,155938602,SRX5075169,SMARCA4,270
chr1,155938336,155938725,SRX5716470,SMARCA4,389
chr1,155938351,155938608,SRX5716467,SMARCA2,257
chr1,155938363,155938612,SRX5020214,SMARCA2,249
chr1,155938464,155938646,SRX5054308,FOSL2,182
chr1,155940790,155940968,SRX5075170,SMARCA4,178
chr1,155940806,155940986,SRX5075169,SMARCA4,180
chr1,155940820,155940999,SRX5075176,SMARCA4,179
chr1,155961927,155962288,SRX5075169,SMARCA4,361
chr1,155961930,155962328,SRX5716469,SMARCA4,398
chr1,155961935,155962328,SRX5075170,SMARCA4,393
chr1,155961968,155962294,SRX5075175,SMARCA4,326
chr1,155961990,155962335,SRX5075176,SMARCA4,345
chr1,155961993,155962270,SRX5054309,FOSL2,277
chr1,155961997,155962275,SRX5054308,FOSL2,278
chr1,155962004,155962227,SRX5716470,SMARCA4,223
chr1,155967685,155968238,SRX5075174,SMARCA4,553
chr1,155970480,155970681,SRX5075170,SMARCA4,201
chr1,155970507,155970803,SRX5075176,SMARCA4,296
chr1,155970522,155970783,SRX5054309,FOSL2,261
chr1,155970524,155970745,SRX5075169,SMARCA4,221
chr1,155970565,155970767,SRX5054308,FOSL2,202
chr1,155970576,155970763,SRX5075175,SMARCA4,187
chr1,155977766,155978764,SRX20140895,INTS13,998
chr1,155978203,155978712,SRX20140868,INTS10,509
chr1,155978466,155978977,SRX16500059,CTCF,511
chr1,155978474,155978951,SRX16500061,CTCF,477
chr1,155978479,155978939,SRX16500060,CTCF,460
chr1,155978580,155978943,SRX16500062,CTCF,363
chr1,155978619,155978849,SRX5075174,SMARCA4,230
chr1,155978652,155978848,SRX5075168,SMARCA4,196
chr1,155983348,155983788,SRX5075170,SMARCA4,440
chr1,155983379,155983866,SRX5075176,SMARCA4,487
chr1,155983402,155983748,SRX5716470,SMARCA4,346
chr1,155983415,155983722,SRX5716468,SMARCA2,307
chr1,155983426,155983812,SRX5054308,FOSL2,386
chr1,155983431,155983797,SRX5075169,SMARCA4,366
chr1,155983436,155983673,SRX5020214,SMARCA2,237
chr1,155983441,155983716,SRX5716467,SMARCA2,275
chr1,155983446,155983752,SRX5716469,SMARCA4,306
chr1,155983451,155983831,SRX5075175,SMARCA4,380
chr1,155983463,155983680,SRX5020211,SMARCA2,217
chr1,155983464,155983835,SRX5054309,FOSL2,371
chr1,155989250,155989797,SRX16500060,CTCF,547
chr1,155989317,155989774,SRX16500061,CTCF,457
chr1,155989326,155989820,SRX16500059,CTCF,494
chr1,155989332,155989813,SRX16500062,CTCF,481
chr1,155989348,155989630,SRX5716470,SMARCA4,282
chr1,155989355,155989611,SRX4174629,CTCF,256
chr1,155989376,155989676,SRX5075169,SMARCA4,300
chr1,155989378,155989647,SRX5075170,SMARCA4,269
chr1,155989379,155989616,SRX5075176,SMARCA4,237
chr1,155989385,155989624,SRX5075168,SMARCA4,239
chr1,155989396,155989637,SRX5075175,SMARCA4,241
chr1,155989432,155989664,SRX5075174,SMARCA4,232
chr1,156020533,156020900,SRX5716470,SMARCA4,367
chr1,156020621,156021098,SRX20140895,INTS13,477
chr1,156020735,156021042,SRX20140868,INTS10,307
chr1,156020744,156021038,SRX20140879,CPSF3L,294
chr1,156020763,156020988,SRX20140867,INTS10,225
chr1,156020775,156021132,SRX5075168,SMARCA4,357
chr1,156020778,156021154,SRX5075174,SMARCA4,376
chr1,156020832,156021024,SRX5075170,SMARCA4,192
chr1,156020843,156021150,SRX5716463,SMARCA4,307
chr1,156025818,156026279,SRX16500061,CTCF,461
chr1,156025864,156026230,SRX16500059,CTCF,366
chr1,156025902,156026330,SRX16500060,CTCF,428
chr1,156025936,156026280,SRX16500062,CTCF,344
chr1,156025946,156026281,SRX5075174,SMARCA4,335
chr1,156025950,156026154,SRX5716463,SMARCA4,204
chr1,156025971,156026265,SRX5075168,SMARCA4,294
chr1,156026030,156026260,SRX4174629,CTCF,230
chr1,156033082,156033435,SRX5075176,SMARCA4,353
chr1,156033131,156033342,SRX5075170,SMARCA4,211
chr1,156053168,156053341,SRX5075174,SMARCA4,173
chr1,156053221,156053587,SRX16500059,CTCF,366
chr1,156053241,156053583,SRX16500060,CTCF,342
chr1,156053289,156053523,SRX16500061,CTCF,234
chr1,156053457,156053718,SRX20140895,INTS13,261
chr1,156053774,156054140,SRX16500059,CTCF,366
chr1,156053841,156054156,SRX5075176,SMARCA4,315
chr1,156053842,156054955,SRX20140895,INTS13,1113
chr1,156053854,156054146,SRX5075169,SMARCA4,292
chr1,156053863,156054174,SRX16500060,CTCF,311
chr1,156053871,156054091,SRX16500062,CTCF,220
chr1,156053876,156054143,SRX5075175,SMARCA4,267
chr1,156053886,156054455,SRX20140867,INTS10,569
chr1,156053894,156054174,SRX16500061,CTCF,280
chr1,156053908,156054158,SRX5075174,SMARCA4,250
chr1,156053933,156054129,SRX5075168,SMARCA4,196
chr1,156053940,156054837,SRX20140868,INTS10,897
chr1,156053951,156054375,SRX20140879,CPSF3L,424
chr1,156054233,156054762,SRX20140881,CPSF3L,529
chr1,156054444,156054903,SRX5716463,SMARCA4,459
chr1,156054472,156054726,SRX20140879,CPSF3L,254
chr1,156054473,156054951,SRX5075174,SMARCA4,478
chr1,156054490,156055048,SRX5075168,SMARCA4,558
chr1,156054541,156054934,SRX5075176,SMARCA4,393
chr1,156054542,156054798,SRX5716454,SOX3,256
chr1,156054588,156054825,SRX5716451,SOX2,237
chr1,156066271,156066678,SRX16500062,CTCF,407
chr1,156066273,156066721,SRX16500061,CTCF,448
chr1,156066278,156066741,SRX16500060,CTCF,463
chr1,156066293,156066737,SRX16500059,CTCF,444
chr1,156066356,156066570,SRX5075174,SMARCA4,214
chr1,156066359,156066647,SRX4174629,CTCF,288
chr1,156066366,156066567,SRX5075176,SMARCA4,201
chr1,156066436,156066650,SRX5075168,SMARCA4,214
chr1,156073766,156074100,SRX5075168,SMARCA4,334
chr1,156073794,156074108,SRX5075174,SMARCA4,314
chr1,156082098,156082437,SRX5075168,SMARCA4,339
chr1,156082238,156082633,SRX20140868,INTS10,395
chr1,156082256,156083101,SRX20140895,INTS13,845
chr1,156082389,156082874,SRX20140867,INTS10,485
chr1,156082604,156082959,SRX5075174,SMARCA4,355
chr1,156082731,156083084,SRX20140879,CPSF3L,353
chr1,156086226,156086621,SRX5075174,SMARCA4,395
chr1,156086315,156086549,SRX5716451,SOX2,234
chr1,156086323,156086576,SRX20140867,INTS10,253
chr1,156086324,156086657,SRX5075168,SMARCA4,333
chr1,156090601,156091123,SRX16500060,CTCF,522
chr1,156090604,156091132,SRX16500059,CTCF,528
chr1,156090626,156091121,SRX16500062,CTCF,495
chr1,156090661,156091112,SRX16500061,CTCF,451
chr1,156090667,156091058,SRX4174629,CTCF,391
chr1,156090747,156091000,SRX5075168,SMARCA4,253
chr1,156090793,156091075,SRX5075176,SMARCA4,282
chr1,156090820,156091000,SRX5075170,SMARCA4,180
chr1,156090828,156091012,SRX5075174,SMARCA4,184
chr1,156096532,156097030,SRX16500062,CTCF,498
chr1,156096541,156096990,SRX4174629,CTCF,449
chr1,156096553,156097020,SRX16500061,CTCF,467
chr1,156096556,156097042,SRX16500060,CTCF,486
chr1,156096559,156097042,SRX16500059,CTCF,483
chr1,156096614,156097134,SRX5075174,SMARCA4,520
chr1,156096659,156097349,SRX5075176,SMARCA4,690
chr1,156096684,156097242,SRX5075168,SMARCA4,558
chr1,156096695,156097369,SRX5075170,SMARCA4,674
chr1,156096729,156097379,SRX5075169,SMARCA4,650
chr1,156096738,156097426,SRX5075175,SMARCA4,688
chr1,156096746,156097388,SRX5716469,SMARCA4,642
chr1,156096760,156097336,SRX5716470,SMARCA4,576
chr1,156096796,156097313,SRX5054309,FOSL2,517
chr1,156096828,156097229,SRX5716467,SMARCA2,401
chr1,156096847,156097404,SRX5054308,FOSL2,557
chr1,156096902,156097308,SRX5020211,SMARCA2,406
chr1,156096920,156097263,SRX5075181,SMARCA2,343
chr1,156102612,156102880,SRX5075170,SMARCA4,268
chr1,156102645,156102883,SRX5075169,SMARCA4,238
chr1,156102647,156102923,SRX5054308,FOSL2,276
chr1,156102671,156102909,SRX5054309,FOSL2,238
chr1,156106024,156106489,SRX20140869,INTS10,465
chr1,156106113,156106536,SRX5075174,SMARCA4,423
chr1,156106131,156106534,SRX20140895,INTS13,403
chr1,156106152,156106624,SRX5716463,SMARCA4,472
chr1,156106155,156106482,SRX20140867,INTS10,327
chr1,156106180,156106580,SRX5075170,SMARCA4,400
chr1,156106190,156106563,SRX5075176,SMARCA4,373
chr1,156106194,156106580,SRX5716469,SMARCA4,386
chr1,156106207,156106534,SRX5054308,FOSL2,327
chr1,156106220,156106549,SRX5716470,SMARCA4,329
chr1,156106220,156106552,SRX5075169,SMARCA4,332
chr1,156106238,156106531,SRX5716467,SMARCA2,293
chr1,156106239,156106626,SRX5075168,SMARCA4,387
chr1,156106253,156106517,SRX5075181,SMARCA2,264
chr1,156106265,156106477,SRX5716454,SOX3,212
chr1,156106269,156106544,SRX5020211,SMARCA2,275
chr1,156106270,156106547,SRX5075175,SMARCA4,277
chr1,156106295,156106517,SRX5054309,FOSL2,222
chr1,156106339,156106572,SRX5716451,SOX2,233
chr1,156113681,156114007,SRX5075176,SMARCA4,326
chr1,156113960,156114495,SRX5716469,SMARCA4,535
chr1,156113970,156114629,SRX5075169,SMARCA4,659
chr1,156114023,156114613,SRX5075170,SMARCA4,590
chr1,156114058,156114464,SRX5716467,SMARCA2,406
chr1,156114063,156114520,SRX5075176,SMARCA4,457
chr1,156114100,156114836,SRX5054309,FOSL2,736
chr1,156114106,156114481,SRX5075175,SMARCA4,375
chr1,156114123,156114358,SRX5054308,FOSL2,235
chr1,156114129,156114363,SRX5716470,SMARCA4,234
chr1,156114146,156114369,SRX5075174,SMARCA4,223
chr1,156114581,156114860,SRX5054308,FOSL2,279
chr1,156119600,156119780,SRX5054308,FOSL2,180
chr1,156122768,156123154,SRX5716470,SMARCA4,386
chr1,156122793,156123158,SRX5075170,SMARCA4,365
chr1,156122832,156123187,SRX5075175,SMARCA4,355
chr1,156122845,156123196,SRX5716469,SMARCA4,351
chr1,156122851,156123168,SRX5075176,SMARCA4,317
chr1,156122854,156123145,SRX5075169,SMARCA4,291
chr1,156122860,156123124,SRX5716467,SMARCA2,264
chr1,156122862,156123125,SRX5020211,SMARCA2,263
chr1,156122891,156123159,SRX5054309,FOSL2,268
chr1,156122903,156123104,SRX5075182,SMARCA2,201
chr1,156122924,156123179,SRX5054308,FOSL2,255
chr1,156123527,156123966,SRX5075174,SMARCA4,439
chr1,156123669,156124049,SRX5075170,SMARCA4,380
chr1,156123674,156123932,SRX20140867,INTS10,258
chr1,156123678,156123990,SRX5054308,FOSL2,312
chr1,156123686,156123979,SRX5054309,FOSL2,293
chr1,156123689,156123940,SRX5075168,SMARCA4,251
chr1,156123702,156123895,SRX5075169,SMARCA4,193
chr1,156123713,156124004,SRX5075176,SMARCA4,291
chr1,156123800,156124001,SRX5054307,FOSL2,201
chr1,156126219,156126601,SRX5075169,SMARCA4,382
chr1,156126231,156126594,SRX5075176,SMARCA4,363
chr1,156126246,156126609,SRX5075170,SMARCA4,363
chr1,156126321,156126533,SRX5716469,SMARCA4,212
chr1,156126326,156126557,SRX5054308,FOSL2,231
chr1,156126327,156126600,SRX5075175,SMARCA4,273
chr1,156126342,156126584,SRX5054309,FOSL2,242
chr1,156128881,156129089,SRX5075170,SMARCA4,208
chr1,156128889,156129093,SRX5075176,SMARCA4,204
chr1,156129361,156129614,SRX5075170,SMARCA4,253
chr1,156129426,156129606,SRX5075169,SMARCA4,180
chr1,156130083,156130608,SRX5075174,SMARCA4,525
chr1,156130086,156130643,SRX5075168,SMARCA4,557
chr1,156130167,156130557,SRX5716463,SMARCA4,390
chr1,156130187,156130544,SRX5054308,FOSL2,357
chr1,156130187,156130568,SRX5075170,SMARCA4,381
chr1,156130191,156130420,SRX20140867,INTS10,229
chr1,156130197,156130593,SRX5075175,SMARCA4,396
chr1,156130203,156130600,SRX5075176,SMARCA4,397
chr1,156130211,156130547,SRX5054309,FOSL2,336
chr1,156130212,156130549,SRX5716470,SMARCA4,337
chr1,156130213,156130448,SRX5020214,SMARCA2,235
chr1,156130217,156130569,SRX5054307,FOSL2,352
chr1,156130220,156130553,SRX5716464,SMARCA4,333
chr1,156130222,156130485,SRX5716467,SMARCA2,263
chr1,156130225,156130572,SRX5075169,SMARCA4,347
chr1,156130234,156130458,SRX5716454,SOX3,224
chr1,156130242,156130593,SRX4174629,CTCF,351
chr1,156130245,156130543,SRX5716469,SMARCA4,298
chr1,156130248,156130490,SRX5716451,SOX2,242
chr1,156130253,156130738,SRX16500061,CTCF,485
chr1,156130267,156130750,SRX16500059,CTCF,483
chr1,156130281,156130541,SRX5075181,SMARCA2,260
chr1,156130283,156130745,SRX16500062,CTCF,462
chr1,156130292,156130794,SRX16500060,CTCF,502
chr1,156141139,156141656,SRX16500059,CTCF,517
chr1,156141154,156141593,SRX16500062,CTCF,439
chr1,156141189,156141609,SRX16500060,CTCF,420
chr1,156141198,156141622,SRX16500061,CTCF,424
chr1,156141283,156141496,SRX5075174,SMARCA4,213
chr1,156145909,156146311,SRX5716470,SMARCA4,402
chr1,156145931,156146387,SRX5075176,SMARCA4,456
chr1,156145954,156146332,SRX5075170,SMARCA4,378
chr1,156145989,156146329,SRX4174629,CTCF,340
chr1,156145990,156146404,SRX16500060,CTCF,414
chr1,156145991,156146288,SRX5075169,SMARCA4,297
chr1,156145996,156146342,SRX16500062,CTCF,346
chr1,156146015,156146408,SRX16500061,CTCF,393
chr1,156146016,156146401,SRX16500059,CTCF,385
chr1,156146052,156146245,SRX5075175,SMARCA4,193
chr1,156146059,156146266,SRX5075168,SMARCA4,207
chr1,156161625,156161903,SRX20140869,INTS10,278
chr1,156193556,156194269,SRX20140897,INTS13,713
chr1,156193557,156194236,SRX20140895,INTS13,679
chr1,156193596,156193885,SRX20140868,INTS10,289
chr1,156193633,156193911,SRX20140869,INTS10,278
chr1,156193667,156194207,SRX5075174,SMARCA4,540
chr1,156193678,156194226,SRX5075168,SMARCA4,548
chr1,156193698,156194250,SRX5075176,SMARCA4,552
chr1,156193704,156194273,SRX20140867,INTS10,569
chr1,156193717,156194128,SRX5716451,SOX2,411
chr1,156193726,156194239,SRX5075170,SMARCA4,513
chr1,156193773,156194182,SRX5054309,FOSL2,409
chr1,156193777,156194174,SRX5054308,FOSL2,397
chr1,156193851,156194083,SRX5716454,SOX3,232
chr1,156193857,156194113,SRX5716464,SMARCA4,256
chr1,156193857,156194272,SRX16500060,CTCF,415
chr1,156193866,156194098,SRX5716463,SMARCA4,232
chr1,156193867,156194305,SRX16500059,CTCF,438
chr1,156193869,156194118,SRX5716470,SMARCA4,249
chr1,156193872,156194130,SRX5054307,FOSL2,258
chr1,156193889,156194240,SRX16500061,CTCF,351
chr1,156193890,156194249,SRX16500062,CTCF,359
chr1,156193936,156194138,SRX5075175,SMARCA4,202
chr1,156193972,156194289,SRX20140881,CPSF3L,317
chr1,156194117,156194325,SRX5075169,SMARCA4,208
chr1,156212687,156212961,SRX5075168,SMARCA4,274
chr1,156212689,156213454,SRX20140895,INTS13,765
chr1,156212718,156212979,SRX5075174,SMARCA4,261
chr1,156212720,156213273,SRX20140869,INTS10,553
chr1,156212725,156212967,SRX5075176,SMARCA4,242
chr1,156212764,156213259,SRX20140881,CPSF3L,495
chr1,156212796,156213507,SRX20140868,INTS10,711
chr1,156212804,156213560,SRX20140867,INTS10,756
chr1,156212818,156213407,SRX20140897,INTS13,589
chr1,156212833,156213029,SRX5054307,FOSL2,196
chr1,156212888,156213468,SRX20140879,CPSF3L,580
chr1,156212896,156213197,SRX5716463,SMARCA4,301
chr1,156213059,156213428,SRX5075170,SMARCA4,369
chr1,156213096,156213453,SRX5075174,SMARCA4,357
chr1,156213100,156213371,SRX5075176,SMARCA4,271
chr1,156213145,156213367,SRX5075169,SMARCA4,222
chr1,156213221,156213498,SRX5075168,SMARCA4,277
chr1,156213293,156213511,SRX5716470,SMARCA4,218
chr1,156214412,156214626,SRX5054309,FOSL2,214
chr1,156222979,156223238,SRX5075169,SMARCA4,259
chr1,156225329,156225931,SRX16500061,CTCF,602
chr1,156225348,156225911,SRX16500059,CTCF,563
chr1,156225360,156225657,SRX5716454,SOX3,297
chr1,156225372,156225874,SRX16500060,CTCF,502
chr1,156225375,156225728,SRX5075174,SMARCA4,353
chr1,156225379,156225821,SRX4174629,CTCF,442
chr1,156225392,156225683,SRX5716464,SMARCA4,291
chr1,156225393,156225785,SRX5075168,SMARCA4,392
chr1,156225403,156225895,SRX16500062,CTCF,492
chr1,156225404,156225741,SRX5716463,SMARCA4,337
chr1,156225422,156225705,SRX5716451,SOX2,283
chr1,156225434,156225752,SRX5075176,SMARCA4,318
chr1,156225450,156225641,SRX5075175,SMARCA4,191
chr1,156225474,156225735,SRX5075170,SMARCA4,261
chr1,156225484,156225718,SRX5075169,SMARCA4,234
chr1,156225484,156225758,SRX5716470,SMARCA4,274
chr1,156230600,156230769,SRX5075170,SMARCA4,169
chr1,156233380,156233789,SRX5716470,SMARCA4,409
chr1,156233393,156233768,SRX5075169,SMARCA4,375
chr1,156233402,156233714,SRX5075170,SMARCA4,312
chr1,156233403,156233775,SRX5716469,SMARCA4,372
chr1,156233411,156233753,SRX5075175,SMARCA4,342
chr1,156233427,156233698,SRX5075176,SMARCA4,271
chr1,156233478,156233771,SRX5054309,FOSL2,293
chr1,156233843,156234112,SRX5054308,FOSL2,269
chr1,156233870,156234063,SRX5075169,SMARCA4,193
chr1,156233873,156234129,SRX5054309,FOSL2,256
chr1,156241494,156241741,SRX5075170,SMARCA4,247
chr1,156241549,156241846,SRX5075169,SMARCA4,297
chr1,156241575,156241770,SRX5054308,FOSL2,195
chr1,156241591,156241884,SRX5075175,SMARCA4,293
chr1,156241593,156241787,SRX5075176,SMARCA4,194
chr1,156263134,156263379,SRX5075175,SMARCA4,245
chr1,156282447,156283107,SRX20140895,INTS13,660
chr1,156282492,156283088,SRX20140897,INTS13,596
chr1,156282492,156283167,SRX20140881,CPSF3L,675
chr1,156282496,156283180,SRX20140869,INTS10,684
chr1,156282514,156283059,SRX20140867,INTS10,545
chr1,156282530,156283055,SRX20140868,INTS10,525
chr1,156282534,156283011,SRX20140879,CPSF3L,477
chr1,156282540,156282890,SRX20140880,CPSF3L,350
chr1,156282551,156283077,SRX20140894,INTS13,526
chr1,156282560,156283053,SRX20140896,INTS13,493
chr1,156282572,156282844,SRX5716470,SMARCA4,272
chr1,156282606,156283007,SRX20140882,CPSF3L,401
chr1,156282629,156283190,SRX5075174,SMARCA4,561
chr1,156282716,156282984,SRX5716454,SOX3,268
chr1,156282805,156283178,SRX5075168,SMARCA4,373
chr1,156295470,156295894,SRX20140897,INTS13,424
chr1,156295510,156295892,SRX20140895,INTS13,382
chr1,156295572,156295912,SRX5075170,SMARCA4,340
chr1,156319460,156319953,SRX16500061,CTCF,493
chr1,156319543,156320041,SRX16500060,CTCF,498
chr1,156319581,156320042,SRX16500059,CTCF,461
chr1,156319595,156320031,SRX16500062,CTCF,436
chr1,156338009,156338270,SRX20140897,INTS13,261
chr1,156338082,156338881,SRX20140895,INTS13,799
chr1,156338087,156338274,SRX5075174,SMARCA4,187
chr1,156338569,156338749,SRX5075174,SMARCA4,180
chr1,156338660,156338849,SRX5075176,SMARCA4,189
chr1,156338692,156338964,SRX5075168,SMARCA4,272
chr1,156356812,156357370,SRX16500061,CTCF,558
chr1,156356835,156357307,SRX16500062,CTCF,472
chr1,156356836,156357318,SRX16500059,CTCF,482
chr1,156356839,156357397,SRX16500060,CTCF,558
chr1,156356854,156357262,SRX4174629,CTCF,408
chr1,156356939,156357192,SRX5075168,SMARCA4,253
chr1,156358768,156358941,SRX5075174,SMARCA4,173
chr1,156382912,156383409,SRX16500060,CTCF,497
chr1,156382924,156383387,SRX16500059,CTCF,463
chr1,156382942,156383359,SRX16500062,CTCF,417
chr1,156382949,156383213,SRX4174629,CTCF,264
chr1,156382972,156383341,SRX16500061,CTCF,369
chr1,156383054,156383293,SRX5075174,SMARCA4,239
chr1,156385513,156385968,SRX16500059,CTCF,455
chr1,156385529,156385967,SRX16500061,CTCF,438
chr1,156385533,156385951,SRX16500062,CTCF,418
chr1,156385544,156385977,SRX16500060,CTCF,433
chr1,156385596,156385962,SRX4174629,CTCF,366
chr1,156388386,156388891,SRX5075168,SMARCA4,505
chr1,156388450,156388802,SRX5075174,SMARCA4,352
chr1,156444409,156444775,SRX16500059,CTCF,366
chr1,156444412,156444740,SRX16500062,CTCF,328
chr1,156444418,156444702,SRX4174629,CTCF,284
chr1,156444422,156444757,SRX16500060,CTCF,335
chr1,156444423,156444785,SRX16500061,CTCF,362
chr1,156445749,156446232,SRX16500061,CTCF,483
chr1,156445772,156446215,SRX16500060,CTCF,443
chr1,156445773,156446236,SRX16500059,CTCF,463
chr1,156445793,156446209,SRX16500062,CTCF,416
chr1,156445797,156446219,SRX5075168,SMARCA4,422
chr1,156445822,156446135,SRX4174629,CTCF,313
chr1,156445829,156446238,SRX5075174,SMARCA4,409
chr1,156445836,156446116,SRX5075169,SMARCA4,280
chr1,156445854,156446152,SRX5075176,SMARCA4,298
chr1,156445860,156446191,SRX5075170,SMARCA4,331
chr1,156445862,156446098,SRX5716470,SMARCA4,236
chr1,156456369,156456790,SRX16500059,CTCF,421
chr1,156456370,156456736,SRX16500062,CTCF,366
chr1,156456387,156456773,SRX5075168,SMARCA4,386
chr1,156456396,156456847,SRX5075174,SMARCA4,451
chr1,156456407,156456811,SRX16500060,CTCF,404
chr1,156456412,156456792,SRX16500061,CTCF,380
chr1,156456428,156456967,SRX5075176,SMARCA4,539
chr1,156456449,156456686,SRX4174629,CTCF,237
chr1,156456469,156457094,SRX5075175,SMARCA4,625
chr1,156456483,156457054,SRX5075170,SMARCA4,571
chr1,156456492,156456891,SRX5075169,SMARCA4,399
chr1,156456615,156457634,SRX20140895,INTS13,1019
chr1,156456652,156457038,SRX20140867,INTS10,386
chr1,156456678,156457113,SRX20140868,INTS10,435
chr1,156456722,156456999,SRX20140879,CPSF3L,277
chr1,156456820,156457234,SRX20140881,CPSF3L,414
chr1,156456827,156457175,SRX5716470,SMARCA4,348
chr1,156457038,156457446,SRX5075168,SMARCA4,408
chr1,156457137,156457533,SRX20140897,INTS13,396
chr1,156457176,156457420,SRX5075176,SMARCA4,244
chr1,156457219,156457560,SRX5075174,SMARCA4,341
chr1,156457261,156457550,SRX5716463,SMARCA4,289
chr1,156457561,156457832,SRX16500062,CTCF,271
chr1,156457589,156457808,SRX16500061,CTCF,219
chr1,156457590,156457769,SRX5075168,SMARCA4,179
chr1,156476898,156477248,SRX5054309,FOSL2,350
chr1,156477008,156477231,SRX5054308,FOSL2,223
chr1,156480649,156481043,SRX16500060,CTCF,394
chr1,156480689,156481052,SRX16500062,CTCF,363
chr1,156480707,156481095,SRX16500061,CTCF,388
chr1,156480730,156481094,SRX16500059,CTCF,364
chr1,156490309,156490593,SRX5716470,SMARCA4,284
chr1,156490348,156490668,SRX5075169,SMARCA4,320
chr1,156500832,156501109,SRX5075174,SMARCA4,277
chr1,156500842,156501481,SRX20140895,INTS13,639
chr1,156500901,156501417,SRX20140897,INTS13,516
chr1,156500968,156501437,SRX20140868,INTS10,469
chr1,156500975,156501386,SRX20140867,INTS10,411
chr1,156500985,156501268,SRX20140879,CPSF3L,283
chr1,156500999,156501326,SRX20140881,CPSF3L,327
chr1,156501037,156501434,SRX20140869,INTS10,397
chr1,156501142,156501514,SRX16500061,CTCF,372
chr1,156501185,156501555,SRX16500059,CTCF,370
chr1,156501205,156501516,SRX16500062,CTCF,311
chr1,156501222,156501594,SRX16500060,CTCF,372
chr1,156501267,156501575,SRX5075168,SMARCA4,308
chr1,156502865,156503124,SRX5075176,SMARCA4,259
chr1,156502935,156503132,SRX5075170,SMARCA4,197
chr1,156502968,156503157,SRX5054308,FOSL2,189
chr1,156503407,156503593,SRX5054309,FOSL2,186
chr1,156505095,156505618,SRX20140895,INTS13,523
chr1,156505290,156505635,SRX5075174,SMARCA4,345
chr1,156571160,156571715,SRX5075169,SMARCA4,555
chr1,156571320,156571622,SRX5716469,SMARCA4,302
chr1,156571322,156571712,SRX5054309,FOSL2,390
chr1,156571337,156571680,SRX5075170,SMARCA4,343
chr1,156571362,156571662,SRX5716470,SMARCA4,300
chr1,156571370,156571643,SRX5075175,SMARCA4,273
chr1,156571417,156571704,SRX5075176,SMARCA4,287
chr1,156572469,156572677,SRX5075174,SMARCA4,208
chr1,156583912,156584455,SRX16500059,CTCF,543
chr1,156583943,156584541,SRX16500062,CTCF,598
chr1,156583947,156584453,SRX16500060,CTCF,506
chr1,156583962,156584422,SRX16500061,CTCF,460
chr1,156584084,156584518,SRX4174629,CTCF,434
chr1,156584102,156584394,SRX5075168,SMARCA4,292
chr1,156584109,156584400,SRX5075174,SMARCA4,291
chr1,156584124,156584336,SRX5075170,SMARCA4,212
chr1,156584165,156584340,SRX5075176,SMARCA4,175
chr1,156591522,156591709,SRX5075175,SMARCA4,187
chr1,156591532,156592113,SRX20140895,INTS13,581
chr1,156591544,156591976,SRX5075176,SMARCA4,432
chr1,156591551,156591953,SRX5075170,SMARCA4,402
chr1,156591568,156592079,SRX5075169,SMARCA4,511
chr1,156591573,156591932,SRX5075174,SMARCA4,359
chr1,156591581,156592006,SRX5075168,SMARCA4,425
chr1,156591622,156591918,SRX5716464,SMARCA4,296
chr1,156591671,156591946,SRX20140867,INTS10,275
chr1,156594175,156594541,SRX5075174,SMARCA4,366
chr1,156594204,156594514,SRX5075168,SMARCA4,310
chr1,156594221,156594415,SRX5716451,SOX2,194
chr1,156594490,156594530,SRX1424891,POU3F2,40
chr1,156601134,156601659,SRX20140897,INTS13,525
chr1,156601224,156601819,SRX20140895,INTS13,595
chr1,156601276,156601776,SRX5075174,SMARCA4,500
chr1,156601341,156601863,SRX20140869,INTS10,522
chr1,156601391,156601765,SRX5075176,SMARCA4,374
chr1,156601411,156601877,SRX5075170,SMARCA4,466
chr1,156601455,156601822,SRX5075175,SMARCA4,367
chr1,156601473,156601763,SRX5075168,SMARCA4,290
chr1,156601530,156601799,SRX5075169,SMARCA4,269
chr1,156601603,156601860,SRX5716469,SMARCA4,257
chr1,156601622,156601841,SRX5716470,SMARCA4,219
chr1,156602777,156603059,SRX16500059,CTCF,282
chr1,156602788,156603009,SRX16500060,CTCF,221
chr1,156602808,156603042,SRX16500062,CTCF,234
chr1,156607701,156607894,SRX5054309,FOSL2,193
chr1,156608022,156608470,SRX16500059,CTCF,448
chr1,156608048,156608480,SRX16500062,CTCF,432
chr1,156608061,156608418,SRX5075174,SMARCA4,357
chr1,156608061,156608477,SRX5075168,SMARCA4,416
chr1,156608071,156608500,SRX16500060,CTCF,429
chr1,156608075,156608407,SRX5075170,SMARCA4,332
chr1,156608080,156608511,SRX16500061,CTCF,431
chr1,156608084,156608330,SRX5075175,SMARCA4,246
chr1,156608085,156608327,SRX5716469,SMARCA4,242
chr1,156608087,156608364,SRX5075169,SMARCA4,277
chr1,156608089,156608402,SRX5716470,SMARCA4,313
chr1,156608090,156608317,SRX5716463,SMARCA4,227
chr1,156608093,156608378,SRX5075176,SMARCA4,285
chr1,156608095,156608323,SRX5716464,SMARCA4,228
chr1,156608099,156608367,SRX4174629,CTCF,268
chr1,156609022,156609352,SRX4174629,CTCF,330
chr1,156609060,156609439,SRX16500060,CTCF,379
chr1,156609073,156609490,SRX16500059,CTCF,417
chr1,156609081,156609477,SRX16500062,CTCF,396
chr1,156609082,156609436,SRX16500061,CTCF,354
chr1,156616486,156616773,SRX5075169,SMARCA4,287
chr1,156619349,156619705,SRX16500059,CTCF,356
chr1,156619380,156619601,SRX16500060,CTCF,221
chr1,156619387,156619669,SRX4174629,CTCF,282
chr1,156625670,156626206,SRX16500060,CTCF,536
chr1,156625719,156626235,SRX16500061,CTCF,516
chr1,156625753,156626266,SRX16500059,CTCF,513
chr1,156625803,156626219,SRX16500062,CTCF,416
chr1,156625868,156626310,SRX4174629,CTCF,442
chr1,156625962,156626137,SRX5075174,SMARCA4,175
chr1,156627405,156627756,SRX16500060,CTCF,351
chr1,156627433,156627777,SRX16500061,CTCF,344
chr1,156627433,156627781,SRX16500062,CTCF,348
chr1,156627440,156627769,SRX5075174,SMARCA4,329
chr1,156627445,156627805,SRX16500059,CTCF,360
chr1,156627473,156627796,SRX5075168,SMARCA4,323
chr1,156627478,156627736,SRX5075176,SMARCA4,258
chr1,156627481,156627737,SRX5075170,SMARCA4,256
chr1,156627486,156627711,SRX5075169,SMARCA4,225
chr1,156627510,156627754,SRX5716463,SMARCA4,244
chr1,156627542,156627761,SRX5716464,SMARCA4,219
chr1,156641824,156642254,SRX5075168,SMARCA4,430
chr1,156641830,156642161,SRX5075170,SMARCA4,331
chr1,156641833,156642407,SRX20140895,INTS13,574
chr1,156641882,156642249,SRX5075174,SMARCA4,367
chr1,156641889,156642104,SRX5075176,SMARCA4,215
chr1,156652072,156652252,SRX5075169,SMARCA4,180
chr1,156652077,156652294,SRX5075176,SMARCA4,217
chr1,156652108,156652328,SRX5075170,SMARCA4,220
chr1,156657433,156657873,SRX16500060,CTCF,440
chr1,156657435,156657836,SRX16500061,CTCF,401
chr1,156657446,156657848,SRX16500059,CTCF,402
chr1,156657470,156657820,SRX16500062,CTCF,350
chr1,156657502,156657692,SRX5075169,SMARCA4,190
chr1,156657505,156657695,SRX5075174,SMARCA4,190
chr1,156657526,156657736,SRX4174629,CTCF,210
chr1,156659844,156660443,SRX16500059,CTCF,599
chr1,156659847,156660450,SRX16500061,CTCF,603
chr1,156659847,156660479,SRX16500060,CTCF,632
chr1,156659850,156660404,SRX16500062,CTCF,554
chr1,156659927,156660479,SRX4174629,CTCF,552
chr1,156660016,156660546,SRX5075174,SMARCA4,530
chr1,156660046,156660470,SRX5075169,SMARCA4,424
chr1,156660047,156660455,SRX5075168,SMARCA4,408
chr1,156660055,156660426,SRX5716470,SMARCA4,371
chr1,156660060,156660502,SRX5075170,SMARCA4,442
chr1,156660073,156660283,SRX5716463,SMARCA4,210
chr1,156660079,156660332,SRX5716464,SMARCA4,253
chr1,156660085,156660501,SRX5075176,SMARCA4,416
chr1,156660125,156660443,SRX5075175,SMARCA4,318
chr1,156660132,156660469,SRX5054307,FOSL2,337
chr1,156660148,156660504,SRX5054308,FOSL2,356
chr1,156660151,156660530,SRX5054309,FOSL2,379
chr1,156660172,156660396,SRX5020214,SMARCA2,224
chr1,156660177,156660399,SRX5020211,SMARCA2,222
chr1,156660184,156660455,SRX5716467,SMARCA2,271
chr1,156661361,156661619,SRX5054309,FOSL2,258
chr1,156661384,156661592,SRX5075176,SMARCA4,208
chr1,156661394,156661642,SRX5054308,FOSL2,248
chr1,156664372,156664742,SRX5716464,SMARCA4,370
chr1,156664446,156664736,SRX5075168,SMARCA4,290
chr1,156664485,156665223,SRX20140867,INTS10,738
chr1,156664489,156664693,SRX5716463,SMARCA4,204
chr1,156664494,156664693,SRX5075174,SMARCA4,199
chr1,156664628,156665053,SRX20140881,CPSF3L,425
chr1,156664711,156665064,SRX20140895,INTS13,353
chr1,156664788,156665113,SRX20140868,INTS10,325
chr1,156667585,156667917,SRX5075176,SMARCA4,332
chr1,156667610,156667895,SRX5075170,SMARCA4,285
chr1,156673641,156674184,SRX5075174,SMARCA4,543
chr1,156673650,156674209,SRX5075168,SMARCA4,559
chr1,156673727,156674005,SRX20140867,INTS10,278
chr1,156673748,156674093,SRX5716454,SOX3,345
chr1,156673758,156674073,SRX5716463,SMARCA4,315
chr1,156673761,156674052,SRX20140879,CPSF3L,291
chr1,156673771,156674134,SRX5716451,SOX2,363
chr1,156673795,156674415,SRX20140895,INTS13,620
chr1,156673855,156674096,SRX5075170,SMARCA4,241
chr1,156677033,156677662,SRX20140895,INTS13,629
chr1,156677062,156677468,SRX20140897,INTS13,406
chr1,156677097,156677631,SRX20140867,INTS10,534
chr1,156677104,156677571,SRX20140881,CPSF3L,467
chr1,156677113,156677519,SRX20140896,INTS13,406
chr1,156677132,156677593,SRX20140894,INTS13,461
chr1,156677134,156677530,SRX20140880,CPSF3L,396
chr1,156677147,156677569,SRX20140879,CPSF3L,422
chr1,156677191,156677643,SRX20140868,INTS10,452
chr1,156677242,156677570,SRX20140869,INTS10,328
chr1,156677307,156677576,SRX5075168,SMARCA4,269
chr1,156677967,156678423,SRX16500059,CTCF,456
chr1,156677999,156678472,SRX16500060,CTCF,473
chr1,156678012,156678420,SRX16500061,CTCF,408
chr1,156678019,156678372,SRX4174629,CTCF,353
chr1,156678030,156678280,SRX5075169,SMARCA4,250
chr1,156678043,156678289,SRX5075176,SMARCA4,246
chr1,156678045,156678403,SRX16500062,CTCF,358
chr1,156678081,156678289,SRX5075170,SMARCA4,208
chr1,156678094,156678289,SRX5075174,SMARCA4,195
chr1,156678116,156678342,SRX5075168,SMARCA4,226
chr1,156688945,156689905,SRX16500059,CTCF,960
chr1,156688986,156689899,SRX16500060,CTCF,913
chr1,156688993,156689874,SRX16500062,CTCF,881
chr1,156689004,156689855,SRX4174629,CTCF,851
chr1,156689043,156689902,SRX16500061,CTCF,859
chr1,156689540,156689825,SRX5075174,SMARCA4,285
chr1,156689591,156689870,SRX5075170,SMARCA4,279
chr1,156689602,156689861,SRX5075176,SMARCA4,259
chr1,156689612,156689801,SRX5075168,SMARCA4,189
chr1,156689657,156689837,SRX5054308,FOSL2,180
chr1,156689682,156689904,SRX5075175,SMARCA4,222
chr1,156691672,156691857,SRX5075169,SMARCA4,185
chr1,156692924,156693236,SRX5075169,SMARCA4,312
chr1,156692927,156693268,SRX5716469,SMARCA4,341
chr1,156692960,156693259,SRX5075176,SMARCA4,299
chr1,156692963,156693220,SRX5716470,SMARCA4,257
chr1,156692968,156693302,SRX5075170,SMARCA4,334
chr1,156692971,156693217,SRX5075175,SMARCA4,246
chr1,156692990,156693242,SRX5716467,SMARCA2,252
chr1,156692999,156693244,SRX5075174,SMARCA4,245
chr1,156693005,156693460,SRX5075168,SMARCA4,455
chr1,156693080,156693317,SRX5716464,SMARCA4,237
chr1,156693121,156693495,SRX20140895,INTS13,374
chr1,156705034,156705306,SRX5054309,FOSL2,272
chr1,156705080,156705319,SRX5054308,FOSL2,239
chr1,156705419,156705868,SRX20140895,INTS13,449
chr1,156705856,156706368,SRX16500061,CTCF,512
chr1,156705895,156706421,SRX16500059,CTCF,526
chr1,156705900,156706408,SRX16500060,CTCF,508
chr1,156705911,156706340,SRX4174629,CTCF,429
chr1,156705923,156706356,SRX16500062,CTCF,433
chr1,156705925,156706536,SRX20140895,INTS13,611
chr1,156705975,156706349,SRX5075168,SMARCA4,374
chr1,156706027,156706423,SRX5075174,SMARCA4,396
chr1,156706172,156706468,SRX20140868,INTS10,296
chr1,156707945,156708208,SRX5075169,SMARCA4,263
chr1,156707986,156708230,SRX5075176,SMARCA4,244
chr1,156707998,156708244,SRX5075175,SMARCA4,246
chr1,156708025,156708288,SRX5075170,SMARCA4,263
chr1,156708034,156708277,SRX5716467,SMARCA2,243
chr1,156713366,156713600,SRX5054308,FOSL2,234
chr1,156713405,156713644,SRX5054309,FOSL2,239
chr1,156714891,156715161,SRX5716470,SMARCA4,270
chr1,156714894,156715163,SRX5716469,SMARCA4,269
chr1,156714894,156715183,SRX5075176,SMARCA4,289
chr1,156714922,156715164,SRX5075170,SMARCA4,242
chr1,156714932,156715124,SRX5075175,SMARCA4,192
chr1,156714940,156715127,SRX5075169,SMARCA4,187
chr1,156725693,156726265,SRX16500059,CTCF,572
chr1,156725710,156726239,SRX4174629,CTCF,529
chr1,156725736,156726230,SRX16500062,CTCF,494
chr1,156725742,156726234,SRX16500060,CTCF,492
chr1,156725759,156726275,SRX16500061,CTCF,516
chr1,156725801,156726022,SRX5075174,SMARCA4,221
chr1,156725809,156726025,SRX5075176,SMARCA4,216
chr1,156725824,156726080,SRX5075170,SMARCA4,256
chr1,156725824,156726132,SRX5075168,SMARCA4,308
chr1,156726568,156726941,SRX16500060,CTCF,373
chr1,156726590,156726867,SRX16500059,CTCF,277
chr1,156726633,156726869,SRX16500062,CTCF,236
chr1,156726638,156726910,SRX16500061,CTCF,272
chr1,156728365,156728944,SRX20140895,INTS13,579
chr1,156728380,156728775,SRX20140897,INTS13,395
chr1,156728406,156728885,SRX20140867,INTS10,479
chr1,156728440,156728794,SRX20140869,INTS10,354
chr1,156728454,156728809,SRX20140881,CPSF3L,355
chr1,156728458,156728781,SRX20140868,INTS10,323
chr1,156728475,156728806,SRX20140879,CPSF3L,331
chr1,156728514,156729052,SRX5075174,SMARCA4,538
chr1,156728631,156729053,SRX5075168,SMARCA4,422
chr1,156728929,156729247,SRX5075176,SMARCA4,318
chr1,156728967,156729154,SRX5075175,SMARCA4,187
chr1,156740793,156741357,SRX20140895,INTS13,564
chr1,156740869,156741575,SRX5075174,SMARCA4,706
chr1,156740921,156741368,SRX5716463,SMARCA4,447
chr1,156740962,156741289,SRX5075170,SMARCA4,327
chr1,156740971,156741332,SRX20140868,INTS10,361
chr1,156741046,156741304,SRX20140867,INTS10,258
chr1,156741049,156741620,SRX5075168,SMARCA4,571
chr1,156741087,156741531,SRX5075176,SMARCA4,444
chr1,156741093,156741420,SRX5716454,SOX3,327
chr1,156741106,156741400,SRX5716464,SMARCA4,294
chr1,156741111,156741341,SRX5716451,SOX2,230
chr1,156741138,156741340,SRX5054307,FOSL2,202
chr1,156741144,156741396,SRX5054309,FOSL2,252
chr1,156741211,156741434,SRX5054308,FOSL2,223
chr1,156746403,156747042,SRX20140895,INTS13,639
chr1,156746640,156747065,SRX20140868,INTS10,425
chr1,156746723,156747004,SRX20140869,INTS10,281
chr1,156746728,156747016,SRX20140897,INTS13,288
chr1,156746742,156747214,SRX5075168,SMARCA4,472
chr1,156746757,156747237,SRX5075174,SMARCA4,480
chr1,156746789,156747145,SRX20140881,CPSF3L,356
chr1,156746807,156747223,SRX5075169,SMARCA4,416
chr1,156746823,156747081,SRX5716463,SMARCA4,258
chr1,156746828,156747094,SRX20140894,INTS13,266
chr1,156746839,156747377,SRX5716469,SMARCA4,538
chr1,156746843,156747144,SRX20140867,INTS10,301
chr1,156746845,156747146,SRX5716464,SMARCA4,301
chr1,156746853,156747403,SRX5075170,SMARCA4,550
chr1,156746971,156747217,SRX5716467,SMARCA2,246
chr1,156746985,156747334,SRX5054308,FOSL2,349
chr1,156747010,156747335,SRX5054309,FOSL2,325
chr1,156747048,156747235,SRX5075175,SMARCA4,187
chr1,156747052,156747284,SRX5054307,FOSL2,232
chr1,156747080,156747465,SRX5716470,SMARCA4,385
chr1,156747229,156747273,SRX1424893,POU3F2,44
chr1,156747232,156747276,SRX1424894,POU3F2,44
chr1,156747232,156747277,SRX1424891,POU3F2,45
chr1,156747293,156747468,SRX5075176,SMARCA4,175
chr1,156747324,156747571,SRX5075168,SMARCA4,247
chr1,156747395,156747630,SRX16500059,CTCF,235
chr1,156751671,156752273,SRX20140895,INTS13,602
chr1,156751749,156752021,SRX5075168,SMARCA4,272
chr1,156751787,156751996,SRX5716464,SMARCA4,209
chr1,156751791,156752124,SRX5075174,SMARCA4,333
chr1,156751802,156752280,SRX20140868,INTS10,478
chr1,156751809,156752053,SRX20140897,INTS13,244
chr1,156751816,156752082,SRX20140869,INTS10,266
chr1,156751833,156752020,SRX5075170,SMARCA4,187
chr1,156751838,156752219,SRX20140867,INTS10,381
chr1,156751897,156752187,SRX20140879,CPSF3L,290
chr1,156751901,156752162,SRX20140881,CPSF3L,261
chr1,156766898,156767247,SRX5716463,SMARCA4,349
chr1,156766935,156767150,SRX5716470,SMARCA4,215
chr1,156766957,156767366,SRX5075174,SMARCA4,409
chr1,156766988,156767346,SRX5075176,SMARCA4,358
chr1,156766997,156767263,SRX5075170,SMARCA4,266
chr1,156767051,156767317,SRX5075168,SMARCA4,266
chr1,156767064,156767885,SRX20140895,INTS13,821
chr1,156767112,156767417,SRX5054309,FOSL2,305
chr1,156767115,156767385,SRX5054308,FOSL2,270
chr1,156767162,156767504,SRX5716454,SOX3,342
chr1,156767204,156767525,SRX5716451,SOX2,321
chr1,156767205,156767568,SRX20140879,CPSF3L,363
chr1,156767407,156767702,SRX20140869,INTS10,295
chr1,156767541,156767785,SRX20140897,INTS13,244
chr1,156767549,156767810,SRX20140868,INTS10,261
chr1,156781520,156781917,SRX5054308,FOSL2,397
chr1,156781554,156781952,SRX5075169,SMARCA4,398
chr1,156781637,156781917,SRX5054309,FOSL2,280
chr1,156781685,156781883,SRX5075175,SMARCA4,198
chr1,156781714,156781914,SRX5020211,SMARCA2,200
chr1,156797226,156797744,SRX16500062,CTCF,518
chr1,156797237,156797739,SRX16500059,CTCF,502
chr1,156797282,156797727,SRX16500060,CTCF,445
chr1,156797292,156797778,SRX16500061,CTCF,486
chr1,156797361,156797623,SRX5075174,SMARCA4,262
chr1,156797384,156797697,SRX4174629,CTCF,313
chr1,156797446,156797642,SRX5075168,SMARCA4,196
chr1,156798449,156798692,SRX5054308,FOSL2,243
chr1,156798476,156798687,SRX5075175,SMARCA4,211
chr1,156801364,156801976,SRX5075176,SMARCA4,612
chr1,156801380,156801810,SRX5075170,SMARCA4,430
chr1,156801431,156801815,SRX5716470,SMARCA4,384
chr1,156801561,156801817,SRX5716468,SMARCA2,256
chr1,156801627,156801829,SRX5075169,SMARCA4,202
chr1,156806136,156806530,SRX5075170,SMARCA4,394
chr1,156806172,156806441,SRX5716470,SMARCA4,269
chr1,156806178,156806429,SRX5716469,SMARCA4,251
chr1,156806180,156806502,SRX5075176,SMARCA4,322
chr1,156806211,156806436,SRX5075169,SMARCA4,225
chr1,156806222,156806463,SRX5020211,SMARCA2,241
chr1,156813709,156814138,SRX16500059,CTCF,429
chr1,156813798,156814095,SRX16500060,CTCF,297
chr1,156813822,156814049,SRX16500062,CTCF,227
chr1,156813908,156814086,SRX5075174,SMARCA4,178
chr1,156815383,156815644,SRX5075170,SMARCA4,261
chr1,156815387,156815653,SRX5075169,SMARCA4,266
chr1,156815476,156815675,SRX5075175,SMARCA4,199
chr1,156826684,156827007,SRX5716467,SMARCA2,323
chr1,156826702,156826963,SRX5075176,SMARCA4,261
chr1,156826712,156827017,SRX5075170,SMARCA4,305
chr1,156826723,156826972,SRX5716470,SMARCA4,249
chr1,156826741,156826985,SRX5075169,SMARCA4,244
chr1,156826748,156826967,SRX5716469,SMARCA4,219
chr1,156838834,156839350,SRX16500061,CTCF,516
chr1,156838834,156839449,SRX16500060,CTCF,615
chr1,156838840,156839396,SRX16500059,CTCF,556
chr1,156838844,156839417,SRX16500062,CTCF,573
chr1,156838873,156839083,SRX4174629,CTCF,210
chr1,156838933,156839205,SRX5075174,SMARCA4,272
chr1,156838945,156839196,SRX5075168,SMARCA4,251
chr1,156839027,156839212,SRX5075176,SMARCA4,185
chr1,156839036,156839245,SRX5075175,SMARCA4,209
chr1,156859193,156859556,SRX20140868,INTS10,363
chr1,156859916,156860534,SRX4174629,CTCF,618
chr1,156860003,156860563,SRX16500059,CTCF,560
chr1,156860004,156860486,SRX16500060,CTCF,482
chr1,156860017,156860449,SRX16500061,CTCF,432
chr1,156860039,156860501,SRX16500062,CTCF,462
chr1,156860070,156860272,SRX5075168,SMARCA4,202
chr1,156860092,156860380,SRX5075174,SMARCA4,288
chr1,156860115,156860303,SRX5075170,SMARCA4,188
chr1,156860133,156860308,SRX5075176,SMARCA4,175
chr1,156870687,156871182,SRX5075170,SMARCA4,495
chr1,156870696,156871141,SRX5075175,SMARCA4,445
chr1,156870720,156871177,SRX5075169,SMARCA4,457
chr1,156870744,156871143,SRX5075176,SMARCA4,399
chr1,156870747,156871074,SRX5054309,FOSL2,327
chr1,156870801,156871034,SRX5054308,FOSL2,233
chr1,156884628,156884856,SRX5075176,SMARCA4,228
chr1,156890084,156890496,SRX4174629,CTCF,412
chr1,156890094,156890537,SRX16500059,CTCF,443
chr1,156890117,156890610,SRX16500060,CTCF,493
chr1,156890132,156890532,SRX16500062,CTCF,400
chr1,156890133,156890481,SRX16500061,CTCF,348
chr1,156890149,156890383,SRX5075174,SMARCA4,234
chr1,156890166,156890341,SRX5075176,SMARCA4,175
chr1,156890173,156890373,SRX5075168,SMARCA4,200
chr1,156892200,156892618,SRX16500059,CTCF,418
chr1,156892207,156892634,SRX16500060,CTCF,427
chr1,156892261,156892636,SRX16500061,CTCF,375
chr1,156892270,156892602,SRX16500062,CTCF,332
chr1,156892288,156892594,SRX5075174,SMARCA4,306
chr1,156892327,156892624,SRX5716463,SMARCA4,297
chr1,156892348,156892598,SRX5075168,SMARCA4,250
chr1,156892370,156892614,SRX5075176,SMARCA4,244
chr1,156892373,156892557,SRX5075170,SMARCA4,184
chr1,156896664,156896888,SRX5054309,FOSL2,224
chr1,156896716,156896982,SRX5075174,SMARCA4,266
chr1,156896790,156897043,SRX5075168,SMARCA4,253
chr1,156902517,156902796,SRX5075175,SMARCA4,279
chr1,156902528,156902826,SRX5716470,SMARCA4,298
chr1,156902537,156902833,SRX5075170,SMARCA4,296
chr1,156902557,156902837,SRX5075176,SMARCA4,280
chr1,156902570,156902856,SRX5716467,SMARCA2,286
chr1,156902577,156902835,SRX5716468,SMARCA2,258
chr1,156910144,156910668,SRX16500060,CTCF,524
chr1,156910156,156910713,SRX16500059,CTCF,557
chr1,156910194,156910589,SRX16500061,CTCF,395
chr1,156910196,156910667,SRX16500062,CTCF,471
chr1,156910224,156910482,SRX4174629,CTCF,258
chr1,156910289,156910604,SRX5716463,SMARCA4,315
chr1,156910326,156910604,SRX5075168,SMARCA4,278
chr1,156910351,156910564,SRX5075174,SMARCA4,213
chr1,156920304,156920773,SRX16500062,CTCF,469
chr1,156920336,156920832,SRX16500059,CTCF,496
chr1,156920342,156920725,SRX5075174,SMARCA4,383
chr1,156920348,156920794,SRX16500060,CTCF,446
chr1,156920350,156920728,SRX5716463,SMARCA4,378
chr1,156920361,156920793,SRX16500061,CTCF,432
chr1,156920384,156920704,SRX5075170,SMARCA4,320
chr1,156920389,156920705,SRX5075168,SMARCA4,316
chr1,156920394,156920678,SRX5075175,SMARCA4,284
chr1,156920433,156920688,SRX5075169,SMARCA4,255
chr1,156920442,156920679,SRX5716464,SMARCA4,237
chr1,156920448,156920688,SRX5075176,SMARCA4,240
chr1,156927708,156928218,SRX16500060,CTCF,510
chr1,156927716,156928202,SRX16500059,CTCF,486
chr1,156927773,156928197,SRX16500062,CTCF,424
chr1,156927795,156928152,SRX16500061,CTCF,357
chr1,156927834,156928105,SRX5075174,SMARCA4,271
chr1,157004277,157004539,SRX5075170,SMARCA4,262
chr1,157004313,157004524,SRX5716470,SMARCA4,211
chr1,157004344,157004548,SRX5075176,SMARCA4,204
chr1,157004400,157004613,SRX5075175,SMARCA4,213
chr1,157004709,157004950,SRX5075176,SMARCA4,241
chr1,157033397,157033650,SRX5075174,SMARCA4,253
chr1,157045418,157046403,SRX20140895,INTS13,985
chr1,157045505,157046107,SRX5075170,SMARCA4,602
chr1,157045546,157045833,SRX20140897,INTS13,287
chr1,157045548,157046248,SRX20140868,INTS10,700
chr1,157045551,157046096,SRX5075175,SMARCA4,545
chr1,157045562,157045761,SRX5075169,SMARCA4,199
chr1,157045570,157046158,SRX5075174,SMARCA4,588
chr1,157045578,157046158,SRX5716470,SMARCA4,580
chr1,157045594,157046187,SRX5075168,SMARCA4,593
chr1,157045613,157045879,SRX20140869,INTS10,266
chr1,157045637,157046107,SRX5075176,SMARCA4,470
chr1,157045656,157046176,SRX20140867,INTS10,520
chr1,157074251,157074588,SRX16500060,CTCF,337
chr1,157074267,157074548,SRX16500059,CTCF,281
chr1,157074320,157074690,SRX16500061,CTCF,370
chr1,157081739,157082099,SRX5075176,SMARCA4,360
chr1,157081753,157082097,SRX5075170,SMARCA4,344
chr1,157081783,157082054,SRX5075175,SMARCA4,271
chr1,157081792,157082035,SRX5075169,SMARCA4,243
chr1,157081792,157082045,SRX5054309,FOSL2,253
chr1,157081849,157082072,SRX5054308,FOSL2,223
chr1,157090025,157090564,SRX16500060,CTCF,539
chr1,157090072,157090567,SRX16500059,CTCF,495
chr1,157090083,157090527,SRX16500061,CTCF,444
chr1,157090103,157090590,SRX16500062,CTCF,487
chr1,157090169,157090479,SRX5075168,SMARCA4,310
chr1,157090175,157090515,SRX4174629,CTCF,340
chr1,157090189,157090497,SRX5075174,SMARCA4,308
chr1,157090217,157090587,SRX5716470,SMARCA4,370
chr1,157090218,157090756,SRX5075170,SMARCA4,538
chr1,157090237,157090605,SRX5075169,SMARCA4,368
chr1,157090246,157090513,SRX5716463,SMARCA4,267
chr1,157090275,157090767,SRX5075176,SMARCA4,492
chr1,157090279,157090618,SRX5075175,SMARCA4,339
chr1,157090281,157090598,SRX5716469,SMARCA4,317
chr1,157090312,157090558,SRX5075181,SMARCA2,246
chr1,157090350,157090615,SRX5716467,SMARCA2,265
chr1,157093019,157093208,SRX5075176,SMARCA4,189
chr1,157104580,157105067,SRX5075174,SMARCA4,487
chr1,157104667,157105018,SRX5075168,SMARCA4,351
chr1,157104692,157104944,SRX5075170,SMARCA4,252
chr1,157104706,157104938,SRX5075169,SMARCA4,232
chr1,157104710,157104921,SRX5054309,FOSL2,211
chr1,157104710,157104952,SRX5075176,SMARCA4,242
chr1,157106424,157106817,SRX5075169,SMARCA4,393
chr1,157106452,157106865,SRX5716469,SMARCA4,413
chr1,157106489,157106837,SRX5075170,SMARCA4,348
chr1,157106495,157106849,SRX5075176,SMARCA4,354
chr1,157106500,157106820,SRX5075175,SMARCA4,320
chr1,157138089,157139000,SRX20140895,INTS13,911
chr1,157138317,157138791,SRX20140867,INTS10,474
chr1,157138330,157138948,SRX20140868,INTS10,618
chr1,157138333,157138929,SRX5075174,SMARCA4,596
chr1,157138376,157138811,SRX5075168,SMARCA4,435
chr1,157138412,157138745,SRX5075169,SMARCA4,333
chr1,157138418,157138829,SRX5075170,SMARCA4,411
chr1,157138441,157138727,SRX5054309,FOSL2,286
chr1,157138451,157138965,SRX5075176,SMARCA4,514
chr1,157138481,157138940,SRX5075175,SMARCA4,459
chr1,157138493,157138880,SRX5716470,SMARCA4,387
chr1,157138502,157138796,SRX5716463,SMARCA4,294
chr1,157138504,157138891,SRX5716469,SMARCA4,387
chr1,157138548,157138881,SRX20140897,INTS13,333
chr1,157139012,157139221,SRX5075170,SMARCA4,209
chr1,157139107,157139318,SRX5716470,SMARCA4,211
chr1,157145201,157145452,SRX5054309,FOSL2,251
chr1,157145203,157145453,SRX5054308,FOSL2,250
chr1,157145255,157145442,SRX5075175,SMARCA4,187
chr1,157145314,157145522,SRX5075170,SMARCA4,208
chr1,157155936,157156441,SRX16500061,CTCF,505
chr1,157155939,157156474,SRX16500060,CTCF,535
chr1,157155953,157156535,SRX16500059,CTCF,582
chr1,157155961,157156398,SRX5075174,SMARCA4,437
chr1,157155969,157156398,SRX5075168,SMARCA4,429
chr1,157155986,157156499,SRX16500062,CTCF,513
chr1,157156001,157156377,SRX5716470,SMARCA4,376
chr1,157156007,157156306,SRX5716463,SMARCA4,299
chr1,157156009,157156304,SRX5075169,SMARCA4,295
chr1,157156012,157156320,SRX5075170,SMARCA4,308
chr1,157156023,157156406,SRX4174629,CTCF,383
chr1,157156025,157156311,SRX5716469,SMARCA4,286
chr1,157156046,157156346,SRX5075176,SMARCA4,300
chr1,157156062,157156342,SRX5075175,SMARCA4,280
chr1,157157542,157157804,SRX5054309,FOSL2,262
chr1,157157565,157157799,SRX5054308,FOSL2,234
chr1,157163484,157164074,SRX16500062,CTCF,590
chr1,157163500,157164048,SRX16500061,CTCF,548
chr1,157163528,157164062,SRX16500060,CTCF,534
chr1,157163582,157164068,SRX16500059,CTCF,486
chr1,157163646,157163995,SRX5075174,SMARCA4,349
chr1,157163690,157163914,SRX4174629,CTCF,224
chr1,157163701,157163933,SRX5716464,SMARCA4,232
chr1,157163711,157163992,SRX5075168,SMARCA4,281
chr1,157163714,157163900,SRX5075170,SMARCA4,186
chr1,157163732,157163948,SRX5075176,SMARCA4,216
chr1,157163787,157163970,SRX5075169,SMARCA4,183
chr1,157170729,157171087,SRX16500061,CTCF,358
chr1,157170752,157171021,SRX16500062,CTCF,269
chr1,157170758,157171103,SRX16500059,CTCF,345
chr1,157170760,157171107,SRX16500060,CTCF,347
chr1,157171900,157172300,SRX16500060,CTCF,400
chr1,157171902,157172312,SRX16500062,CTCF,410
chr1,157171929,157172317,SRX16500061,CTCF,388
chr1,157171942,157172344,SRX16500059,CTCF,402
chr1,157171950,157172276,SRX4174629,CTCF,326
chr1,157171996,157172300,SRX5075174,SMARCA4,304
chr1,157172000,157172186,SRX5075170,SMARCA4,186
chr1,157172012,157172227,SRX5716463,SMARCA4,215
chr1,157172015,157172290,SRX5075168,SMARCA4,275
chr1,157172019,157172235,SRX5716464,SMARCA4,216
chr1,157172022,157172252,SRX5075176,SMARCA4,230
chr1,157193593,157193986,SRX16500062,CTCF,393
chr1,157193602,157193998,SRX16500059,CTCF,396
chr1,157193638,157193981,SRX16500060,CTCF,343
chr1,157193640,157194012,SRX16500061,CTCF,372
chr1,157193738,157193935,SRX5075170,SMARCA4,197
chr1,157196879,157197298,SRX16500061,CTCF,419
chr1,157196886,157197363,SRX16500060,CTCF,477
chr1,157196892,157197275,SRX16500059,CTCF,383
chr1,157196929,157197290,SRX16500062,CTCF,361
chr1,157196936,157197222,SRX5716463,SMARCA4,286
chr1,157196953,157197233,SRX5075174,SMARCA4,280
chr1,157196954,157197256,SRX5075168,SMARCA4,302
chr1,157196956,157197220,SRX5075176,SMARCA4,264
chr1,157196995,157197234,SRX4174629,CTCF,239
chr1,157197008,157197239,SRX5075170,SMARCA4,231
chr1,157274908,157275154,SRX5054309,FOSL2,246
chr1,157311138,157311369,SRX16500061,CTCF,231
chr1,157311158,157311483,SRX16500060,CTCF,325
chr1,157311174,157311510,SRX16500062,CTCF,336
chr1,157311180,157311512,SRX16500059,CTCF,332
chr1,157363556,157363934,SRX16500061,CTCF,378
chr1,157363568,157363945,SRX16500059,CTCF,377
chr1,157363598,157363893,SRX16500060,CTCF,295
chr1,157363614,157363843,SRX16500062,CTCF,229
chr1,157369825,157370376,SRX16500059,CTCF,551
chr1,157369849,157370181,SRX4174629,CTCF,332
chr1,157369851,157370330,SRX16500062,CTCF,479
chr1,157369865,157370380,SRX16500061,CTCF,515
chr1,157369900,157370445,SRX16500060,CTCF,545
chr1,157369990,157370235,SRX5075174,SMARCA4,245
chr1,157370007,157370235,SRX5075168,SMARCA4,228
chr1,157377157,157377666,SRX16500059,CTCF,509
chr1,157377224,157377721,SRX16500060,CTCF,497
chr1,157377250,157377658,SRX16500062,CTCF,408
chr1,157377258,157377652,SRX16500061,CTCF,394
chr1,157377265,157377664,SRX5075168,SMARCA4,399
chr1,157377331,157377571,SRX5075174,SMARCA4,240
chr1,157377342,157377585,SRX5716463,SMARCA4,243
chr1,157377345,157377548,SRX5075170,SMARCA4,203
chr1,157377360,157377560,SRX5075175,SMARCA4,200
chr1,157377362,157377630,SRX5716464,SMARCA4,268
chr1,157377375,157377562,SRX5075176,SMARCA4,187
chr1,157390679,157391059,SRX5054309,FOSL2,380
chr1,157390703,157391022,SRX5075176,SMARCA4,319
chr1,157390734,157391057,SRX5075170,SMARCA4,323
chr1,157390762,157391037,SRX5075175,SMARCA4,275
chr1,157390763,157391049,SRX5075169,SMARCA4,286
chr1,157390768,157391042,SRX5054308,FOSL2,274
chr1,157489350,157489818,SRX16500061,CTCF,468
chr1,157489352,157489791,SRX16500060,CTCF,439
chr1,157489372,157489776,SRX16500059,CTCF,404
chr1,157489373,157489777,SRX16500062,CTCF,404
chr1,157489415,157489678,SRX5075174,SMARCA4,263
chr1,157489417,157489628,SRX5075175,SMARCA4,211
chr1,157489426,157489658,SRX5075168,SMARCA4,232
chr1,157489441,157489654,SRX5075176,SMARCA4,213
chr1,157489447,157489660,SRX5075170,SMARCA4,213
chr1,157489822,157490058,SRX4174629,CTCF,236
chr1,157490576,157490919,SRX16500062,CTCF,343
chr1,157490576,157490992,SRX16500061,CTCF,416
chr1,157490599,157490938,SRX16500060,CTCF,339
chr1,157490608,157490964,SRX16500059,CTCF,356
chr1,157495943,157496526,SRX16500059,CTCF,583
chr1,157495965,157496468,SRX16500062,CTCF,503
chr1,157495974,157496497,SRX16500060,CTCF,523
chr1,157496015,157496458,SRX16500061,CTCF,443
chr1,157496088,157496400,SRX5075168,SMARCA4,312
chr1,157496101,157496398,SRX5075174,SMARCA4,297
chr1,157496117,157496396,SRX4174629,CTCF,279
chr1,157505592,157506017,SRX16500059,CTCF,425
chr1,157505595,157506146,SRX16500060,CTCF,551
chr1,157505607,157506111,SRX16500062,CTCF,504
chr1,157505655,157506071,SRX16500061,CTCF,416
chr1,157505694,157505904,SRX4174629,CTCF,210
chr1,157505750,157505940,SRX5075174,SMARCA4,190
chr1,157505756,157505941,SRX5075168,SMARCA4,185
chr1,157580148,157580602,SRX16500060,CTCF,454
chr1,157580158,157580606,SRX16500059,CTCF,448
chr1,157580161,157580560,SRX16500061,CTCF,399
chr1,157580167,157580462,SRX4174629,CTCF,295
chr1,157580167,157580566,SRX16500062,CTCF,399
chr1,157580226,157580574,SRX5075168,SMARCA4,348
chr1,157580228,157580600,SRX5075174,SMARCA4,372
chr1,157580235,157580559,SRX5716470,SMARCA4,324
chr1,157580238,157580534,SRX5075169,SMARCA4,296
chr1,157580244,157580513,SRX5716464,SMARCA4,269
chr1,157580246,157580556,SRX5716463,SMARCA4,310
chr1,157580263,157580565,SRX5075170,SMARCA4,302
chr1,157580272,157580541,SRX5075176,SMARCA4,269
chr1,157580279,157580528,SRX5075175,SMARCA4,249
chr1,157580286,157580498,SRX5716469,SMARCA4,212
chr1,157691264,157691701,SRX16500059,CTCF,437
chr1,157691327,157691729,SRX16500061,CTCF,402
chr1,157691339,157691718,SRX16500060,CTCF,379
chr1,157691372,157691676,SRX16500062,CTCF,304
chr1,157770518,157770766,SRX16500060,CTCF,248
chr1,157773755,157773974,SRX16500061,CTCF,219
chr1,157878049,157878442,SRX16500059,CTCF,393
chr1,157878053,157878404,SRX16500060,CTCF,351
chr1,157878188,157878399,SRX16500062,CTCF,211
chr1,157948484,157948951,SRX16500059,CTCF,467
chr1,157948528,157948800,SRX4174629,CTCF,272
chr1,157948553,157948923,SRX16500060,CTCF,370
chr1,157948554,157948921,SRX16500062,CTCF,367
chr1,157948556,157948848,SRX5075168,SMARCA4,292
chr1,157948581,157948923,SRX16500061,CTCF,342
chr1,157948592,157948852,SRX5075174,SMARCA4,260
chr1,157962393,157962661,SRX5054309,FOSL2,268
chr1,157963581,157964049,SRX16500059,CTCF,468
chr1,157963584,157964016,SRX16500062,CTCF,432
chr1,157963585,157964066,SRX16500060,CTCF,481
chr1,157963594,157964039,SRX16500061,CTCF,445
chr1,157963689,157964056,SRX4174629,CTCF,367
chr1,157963728,157963944,SRX5716463,SMARCA4,216
chr1,157963738,157963962,SRX5075174,SMARCA4,224
chr1,157963742,157963958,SRX5075168,SMARCA4,216
chr1,157966138,157966390,SRX5075169,SMARCA4,252
chr1,157968542,157968757,SRX5075176,SMARCA4,215
chr1,157968552,157968842,SRX5075170,SMARCA4,290
chr1,157968984,157969248,SRX5075170,SMARCA4,264
chr1,157969021,157969271,SRX5075176,SMARCA4,250
chr1,157969660,157970159,SRX16500061,CTCF,499
chr1,157969665,157970128,SRX16500062,CTCF,463
chr1,157969678,157970031,SRX5054308,FOSL2,353
chr1,157969699,157970023,SRX5054309,FOSL2,324
chr1,157969716,157970156,SRX16500060,CTCF,440
chr1,157969732,157970019,SRX5075175,SMARCA4,287
chr1,157969735,157970180,SRX16500059,CTCF,445
chr1,157969750,157970074,SRX5075169,SMARCA4,324
chr1,157969756,157970065,SRX5075170,SMARCA4,309
chr1,157969760,157970028,SRX5020214,SMARCA2,268
chr1,157969768,157970032,SRX5075176,SMARCA4,264
chr1,157969790,157970061,SRX5075168,SMARCA4,271
chr1,157969797,157970117,SRX4174629,CTCF,320
chr1,157975173,157975597,SRX5075174,SMARCA4,424
chr1,157975296,157975559,SRX5075168,SMARCA4,263
chr1,157991903,157992399,SRX16500062,CTCF,496
chr1,157991909,157992406,SRX16500059,CTCF,497
chr1,157991923,157992379,SRX16500061,CTCF,456
chr1,157991933,157992362,SRX16500060,CTCF,429
chr1,157991941,157992335,SRX4174629,CTCF,394
chr1,157992046,157992221,SRX5075176,SMARCA4,175
chr1,157992048,157992238,SRX5075168,SMARCA4,190
chr1,157992057,157992260,SRX5075174,SMARCA4,203
chr1,157992064,157992252,SRX5075170,SMARCA4,188
chr1,157993434,157993633,SRX5075175,SMARCA4,199
chr1,157993441,157993772,SRX5075170,SMARCA4,331
chr1,157993466,157993983,SRX20140895,INTS13,517
chr1,157993486,157993753,SRX5075176,SMARCA4,267
chr1,157993529,157993988,SRX20140868,INTS10,459
chr1,157993580,157993818,SRX5075169,SMARCA4,238
chr1,157993600,157993780,SRX5075174,SMARCA4,180
chr1,158002648,158003132,SRX5075174,SMARCA4,484
chr1,158002788,158003046,SRX5716470,SMARCA4,258
chr1,158003080,158003353,SRX5075170,SMARCA4,273
chr1,158009759,158009968,SRX5054309,FOSL2,209
chr1,158009787,158009969,SRX5075174,SMARCA4,182
chr1,158009792,158009977,SRX5075168,SMARCA4,185
chr1,158010612,158011115,SRX5716469,SMARCA4,503
chr1,158010666,158011146,SRX5075175,SMARCA4,480
chr1,158010678,158011139,SRX5020211,SMARCA2,461
chr1,158010698,158011239,SRX5075169,SMARCA4,541
chr1,158010699,158011211,SRX5075170,SMARCA4,512
chr1,158010707,158011259,SRX5075176,SMARCA4,552
chr1,158010734,158011131,SRX5716470,SMARCA4,397
chr1,158010744,158011095,SRX5716467,SMARCA2,351
chr1,158010745,158011176,SRX5054309,FOSL2,431
chr1,158010753,158011131,SRX5054308,FOSL2,378
chr1,158010757,158011202,SRX5020214,SMARCA2,445
chr1,158010758,158011076,SRX5716468,SMARCA2,318
chr1,158010819,158011059,SRX5075181,SMARCA2,240
chr1,158010819,158011152,SRX5075182,SMARCA2,333
chr1,158010893,158011125,SRX5075174,SMARCA4,232
chr1,158014260,158014442,SRX5075168,SMARCA4,182
chr1,158019441,158019977,SRX5075170,SMARCA4,536
chr1,158019458,158019954,SRX5075175,SMARCA4,496
chr1,158019477,158019987,SRX5716470,SMARCA4,510
chr1,158019489,158020057,SRX5075169,SMARCA4,568
chr1,158019492,158019921,SRX5075174,SMARCA4,429
chr1,158019496,158019900,SRX5075168,SMARCA4,404
chr1,158019499,158019982,SRX5075176,SMARCA4,483
chr1,158019502,158020044,SRX5716469,SMARCA4,542
chr1,158019528,158019849,SRX5075182,SMARCA2,321
chr1,158019538,158019866,SRX5716468,SMARCA2,328
chr1,158019544,158019952,SRX5054309,FOSL2,408
chr1,158019552,158019911,SRX5716467,SMARCA2,359
chr1,158019555,158019834,SRX5716463,SMARCA4,279
chr1,158019556,158019840,SRX5075181,SMARCA2,284
chr1,158019556,158019873,SRX5020211,SMARCA2,317
chr1,158019557,158019796,SRX5716464,SMARCA4,239
chr1,158019571,158019865,SRX5054308,FOSL2,294
chr1,158019607,158019908,SRX20140897,INTS13,301
chr1,158029058,158029233,SRX5075176,SMARCA4,175
chr1,158035958,158036411,SRX16500061,CTCF,453
chr1,158035976,158036431,SRX16500059,CTCF,455
chr1,158035981,158036391,SRX16500060,CTCF,410
chr1,158036002,158036415,SRX16500062,CTCF,413
chr1,158036009,158036293,SRX5075168,SMARCA4,284
chr1,158036033,158036274,SRX5075174,SMARCA4,241
chr1,158037845,158038097,SRX5075170,SMARCA4,252
chr1,158037909,158038096,SRX5075175,SMARCA4,187
chr1,158037974,158038162,SRX5075169,SMARCA4,188
chr1,158043291,158043664,SRX5075168,SMARCA4,373
chr1,158043297,158043674,SRX5075174,SMARCA4,377
chr1,158043322,158043800,SRX20140895,INTS13,478
chr1,158043328,158043642,SRX20140868,INTS10,314
chr1,158043377,158043607,SRX5716463,SMARCA4,230
chr1,158043407,158043723,SRX5716451,SOX2,316
chr1,158045701,158045947,SRX5075168,SMARCA4,246
chr1,158049930,158050123,SRX5075176,SMARCA4,193
chr1,158058220,158058505,SRX5075170,SMARCA4,285
chr1,158060153,158060328,SRX5075174,SMARCA4,175
chr1,158087214,158087790,SRX16500061,CTCF,576
chr1,158087217,158087830,SRX16500060,CTCF,613
chr1,158087227,158087758,SRX4174629,CTCF,531
chr1,158087227,158087853,SRX16500059,CTCF,626
chr1,158087235,158087779,SRX16500062,CTCF,544
chr1,158087307,158087692,SRX5075168,SMARCA4,385
chr1,158087355,158087625,SRX5075170,SMARCA4,270
chr1,158087360,158087639,SRX5075176,SMARCA4,279
chr1,158087364,158087633,SRX5075175,SMARCA4,269
chr1,158087376,158087571,SRX5075169,SMARCA4,195
chr1,158087404,158087673,SRX5075174,SMARCA4,269
chr1,158087482,158087695,SRX5716464,SMARCA4,213
chr1,158095708,158096170,SRX16500059,CTCF,462
chr1,158095744,158096132,SRX16500060,CTCF,388
chr1,158095796,158096091,SRX16500061,CTCF,295
chr1,158095827,158096082,SRX16500062,CTCF,255
chr1,158102047,158102256,SRX5054309,FOSL2,209
chr1,158113363,158113683,SRX5075175,SMARCA4,320
chr1,158113382,158113701,SRX5075169,SMARCA4,319
chr1,158113387,158113808,SRX5075170,SMARCA4,421
chr1,158113390,158113738,SRX20140895,INTS13,348
chr1,158113390,158113818,SRX5075174,SMARCA4,428
chr1,158113396,158113838,SRX5075168,SMARCA4,442
chr1,158113434,158113794,SRX5716470,SMARCA4,360
chr1,158113451,158113862,SRX16500060,CTCF,411
chr1,158113481,158113878,SRX16500059,CTCF,397
chr1,158113483,158113696,SRX5716469,SMARCA4,213
chr1,158113487,158113811,SRX5075176,SMARCA4,324
chr1,158113512,158113833,SRX16500062,CTCF,321
chr1,158113549,158113856,SRX16500061,CTCF,307
chr1,158117840,158118152,SRX16500060,CTCF,312
chr1,158117865,158118204,SRX16500059,CTCF,339
chr1,158117869,158118091,SRX16500062,CTCF,222
chr1,158117915,158118120,SRX5075174,SMARCA4,205
chr1,158121657,158122008,SRX16500061,CTCF,351
chr1,158121660,158122025,SRX16500060,CTCF,365
chr1,158121664,158122029,SRX16500059,CTCF,365
chr1,158121670,158121996,SRX16500062,CTCF,326
chr1,158124934,158125335,SRX16500061,CTCF,401
chr1,158124937,158125325,SRX16500060,CTCF,388
chr1,158124938,158125341,SRX16500062,CTCF,403
chr1,158124944,158125350,SRX16500059,CTCF,406
chr1,158124965,158125270,SRX4174629,CTCF,305
chr1,158124980,158125295,SRX5716463,SMARCA4,315
chr1,158124989,158125321,SRX5075169,SMARCA4,332
chr1,158125008,158125363,SRX5075174,SMARCA4,355
chr1,158125009,158125347,SRX5075168,SMARCA4,338
chr1,158125034,158125303,SRX5075176,SMARCA4,269
chr1,158125040,158125251,SRX5716470,SMARCA4,211
chr1,158125053,158125357,SRX5075170,SMARCA4,304
chr1,158125066,158125326,SRX5054309,FOSL2,260
chr1,158145241,158145510,SRX5075175,SMARCA4,269
chr1,158145252,158145427,SRX5075176,SMARCA4,175
chr1,158145259,158145567,SRX5075170,SMARCA4,308
chr1,158145264,158145512,SRX5075169,SMARCA4,248
chr1,158149698,158149937,SRX5075168,SMARCA4,239
chr1,158177761,158178110,SRX5075174,SMARCA4,349
chr1,158177791,158178089,SRX5075168,SMARCA4,298
chr1,158177855,158178060,SRX5716464,SMARCA4,205
chr1,158186305,158186577,SRX20140869,INTS10,272
chr1,158203709,158204285,SRX16500060,CTCF,576
chr1,158203709,158204300,SRX16500059,CTCF,591
chr1,158203766,158204360,SRX16500062,CTCF,594
chr1,158203778,158204255,SRX16500061,CTCF,477
chr1,158203864,158204119,SRX5075174,SMARCA4,255
chr1,158203912,158204132,SRX5075168,SMARCA4,220
chr1,158203999,158204329,SRX4174629,CTCF,330
chr1,158274889,158275175,SRX5075174,SMARCA4,286
chr1,158283776,158284391,SRX5075174,SMARCA4,615
chr1,158283804,158284474,SRX5075168,SMARCA4,670
chr1,158283829,158284317,SRX5716463,SMARCA4,488
chr1,158391133,158391446,SRX5054309,FOSL2,313
chr1,158391188,158391520,SRX5054308,FOSL2,332
chr1,158422197,158422617,SRX5075174,SMARCA4,420
chr1,158422199,158422611,SRX5075168,SMARCA4,412
chr1,158422211,158422615,SRX5716463,SMARCA4,404
chr1,158422297,158422533,SRX5716464,SMARCA4,236
chr1,158496373,158496765,SRX16500060,CTCF,392
chr1,158496426,158496645,SRX16500061,CTCF,219
chr1,158496450,158496692,SRX16500059,CTCF,242
chr1,158506371,158506753,SRX16500059,CTCF,382
chr1,158506422,158506742,SRX16500060,CTCF,320
chr1,158506435,158506722,SRX16500061,CTCF,287
chr1,158506476,158506691,SRX16500062,CTCF,215
chr1,158509510,158509885,SRX5075176,SMARCA4,375
chr1,158509579,158510037,SRX5075170,SMARCA4,458
chr1,158562301,158562489,SRX5054309,FOSL2,188
chr1,158586987,158587310,SRX5075174,SMARCA4,323
chr1,158587112,158587304,SRX5075168,SMARCA4,192
chr1,158798490,158798749,SRX16500062,CTCF,259
chr1,158864630,158864983,SRX5075168,SMARCA4,353
chr1,158864688,158864906,SRX5075174,SMARCA4,218
chr1,158998516,158999143,SRX16500059,CTCF,627
chr1,158998562,158999145,SRX16500060,CTCF,583
chr1,158998604,158999206,SRX16500061,CTCF,602
chr1,158998638,158999147,SRX16500062,CTCF,509
chr1,158998867,158999149,SRX4174629,CTCF,282
chr1,158999490,159000152,SRX5075174,SMARCA4,662
chr1,158999550,158999975,SRX20140895,INTS13,425
chr1,158999588,159000040,SRX5716469,SMARCA4,452
chr1,158999605,159000145,SRX5075170,SMARCA4,540
chr1,158999647,158999977,SRX5716470,SMARCA4,330
chr1,158999684,158999968,SRX5716451,SOX2,284
chr1,158999692,158999957,SRX5716463,SMARCA4,265
chr1,158999701,158999929,SRX5716464,SMARCA4,228
chr1,158999710,159000171,SRX5075168,SMARCA4,461
chr1,158999713,159000059,SRX5075169,SMARCA4,346
chr1,158999765,159000164,SRX5075176,SMARCA4,399
chr1,159000494,159000865,SRX5716460,Epitope tags,371
chr1,159000621,159000991,SRX5075176,SMARCA4,370
chr1,159000636,159000994,SRX5075170,SMARCA4,358
chr1,159000644,159001002,SRX5075169,SMARCA4,358
chr1,159000645,159000975,SRX5716470,SMARCA4,330
chr1,159000652,159000984,SRX5075175,SMARCA4,332
chr1,159000663,159000940,SRX5716467,SMARCA2,277
chr1,159000681,159000919,SRX5716469,SMARCA4,238
chr1,159000694,159001003,SRX5054308,FOSL2,309
chr1,159000711,159001038,SRX5054309,FOSL2,327
chr1,159000725,159000995,SRX5075168,SMARCA4,270
chr1,159000736,159000995,SRX5075174,SMARCA4,259
chr1,159009436,159010071,SRX5075170,SMARCA4,635
chr1,159009468,159010084,SRX5054308,FOSL2,616
chr1,159009521,159010110,SRX5075169,SMARCA4,589
chr1,159009574,159010086,SRX5075176,SMARCA4,512
chr1,159009575,159010037,SRX5716469,SMARCA4,462
chr1,159009631,159009955,SRX5716470,SMARCA4,324
chr1,159009640,159010061,SRX5054309,FOSL2,421
chr1,159009658,159010069,SRX5075175,SMARCA4,411
chr1,159009701,159009916,SRX5716467,SMARCA2,215
chr1,159009758,159010030,SRX5075174,SMARCA4,272
chr1,159015519,159015816,SRX5054308,FOSL2,297
chr1,159015537,159015818,SRX5054309,FOSL2,281
chr1,159015562,159015765,SRX5075176,SMARCA4,203
chr1,159015614,159015799,SRX5075170,SMARCA4,185
chr1,159054411,159054766,SRX20140895,INTS13,355
chr1,159054447,159054659,SRX5075174,SMARCA4,212
chr1,159054502,159054690,SRX5054308,FOSL2,188
chr1,159054505,159054730,SRX20140867,INTS10,225
chr1,159071939,159072390,SRX16500061,CTCF,451
chr1,159071939,159072413,SRX16500060,CTCF,474
chr1,159071963,159072390,SRX16500062,CTCF,427
chr1,159071991,159072389,SRX16500059,CTCF,398
chr1,159072034,159072349,SRX5075174,SMARCA4,315
chr1,159072036,159072205,SRX5075170,SMARCA4,169
chr1,159072055,159072274,SRX5075168,SMARCA4,219
chr1,159089164,159089637,SRX16500059,CTCF,473
chr1,159089196,159089534,SRX16500061,CTCF,338
chr1,159089196,159089561,SRX16500060,CTCF,365
chr1,159089207,159089515,SRX5075174,SMARCA4,308
chr1,159089249,159089549,SRX16500062,CTCF,300
chr1,159089276,159089455,SRX5075168,SMARCA4,179
chr1,159090960,159091149,SRX5054309,FOSL2,189
chr1,159092107,159092354,SRX5075170,SMARCA4,247
chr1,159092130,159092389,SRX5054308,FOSL2,259
chr1,159092132,159092409,SRX5054309,FOSL2,277
chr1,159092164,159092360,SRX5075176,SMARCA4,196
chr1,159122125,159122372,SRX5054308,FOSL2,247
chr1,159122134,159122395,SRX5054309,FOSL2,261
chr1,159126098,159126277,SRX5075168,SMARCA4,179
chr1,159132233,159132748,SRX16500061,CTCF,515
chr1,159132236,159132698,SRX16500059,CTCF,462
chr1,159132284,159132716,SRX16500060,CTCF,432
chr1,159132286,159132661,SRX16500062,CTCF,375
chr1,159132350,159132613,SRX5075174,SMARCA4,263
chr1,159132364,159132637,SRX5075168,SMARCA4,273
chr1,159132370,159132581,SRX5716470,SMARCA4,211
chr1,159132374,159132618,SRX4174629,CTCF,244
chr1,159132402,159132578,SRX5075170,SMARCA4,176
chr1,159141837,159142258,SRX20140895,INTS13,421
chr1,159141983,159142247,SRX5075174,SMARCA4,264
chr1,159141994,159142254,SRX5075168,SMARCA4,260
chr1,159160815,159161546,SRX4174629,CTCF,731
chr1,159160911,159161450,SRX16500059,CTCF,539
chr1,159160938,159161464,SRX16500060,CTCF,526
chr1,159160940,159161402,SRX16500061,CTCF,462
chr1,159160966,159161428,SRX16500062,CTCF,462
chr1,159161045,159161343,SRX5716464,SMARCA4,298
chr1,159161049,159161400,SRX5075168,SMARCA4,351
chr1,159161068,159161377,SRX5075174,SMARCA4,309
chr1,159161071,159161302,SRX5716470,SMARCA4,231
chr1,159161074,159161354,SRX5716469,SMARCA4,280
chr1,159161074,159161658,SRX5075170,SMARCA4,584
chr1,159161076,159161384,SRX5075175,SMARCA4,308
chr1,159161088,159161398,SRX5075176,SMARCA4,310
chr1,159161090,159161363,SRX5716463,SMARCA4,273
chr1,159161094,159161362,SRX5075169,SMARCA4,268
chr1,159161140,159161345,SRX5020214,SMARCA2,205
chr1,159161477,159161747,SRX5075176,SMARCA4,270
chr1,159161493,159161738,SRX5054309,FOSL2,245
chr1,159161534,159161764,SRX5054308,FOSL2,230
chr1,159171315,159171974,SRX20140895,INTS13,659
chr1,159171428,159171859,SRX20140868,INTS10,431
chr1,159177279,159177618,SRX5716470,SMARCA4,339
chr1,159177293,159177562,SRX5075175,SMARCA4,269
chr1,159177302,159177609,SRX5075176,SMARCA4,307
chr1,159177304,159177612,SRX5075170,SMARCA4,308
chr1,159177310,159177618,SRX5075169,SMARCA4,308
chr1,159177315,159177606,SRX5075168,SMARCA4,291
chr1,159177338,159177586,SRX5075174,SMARCA4,248
chr1,159188119,159188735,SRX20140895,INTS13,616
chr1,159188381,159188764,SRX5075174,SMARCA4,383
chr1,159188431,159188654,SRX20140867,INTS10,223
chr1,159188431,159188795,SRX5075168,SMARCA4,364
chr1,159188473,159188765,SRX5716463,SMARCA4,292
chr1,159197886,159198363,SRX4174629,CTCF,477
chr1,159197893,159198406,SRX16500061,CTCF,513
chr1,159197922,159198417,SRX16500059,CTCF,495
chr1,159197942,159198412,SRX16500060,CTCF,470
chr1,159197949,159198398,SRX16500062,CTCF,449
chr1,159197985,159198310,SRX5075168,SMARCA4,325
chr1,159198001,159198290,SRX5075174,SMARCA4,289
chr1,159211499,159211915,SRX16500062,CTCF,416
chr1,159211503,159211936,SRX16500059,CTCF,433
chr1,159211509,159212007,SRX16500060,CTCF,498
chr1,159211530,159211973,SRX16500061,CTCF,443
chr1,159211577,159211776,SRX5075168,SMARCA4,199
chr1,159211584,159211850,SRX4174629,CTCF,266
chr1,159211590,159211821,SRX5075174,SMARCA4,231
chr1,159214078,159214551,SRX16500060,CTCF,473
chr1,159214107,159214557,SRX16500059,CTCF,450
chr1,159214134,159214514,SRX16500062,CTCF,380
chr1,159214139,159214529,SRX16500061,CTCF,390
chr1,159214165,159214410,SRX4174629,CTCF,245
chr1,159214215,159214459,SRX5075168,SMARCA4,244
chr1,159574572,159574612,SRX1424891,POU3F2,40
chr1,159780437,159780900,SRX16500062,CTCF,463
chr1,159780453,159780940,SRX16500060,CTCF,487
chr1,159780458,159780949,SRX16500059,CTCF,491
chr1,159780467,159780990,SRX5075176,SMARCA4,523
chr1,159780479,159780886,SRX16500061,CTCF,407
chr1,159780496,159780859,SRX5020211,SMARCA2,363
chr1,159780510,159780894,SRX4174629,CTCF,384
chr1,159780531,159780928,SRX5716463,SMARCA4,397
chr1,159780547,159781089,SRX5075174,SMARCA4,542
chr1,159780566,159780972,SRX5716464,SMARCA4,406
chr1,159780574,159781063,SRX5075170,SMARCA4,489
chr1,159780586,159781059,SRX5075168,SMARCA4,473
chr1,159780607,159780843,SRX5075169,SMARCA4,236
chr1,159780614,159780871,SRX5075175,SMARCA4,257
chr1,159780652,159780918,SRX5716469,SMARCA4,266
chr1,159780659,159780890,SRX5054308,FOSL2,231
chr1,159780703,159781219,SRX5716470,SMARCA4,516
chr1,159780765,159781155,SRX20140897,INTS13,390
chr1,159781024,159781204,SRX5075169,SMARCA4,180
chr1,159790271,159790751,SRX16500059,CTCF,480
chr1,159790300,159790708,SRX16500061,CTCF,408
chr1,159790304,159790681,SRX16500062,CTCF,377
chr1,159790336,159790794,SRX16500060,CTCF,458
chr1,159798781,159799381,SRX16500059,CTCF,600
chr1,159798789,159799256,SRX16500061,CTCF,467
chr1,159798791,159799279,SRX16500060,CTCF,488
chr1,159798791,159799279,SRX4174629,CTCF,488
chr1,159798828,159799270,SRX16500062,CTCF,442
chr1,159798932,159799164,SRX5075174,SMARCA4,232
chr1,159798933,159799133,SRX5075170,SMARCA4,200
chr1,159798937,159799227,SRX5075176,SMARCA4,290
chr1,159829198,159829603,SRX16500060,CTCF,405
chr1,159829226,159829681,SRX16500059,CTCF,455
chr1,159829251,159829522,SRX16500062,CTCF,271
chr1,159829322,159829624,SRX16500061,CTCF,302
chr1,159849074,159849265,SRX5075168,SMARCA4,191
chr1,159849084,159849329,SRX5075170,SMARCA4,245
chr1,159849090,159849264,SRX5075174,SMARCA4,174
chr1,159854574,159855004,SRX5716470,SMARCA4,430
chr1,159854590,159855008,SRX5075176,SMARCA4,418
chr1,159854653,159854866,SRX5075168,SMARCA4,213
chr1,159854696,159854935,SRX5075170,SMARCA4,239
chr1,159854730,159854983,SRX5075169,SMARCA4,253
chr1,159854752,159854968,SRX5075174,SMARCA4,216
chr1,159854807,159855044,SRX5075175,SMARCA4,237
chr1,159869157,159869387,SRX5075169,SMARCA4,230
chr1,159869224,159869573,SRX5075175,SMARCA4,349
chr1,159869268,159869579,SRX5075176,SMARCA4,311
chr1,159869304,159869532,SRX5075170,SMARCA4,228
chr1,159881845,159882276,SRX5075176,SMARCA4,431
chr1,159881857,159882269,SRX5075170,SMARCA4,412
chr1,159881894,159882350,SRX5075169,SMARCA4,456
chr1,159881915,159882269,SRX5054309,FOSL2,354
chr1,159881963,159882289,SRX5075175,SMARCA4,326
chr1,159881970,159882273,SRX5054308,FOSL2,303
chr1,159881999,159882295,SRX5716469,SMARCA4,296
chr1,159889804,159890316,SRX5075169,SMARCA4,512
chr1,159889816,159890282,SRX5075170,SMARCA4,466
chr1,159889819,159890269,SRX5075176,SMARCA4,450
chr1,159889875,159890201,SRX5020211,SMARCA2,326
chr1,159889883,159890301,SRX5075175,SMARCA4,418
chr1,159889912,159890260,SRX5054309,FOSL2,348
chr1,159889924,159890266,SRX5054308,FOSL2,342
chr1,159889945,159890150,SRX5020214,SMARCA2,205
chr1,159889951,159890215,SRX5716467,SMARCA2,264
chr1,159889988,159890218,SRX5716469,SMARCA4,230
chr1,159890003,159890278,SRX5075174,SMARCA4,275
chr1,159890013,159890198,SRX5075182,SMARCA2,185
chr1,159890040,159890255,SRX5075168,SMARCA4,215
chr1,159891412,159892001,SRX4174629,CTCF,589
chr1,159891513,159891969,SRX16500062,CTCF,456
chr1,159891522,159891934,SRX16500060,CTCF,412
chr1,159891527,159891944,SRX16500059,CTCF,417
chr1,159891530,159891953,SRX16500061,CTCF,423
chr1,159899976,159900376,SRX5716464,SMARCA4,400
chr1,159900017,159900405,SRX5075174,SMARCA4,388
chr1,159900025,159900415,SRX5075168,SMARCA4,390
chr1,159900049,159900329,SRX5716463,SMARCA4,280
chr1,159900063,159900308,SRX5075170,SMARCA4,245
chr1,159910409,159910888,SRX5075174,SMARCA4,479
chr1,159910511,159910777,SRX5075168,SMARCA4,266
chr1,159916110,159916546,SRX5075176,SMARCA4,436
chr1,159916221,159916580,SRX5075169,SMARCA4,359
chr1,159916259,159916505,SRX5075175,SMARCA4,246
chr1,159916268,159916582,SRX5075168,SMARCA4,314
chr1,159916363,159916571,SRX5075174,SMARCA4,208
chr1,159918149,159918483,SRX5075170,SMARCA4,334
chr1,159918179,159918359,SRX5075169,SMARCA4,180
chr1,159924478,159924837,SRX5075170,SMARCA4,359
chr1,159924482,159924910,SRX5716469,SMARCA4,428
chr1,159924483,159924785,SRX5054309,FOSL2,302
chr1,159924488,159924921,SRX5716470,SMARCA4,433
chr1,159924491,159924863,SRX5075176,SMARCA4,372
chr1,159924491,159924877,SRX5075169,SMARCA4,386
chr1,159924495,159924839,SRX5075175,SMARCA4,344
chr1,159924502,159924820,SRX5054308,FOSL2,318
chr1,159924556,159924848,SRX5716467,SMARCA2,292
chr1,159924559,159924816,SRX5075181,SMARCA2,257
chr1,159924977,159925610,SRX20140881,CPSF3L,633
chr1,159925124,159925762,SRX5075174,SMARCA4,638
chr1,159925133,159925468,SRX20140895,INTS13,335
chr1,159925182,159925471,SRX20140867,INTS10,289
chr1,159925282,159925743,SRX5075168,SMARCA4,461
chr1,159925305,159925577,SRX5716463,SMARCA4,272
chr1,159925409,159925654,SRX5075175,SMARCA4,245
chr1,159925448,159925658,SRX5075170,SMARCA4,210
chr1,159925461,159925663,SRX5075176,SMARCA4,202
chr1,159936271,159936852,SRX16500059,CTCF,581
chr1,159936317,159936851,SRX16500060,CTCF,534
chr1,159936339,159936819,SRX16500062,CTCF,480
chr1,159936340,159936846,SRX16500061,CTCF,506
chr1,159936443,159936798,SRX4174629,CTCF,355
chr1,159936486,159936733,SRX5075174,SMARCA4,247
chr1,159936518,159936727,SRX5075168,SMARCA4,209
chr1,159941205,159941435,SRX5075174,SMARCA4,230
chr1,159941244,159941424,SRX5075168,SMARCA4,180
chr1,159945427,159945918,SRX5075174,SMARCA4,491
chr1,159945454,159946002,SRX5075168,SMARCA4,548
chr1,159945460,159945990,SRX5075176,SMARCA4,530
chr1,159945475,159946064,SRX20140895,INTS13,589
chr1,159945500,159945887,SRX5716463,SMARCA4,387
chr1,159945519,159946055,SRX16500059,CTCF,536
chr1,159945543,159945918,SRX5075169,SMARCA4,375
chr1,159945563,159946044,SRX16500060,CTCF,481
chr1,159945568,159945836,SRX5716470,SMARCA4,268
chr1,159945570,159945864,SRX5716464,SMARCA4,294
chr1,159945577,159946011,SRX5075170,SMARCA4,434
chr1,159945604,159946005,SRX16500061,CTCF,401
chr1,159945631,159945875,SRX20140897,INTS13,244
chr1,159945660,159946036,SRX16500062,CTCF,376
chr1,159945685,159946058,SRX20140868,INTS10,373
chr1,159945711,159946005,SRX20140879,CPSF3L,294
chr1,160006283,160006825,SRX16500059,CTCF,542
chr1,160006303,160006774,SRX16500060,CTCF,471
chr1,160006316,160006734,SRX16500061,CTCF,418
chr1,160006318,160006711,SRX16500062,CTCF,393
chr1,160006336,160006672,SRX4174629,CTCF,336
chr1,160006390,160006615,SRX5075168,SMARCA4,225
chr1,160006424,160006621,SRX5075174,SMARCA4,197
chr1,160007246,160007801,SRX4174629,CTCF,555
chr1,160007469,160007990,SRX16500060,CTCF,521
chr1,160007536,160007969,SRX16500061,CTCF,433
chr1,160007548,160007980,SRX16500059,CTCF,432
chr1,160007569,160007965,SRX16500062,CTCF,396
chr1,160007601,160007780,SRX5075168,SMARCA4,179
chr1,160025270,160025467,SRX5075168,SMARCA4,197
chr1,160031534,160031749,SRX5075169,SMARCA4,215
chr1,160031657,160032306,SRX5075176,SMARCA4,649
chr1,160031739,160032247,SRX5075174,SMARCA4,508
chr1,160031795,160032349,SRX5075168,SMARCA4,554
chr1,160031817,160032297,SRX5075170,SMARCA4,480
chr1,160031910,160032270,SRX5716463,SMARCA4,360
chr1,160031911,160032291,SRX5075169,SMARCA4,380
chr1,160031956,160032146,SRX5054307,FOSL2,190
chr1,160031979,160032260,SRX5716470,SMARCA4,281
chr1,160031991,160032196,SRX5716464,SMARCA4,205
chr1,160032072,160032296,SRX5075175,SMARCA4,224
chr1,160046607,160047025,SRX16500062,CTCF,418
chr1,160046618,160047098,SRX16500059,CTCF,480
chr1,160046630,160046959,SRX5716470,SMARCA4,329
chr1,160046637,160047037,SRX16500060,CTCF,400
chr1,160046679,160046974,SRX5075168,SMARCA4,295
chr1,160046682,160047033,SRX16500061,CTCF,351
chr1,160046686,160046908,SRX5075176,SMARCA4,222
chr1,160046693,160046996,SRX5075174,SMARCA4,303
chr1,160046753,160046958,SRX5716464,SMARCA4,205
chr1,160046785,160047007,SRX5075169,SMARCA4,222
chr1,160053667,160054007,SRX20140895,INTS13,340
chr1,160053678,160053874,SRX5075168,SMARCA4,196
chr1,160053692,160053929,SRX20140867,INTS10,237
chr1,160053704,160053974,SRX20140868,INTS10,270
chr1,160053736,160053930,SRX5075174,SMARCA4,194
chr1,160053744,160053957,SRX5716454,SOX3,213
chr1,160062123,160062460,SRX20140895,INTS13,337
chr1,160062143,160062519,SRX5075174,SMARCA4,376
chr1,160062188,160062481,SRX5075168,SMARCA4,293
chr1,160070108,160070667,SRX5075174,SMARCA4,559
chr1,160070238,160070585,SRX5075168,SMARCA4,347
chr1,160070309,160070563,SRX5075170,SMARCA4,254
chr1,160070587,160070767,SRX5075169,SMARCA4,180
chr1,160078564,160079060,SRX16500059,CTCF,496
chr1,160078607,160078998,SRX16500060,CTCF,391
chr1,160078628,160078980,SRX16500061,CTCF,352
chr1,160078643,160078964,SRX16500062,CTCF,321
chr1,160085493,160086014,SRX16500060,CTCF,521
chr1,160085512,160086011,SRX16500059,CTCF,499
chr1,160085571,160085964,SRX16500062,CTCF,393
chr1,160085598,160085988,SRX16500061,CTCF,390
chr1,160085649,160085960,SRX5075168,SMARCA4,311
chr1,160085660,160085947,SRX5075174,SMARCA4,287
chr1,160085684,160085957,SRX5075170,SMARCA4,273
chr1,160085721,160085939,SRX5075176,SMARCA4,218
chr1,160085729,160085939,SRX4174629,CTCF,210
chr1,160085762,160085983,SRX5716463,SMARCA4,221
chr1,160098537,160099216,SRX5054307,FOSL2,679
chr1,160098707,160099073,SRX5054308,FOSL2,366
chr1,160098725,160099150,SRX5054309,FOSL2,425
chr1,160098956,160099295,SRX5075168,SMARCA4,339
chr1,160098992,160099275,SRX5075174,SMARCA4,283
chr1,160099006,160099227,SRX5075176,SMARCA4,221
chr1,160099012,160099190,SRX5075170,SMARCA4,178
chr1,160099037,160099255,SRX5716463,SMARCA4,218
chr1,160100883,160101400,SRX16500061,CTCF,517
chr1,160100883,160101468,SRX16500060,CTCF,585
chr1,160100903,160101410,SRX16500062,CTCF,507
chr1,160100907,160101410,SRX4174629,CTCF,503
chr1,160100931,160101397,SRX16500059,CTCF,466
chr1,160101054,160101298,SRX5075168,SMARCA4,244
chr1,160101060,160101321,SRX5075174,SMARCA4,261
chr1,160101121,160101324,SRX5075176,SMARCA4,203
chr1,160104093,160104450,SRX5075176,SMARCA4,357
chr1,160104191,160104370,SRX5075170,SMARCA4,179
chr1,160108883,160109301,SRX16500059,CTCF,418
chr1,160108888,160109378,SRX16500060,CTCF,490
chr1,160108889,160109306,SRX16500061,CTCF,417
chr1,160108919,160109340,SRX16500062,CTCF,421
chr1,160109023,160109382,SRX5716470,SMARCA4,359
chr1,160109038,160109301,SRX5716463,SMARCA4,263
chr1,160109040,160109247,SRX5075174,SMARCA4,207
chr1,160109067,160109599,SRX5075176,SMARCA4,532
chr1,160109081,160109298,SRX5075168,SMARCA4,217
chr1,160109085,160109628,SRX5075175,SMARCA4,543
chr1,160109091,160109898,SRX5075170,SMARCA4,807
chr1,160109152,160109709,SRX5075169,SMARCA4,557
chr1,160109228,160109664,SRX5716467,SMARCA2,436
chr1,160109428,160109720,SRX20140867,INTS10,292
chr1,160109682,160110002,SRX5075176,SMARCA4,320
chr1,160117851,160118247,SRX5075170,SMARCA4,396
chr1,160117872,160118251,SRX5075176,SMARCA4,379
chr1,160117895,160118168,SRX5716470,SMARCA4,273
chr1,160117958,160118216,SRX5716469,SMARCA4,258
chr1,160124595,160125027,SRX5075176,SMARCA4,432
chr1,160124736,160125145,SRX5075168,SMARCA4,409
chr1,160124749,160125267,SRX5075174,SMARCA4,518
chr1,160124765,160125023,SRX5054309,FOSL2,258
chr1,160124792,160125167,SRX5075170,SMARCA4,375
chr1,160124801,160125032,SRX5075175,SMARCA4,231
chr1,160124891,160125086,SRX5075169,SMARCA4,195
chr1,160124976,160125188,SRX5716469,SMARCA4,212
chr1,160128276,160128500,SRX5054309,FOSL2,224
chr1,160128286,160128504,SRX5054308,FOSL2,218
chr1,160149713,160150093,SRX5075170,SMARCA4,380
chr1,160149761,160150070,SRX5075176,SMARCA4,309
chr1,160149774,160150007,SRX5716470,SMARCA4,233
chr1,160149793,160150099,SRX5075169,SMARCA4,306
chr1,160149794,160150044,SRX5716467,SMARCA2,250
chr1,160149805,160150042,SRX5054309,FOSL2,237
chr1,160149852,160150078,SRX5075175,SMARCA4,226
chr1,160162294,160162636,SRX16500060,CTCF,342
chr1,160162339,160162561,SRX16500062,CTCF,222
chr1,160162369,160162719,SRX16500059,CTCF,350
chr1,160168608,160168906,SRX5054309,FOSL2,298
chr1,160168696,160168883,SRX5054308,FOSL2,187
chr1,160168707,160168997,SRX5075176,SMARCA4,290
chr1,160168721,160169012,SRX5075170,SMARCA4,291
chr1,160168741,160168945,SRX5075175,SMARCA4,204
chr1,160168742,160169026,SRX5716470,SMARCA4,284
chr1,160169132,160169482,SRX16500060,CTCF,350
chr1,160169390,160169936,SRX5075176,SMARCA4,546
chr1,160169422,160169898,SRX5075169,SMARCA4,476
chr1,160169428,160169934,SRX5075168,SMARCA4,506
chr1,160169481,160169971,SRX5075170,SMARCA4,490
chr1,160169484,160169948,SRX5075174,SMARCA4,464
chr1,160169492,160169950,SRX20140867,INTS10,458
chr1,160169504,160169867,SRX5075175,SMARCA4,363
chr1,160169504,160169875,SRX5716464,SMARCA4,371
chr1,160169506,160169888,SRX5716469,SMARCA4,382
chr1,160169517,160169825,SRX20140895,INTS13,308
chr1,160169560,160169874,SRX5716470,SMARCA4,314
chr1,160169562,160169992,SRX20140881,CPSF3L,430
chr1,160169606,160169916,SRX5716463,SMARCA4,310
chr1,160169646,160169907,SRX20140868,INTS10,261
chr1,160172074,160172264,SRX5075174,SMARCA4,190
chr1,160189716,160190018,SRX5075176,SMARCA4,302
chr1,160189775,160189988,SRX5075170,SMARCA4,213
chr1,160193023,160193539,SRX16500060,CTCF,516
chr1,160193042,160193519,SRX16500061,CTCF,477
chr1,160193047,160193594,SRX16500059,CTCF,547
chr1,160193065,160193500,SRX16500062,CTCF,435
chr1,160193091,160193476,SRX4174629,CTCF,385
chr1,160193129,160193422,SRX5716463,SMARCA4,293
chr1,160193151,160193450,SRX5075174,SMARCA4,299
chr1,160193152,160193492,SRX5075168,SMARCA4,340
chr1,160193155,160193498,SRX5075170,SMARCA4,343
chr1,160193194,160193508,SRX5716470,SMARCA4,314
chr1,160193195,160193433,SRX5075169,SMARCA4,238
chr1,160193212,160193460,SRX5075175,SMARCA4,248
chr1,160193216,160193426,SRX5054309,FOSL2,210
chr1,160193232,160193444,SRX5716469,SMARCA4,212
chr1,160193234,160193471,SRX5075176,SMARCA4,237
chr1,160206397,160206840,SRX5075170,SMARCA4,443
chr1,160206433,160206852,SRX5054309,FOSL2,419
chr1,160206452,160206738,SRX5716470,SMARCA4,286
chr1,160206455,160206819,SRX5075176,SMARCA4,364
chr1,160206458,160206756,SRX5054308,FOSL2,298
chr1,160206462,160206859,SRX5075169,SMARCA4,397
chr1,160206477,160206755,SRX5716469,SMARCA4,278
chr1,160206492,160206705,SRX5075174,SMARCA4,213
chr1,160206516,160206821,SRX5075175,SMARCA4,305
chr1,160211080,160211399,SRX5075168,SMARCA4,319
chr1,160211103,160211324,SRX5716464,SMARCA4,221
chr1,160211140,160211422,SRX5075174,SMARCA4,282
chr1,160219665,160219855,SRX5075170,SMARCA4,190
chr1,160222616,160222883,SRX5716470,SMARCA4,267
chr1,160222619,160222864,SRX5716469,SMARCA4,245
chr1,160251876,160252346,SRX16500060,CTCF,470
chr1,160251886,160252406,SRX16500059,CTCF,520
chr1,160251888,160252330,SRX16500061,CTCF,442
chr1,160251899,160252227,SRX4174629,CTCF,328
chr1,160251916,160252323,SRX16500062,CTCF,407
chr1,160251955,160252258,SRX5075168,SMARCA4,303
chr1,160251984,160252237,SRX5075170,SMARCA4,253
chr1,160252003,160252226,SRX5075176,SMARCA4,223
chr1,160252005,160252282,SRX5075174,SMARCA4,277
chr1,160256690,160256901,SRX5716470,SMARCA4,211
chr1,160261000,160261354,SRX5716470,SMARCA4,354
chr1,160261068,160261318,SRX5075169,SMARCA4,250
chr1,160261073,160261282,SRX5075176,SMARCA4,209
chr1,160261096,160261290,SRX5075170,SMARCA4,194
chr1,160262152,160262728,SRX20140895,INTS13,576
chr1,160262159,160262545,SRX20140881,CPSF3L,386
chr1,160262170,160262676,SRX20140868,INTS10,506
chr1,160262200,160262755,SRX20140897,INTS13,555
chr1,160262203,160262621,SRX20140867,INTS10,418
chr1,160262215,160262529,SRX20140882,CPSF3L,314
chr1,160262239,160262644,SRX20140869,INTS10,405
chr1,160262265,160262628,SRX20140879,CPSF3L,363
chr1,160262339,160262637,SRX20140896,INTS13,298
chr1,160262405,160262756,SRX5075170,SMARCA4,351
chr1,160262443,160262732,SRX5054307,FOSL2,289
chr1,160262463,160262809,SRX5075174,SMARCA4,346
chr1,160262467,160262765,SRX5075176,SMARCA4,298
chr1,160262472,160262810,SRX5716463,SMARCA4,338
chr1,160262495,160262836,SRX5075168,SMARCA4,341
chr1,160284858,160285352,SRX20140895,INTS13,494
chr1,160284888,160285180,SRX20140869,INTS10,292
chr1,160284912,160285261,SRX20140868,INTS10,349
chr1,160284952,160285229,SRX20140881,CPSF3L,277
chr1,160284984,160285254,SRX5075170,SMARCA4,270
chr1,160284989,160285376,SRX5075168,SMARCA4,387
chr1,160285035,160285339,SRX5075174,SMARCA4,304
chr1,160285078,160285313,SRX5075176,SMARCA4,235
chr1,160285097,160285286,SRX5054307,FOSL2,189
chr1,160291227,160291977,SRX16500061,CTCF,750
chr1,160291254,160291939,SRX16500059,CTCF,685
chr1,160291275,160291819,SRX4174629,CTCF,544
chr1,160291282,160291951,SRX16500060,CTCF,669
chr1,160291303,160291828,SRX16500062,CTCF,525
chr1,160291340,160291599,SRX5075174,SMARCA4,259
chr1,160291358,160291640,SRX5075168,SMARCA4,282
chr1,160328216,160328443,SRX5716454,SOX3,227
chr1,160328273,160328573,SRX20140895,INTS13,300
chr1,160343022,160343557,SRX20140869,INTS10,535
chr1,160343070,160343516,SRX20140897,INTS13,446
chr1,160343099,160343607,SRX20140895,INTS13,508
chr1,160343148,160343506,SRX20140881,CPSF3L,358
chr1,160343153,160343481,SRX5716463,SMARCA4,328
chr1,160343159,160343395,SRX5075168,SMARCA4,236
chr1,160343162,160343565,SRX5075174,SMARCA4,403
chr1,160343164,160343413,SRX5075170,SMARCA4,249
chr1,160343189,160343516,SRX5716464,SMARCA4,327
chr1,160343192,160343543,SRX20140867,INTS10,351
chr1,160343210,160343399,SRX5054307,FOSL2,189
chr1,160343243,160343438,SRX5075176,SMARCA4,195
chr1,160354259,160354717,SRX16500061,CTCF,458
chr1,160354381,160354794,SRX16500060,CTCF,413
chr1,160354382,160354801,SRX16500059,CTCF,419
chr1,160354421,160354758,SRX16500062,CTCF,337
chr1,160354500,160354753,SRX4174629,CTCF,253
chr1,160375692,160376235,SRX20140895,INTS13,543
chr1,160375752,160376224,SRX5075174,SMARCA4,472
chr1,160375802,160376220,SRX5075168,SMARCA4,418
chr1,160376442,160376882,SRX5075168,SMARCA4,440
chr1,160376463,160376951,SRX16500060,CTCF,488
chr1,160376468,160376902,SRX16500062,CTCF,434
chr1,160376477,160376916,SRX16500061,CTCF,439
chr1,160376481,160376927,SRX16500059,CTCF,446
chr1,160376508,160376935,SRX4174629,CTCF,427
chr1,160376513,160376889,SRX5075174,SMARCA4,376
chr1,160376528,160376782,SRX5716470,SMARCA4,254
chr1,160376534,160376806,SRX5075169,SMARCA4,272
chr1,160376552,160376801,SRX5075175,SMARCA4,249
chr1,160376555,160376798,SRX5075176,SMARCA4,243
chr1,160376566,160376815,SRX5075170,SMARCA4,249
chr1,160399980,160400394,SRX16500062,CTCF,414
chr1,160399985,160400436,SRX16500059,CTCF,451
chr1,160399989,160400347,SRX16500061,CTCF,358
chr1,160400032,160400428,SRX20140881,CPSF3L,396
chr1,160400033,160400487,SRX16500060,CTCF,454
chr1,160400086,160400489,SRX20140895,INTS13,403
chr1,160400166,160400536,SRX5075176,SMARCA4,370
chr1,160400168,160400443,SRX20140868,INTS10,275
chr1,160400182,160400452,SRX20140897,INTS13,270
chr1,160400190,160400501,SRX20140867,INTS10,311
chr1,160400206,160400508,SRX5075175,SMARCA4,302
chr1,160400213,160400448,SRX5716469,SMARCA4,235
chr1,160400234,160400502,SRX5716470,SMARCA4,268
chr1,160400240,160400499,SRX5075168,SMARCA4,259
chr1,160400245,160400492,SRX5075169,SMARCA4,247
chr1,160400260,160400599,SRX5075174,SMARCA4,339
chr1,160400265,160400527,SRX5075170,SMARCA4,262
chr1,160400660,160400991,SRX20140895,INTS13,331
chr1,160410419,160411327,SRX20140895,INTS13,908
chr1,160410491,160411588,SRX5075174,SMARCA4,1097
chr1,160410521,160411312,SRX5716463,SMARCA4,791
chr1,160410547,160411496,SRX5075168,SMARCA4,949
chr1,160410557,160411016,SRX5716469,SMARCA4,459
chr1,160410565,160411063,SRX5075170,SMARCA4,498
chr1,160410588,160411081,SRX5075176,SMARCA4,493
chr1,160410602,160411054,SRX5716454,SOX3,452
chr1,160410610,160411072,SRX5075175,SMARCA4,462
chr1,160410648,160411043,SRX5716470,SMARCA4,395
chr1,160410651,160411161,SRX5716451,SOX2,510
chr1,160410677,160411087,SRX5716467,SMARCA2,410
chr1,160410696,160411151,SRX20140867,INTS10,455
chr1,160410706,160410961,SRX5075169,SMARCA4,255
chr1,160410721,160411285,SRX20140868,INTS10,564
chr1,160410745,160411187,SRX5716464,SMARCA4,442
chr1,160410766,160411171,SRX20140879,CPSF3L,405
chr1,160410827,160411098,SRX20140894,INTS13,271
chr1,160411513,160411855,SRX16500060,CTCF,342
chr1,160416412,160416744,SRX16500061,CTCF,332
chr1,160416452,160416727,SRX16500060,CTCF,275
chr1,160416452,160416735,SRX16500062,CTCF,283
chr1,160416480,160416776,SRX16500059,CTCF,296
chr1,160428536,160428942,SRX16500059,CTCF,406
chr1,160428599,160428948,SRX16500062,CTCF,349
chr1,160428604,160428947,SRX16500060,CTCF,343
chr1,160428607,160428926,SRX16500061,CTCF,319
chr1,160428612,160429002,SRX5075170,SMARCA4,390
chr1,160428662,160428842,SRX5075174,SMARCA4,180
chr1,160428673,160428923,SRX5075168,SMARCA4,250
chr1,160428690,160428939,SRX5716470,SMARCA4,249
chr1,160428708,160429006,SRX5075176,SMARCA4,298
chr1,160428728,160429040,SRX5716469,SMARCA4,312
chr1,160428737,160428953,SRX5075169,SMARCA4,216
chr1,160428741,160428945,SRX5716463,SMARCA4,204
chr1,160428820,160429039,SRX5075175,SMARCA4,219
chr1,160465017,160465254,SRX5054309,FOSL2,237
chr1,160542063,160542268,SRX5054309,FOSL2,205
chr1,160542560,160543011,SRX5075170,SMARCA4,451
chr1,160542567,160542995,SRX5054309,FOSL2,428
chr1,160542571,160542976,SRX5075169,SMARCA4,405
chr1,160542595,160542935,SRX5020214,SMARCA2,340
chr1,160542601,160542881,SRX5716470,SMARCA4,280
chr1,160542608,160542948,SRX5716467,SMARCA2,340
chr1,160542613,160542914,SRX5054308,FOSL2,301
chr1,160542613,160543022,SRX5075176,SMARCA4,409
chr1,160542627,160542934,SRX5075175,SMARCA4,307
chr1,160542632,160542914,SRX5716469,SMARCA4,282
chr1,160542668,160542911,SRX5020211,SMARCA2,243
chr1,160542715,160542894,SRX5075182,SMARCA2,179
chr1,160544688,160544956,SRX16500059,CTCF,268
chr1,160544701,160544968,SRX16500060,CTCF,267
chr1,160544756,160545024,SRX16500061,CTCF,268
chr1,160607042,160607535,SRX16500059,CTCF,493
chr1,160607063,160607556,SRX16500061,CTCF,493
chr1,160607074,160607595,SRX16500060,CTCF,521
chr1,160607107,160607587,SRX16500062,CTCF,480
chr1,160607115,160607395,SRX5075174,SMARCA4,280
chr1,160607138,160607424,SRX5716463,SMARCA4,286
chr1,160607150,160607395,SRX5075168,SMARCA4,245
chr1,160607163,160607389,SRX5075176,SMARCA4,226
chr1,160618777,160619087,SRX16500060,CTCF,310
chr1,160618781,160619058,SRX16500059,CTCF,277
chr1,160630525,160630891,SRX5075168,SMARCA4,366
chr1,160637939,160638118,SRX5075168,SMARCA4,179
chr1,160652237,160652554,SRX5075174,SMARCA4,317
chr1,160652244,160652525,SRX5075168,SMARCA4,281
chr1,160675506,160675949,SRX16500060,CTCF,443
chr1,160675547,160675955,SRX16500062,CTCF,408
chr1,160675548,160676002,SRX16500061,CTCF,454
chr1,160675558,160675968,SRX16500059,CTCF,410
chr1,160675558,160676067,SRX4174629,CTCF,509
chr1,160675607,160675857,SRX5075168,SMARCA4,250
chr1,160675662,160675920,SRX5075174,SMARCA4,258
chr1,160675676,160675880,SRX5716463,SMARCA4,204
chr1,160675718,160675895,SRX5075176,SMARCA4,177
chr1,160681412,160681890,SRX16500059,CTCF,478
chr1,160681447,160681901,SRX16500060,CTCF,454
chr1,160681472,160681879,SRX16500062,CTCF,407
chr1,160681509,160681844,SRX16500061,CTCF,335
chr1,160681510,160681910,SRX4174629,CTCF,400
chr1,160726682,160727293,SRX16500059,CTCF,611
chr1,160726742,160727259,SRX16500060,CTCF,517
chr1,160726773,160727212,SRX16500062,CTCF,439
chr1,160726782,160727221,SRX16500061,CTCF,439
chr1,160726806,160727219,SRX4174629,CTCF,413
chr1,160726832,160727160,SRX5075168,SMARCA4,328
chr1,160726902,160727155,SRX5075174,SMARCA4,253
chr1,160726912,160727178,SRX5716463,SMARCA4,266
chr1,160777443,160777855,SRX16500060,CTCF,412
chr1,160777465,160777730,SRX16500062,CTCF,265
chr1,160777497,160777815,SRX16500061,CTCF,318
chr1,160777500,160777794,SRX16500059,CTCF,294
chr1,160780129,160780417,SRX16500059,CTCF,288
chr1,160830527,160830969,SRX16500059,CTCF,442
chr1,160830562,160830965,SRX16500062,CTCF,403
chr1,160830574,160830966,SRX16500060,CTCF,392
chr1,160830590,160830961,SRX16500061,CTCF,371
chr1,160834959,160835357,SRX16500059,CTCF,398
chr1,160834971,160835387,SRX16500060,CTCF,416
chr1,160834981,160835311,SRX16500062,CTCF,330
chr1,160834986,160835352,SRX16500061,CTCF,366
chr1,160835070,160835251,SRX5075174,SMARCA4,181
chr1,160951362,160951763,SRX16500060,CTCF,401
chr1,160951370,160951754,SRX16500061,CTCF,384
chr1,160951411,160951756,SRX16500059,CTCF,345
chr1,160951425,160951649,SRX5075174,SMARCA4,224
chr1,160951427,160951764,SRX16500062,CTCF,337
chr1,160954229,160954601,SRX16500060,CTCF,372
chr1,160954258,160954568,SRX16500061,CTCF,310
chr1,160954266,160954607,SRX16500059,CTCF,341
chr1,160954290,160954510,SRX16500062,CTCF,220
chr1,160971531,160972154,SRX5075168,SMARCA4,623
chr1,160971579,160972194,SRX5075174,SMARCA4,615
chr1,160971761,160972156,SRX5716463,SMARCA4,395
chr1,160971776,160971994,SRX5716464,SMARCA4,218
chr1,160971798,160972095,SRX5716451,SOX2,297
chr1,160971870,160972075,SRX5716454,SOX3,205
chr1,160990166,160990789,SRX16500060,CTCF,623
chr1,160990215,160990710,SRX16500062,CTCF,495
chr1,160990219,160990827,SRX16500059,CTCF,608
chr1,160990228,160990707,SRX16500061,CTCF,479
chr1,160990326,160990589,SRX5075174,SMARCA4,263
chr1,160990334,160990591,SRX5075168,SMARCA4,257
chr1,160997406,160997625,SRX16500061,CTCF,219
chr1,160997420,160997668,SRX16500059,CTCF,248
chr1,161020551,161020818,SRX20140895,INTS13,267
chr1,161020639,161020911,SRX16500060,CTCF,272
chr1,161041466,161041842,SRX16500061,CTCF,376
chr1,161041492,161041862,SRX16500059,CTCF,370
chr1,161041522,161041863,SRX16500062,CTCF,341
chr1,161041559,161041803,SRX16500060,CTCF,244
chr1,161044810,161045050,SRX5075170,SMARCA4,240
chr1,161045152,161045351,SRX5075168,SMARCA4,199
chr1,161045163,161046433,SRX20140895,INTS13,1270
chr1,161045272,161045695,SRX20140868,INTS10,423
chr1,161045760,161045935,SRX5075176,SMARCA4,175
chr1,161045773,161046346,SRX20140868,INTS10,573
chr1,161045780,161046231,SRX5075174,SMARCA4,451
chr1,161045960,161046589,SRX20140869,INTS10,629
chr1,161046001,161046320,SRX20140867,INTS10,319
chr1,161046041,161046466,SRX20140897,INTS13,425
chr1,161046046,161046367,SRX5716470,SMARCA4,321
chr1,161046154,161046323,SRX5075170,SMARCA4,169
chr1,161071798,161072245,SRX16500061,CTCF,447
chr1,161071806,161072192,SRX16500062,CTCF,386
chr1,161071810,161072187,SRX16500060,CTCF,377
chr1,161071820,161072211,SRX16500059,CTCF,391
chr1,161080519,161080960,SRX5075168,SMARCA4,441
chr1,161080552,161080996,SRX5075174,SMARCA4,444
chr1,161083487,161083727,SRX5054309,FOSL2,240
chr1,161097619,161097822,SRX5075176,SMARCA4,203
chr1,161097643,161097875,SRX5075168,SMARCA4,232
chr1,161097677,161098101,SRX4174629,CTCF,424
chr1,161097691,161097939,SRX5075170,SMARCA4,248
chr1,161097731,161098632,SRX16500060,CTCF,901
chr1,161097748,161098100,SRX16500062,CTCF,352
chr1,161097764,161098589,SRX16500061,CTCF,825
chr1,161097765,161098019,SRX5075174,SMARCA4,254
chr1,161097787,161098633,SRX16500059,CTCF,846
chr1,161098137,161098504,SRX5075176,SMARCA4,367
chr1,161098195,161098553,SRX5075168,SMARCA4,358
chr1,161098200,161098508,SRX5716464,SMARCA4,308
chr1,161098209,161098637,SRX5075174,SMARCA4,428
chr1,161098242,161098459,SRX5075170,SMARCA4,217
chr1,161098244,161098707,SRX20140895,INTS13,463
chr1,161098345,161098621,SRX16500062,CTCF,276
chr1,161117783,161118281,SRX20140895,INTS13,498
chr1,161117817,161118196,SRX20140869,INTS10,379
chr1,161117881,161118402,SRX5075174,SMARCA4,521
chr1,161117900,161118180,SRX20140867,INTS10,280
chr1,161117914,161118417,SRX5075176,SMARCA4,503
chr1,161117924,161118314,SRX5075170,SMARCA4,390
chr1,161117965,161118221,SRX5716464,SMARCA4,256
chr1,161118024,161118456,SRX5075168,SMARCA4,432
chr1,161118176,161118410,SRX5716470,SMARCA4,234
chr1,161119665,161119953,SRX16500060,CTCF,288
chr1,161132329,161132857,SRX20140881,CPSF3L,528
chr1,161132364,161133232,SRX20140895,INTS13,868
chr1,161132377,161133004,SRX20140897,INTS13,627
chr1,161132466,161133125,SRX20140868,INTS10,659
chr1,161132476,161132812,SRX20140879,CPSF3L,336
chr1,161132483,161133246,SRX5075174,SMARCA4,763
chr1,161132486,161133114,SRX20140867,INTS10,628
chr1,161132502,161133055,SRX20140869,INTS10,553
chr1,161132531,161132832,SRX5075168,SMARCA4,301
chr1,161132681,161133152,SRX5075170,SMARCA4,471
chr1,161132872,161133151,SRX5054308,FOSL2,279
chr1,161132908,161133175,SRX5054307,FOSL2,267
chr1,161132925,161133187,SRX5054309,FOSL2,262
chr1,161132938,161133280,SRX5075169,SMARCA4,342
chr1,161132941,161133295,SRX5075176,SMARCA4,354
chr1,161132969,161133347,SRX5075168,SMARCA4,378
chr1,161132979,161133207,SRX5075175,SMARCA4,228
chr1,161139698,161140156,SRX16500061,CTCF,458
chr1,161139748,161140242,SRX16500060,CTCF,494
chr1,161139762,161140246,SRX16500059,CTCF,484
chr1,161139808,161140100,SRX5075170,SMARCA4,292
chr1,161139809,161140203,SRX16500062,CTCF,394
chr1,161139832,161140094,SRX5075174,SMARCA4,262
chr1,161139845,161140134,SRX5075168,SMARCA4,289
chr1,161139879,161140094,SRX5075169,SMARCA4,215
chr1,161153677,161154238,SRX20140879,CPSF3L,561
chr1,161153686,161154251,SRX20140895,INTS13,565
chr1,161153692,161154292,SRX20140868,INTS10,600
chr1,161153723,161153896,SRX5075174,SMARCA4,173
chr1,161153724,161154002,SRX5075168,SMARCA4,278
chr1,161153751,161154175,SRX20140867,INTS10,424
chr1,161153759,161154204,SRX20140897,INTS13,445
chr1,161153759,161154217,SRX20140869,INTS10,458
chr1,161153814,161154110,SRX5075170,SMARCA4,296
chr1,161159214,161159720,SRX5075174,SMARCA4,506
chr1,161159225,161159647,SRX5716463,SMARCA4,422
chr1,161159230,161159770,SRX5075176,SMARCA4,540
chr1,161159239,161159510,SRX5075170,SMARCA4,271
chr1,161159247,161159827,SRX5075168,SMARCA4,580
chr1,161159270,161160012,SRX20140895,INTS13,742
chr1,161159334,161159552,SRX20140867,INTS10,218
chr1,161159335,161159947,SRX20140868,INTS10,612
chr1,161159411,161159849,SRX20140897,INTS13,438
chr1,161159535,161159907,SRX20140869,INTS10,372
chr1,161159587,161159930,SRX5075169,SMARCA4,343
chr1,161165675,161166330,SRX16500060,CTCF,655
chr1,161165684,161166256,SRX16500061,CTCF,572
chr1,161165719,161166344,SRX16500059,CTCF,625
chr1,161165720,161166016,SRX16500062,CTCF,296
chr1,161165782,161166450,SRX4174629,CTCF,668
chr1,161165915,161166126,SRX5716470,SMARCA4,211
chr1,161165946,161166483,SRX5075176,SMARCA4,537
chr1,161165990,161166468,SRX5075168,SMARCA4,478
chr1,161166010,161166528,SRX5075174,SMARCA4,518
chr1,161166036,161166461,SRX20140867,INTS10,425
chr1,161166076,161166448,SRX5075169,SMARCA4,372
chr1,161166104,161166540,SRX20140897,INTS13,436
chr1,161166107,161166693,SRX20140895,INTS13,586
chr1,161166126,161166467,SRX5075170,SMARCA4,341
chr1,161166155,161166610,SRX20140881,CPSF3L,455
chr1,161166200,161166467,SRX5716464,SMARCA4,267
chr1,161172931,161173519,SRX5075170,SMARCA4,588
chr1,161172947,161173263,SRX5716470,SMARCA4,316
chr1,161172967,161173375,SRX5054309,FOSL2,408
chr1,161172973,161173407,SRX5075176,SMARCA4,434
chr1,161172987,161173388,SRX5075169,SMARCA4,401
chr1,161173004,161173248,SRX5716468,SMARCA2,244
chr1,161173017,161173341,SRX5075175,SMARCA4,324
chr1,161173030,161173241,SRX5054308,FOSL2,211
chr1,161173034,161173294,SRX5716469,SMARCA4,260
chr1,161173046,161173291,SRX5075181,SMARCA2,245
chr1,161173058,161173280,SRX5716467,SMARCA2,222
chr1,161177235,161177799,SRX20140895,INTS13,564
chr1,161177247,161177674,SRX20140897,INTS13,427
chr1,161177264,161177600,SRX20140881,CPSF3L,336
chr1,161177277,161177577,SRX20140869,INTS10,300
chr1,161177285,161177828,SRX20140879,CPSF3L,543
chr1,161177286,161177697,SRX20140867,INTS10,411
chr1,161177318,161177827,SRX5075174,SMARCA4,509
chr1,161177328,161177777,SRX5075168,SMARCA4,449
chr1,161177340,161177731,SRX20140868,INTS10,391
chr1,161177503,161177730,SRX5075175,SMARCA4,227
chr1,161177511,161177747,SRX5075170,SMARCA4,236
chr1,161185378,161185723,SRX5075176,SMARCA4,345
chr1,161192394,161192905,SRX16500060,CTCF,511
chr1,161192423,161192920,SRX16500062,CTCF,497
chr1,161192444,161192900,SRX16500061,CTCF,456
chr1,161192459,161192938,SRX16500059,CTCF,479
chr1,161192498,161192889,SRX4174629,CTCF,391
chr1,161192526,161192802,SRX5075176,SMARCA4,276
chr1,161192546,161192892,SRX5075174,SMARCA4,346
chr1,161192554,161192886,SRX5075168,SMARCA4,332
chr1,161192611,161192827,SRX5716463,SMARCA4,216
chr1,161192642,161192859,SRX5716464,SMARCA4,217
chr1,161202008,161202705,SRX20140895,INTS13,697
chr1,161202060,161202635,SRX5075174,SMARCA4,575
chr1,161202139,161202645,SRX20140869,INTS10,506
chr1,161202143,161202647,SRX20140868,INTS10,504
chr1,161202175,161202626,SRX20140867,INTS10,451
chr1,161202180,161202519,SRX5075168,SMARCA4,339
chr1,161202191,161202405,SRX5716451,SOX2,214
chr1,161202196,161202628,SRX20140897,INTS13,432
chr1,161202201,161202636,SRX20140896,INTS13,435
chr1,161202235,161202708,SRX20140881,CPSF3L,473
chr1,161202274,161202629,SRX20140879,CPSF3L,355
chr1,161202360,161202737,SRX16500060,CTCF,377
chr1,161202373,161202628,SRX5716463,SMARCA4,255
chr1,161202471,161202759,SRX16500062,CTCF,288
chr1,161202477,161202831,SRX16500059,CTCF,354
chr1,161209690,161210220,SRX16500059,CTCF,530
chr1,161209690,161210268,SRX16500060,CTCF,578
chr1,161209730,161210315,SRX16500062,CTCF,585
chr1,161209748,161210261,SRX16500061,CTCF,513
chr1,161209815,161210279,SRX4174629,CTCF,464
chr1,161209852,161210188,SRX5075174,SMARCA4,336
chr1,161209889,161210185,SRX5075168,SMARCA4,296
chr1,161209906,161210114,SRX5075170,SMARCA4,208
chr1,161209916,161210153,SRX5716470,SMARCA4,237
chr1,161209942,161210135,SRX5075169,SMARCA4,193
chr1,161209962,161210166,SRX5716463,SMARCA4,204
chr1,161217190,161217478,SRX5054309,FOSL2,288
chr1,161217360,161217540,SRX5075169,SMARCA4,180
chr1,161225524,161225911,SRX5075176,SMARCA4,387
chr1,161225528,161225789,SRX16500062,CTCF,261
chr1,161225560,161225852,SRX16500059,CTCF,292
chr1,161225576,161225926,SRX5075170,SMARCA4,350
chr1,161225610,161225980,SRX5075174,SMARCA4,370
chr1,161225653,161225898,SRX5716470,SMARCA4,245
chr1,161225707,161226115,SRX5075168,SMARCA4,408
chr1,161225728,161226281,SRX20140895,INTS13,553
chr1,161225729,161225940,SRX4174629,CTCF,211
chr1,161225780,161226093,SRX5716451,SOX2,313
chr1,161225815,161226052,SRX5716453,SOX2,237
chr1,161227292,161227845,SRX16500059,CTCF,553
chr1,161227306,161227783,SRX16500061,CTCF,477
chr1,161227315,161227759,SRX16500060,CTCF,444
chr1,161227333,161227767,SRX16500062,CTCF,434
chr1,161227455,161227647,SRX5075168,SMARCA4,192
chr1,161227474,161227649,SRX5075176,SMARCA4,175
chr1,161227476,161227680,SRX5075174,SMARCA4,204
chr1,161291420,161291791,SRX16500062,CTCF,371
chr1,161291425,161291790,SRX16500059,CTCF,365
chr1,161291455,161291787,SRX16500060,CTCF,332
chr1,161291493,161291787,SRX16500061,CTCF,294
chr1,161291577,161291763,SRX5075168,SMARCA4,186
chr1,161307379,161307711,SRX5075170,SMARCA4,332
chr1,161307412,161307675,SRX5075176,SMARCA4,263
chr1,161307419,161307659,SRX5054309,FOSL2,240
chr1,161307420,161307691,SRX5054308,FOSL2,271
chr1,161307431,161307673,SRX5075175,SMARCA4,242
chr1,161307434,161307701,SRX5075169,SMARCA4,267
chr1,161314060,161314468,SRX5075174,SMARCA4,408
chr1,161314063,161314543,SRX20140897,INTS13,480
chr1,161314072,161314431,SRX5075176,SMARCA4,359
chr1,161314074,161314719,SRX20140895,INTS13,645
chr1,161314077,161314424,SRX5716469,SMARCA4,347
chr1,161314083,161315037,SRX5075170,SMARCA4,954
chr1,161314091,161314546,SRX5075168,SMARCA4,455
chr1,161314105,161314576,SRX5075169,SMARCA4,471
chr1,161314114,161314402,SRX5075175,SMARCA4,288
chr1,161314175,161314481,SRX20140869,INTS10,306
chr1,161314205,161314527,SRX20140896,INTS13,322
chr1,161314216,161314561,SRX20140867,INTS10,345
chr1,161314260,161314601,SRX20140868,INTS10,341
chr1,161314751,161315040,SRX5075169,SMARCA4,289
chr1,161314751,161315099,SRX5075175,SMARCA4,348
chr1,161314802,161315023,SRX16500060,CTCF,221
chr1,161314825,161315013,SRX5075168,SMARCA4,188
chr1,161367698,161368193,SRX5075176,SMARCA4,495
chr1,161367727,161368132,SRX5075168,SMARCA4,405
chr1,161367737,161368162,SRX5075174,SMARCA4,425
chr1,161367768,161368054,SRX5716467,SMARCA2,286
chr1,161367772,161368080,SRX5716469,SMARCA4,308
chr1,161367772,161368130,SRX5075170,SMARCA4,358
chr1,161367785,161368005,SRX5075175,SMARCA4,220
chr1,161367789,161368075,SRX5716470,SMARCA4,286
chr1,161367855,161368035,SRX5075169,SMARCA4,180
chr1,161367873,161368113,SRX16500060,CTCF,240
chr1,161367907,161368126,SRX16500061,CTCF,219
chr1,161382024,161382599,SRX16500060,CTCF,575
chr1,161382067,161382613,SRX16500059,CTCF,546
chr1,161382072,161382646,SRX16500061,CTCF,574
chr1,161382113,161382546,SRX16500062,CTCF,433
chr1,161382170,161382442,SRX5075174,SMARCA4,272
chr1,161382174,161382411,SRX5075169,SMARCA4,237
chr1,161382191,161382429,SRX5075168,SMARCA4,238
chr1,161382213,161382459,SRX5075170,SMARCA4,246
chr1,161382230,161382500,SRX5075176,SMARCA4,270
chr1,161389644,161390118,SRX5075170,SMARCA4,474
chr1,161389673,161389948,SRX5716469,SMARCA4,275
chr1,161389697,161390072,SRX20140895,INTS13,375
chr1,161389699,161390640,SRX5075168,SMARCA4,941
chr1,161389707,161389957,SRX20140879,CPSF3L,250
chr1,161389710,161390080,SRX5075169,SMARCA4,370
chr1,161389712,161389995,SRX5716467,SMARCA2,283
chr1,161389713,161390089,SRX5075176,SMARCA4,376
chr1,161389715,161390038,SRX5075175,SMARCA4,323
chr1,161389720,161390011,SRX20140881,CPSF3L,291
chr1,161389733,161389994,SRX5716468,SMARCA2,261
chr1,161389738,161390085,SRX5716470,SMARCA4,347
chr1,161389753,161390036,SRX20140897,INTS13,283
chr1,161389758,161390617,SRX5075174,SMARCA4,859
chr1,161389763,161390012,SRX20140867,INTS10,249
chr1,161389789,161390140,SRX5716463,SMARCA4,351
chr1,161389813,161390129,SRX5054309,FOSL2,316
chr1,161389827,161390132,SRX5054308,FOSL2,305
chr1,161389841,161390191,SRX5054307,FOSL2,350
chr1,161389853,161390058,SRX5716464,SMARCA4,205
chr1,161390194,161390410,SRX5716463,SMARCA4,216
chr1,161390249,161390475,SRX5075176,SMARCA4,226
chr1,161390311,161390686,SRX5716470,SMARCA4,375
chr1,161390328,161390589,SRX5075175,SMARCA4,261
chr1,161390337,161390589,SRX5716469,SMARCA4,252
chr1,161390367,161390579,SRX5075170,SMARCA4,212
chr1,161390381,161390567,SRX5075169,SMARCA4,186
chr1,161398997,161400037,SRX20140869,INTS10,1040
chr1,161399073,161400081,SRX20140895,INTS13,1008
chr1,161399097,161400035,SRX20140868,INTS10,938
chr1,161399124,161399949,SRX20140867,INTS10,825
chr1,161399167,161399743,SRX5716470,SMARCA4,576
chr1,161399194,161399926,SRX20140897,INTS13,732
chr1,161399259,161399559,SRX5716469,SMARCA4,300
chr1,161399305,161399642,SRX5716463,SMARCA4,337
chr1,161399311,161399715,SRX16500060,CTCF,404
chr1,161399324,161399704,SRX5075168,SMARCA4,380
chr1,161399332,161399547,SRX5716464,SMARCA4,215
chr1,161399350,161399708,SRX16500059,CTCF,358
chr1,161399368,161399799,SRX16500062,CTCF,431
chr1,161399431,161399743,SRX16500061,CTCF,312
chr1,161399436,161399897,SRX20140881,CPSF3L,461
chr1,161399468,161399714,SRX5075170,SMARCA4,246
chr1,161399472,161400026,SRX20140894,INTS13,554
chr1,161399525,161399905,SRX5075176,SMARCA4,380
chr1,161399563,161399893,SRX20140879,CPSF3L,330
chr1,161399582,161399827,SRX5075174,SMARCA4,245
chr1,161399586,161399876,SRX20140870,INTS10,290
chr1,161440260,161440861,SRX16500059,CTCF,601
chr1,161440318,161440819,SRX16500060,CTCF,501
chr1,161440352,161440735,SRX16500061,CTCF,383
chr1,161440375,161440752,SRX16500062,CTCF,377
chr1,161440421,161440829,SRX20140895,INTS13,408
chr1,161446967,161447221,SRX16500060,CTCF,254
chr1,161447122,161447532,SRX20140895,INTS13,410
chr1,161447150,161447399,SRX5075168,SMARCA4,249
chr1,161447156,161447581,SRX20140868,INTS10,425
chr1,161447772,161448185,SRX16500060,CTCF,413
chr1,161447773,161448233,SRX16500059,CTCF,460
chr1,161447781,161448223,SRX16500062,CTCF,442
chr1,161447816,161448255,SRX16500061,CTCF,439
chr1,161454221,161454580,SRX16500061,CTCF,359
chr1,161454307,161454683,SRX16500059,CTCF,376
chr1,161454330,161454667,SRX16500060,CTCF,337
chr1,161454428,161454604,SRX5075176,SMARCA4,176
chr1,161454433,161454972,SRX20140895,INTS13,539
chr1,161454473,161454934,SRX20140868,INTS10,461
chr1,161454476,161454895,SRX5075174,SMARCA4,419
chr1,161454499,161454917,SRX5075168,SMARCA4,418
chr1,161454527,161454929,SRX20140867,INTS10,402
chr1,161454585,161454850,SRX20140879,CPSF3L,265
chr1,161454607,161454889,SRX20140869,INTS10,282
chr1,161454729,161454933,SRX5716463,SMARCA4,204
chr1,161454774,161454943,SRX5075170,SMARCA4,169
chr1,161455157,161455596,SRX16500059,CTCF,439
chr1,161455161,161455555,SRX16500062,CTCF,394
chr1,161455162,161455661,SRX16500060,CTCF,499
chr1,161455178,161455560,SRX16500061,CTCF,382
chr1,161461846,161462369,SRX20140895,INTS13,523
chr1,161461914,161462359,SRX20140868,INTS10,445
chr1,161461976,161462281,SRX20140869,INTS10,305
chr1,161462060,161462387,SRX20140867,INTS10,327
chr1,161462549,161463016,SRX16500060,CTCF,467
chr1,161462556,161463029,SRX16500059,CTCF,473
chr1,161462586,161462973,SRX16500062,CTCF,387
chr1,161462593,161462946,SRX16500061,CTCF,353
chr1,161469047,161469650,SRX16500059,CTCF,603
chr1,161469114,161469382,SRX16500060,CTCF,268
chr1,161469136,161469427,SRX16500061,CTCF,291
chr1,161469141,161469383,SRX16500062,CTCF,242
chr1,161469208,161469771,SRX20140895,INTS13,563
chr1,161469271,161469736,SRX20140868,INTS10,465
chr1,161469299,161469782,SRX5075174,SMARCA4,483
chr1,161469343,161469613,SRX20140869,INTS10,270
chr1,161469363,161469810,SRX20140867,INTS10,447
chr1,161469400,161469647,SRX20140894,INTS13,247
chr1,161469545,161469724,SRX5075168,SMARCA4,179
chr1,161469937,161470336,SRX16500060,CTCF,399
chr1,161469946,161470385,SRX16500061,CTCF,439
chr1,161469948,161470408,SRX16500059,CTCF,460
chr1,161469949,161470396,SRX16500062,CTCF,447
chr1,161486954,161487440,SRX16500061,CTCF,486
chr1,161486978,161487405,SRX16500060,CTCF,427
chr1,161486992,161487450,SRX16500059,CTCF,458
chr1,161487005,161487398,SRX16500062,CTCF,393
chr1,161487148,161487374,SRX4174629,CTCF,226
chr1,161523751,161523969,SRX5075168,SMARCA4,218
chr1,161523771,161524050,SRX20140869,INTS10,279
chr1,161523799,161524200,SRX20140868,INTS10,401
chr1,161523819,161524484,SRX20140895,INTS13,665
chr1,161524207,161524802,SRX20140881,CPSF3L,595
chr1,161524309,161524546,SRX5716470,SMARCA4,237
chr1,161530289,161530650,SRX20140869,INTS10,361
chr1,161530484,161531148,SRX20140895,INTS13,664
chr1,161530681,161531072,SRX5075174,SMARCA4,391
chr1,161530709,161531325,SRX5075168,SMARCA4,616
chr1,161530795,161531018,SRX5075176,SMARCA4,223
chr1,161530862,161531299,SRX20140869,INTS10,437
chr1,161530881,161531084,SRX5054309,FOSL2,203
chr1,161531034,161531468,SRX5075170,SMARCA4,434
chr1,161531153,161531431,SRX5075176,SMARCA4,278
chr1,161532586,161532983,SRX20140895,INTS13,397
chr1,161532620,161532931,SRX20140868,INTS10,311
chr1,161540044,161540348,SRX20140869,INTS10,304
chr1,161566184,161566571,SRX16500059,CTCF,387
chr1,161566195,161566540,SRX16500060,CTCF,345
chr1,161566213,161566526,SRX16500061,CTCF,313
chr1,161566223,161566579,SRX16500062,CTCF,356
chr1,161566227,161566529,SRX5075170,SMARCA4,302
chr1,161566244,161566512,SRX5075176,SMARCA4,268
chr1,161566251,161566528,SRX5075169,SMARCA4,277
chr1,161566259,161566521,SRX5716470,SMARCA4,262
chr1,161566261,161566484,SRX5075174,SMARCA4,223
chr1,161566272,161566469,SRX5075168,SMARCA4,197
chr1,161612094,161612454,SRX20140895,INTS13,360
chr1,161612135,161612937,SRX5075176,SMARCA4,802
chr1,161612146,161612741,SRX5075174,SMARCA4,595
chr1,161612156,161612694,SRX5075168,SMARCA4,538
chr1,161612206,161612805,SRX20140868,INTS10,599
chr1,161612248,161612672,SRX5716470,SMARCA4,424
chr1,161612341,161612879,SRX20140869,INTS10,538
chr1,161612355,161612989,SRX5075170,SMARCA4,634
chr1,161612362,161612656,SRX5716469,SMARCA4,294
chr1,161612365,161612614,SRX5075175,SMARCA4,249
chr1,161612490,161612799,SRX5054309,FOSL2,309
chr1,161612508,161612772,SRX5716451,SOX2,264
chr1,161612559,161612808,SRX5054308,FOSL2,249
chr1,161612566,161612770,SRX5716463,SMARCA4,204
chr1,161612588,161612793,SRX5716454,SOX3,205
chr1,161612767,161613007,SRX5075169,SMARCA4,240
chr1,161612797,161612970,SRX5075174,SMARCA4,173
chr1,161621417,161621625,SRX5075170,SMARCA4,208
chr1,161621762,161622029,SRX5075169,SMARCA4,267
chr1,161647617,161647840,SRX5075174,SMARCA4,223
chr1,161647626,161647931,SRX16500061,CTCF,305
chr1,161647636,161647978,SRX16500059,CTCF,342
chr1,161647639,161647910,SRX16500060,CTCF,271
chr1,161647651,161647892,SRX5075170,SMARCA4,241
chr1,161647674,161647893,SRX16500062,CTCF,219
chr1,161647692,161647872,SRX5075169,SMARCA4,180
chr1,161706443,161706805,SRX5075175,SMARCA4,362
chr1,161706486,161706791,SRX5054308,FOSL2,305
chr1,161706495,161706809,SRX5075169,SMARCA4,314
chr1,161706587,161706866,SRX5054309,FOSL2,279
chr1,161725963,161726325,SRX16500062,CTCF,362
chr1,161725966,161726417,SRX16500059,CTCF,451
chr1,161726458,161727065,SRX20140895,INTS13,607
chr1,161726692,161726980,SRX5075169,SMARCA4,288
chr1,161726831,161727014,SRX5075176,SMARCA4,183
chr1,161726942,161727189,SRX5075174,SMARCA4,247
chr1,161727114,161727563,SRX20140895,INTS13,449
chr1,161727164,161727345,SRX5075168,SMARCA4,181
chr1,161738766,161738999,SRX16500062,CTCF,233
chr1,161738787,161739030,SRX16500059,CTCF,243
chr1,161738789,161739047,SRX16500060,CTCF,258
chr1,161741349,161741882,SRX16500059,CTCF,533
chr1,161741417,161741855,SRX16500061,CTCF,438
chr1,161741451,161741898,SRX16500060,CTCF,447
chr1,161741464,161741872,SRX16500062,CTCF,408
chr1,161741491,161741678,SRX5075175,SMARCA4,187
chr1,161741512,161741698,SRX5075170,SMARCA4,186
chr1,161741515,161741809,SRX5075174,SMARCA4,294
chr1,161741528,161741755,SRX5075176,SMARCA4,227
chr1,161741532,161741769,SRX5075168,SMARCA4,237
chr1,161744140,161744408,SRX5054309,FOSL2,268
chr1,161744160,161744433,SRX5054308,FOSL2,273
chr1,161749482,161749813,SRX5075174,SMARCA4,331
chr1,161749501,161749888,SRX5075168,SMARCA4,387
chr1,161749511,161749763,SRX5075175,SMARCA4,252
chr1,161749514,161749732,SRX5716463,SMARCA4,218
chr1,161749520,161749829,SRX5716470,SMARCA4,309
chr1,161749537,161749834,SRX5716459,Epitope tags,297
chr1,161749540,161749957,SRX5075176,SMARCA4,417
chr1,161749541,161749859,SRX5075170,SMARCA4,318
chr1,161749550,161750275,SRX5075169,SMARCA4,725
chr1,161749597,161750475,SRX20140895,INTS13,878
chr1,161749639,161750512,SRX20140868,INTS10,873
chr1,161749651,161750313,SRX20140869,INTS10,662
chr1,161749656,161750377,SRX20140867,INTS10,721
chr1,161749685,161750284,SRX20140897,INTS13,599
chr1,161749714,161750066,SRX20140894,INTS13,352
chr1,161749715,161750224,SRX20140881,CPSF3L,509
chr1,161749724,161750322,SRX20140879,CPSF3L,598
chr1,161749774,161750086,SRX20140896,INTS13,312
chr1,161750029,161750226,SRX5075176,SMARCA4,197
chr1,161750092,161750427,SRX5075170,SMARCA4,335
chr1,161750242,161750443,SRX5075174,SMARCA4,201
chr1,161750364,161750558,SRX5075168,SMARCA4,194
chr1,161763417,161763926,SRX16500059,CTCF,509
chr1,161763486,161763865,SRX16500060,CTCF,379
chr1,161763530,161763899,SRX16500061,CTCF,369
chr1,161763549,161763876,SRX16500062,CTCF,327
chr1,161765145,161765495,SRX5075170,SMARCA4,350
chr1,161765151,161765532,SRX5716469,SMARCA4,381
chr1,161765172,161765465,SRX5075169,SMARCA4,293
chr1,161765186,161765472,SRX5716470,SMARCA4,286
chr1,161765194,161765472,SRX5716467,SMARCA2,278
chr1,161765231,161765449,SRX5075176,SMARCA4,218
chr1,161766045,161766453,SRX20140881,CPSF3L,408
chr1,161766118,161766392,SRX5075170,SMARCA4,274
chr1,161766122,161766386,SRX5075174,SMARCA4,264
chr1,161766122,161766400,SRX20140895,INTS13,278
chr1,161766154,161766421,SRX5075176,SMARCA4,267
chr1,161766177,161766371,SRX5054309,FOSL2,194
chr1,161766180,161766436,SRX20140867,INTS10,256
chr1,161766206,161766449,SRX5075175,SMARCA4,243
chr1,161766227,161766437,SRX5054308,FOSL2,210
chr1,161766283,161766462,SRX5075168,SMARCA4,179
chr1,161787320,161787642,SRX4174629,CTCF,322
chr1,161792614,161793113,SRX16500060,CTCF,499
chr1,161792646,161793129,SRX16500059,CTCF,483
chr1,161792672,161793071,SRX16500062,CTCF,399
chr1,161792688,161793071,SRX16500061,CTCF,383
chr1,161792800,161793020,SRX5075174,SMARCA4,220
chr1,161792804,161793091,SRX5075176,SMARCA4,287
chr1,161792808,161793057,SRX5075168,SMARCA4,249
chr1,161792815,161793113,SRX5054309,FOSL2,298
chr1,161792818,161793022,SRX5075170,SMARCA4,204
chr1,161792853,161793106,SRX5054308,FOSL2,253
chr1,161792855,161793063,SRX5075169,SMARCA4,208
chr1,161805767,161806004,SRX5075181,SMARCA2,237
chr1,161805767,161806078,SRX5716467,SMARCA2,311
chr1,161805796,161806140,SRX5075175,SMARCA4,344
chr1,161805800,161806044,SRX5716470,SMARCA4,244
chr1,161805803,161806189,SRX5075176,SMARCA4,386
chr1,161805815,161806236,SRX5075170,SMARCA4,421
chr1,161805820,161806087,SRX5716469,SMARCA4,267
chr1,161805872,161806095,SRX5020211,SMARCA2,223
chr1,161805901,161806152,SRX5075169,SMARCA4,251
chr1,161816154,161816500,SRX5716470,SMARCA4,346
chr1,161816228,161816558,SRX5075169,SMARCA4,330
chr1,161816269,161816515,SRX5716469,SMARCA4,246
chr1,161827875,161828152,SRX5054309,FOSL2,277
chr1,161848790,161849014,SRX5075170,SMARCA4,224
chr1,161864635,161864935,SRX5075169,SMARCA4,300
chr1,161864643,161864921,SRX5075170,SMARCA4,278
chr1,161864652,161864899,SRX5075175,SMARCA4,247
chr1,161864652,161864913,SRX5075176,SMARCA4,261
chr1,161864659,161864925,SRX5716470,SMARCA4,266
chr1,161864717,161864941,SRX5716469,SMARCA4,224
chr1,161884941,161885433,SRX5075170,SMARCA4,492
chr1,161884944,161885374,SRX5020211,SMARCA2,430
chr1,161884950,161885439,SRX5075176,SMARCA4,489
chr1,161884956,161885478,SRX5075175,SMARCA4,522
chr1,161884969,161885402,SRX5716469,SMARCA4,433
chr1,161884978,161885308,SRX5075181,SMARCA2,330
chr1,161884990,161885475,SRX5075169,SMARCA4,485
chr1,161885003,161885392,SRX5716468,SMARCA2,389
chr1,161885022,161885433,SRX5054308,FOSL2,411
chr1,161885026,161885385,SRX5716470,SMARCA4,359
chr1,161885037,161885440,SRX5054309,FOSL2,403
chr1,161885040,161885373,SRX5020214,SMARCA2,333
chr1,161885057,161885355,SRX5716467,SMARCA2,298
chr1,161887828,161888268,SRX5075176,SMARCA4,440
chr1,161887954,161888294,SRX5075169,SMARCA4,340
chr1,161887959,161888251,SRX5075170,SMARCA4,292
chr1,161888096,161888292,SRX5054308,FOSL2,196
chr1,161921941,161922371,SRX5075176,SMARCA4,430
chr1,161921962,161922325,SRX5054308,FOSL2,363
chr1,161921967,161922339,SRX5075170,SMARCA4,372
chr1,161921983,161922341,SRX5054309,FOSL2,358
chr1,161921996,161922343,SRX5075175,SMARCA4,347
chr1,161922003,161922362,SRX5075169,SMARCA4,359
chr1,161922058,161922301,SRX5716467,SMARCA2,243
chr1,161930120,161930434,SRX5075170,SMARCA4,314
chr1,161930123,161930499,SRX5054309,FOSL2,376
chr1,161930150,161930460,SRX5054308,FOSL2,310
chr1,161930160,161930438,SRX5075169,SMARCA4,278
chr1,161930166,161930441,SRX5075176,SMARCA4,275
chr1,161930174,161930412,SRX5075175,SMARCA4,238
chr1,161930227,161930578,SRX5716467,SMARCA2,351
chr1,161946237,161946697,SRX5020211,SMARCA2,460
chr1,161946341,161946744,SRX5075174,SMARCA4,403
chr1,161946344,161946655,SRX5054309,FOSL2,311
chr1,161946345,161946752,SRX5075169,SMARCA4,407
chr1,161946365,161946641,SRX5020214,SMARCA2,276
chr1,161946368,161946704,SRX5054308,FOSL2,336
chr1,161946387,161946799,SRX5075175,SMARCA4,412
chr1,161946405,161946628,SRX5716468,SMARCA2,223
chr1,161946409,161946745,SRX5716469,SMARCA4,336
chr1,161946409,161946771,SRX5075170,SMARCA4,362
chr1,161946419,161946697,SRX5075168,SMARCA4,278
chr1,161946419,161946728,SRX5075176,SMARCA4,309
chr1,161946431,161946735,SRX5716470,SMARCA4,304
chr1,161946433,161946728,SRX5716467,SMARCA2,295
chr1,161946474,161946718,SRX5075181,SMARCA2,244
chr1,161956057,161956496,SRX5075176,SMARCA4,439
chr1,161956082,161956512,SRX5075170,SMARCA4,430
chr1,161956106,161956375,SRX5075169,SMARCA4,269
chr1,161956125,161956400,SRX5075175,SMARCA4,275
chr1,161956154,161956369,SRX5716467,SMARCA2,215
chr1,161956204,161956416,SRX5716469,SMARCA4,212
chr1,161956224,161956426,SRX5054309,FOSL2,202
chr1,161961998,161962960,SRX5075170,SMARCA4,962
chr1,161962001,161962363,SRX5716469,SMARCA4,362
chr1,161962035,161962925,SRX5075176,SMARCA4,890
chr1,161962074,161962904,SRX5075175,SMARCA4,830
chr1,161962083,161962335,SRX5054308,FOSL2,252
chr1,161962098,161963004,SRX5075169,SMARCA4,906
chr1,161962107,161962291,SRX5054309,FOSL2,184
chr1,161962246,161962869,SRX5716470,SMARCA4,623
chr1,161962401,161962907,SRX5075168,SMARCA4,506
chr1,161962419,161962966,SRX5716469,SMARCA4,547
chr1,161962501,161962940,SRX5075174,SMARCA4,439
chr1,161962546,161962872,SRX5020214,SMARCA2,326
chr1,161962556,161962941,SRX5054308,FOSL2,385
chr1,161962610,161962922,SRX5054309,FOSL2,312
chr1,161962621,161962923,SRX5020211,SMARCA2,302
chr1,162003009,162003534,SRX5075169,SMARCA4,525
chr1,162003046,162003503,SRX5075175,SMARCA4,457
chr1,162003050,162003517,SRX5075170,SMARCA4,467
chr1,162003068,162003409,SRX5020211,SMARCA2,341
chr1,162003080,162003496,SRX5054309,FOSL2,416
chr1,162003084,162003572,SRX5075176,SMARCA4,488
chr1,162003107,162003557,SRX5716469,SMARCA4,450
chr1,162003117,162003699,SRX5716470,SMARCA4,582
chr1,162003120,162003506,SRX5054308,FOSL2,386
chr1,162003205,162003472,SRX5716467,SMARCA2,267
chr1,162003215,162003433,SRX5716468,SMARCA2,218
chr1,162003231,162003473,SRX5020214,SMARCA2,242
chr1,162003873,162004268,SRX5075176,SMARCA4,395
chr1,162003904,162004190,SRX5075170,SMARCA4,286
chr1,162003908,162004263,SRX5716469,SMARCA4,355
chr1,162003914,162004254,SRX5075169,SMARCA4,340
chr1,162003957,162004257,SRX5075175,SMARCA4,300
chr1,162003989,162004209,SRX5054309,FOSL2,220
chr1,162023408,162024155,SRX20140895,INTS13,747
chr1,162023609,162024038,SRX20140868,INTS10,429
chr1,162023640,162023930,SRX20140867,INTS10,290
chr1,162023667,162024318,SRX5075174,SMARCA4,651
chr1,162023679,162024159,SRX5716463,SMARCA4,480
chr1,162023729,162024138,SRX5075168,SMARCA4,409
chr1,162024232,162024522,SRX5075170,SMARCA4,290
chr1,162036919,162037323,SRX16500059,CTCF,404
chr1,162036923,162037305,SRX16500060,CTCF,382
chr1,162036949,162037306,SRX16500062,CTCF,357
chr1,162036977,162037423,SRX16500061,CTCF,446
chr1,162055104,162055444,SRX5075170,SMARCA4,340
chr1,162055145,162055475,SRX5075176,SMARCA4,330
chr1,162055159,162055519,SRX5054309,FOSL2,360
chr1,162055165,162055437,SRX5075169,SMARCA4,272
chr1,162055192,162055515,SRX5075175,SMARCA4,323
chr1,162055206,162055418,SRX5716469,SMARCA4,212
chr1,162055913,162056364,SRX16500060,CTCF,451
chr1,162055924,162056432,SRX16500059,CTCF,508
chr1,162055925,162056394,SRX16500061,CTCF,469
chr1,162055943,162056402,SRX16500062,CTCF,459
chr1,162056007,162056392,SRX4174629,CTCF,385
chr1,162056037,162056300,SRX5075169,SMARCA4,263
chr1,162056080,162056260,SRX5075176,SMARCA4,180
chr1,162056095,162056333,SRX5075170,SMARCA4,238
chr1,162056095,162056391,SRX5075174,SMARCA4,296
chr1,162062540,162062921,SRX5075176,SMARCA4,381
chr1,162062640,162062847,SRX5075174,SMARCA4,207
chr1,162062651,162062888,SRX5075175,SMARCA4,237
chr1,162065408,162065845,SRX16500059,CTCF,437
chr1,162065435,162065778,SRX16500062,CTCF,343
chr1,162065451,162065758,SRX16500061,CTCF,307
chr1,162065470,162065779,SRX16500060,CTCF,309
chr1,162069421,162069971,SRX5075174,SMARCA4,550
chr1,162069428,162069885,SRX5075168,SMARCA4,457
chr1,162069444,162069655,SRX5716470,SMARCA4,211
chr1,162069496,162070010,SRX5075169,SMARCA4,514
chr1,162069506,162069888,SRX5075176,SMARCA4,382
chr1,162069718,162069952,SRX5075170,SMARCA4,234
chr1,162069777,162070045,SRX5075175,SMARCA4,268
chr1,162069821,162070037,SRX5716469,SMARCA4,216
chr1,162091808,162092166,SRX20140881,CPSF3L,358
chr1,162091815,162092062,SRX5716464,SMARCA4,247
chr1,162091911,162092347,SRX5075168,SMARCA4,436
chr1,162091931,162092297,SRX5075174,SMARCA4,366
chr1,162136775,162137084,SRX5054308,FOSL2,309
chr1,162136792,162137127,SRX5075169,SMARCA4,335
chr1,162136802,162137080,SRX5075174,SMARCA4,278
chr1,162136805,162137115,SRX5075175,SMARCA4,310
chr1,162136807,162137129,SRX5054309,FOSL2,322
chr1,162136817,162137072,SRX5075176,SMARCA4,255
chr1,162136859,162137079,SRX5075168,SMARCA4,220
chr1,162136886,162137063,SRX5075170,SMARCA4,177
chr1,162139343,162139547,SRX5075174,SMARCA4,204
chr1,162139343,162139587,SRX5075168,SMARCA4,244
chr1,162144915,162145103,SRX5075174,SMARCA4,188
chr1,162145291,162145834,SRX5075176,SMARCA4,543
chr1,162145301,162145774,SRX5075168,SMARCA4,473
chr1,162145338,162145832,SRX20140895,INTS13,494
chr1,162145408,162145789,SRX5075174,SMARCA4,381
chr1,162145442,162145714,SRX20140868,INTS10,272
chr1,162145472,162145731,SRX5075170,SMARCA4,259
chr1,162169104,162169583,SRX5075170,SMARCA4,479
chr1,162169247,162169438,SRX5075176,SMARCA4,191
chr1,162169270,162169555,SRX5075169,SMARCA4,285
chr1,162169732,162169942,SRX5075176,SMARCA4,210
chr1,162175403,162175735,SRX5075168,SMARCA4,332
chr1,162175415,162175796,SRX5075174,SMARCA4,381
chr1,162175483,162175815,SRX5716463,SMARCA4,332
chr1,162213654,162213966,SRX5075174,SMARCA4,312
chr1,162213667,162213880,SRX5075176,SMARCA4,213
chr1,162213673,162213927,SRX5075168,SMARCA4,254
chr1,162215985,162216164,SRX5075168,SMARCA4,179
chr1,162235219,162235799,SRX20140881,CPSF3L,580
chr1,162248798,162249400,SRX5075174,SMARCA4,602
chr1,162248804,162249495,SRX5075168,SMARCA4,691
chr1,162248830,162249175,SRX5716454,SOX3,345
chr1,162248835,162249242,SRX5716463,SMARCA4,407
chr1,162248843,162249203,SRX5716451,SOX2,360
chr1,162248865,162249187,SRX5075176,SMARCA4,322
chr1,162248878,162249191,SRX5075170,SMARCA4,313
chr1,162248885,162249224,SRX5054307,FOSL2,339
chr1,162248895,162249267,SRX20140879,CPSF3L,372
chr1,162248904,162249244,SRX20140860,SOX2,340
chr1,162248915,162249449,SRX20140895,INTS13,534
chr1,162248932,162249213,SRX5716464,SMARCA4,281
chr1,162248943,162249332,SRX20140867,INTS10,389
chr1,162259925,162260118,SRX5075174,SMARCA4,193
chr1,162270142,162270358,SRX5075176,SMARCA4,216
chr1,162276594,162276829,SRX16500059,CTCF,235
chr1,162292505,162292850,SRX5075176,SMARCA4,345
chr1,162292578,162292758,SRX5075169,SMARCA4,180
chr1,162292588,162292823,SRX5075170,SMARCA4,235
chr1,162292600,162292839,SRX5075174,SMARCA4,239
chr1,162292608,162292959,SRX5075168,SMARCA4,351
chr1,162302969,162303441,SRX5054309,FOSL2,472
chr1,162303003,162303358,SRX5075175,SMARCA4,355
chr1,162303016,162303381,SRX5075169,SMARCA4,365
chr1,162303018,162303423,SRX5075176,SMARCA4,405
chr1,162303042,162303364,SRX5054308,FOSL2,322
chr1,162303081,162303341,SRX5020214,SMARCA2,260
chr1,162303088,162303316,SRX5075170,SMARCA4,228
chr1,162310291,162310730,SRX5075176,SMARCA4,439
chr1,162310337,162310869,SRX5075168,SMARCA4,532
chr1,162310382,162310849,SRX5075174,SMARCA4,467
chr1,162310384,162310823,SRX5075170,SMARCA4,439
chr1,162310434,162310683,SRX5054309,FOSL2,249
chr1,162310464,162310712,SRX5075175,SMARCA4,248
chr1,162310476,162310764,SRX5075169,SMARCA4,288
chr1,162310488,162310668,SRX5054308,FOSL2,180
chr1,162329624,162329962,SRX5075169,SMARCA4,338
chr1,162329643,162330149,SRX5075175,SMARCA4,506
chr1,162329669,162330304,SRX5075176,SMARCA4,635
chr1,162329688,162329910,SRX5716470,SMARCA4,222
chr1,162329699,162329994,SRX5716467,SMARCA2,295
chr1,162329709,162330406,SRX5075170,SMARCA4,697
chr1,162329808,162330120,SRX5716469,SMARCA4,312
chr1,162334097,162334410,SRX5075168,SMARCA4,313
chr1,162334119,162334340,SRX5075174,SMARCA4,221
chr1,162334516,162334765,SRX5075174,SMARCA4,249
chr1,162335150,162335404,SRX5075176,SMARCA4,254
chr1,162335152,162335448,SRX5075170,SMARCA4,296
chr1,162349810,162350074,SRX5054309,FOSL2,264
chr1,162349816,162350075,SRX5075175,SMARCA4,259
chr1,162357612,162358029,SRX16500062,CTCF,417
chr1,162357639,162358001,SRX16500059,CTCF,362
chr1,162357644,162358104,SRX16500060,CTCF,460
chr1,162357702,162358030,SRX16500061,CTCF,328
chr1,162373889,162374082,SRX5075174,SMARCA4,193
chr1,162373922,162374143,SRX5075176,SMARCA4,221
chr1,162384536,162384849,SRX20140869,INTS10,313
chr1,162391994,162392553,SRX16500059,CTCF,559
chr1,162392038,162392557,SRX16500061,CTCF,519
chr1,162392050,162392472,SRX16500062,CTCF,422
chr1,162392058,162392404,SRX4174629,CTCF,346
chr1,162392075,162392493,SRX16500060,CTCF,418
chr1,162392124,162392299,SRX5075176,SMARCA4,175
chr1,162392151,162392390,SRX5075168,SMARCA4,239
chr1,162392195,162392440,SRX5075174,SMARCA4,245
chr1,162404820,162405006,SRX5075170,SMARCA4,186
chr1,162404854,162405086,SRX5054309,FOSL2,232
chr1,162404911,162405138,SRX5054308,FOSL2,227
chr1,162497513,162497948,SRX5075174,SMARCA4,435
chr1,162497523,162497824,SRX5075170,SMARCA4,301
chr1,162497576,162497765,SRX5075176,SMARCA4,189
chr1,162497590,162498004,SRX5075168,SMARCA4,414
chr1,162497626,162497906,SRX5075175,SMARCA4,280
chr1,162497703,162498108,SRX20140895,INTS13,405
chr1,162497720,162498057,SRX20140869,INTS10,337
chr1,162497894,162498141,SRX20140867,INTS10,247
chr1,162497901,162498074,SRX5075170,SMARCA4,173
chr1,162538737,162539299,SRX5075169,SMARCA4,562
chr1,162538807,162539470,SRX5054309,FOSL2,663
chr1,162538838,162539413,SRX5054308,FOSL2,575
chr1,162538909,162539398,SRX5716469,SMARCA4,489
chr1,162538916,162539336,SRX5075170,SMARCA4,420
chr1,162538922,162539137,SRX5020211,SMARCA2,215
chr1,162538938,162539251,SRX5716470,SMARCA4,313
chr1,162538994,162539346,SRX5075182,SMARCA2,352
chr1,162541724,162542250,SRX5075176,SMARCA4,526
chr1,162541778,162542177,SRX5075169,SMARCA4,399
chr1,162541779,162542124,SRX5716467,SMARCA2,345
chr1,162541785,162542222,SRX5075175,SMARCA4,437
chr1,162541806,162542163,SRX5075170,SMARCA4,357
chr1,162541836,162542047,SRX5716470,SMARCA4,211
chr1,162541852,162542118,SRX5054309,FOSL2,266
chr1,162541854,162542051,SRX5054308,FOSL2,197
chr1,162541916,162542174,SRX5716469,SMARCA4,258
chr1,162561043,162562046,SRX20140895,INTS13,1003
chr1,162561069,162561626,SRX5075169,SMARCA4,557
chr1,162561078,162561790,SRX5075170,SMARCA4,712
chr1,162561082,162561783,SRX5075175,SMARCA4,701
chr1,162561114,162561745,SRX5075176,SMARCA4,631
chr1,162561124,162561806,SRX5075174,SMARCA4,682
chr1,162561132,162561806,SRX5075168,SMARCA4,674
chr1,162561142,162561920,SRX20140868,INTS10,778
chr1,162561159,162561920,SRX20140867,INTS10,761
chr1,162561176,162562004,SRX20140897,INTS13,828
chr1,162561178,162561617,SRX5716470,SMARCA4,439
chr1,162561230,162561618,SRX5716463,SMARCA4,388
chr1,162561309,162561617,SRX5716464,SMARCA4,308
chr1,162561350,162561702,SRX5054309,FOSL2,352
chr1,162561372,162561636,SRX5054308,FOSL2,264
chr1,162561450,162561811,SRX5716469,SMARCA4,361
chr1,162561454,162561964,SRX20140869,INTS10,510
chr1,162561520,162561988,SRX20140879,CPSF3L,468
chr1,162561526,162562013,SRX20140881,CPSF3L,487
chr1,162561529,162561802,SRX5716468,SMARCA2,273
chr1,162561537,162561906,SRX20140894,INTS13,369
chr1,162561560,162561868,SRX20140896,INTS13,308
chr1,162561623,162561898,SRX20140882,CPSF3L,275
chr1,162578339,162578530,SRX5075176,SMARCA4,191
chr1,162578376,162578631,SRX5075170,SMARCA4,255
chr1,162605376,162605966,SRX5075175,SMARCA4,590
chr1,162605392,162605953,SRX5716469,SMARCA4,561
chr1,162605444,162605942,SRX5075169,SMARCA4,498
chr1,162605448,162605973,SRX5075176,SMARCA4,525
chr1,162605462,162605950,SRX5054309,FOSL2,488
chr1,162605486,162606004,SRX5075170,SMARCA4,518
chr1,162605506,162605911,SRX5716470,SMARCA4,405
chr1,162605522,162605942,SRX5054308,FOSL2,420
chr1,162605541,162605872,SRX5075182,SMARCA2,331
chr1,162605557,162605936,SRX5716467,SMARCA2,379
chr1,162605567,162605843,SRX5716468,SMARCA2,276
chr1,162605596,162605940,SRX5020214,SMARCA2,344
chr1,162605648,162605923,SRX5020211,SMARCA2,275
chr1,162613607,162614092,SRX16500059,CTCF,485
chr1,162613608,162613969,SRX5075169,SMARCA4,361
chr1,162613634,162614093,SRX16500060,CTCF,459
chr1,162613637,162614059,SRX16500061,CTCF,422
chr1,162613679,162614072,SRX4174629,CTCF,393
chr1,162613693,162614090,SRX16500062,CTCF,397
chr1,162613703,162614051,SRX5075176,SMARCA4,348
chr1,162613715,162614071,SRX5075174,SMARCA4,356
chr1,162613720,162614057,SRX5716470,SMARCA4,337
chr1,162613722,162614021,SRX5075170,SMARCA4,299
chr1,162613723,162614040,SRX5075175,SMARCA4,317
chr1,162613729,162614029,SRX5075168,SMARCA4,300
chr1,162613749,162614002,SRX5716463,SMARCA4,253
chr1,162613787,162613997,SRX5716464,SMARCA4,210
chr1,162626050,162626402,SRX5075176,SMARCA4,352
chr1,162626103,162626381,SRX5075170,SMARCA4,278
chr1,162627701,162628028,SRX16500062,CTCF,327
chr1,162627711,162628082,SRX16500061,CTCF,371
chr1,162627712,162627974,SRX16500060,CTCF,262
chr1,162627736,162628098,SRX16500059,CTCF,362
chr1,162629653,162630018,SRX5054309,FOSL2,365
chr1,162629653,162630021,SRX5075169,SMARCA4,368
chr1,162629656,162630005,SRX5054308,FOSL2,349
chr1,162629662,162629965,SRX5075175,SMARCA4,303
chr1,162629671,162630027,SRX5075176,SMARCA4,356
chr1,162629674,162629913,SRX5716467,SMARCA2,239
chr1,162629693,162629995,SRX5075170,SMARCA4,302
chr1,162629694,162629990,SRX5716469,SMARCA4,296
chr1,162629698,162629924,SRX5716470,SMARCA4,226
chr1,162629748,162629949,SRX5054307,FOSL2,201
chr1,162632153,162632558,SRX5075176,SMARCA4,405
chr1,162632169,162632516,SRX5716470,SMARCA4,347
chr1,162632219,162632591,SRX5075170,SMARCA4,372
chr1,162632222,162632554,SRX5075169,SMARCA4,332
chr1,162632250,162632503,SRX5716468,SMARCA2,253
chr1,162632261,162632518,SRX5075175,SMARCA4,257
chr1,162649540,162649923,SRX5075176,SMARCA4,383
chr1,162649550,162649960,SRX5716470,SMARCA4,410
chr1,162649569,162649976,SRX5716469,SMARCA4,407
chr1,162649577,162649932,SRX5716467,SMARCA2,355
chr1,162649581,162649878,SRX5075169,SMARCA4,297
chr1,162649607,162649900,SRX5075175,SMARCA4,293
chr1,162649608,162649911,SRX5716468,SMARCA2,303
chr1,162649613,162649876,SRX5054308,FOSL2,263
chr1,162649619,162649967,SRX5075170,SMARCA4,348
chr1,162649664,162649910,SRX5020211,SMARCA2,246
chr1,162663617,162663887,SRX5075170,SMARCA4,270
chr1,162663634,162663857,SRX5075174,SMARCA4,223
chr1,162663639,162663821,SRX5075169,SMARCA4,182
chr1,162663673,162663851,SRX5075176,SMARCA4,178
chr1,162667750,162667980,SRX5075176,SMARCA4,230
chr1,162673227,162673604,SRX5054309,FOSL2,377
chr1,162673335,162673537,SRX5054308,FOSL2,202
chr1,162673356,162673634,SRX5075169,SMARCA4,278
chr1,162676965,162677142,SRX5075176,SMARCA4,177
chr1,162690671,162691244,SRX5075175,SMARCA4,573
chr1,162690686,162691115,SRX5716469,SMARCA4,429
chr1,162690709,162691344,SRX5075176,SMARCA4,635
chr1,162690759,162691120,SRX5716470,SMARCA4,361
chr1,162690791,162691088,SRX5716460,Epitope tags,297
chr1,162690802,162691201,SRX5020214,SMARCA2,399
chr1,162690805,162691282,SRX5075169,SMARCA4,477
chr1,162690809,162691286,SRX5075168,SMARCA4,477
chr1,162690811,162691231,SRX5054309,FOSL2,420
chr1,162690820,162691299,SRX5075170,SMARCA4,479
chr1,162690867,162691248,SRX5075174,SMARCA4,381
chr1,162690905,162691183,SRX5054308,FOSL2,278
chr1,162690958,162691160,SRX5075182,SMARCA2,202
chr1,162696226,162696761,SRX5716470,SMARCA4,535
chr1,162696231,162696740,SRX5075170,SMARCA4,509
chr1,162696243,162696713,SRX5075176,SMARCA4,470
chr1,162696256,162696757,SRX5075174,SMARCA4,501
chr1,162696262,162696769,SRX5075175,SMARCA4,507
chr1,162696285,162696671,SRX5716469,SMARCA4,386
chr1,162696286,162696861,SRX5075168,SMARCA4,575
chr1,162696299,162696613,SRX5716464,SMARCA4,314
chr1,162696308,162696655,SRX5075169,SMARCA4,347
chr1,162696318,162696554,SRX5020211,SMARCA2,236
chr1,162696324,162696664,SRX5716467,SMARCA2,340
chr1,162696332,162696589,SRX5716463,SMARCA4,257
chr1,162696336,162696524,SRX5054308,FOSL2,188
chr1,162696359,162696542,SRX5054309,FOSL2,183
chr1,162696366,162696563,SRX5075181,SMARCA2,197
chr1,162696366,162696588,SRX5716468,SMARCA2,222
chr1,162711056,162711433,SRX5716469,SMARCA4,377
chr1,162711069,162711477,SRX5716470,SMARCA4,408
chr1,162711098,162711378,SRX5075176,SMARCA4,280
chr1,162711117,162711411,SRX5716468,SMARCA2,294
chr1,162711118,162711496,SRX5075170,SMARCA4,378
chr1,162711142,162711434,SRX5075169,SMARCA4,292
chr1,162711154,162711525,SRX5075175,SMARCA4,371
chr1,162711171,162711410,SRX5054309,FOSL2,239
chr1,162711174,162711469,SRX5716467,SMARCA2,295
chr1,162711214,162711420,SRX5054308,FOSL2,206
chr1,162711216,162711439,SRX5075181,SMARCA2,223
chr1,162785928,162786369,SRX5075174,SMARCA4,441
chr1,162786059,162786316,SRX5075168,SMARCA4,257
chr1,162790324,162790622,SRX5075168,SMARCA4,298
chr1,162790345,162790564,SRX16500061,CTCF,219
chr1,162790417,162790624,SRX5075176,SMARCA4,207
chr1,162790442,162790696,SRX16500062,CTCF,254
chr1,162800211,162800653,SRX16500060,CTCF,442
chr1,162800222,162800526,SRX4174629,CTCF,304
chr1,162800248,162800639,SRX16500059,CTCF,391
chr1,162800257,162800616,SRX16500062,CTCF,359
chr1,162800281,162800643,SRX16500061,CTCF,362
chr1,162800299,162800571,SRX5075170,SMARCA4,272
chr1,162817763,162817958,SRX5054309,FOSL2,195
chr1,162822336,162822548,SRX5716469,SMARCA4,212
chr1,162822394,162822712,SRX5716470,SMARCA4,318
chr1,162822411,162822618,SRX5075169,SMARCA4,207
chr1,162835298,162835610,SRX5075170,SMARCA4,312
chr1,162835311,162835547,SRX5075176,SMARCA4,236
chr1,162845046,162845248,SRX5075170,SMARCA4,202
chr1,162846909,162847098,SRX5075176,SMARCA4,189
chr1,162847766,162848302,SRX16500059,CTCF,536
chr1,162847787,162848388,SRX16500060,CTCF,601
chr1,162847791,162848235,SRX16500062,CTCF,444
chr1,162847795,162848281,SRX16500061,CTCF,486
chr1,162847845,162848183,SRX4174629,CTCF,338
chr1,162847875,162848200,SRX5716463,SMARCA4,325
chr1,162847880,162848136,SRX5075170,SMARCA4,256
chr1,162847893,162848170,SRX5075168,SMARCA4,277
chr1,162847901,162848158,SRX5075176,SMARCA4,257
chr1,162847914,162848187,SRX5075174,SMARCA4,273
chr1,162847927,162848155,SRX5716464,SMARCA4,228
chr1,162854087,162854671,SRX16500060,CTCF,584
chr1,162854137,162854670,SRX16500061,CTCF,533
chr1,162854201,162854660,SRX16500059,CTCF,459
chr1,162854262,162854699,SRX16500062,CTCF,437
chr1,162854265,162854551,SRX5075168,SMARCA4,286
chr1,162854290,162854575,SRX5075174,SMARCA4,285
chr1,162854312,162854570,SRX5716463,SMARCA4,258
chr1,162854334,162854558,SRX5075170,SMARCA4,224
chr1,162854371,162854554,SRX5075176,SMARCA4,183
chr1,162856183,162856641,SRX5075169,SMARCA4,458
chr1,162856221,162856640,SRX5716470,SMARCA4,419
chr1,162856226,162856631,SRX5075176,SMARCA4,405
chr1,162856251,162856681,SRX5075170,SMARCA4,430
chr1,162856252,162856578,SRX5020211,SMARCA2,326
chr1,162856261,162856612,SRX5716467,SMARCA2,351
chr1,162856263,162856637,SRX5054308,FOSL2,374
chr1,162856270,162856632,SRX5054309,FOSL2,362
chr1,162856290,162856675,SRX5075175,SMARCA4,385
chr1,162856299,162856637,SRX5716469,SMARCA4,338
chr1,162856314,162856525,SRX5716468,SMARCA2,211
chr1,162873801,162873981,SRX5075169,SMARCA4,180
chr1,162877981,162878420,SRX16500060,CTCF,439
chr1,162877988,162878418,SRX16500062,CTCF,430
chr1,162877991,162878413,SRX16500061,CTCF,422
chr1,162878006,162878436,SRX16500059,CTCF,430
chr1,162878083,162878386,SRX4174629,CTCF,303
chr1,162878161,162878349,SRX5075169,SMARCA4,188
chr1,162899683,162900044,SRX5054308,FOSL2,361
chr1,162899687,162900087,SRX5075169,SMARCA4,400
chr1,162899726,162899986,SRX5716470,SMARCA4,260
chr1,162899790,162900014,SRX5716469,SMARCA4,224
chr1,162899792,162900064,SRX5020211,SMARCA2,272
chr1,162905566,162906042,SRX5075176,SMARCA4,476
chr1,162905605,162906064,SRX5075169,SMARCA4,459
chr1,162905639,162906012,SRX5716467,SMARCA2,373
chr1,162905656,162906054,SRX5075175,SMARCA4,398
chr1,162905661,162906007,SRX5716469,SMARCA4,346
chr1,162905675,162905989,SRX5020211,SMARCA2,314
chr1,162905681,162905999,SRX5716470,SMARCA4,318
chr1,162905682,162906009,SRX5054308,FOSL2,327
chr1,162905709,162906040,SRX5054309,FOSL2,331
chr1,162905719,162906041,SRX5075170,SMARCA4,322
chr1,162905738,162905983,SRX5020214,SMARCA2,245
chr1,162905777,162905972,SRX5075182,SMARCA2,195
chr1,162908777,162909198,SRX5075169,SMARCA4,421
chr1,162908833,162909115,SRX5075176,SMARCA4,282
chr1,162908839,162909081,SRX5054308,FOSL2,242
chr1,162908842,162909148,SRX5054309,FOSL2,306
chr1,162908847,162909164,SRX5075175,SMARCA4,317
chr1,162908871,162909105,SRX5075170,SMARCA4,234
chr1,162916455,162916785,SRX5054309,FOSL2,330
chr1,162916543,162916737,SRX5054308,FOSL2,194
chr1,162943227,162943433,SRX5075175,SMARCA4,206
chr1,162943230,162943498,SRX5075176,SMARCA4,268
chr1,162943234,162943424,SRX5075170,SMARCA4,190
chr1,162943265,162943477,SRX5716469,SMARCA4,212
chr1,162943265,162943536,SRX5716470,SMARCA4,271
chr1,162943274,162943596,SRX5075169,SMARCA4,322
chr1,162943570,162943896,SRX20140869,INTS10,326
chr1,162943636,162943854,SRX5075170,SMARCA4,218
chr1,162973308,162973838,SRX5054309,FOSL2,530
chr1,162973332,162973814,SRX5054308,FOSL2,482
chr1,162973338,162973832,SRX5075175,SMARCA4,494
chr1,162973351,162973551,SRX5020211,SMARCA2,200
chr1,162973386,162973873,SRX5075170,SMARCA4,487
chr1,162973409,162973738,SRX5075169,SMARCA4,329
chr1,162973567,162973822,SRX5075176,SMARCA4,255
chr1,162973568,162973802,SRX5716469,SMARCA4,234
chr1,162973593,162973825,SRX5716470,SMARCA4,232
chr1,162997591,162997840,SRX5075169,SMARCA4,249
chr1,162997597,162997810,SRX5054309,FOSL2,213
chr1,163035427,163036086,SRX5054308,FOSL2,659
chr1,163035446,163036304,SRX5075170,SMARCA4,858
chr1,163035451,163036152,SRX5716469,SMARCA4,701
chr1,163035466,163036309,SRX5075176,SMARCA4,843
chr1,163035481,163036185,SRX5054309,FOSL2,704
chr1,163035484,163036096,SRX5020211,SMARCA2,612
chr1,163035511,163036238,SRX5075175,SMARCA4,727
chr1,163035522,163036256,SRX5075169,SMARCA4,734
chr1,163035523,163035702,SRX5075182,SMARCA2,179
chr1,163035559,163036072,SRX5716467,SMARCA2,513
chr1,163035631,163035935,SRX5020214,SMARCA2,304
chr1,163035682,163036186,SRX5716470,SMARCA4,504
chr1,163035763,163036022,SRX5716459,Epitope tags,259
chr1,163035787,163036032,SRX5716468,SMARCA2,245
chr1,163035870,163036052,SRX5075174,SMARCA4,182
chr1,163056875,163057156,SRX5075169,SMARCA4,281
chr1,163056900,163057181,SRX5054308,FOSL2,281
chr1,163056921,163057166,SRX5054309,FOSL2,245
chr1,163056981,163057162,SRX5075176,SMARCA4,181
chr1,163063565,163064070,SRX5075176,SMARCA4,505
chr1,163063572,163063989,SRX5075170,SMARCA4,417
chr1,163063605,163063865,SRX5075175,SMARCA4,260
chr1,163063621,163063921,SRX5075169,SMARCA4,300
chr1,163063656,163063991,SRX5716470,SMARCA4,335
chr1,163069058,163069504,SRX5075168,SMARCA4,446
chr1,163069067,163069512,SRX5075176,SMARCA4,445
chr1,163069115,163069462,SRX5075170,SMARCA4,347
chr1,163069122,163069419,SRX5075175,SMARCA4,297
chr1,163069140,163069570,SRX4174629,CTCF,430
chr1,163069142,163069535,SRX5075174,SMARCA4,393
chr1,163069152,163069403,SRX5075169,SMARCA4,251
chr1,163069155,163069451,SRX5054308,FOSL2,296
chr1,163069164,163069532,SRX16500062,CTCF,368
chr1,163069191,163069488,SRX5716463,SMARCA4,297
chr1,163069209,163069560,SRX5716469,SMARCA4,351
chr1,163069241,163069625,SRX16500060,CTCF,384
chr1,163069244,163069568,SRX16500059,CTCF,324
chr1,163069245,163069522,SRX16500061,CTCF,277
chr1,163071774,163072224,SRX16500059,CTCF,450
chr1,163071777,163072255,SRX16500060,CTCF,478
chr1,163071793,163072185,SRX16500062,CTCF,392
chr1,163071863,163072209,SRX16500061,CTCF,346
chr1,163071864,163072087,SRX4174629,CTCF,223
chr1,163085533,163085908,SRX5075175,SMARCA4,375
chr1,163085537,163085868,SRX5075176,SMARCA4,331
chr1,163085565,163085881,SRX5075170,SMARCA4,316
chr1,163085637,163085905,SRX5075169,SMARCA4,268
chr1,163085657,163085884,SRX5716469,SMARCA4,227
chr1,163085662,163085872,SRX5054309,FOSL2,210
chr1,163090639,163090819,SRX5054308,FOSL2,180
chr1,163094263,163094472,SRX5054308,FOSL2,209
chr1,163094267,163094458,SRX5054309,FOSL2,191
chr1,163094607,163094967,SRX5075170,SMARCA4,360
chr1,163094614,163094889,SRX5075169,SMARCA4,275
chr1,163094697,163094934,SRX5075176,SMARCA4,237
chr1,163162356,163162899,SRX5054309,FOSL2,543
chr1,163162381,163162887,SRX5716469,SMARCA4,506
chr1,163162404,163162907,SRX5054308,FOSL2,503
chr1,163162411,163162936,SRX5075176,SMARCA4,525
chr1,163162412,163162943,SRX5075170,SMARCA4,531
chr1,163162414,163162935,SRX5075175,SMARCA4,521
chr1,163162415,163162913,SRX5075169,SMARCA4,498
chr1,163162517,163162853,SRX5716470,SMARCA4,336
chr1,163162526,163162906,SRX5020211,SMARCA2,380
chr1,163162544,163162907,SRX5716467,SMARCA2,363
chr1,163162635,163162927,SRX5020214,SMARCA2,292
chr1,163162714,163162914,SRX5075181,SMARCA2,200
chr1,163168008,163168490,SRX5075176,SMARCA4,482
chr1,163168022,163168446,SRX5075169,SMARCA4,424
chr1,163168040,163168467,SRX5075170,SMARCA4,427
chr1,163168046,163168444,SRX5054308,FOSL2,398
chr1,163168047,163168433,SRX5054309,FOSL2,386
chr1,163168050,163168365,SRX5716470,SMARCA4,315
chr1,163168068,163168463,SRX5075175,SMARCA4,395
chr1,163168072,163168391,SRX5716469,SMARCA4,319
chr1,163168075,163168418,SRX5716467,SMARCA2,343
chr1,163168113,163168342,SRX5716468,SMARCA2,229
chr1,163168115,163168373,SRX5020211,SMARCA2,258
chr1,163168115,163168400,SRX5075168,SMARCA4,285
chr1,163168143,163168435,SRX5020214,SMARCA2,292
chr1,163168151,163168371,SRX5075174,SMARCA4,220
chr1,163168176,163168370,SRX5075181,SMARCA2,194
chr1,163171137,163171360,SRX16500060,CTCF,223
chr1,163173285,163173505,SRX5075169,SMARCA4,220
chr1,163174708,163175092,SRX4174629,CTCF,384
chr1,163174720,163175173,SRX16500059,CTCF,453
chr1,163174736,163175170,SRX16500061,CTCF,434
chr1,163174769,163175179,SRX16500062,CTCF,410
chr1,163174776,163175195,SRX16500060,CTCF,419
chr1,163174860,163175092,SRX5075174,SMARCA4,232
chr1,163174926,163175105,SRX5075168,SMARCA4,179
chr1,163202777,163203314,SRX20140881,CPSF3L,537
chr1,163202947,163203321,SRX20140897,INTS13,374
chr1,163202973,163203381,SRX20140869,INTS10,408
chr1,163203012,163203642,SRX5075168,SMARCA4,630
chr1,163203087,163203589,SRX5716463,SMARCA4,502
chr1,163203149,163203534,SRX5075174,SMARCA4,385
chr1,163203167,163203511,SRX5716464,SMARCA4,344
chr1,163203169,163203609,SRX5075170,SMARCA4,440
chr1,163203205,163203479,SRX5075169,SMARCA4,274
chr1,163203209,163203561,SRX5716470,SMARCA4,352
chr1,163203219,163203538,SRX5075176,SMARCA4,319
chr1,163203266,163203559,SRX5075175,SMARCA4,293
chr1,163203292,163203545,SRX5716469,SMARCA4,253
chr1,163203299,163203521,SRX5716467,SMARCA2,222
chr1,163231390,163231639,SRX5716467,SMARCA2,249
chr1,163231407,163231752,SRX5075176,SMARCA4,345
chr1,163231425,163231702,SRX5716470,SMARCA4,277
chr1,163231453,163231725,SRX5716469,SMARCA4,272
chr1,163257696,163258590,SRX5075169,SMARCA4,894
chr1,163257711,163258492,SRX5716470,SMARCA4,781
chr1,163257847,163258516,SRX5716469,SMARCA4,669
chr1,163258214,163258469,SRX5075175,SMARCA4,255
chr1,163258278,163258451,SRX5075170,SMARCA4,173
chr1,163258285,163258555,SRX5054308,FOSL2,270
chr1,163258294,163258548,SRX5054309,FOSL2,254
chr1,163307582,163307843,SRX5054308,FOSL2,261
chr1,163307590,163307785,SRX5075169,SMARCA4,195
chr1,163307601,163307852,SRX5075175,SMARCA4,251
chr1,163315703,163316221,SRX16500059,CTCF,518
chr1,163315728,163316193,SRX16500062,CTCF,465
chr1,163315738,163316264,SRX16500060,CTCF,526
chr1,163315760,163316183,SRX16500061,CTCF,423
chr1,163315787,163316062,SRX5075176,SMARCA4,275
chr1,163315854,163316031,SRX5075170,SMARCA4,177
chr1,163321536,163322018,SRX5075168,SMARCA4,482
chr1,163321569,163322048,SRX5075170,SMARCA4,479
chr1,163321578,163322237,SRX20140869,INTS10,659
chr1,163321583,163322112,SRX5075174,SMARCA4,529
chr1,163321586,163322247,SRX20140895,INTS13,661
chr1,163321637,163322072,SRX5075175,SMARCA4,435
chr1,163321644,163322008,SRX20140897,INTS13,364
chr1,163321647,163321951,SRX5716464,SMARCA4,304
chr1,163321666,163322122,SRX5716463,SMARCA4,456
chr1,163321669,163322051,SRX5075176,SMARCA4,382
chr1,163321678,163322013,SRX20140881,CPSF3L,335
chr1,163321680,163321908,SRX5020211,SMARCA2,228
chr1,163321700,163321974,SRX5075169,SMARCA4,274
chr1,163321701,163322022,SRX5716467,SMARCA2,321
chr1,163321702,163322090,SRX20140867,INTS10,388
chr1,163321720,163322052,SRX5716470,SMARCA4,332
chr1,163321766,163322005,SRX5716469,SMARCA4,239
chr1,163321775,163322022,SRX20140894,INTS13,247
chr1,163321787,163322027,SRX20140879,CPSF3L,240
chr1,163321818,163321997,SRX5054307,FOSL2,179
chr1,163321842,163322057,SRX5054309,FOSL2,215
chr1,163359130,163359509,SRX16500061,CTCF,379
chr1,163359130,163359542,SRX16500059,CTCF,412
chr1,163359137,163359518,SRX16500060,CTCF,381
chr1,163359153,163359504,SRX16500062,CTCF,351
chr1,163359561,163359785,SRX4174629,CTCF,224
chr1,163361114,163361538,SRX16500060,CTCF,424
chr1,163361135,163361471,SRX16500061,CTCF,336
chr1,163361135,163361486,SRX16500059,CTCF,351
chr1,163361160,163361495,SRX16500062,CTCF,335
chr1,163395890,163396059,SRX5075170,SMARCA4,169
chr1,163395966,163396151,SRX5054309,FOSL2,185
chr1,163399931,163400298,SRX5075168,SMARCA4,367
chr1,163399959,163400276,SRX5075174,SMARCA4,317
chr1,163400075,163400279,SRX5716463,SMARCA4,204
chr1,163409877,163410408,SRX16500061,CTCF,531
chr1,163409936,163410440,SRX16500059,CTCF,504
chr1,163409964,163410429,SRX16500060,CTCF,465
chr1,163409973,163410418,SRX16500062,CTCF,445
chr1,163410005,163410553,SRX5075174,SMARCA4,548
chr1,163410012,163410457,SRX5075168,SMARCA4,445
chr1,163410022,163410379,SRX5075170,SMARCA4,357
chr1,163410024,163410449,SRX5075176,SMARCA4,425
chr1,163410045,163410333,SRX5075169,SMARCA4,288
chr1,163410049,163410325,SRX5716470,SMARCA4,276
chr1,163410062,163410267,SRX5716464,SMARCA4,205
chr1,163410114,163410439,SRX5716463,SMARCA4,325
chr1,163410278,163410609,SRX20140895,INTS13,331
chr1,163426840,163427182,SRX5075168,SMARCA4,342
chr1,163426860,163427260,SRX5075174,SMARCA4,400
chr1,163472303,163472567,SRX5075168,SMARCA4,264
chr1,163528643,163529117,SRX16500059,CTCF,474
chr1,163528682,163529133,SRX16500061,CTCF,451
chr1,163528683,163529096,SRX16500062,CTCF,413
chr1,163528697,163529129,SRX16500060,CTCF,432
chr1,163528852,163529068,SRX5075174,SMARCA4,216
chr1,163535802,163536180,SRX16500059,CTCF,378
chr1,163535804,163536076,SRX16500060,CTCF,272
chr1,163535834,163536124,SRX16500061,CTCF,290
chr1,163561538,163561968,SRX16500060,CTCF,430
chr1,163561561,163561907,SRX16500061,CTCF,346
chr1,163561564,163561946,SRX16500059,CTCF,382
chr1,163561629,163561942,SRX16500062,CTCF,313
chr1,163565170,163565577,SRX5075168,SMARCA4,407
chr1,163565179,163565487,SRX5075176,SMARCA4,308
chr1,163565181,163565435,SRX20140867,INTS10,254
chr1,163565208,163565412,SRX5075170,SMARCA4,204
chr1,163565295,163565570,SRX5075174,SMARCA4,275
chr1,163565308,163565519,SRX5716470,SMARCA4,211
chr1,163709696,163710041,SRX5054309,FOSL2,345
chr1,163709736,163709940,SRX5075174,SMARCA4,204
chr1,163796352,163796521,SRX5075170,SMARCA4,169
chr1,163796407,163796602,SRX5075176,SMARCA4,195
chr1,163824015,163824482,SRX5075170,SMARCA4,467
chr1,163824028,163824419,SRX5075176,SMARCA4,391
chr1,163824067,163824425,SRX5075175,SMARCA4,358
chr1,163824082,163824417,SRX5075169,SMARCA4,335
chr1,163824100,163824397,SRX5054309,FOSL2,297
chr1,163824143,163824547,SRX5716469,SMARCA4,404
chr1,163824237,163824487,SRX5054308,FOSL2,250
chr1,163844463,163844790,SRX5075176,SMARCA4,327
chr1,163844493,163844676,SRX5054309,FOSL2,183
chr1,163844522,163844809,SRX5075170,SMARCA4,287
chr1,163844527,163844707,SRX5075169,SMARCA4,180
chr1,163844548,163844785,SRX5075175,SMARCA4,237
chr1,163870709,163870955,SRX5054309,FOSL2,246
chr1,163870785,163871068,SRX5716469,SMARCA4,283
chr1,163874126,163874510,SRX16500062,CTCF,384
chr1,163874136,163874500,SRX16500060,CTCF,364
chr1,163874182,163874464,SRX16500059,CTCF,282
chr1,163874266,163874536,SRX16500061,CTCF,270
chr1,163875535,163875765,SRX5075175,SMARCA4,230
chr1,163875553,163875989,SRX5075174,SMARCA4,436
chr1,163875565,163876022,SRX5075170,SMARCA4,457
chr1,163875571,163876002,SRX5075176,SMARCA4,431
chr1,163875610,163875949,SRX5075168,SMARCA4,339
chr1,163875617,163875868,SRX5075169,SMARCA4,251
chr1,163875646,163875891,SRX5716470,SMARCA4,245
chr1,163875681,163875977,SRX5716463,SMARCA4,296
chr1,163875684,163875935,SRX5716469,SMARCA4,251
chr1,163882660,163882927,SRX5075170,SMARCA4,267
chr1,163882728,163882932,SRX5054309,FOSL2,204
chr1,163897547,163897743,SRX5075170,SMARCA4,196
chr1,163928479,163929063,SRX5075174,SMARCA4,584
chr1,163928606,163929060,SRX5075168,SMARCA4,454
chr1,163928753,163929062,SRX5716463,SMARCA4,309
chr1,163970575,163971065,SRX5075174,SMARCA4,490
chr1,163970770,163971160,SRX5075168,SMARCA4,390
chr1,163970831,163971059,SRX5716463,SMARCA4,228
chr1,164092662,164092930,SRX16500062,CTCF,268
chr1,164155475,164155654,SRX5075168,SMARCA4,179
chr1,164163305,164163821,SRX5075174,SMARCA4,516
chr1,164163328,164163945,SRX5075168,SMARCA4,617
chr1,164310213,164310529,SRX5054309,FOSL2,316
chr1,164320903,164321108,SRX5075168,SMARCA4,205
chr1,164320912,164321096,SRX5075174,SMARCA4,184
chr1,164321007,164321254,SRX5075170,SMARCA4,247
chr1,164321174,164321631,SRX5716470,SMARCA4,457
chr1,164321342,164321560,SRX5075170,SMARCA4,218
chr1,164325705,164326294,SRX5075168,SMARCA4,589
chr1,164325778,164326281,SRX5075174,SMARCA4,503
chr1,164325823,164326154,SRX20140894,INTS13,331
chr1,164325827,164326283,SRX5716463,SMARCA4,456
chr1,164325916,164326207,SRX20140895,INTS13,291
chr1,164325916,164326217,SRX5716454,SOX3,301
chr1,164325919,164326228,SRX5716451,SOX2,309
chr1,164325946,164326284,SRX20140868,INTS10,338
chr1,164325959,164326248,SRX5716464,SMARCA4,289
chr1,164337905,164338283,SRX5075168,SMARCA4,378
chr1,164337937,164338253,SRX5075174,SMARCA4,316
chr1,164337967,164338178,SRX5716463,SMARCA4,211
chr1,164338010,164338189,SRX5054307,FOSL2,179
chr1,164380888,164381281,SRX5075176,SMARCA4,393
chr1,164380889,164381256,SRX5075170,SMARCA4,367
chr1,164380940,164381277,SRX5054309,FOSL2,337
chr1,164380983,164381193,SRX5075175,SMARCA4,210
chr1,164440310,164440550,SRX16500059,CTCF,240
chr1,164524793,164525165,SRX5075176,SMARCA4,372
chr1,164524861,164525211,SRX5054309,FOSL2,350
chr1,164524917,164525175,SRX5075170,SMARCA4,258
chr1,164524971,164525172,SRX5054308,FOSL2,201
chr1,164541137,164541194,SRX1424892,POU3F2,57
chr1,164541148,164541191,SRX1424894,POU3F2,43
chr1,164558595,164559250,SRX5075174,SMARCA4,655
chr1,164558681,164559154,SRX5075170,SMARCA4,473
chr1,164558725,164559000,SRX20140897,INTS13,275
chr1,164558734,164559255,SRX5075168,SMARCA4,521
chr1,164558759,164559101,SRX5716463,SMARCA4,342
chr1,164558857,164559077,SRX5054307,FOSL2,220
chr1,164558862,164559108,SRX5716464,SMARCA4,246
chr1,164558904,164559298,SRX5075176,SMARCA4,394
chr1,164559078,164559297,SRX5716470,SMARCA4,219
chr1,164577041,164577301,SRX5054309,FOSL2,260
chr1,164577083,164577536,SRX5075175,SMARCA4,453
chr1,164577128,164577334,SRX5054308,FOSL2,206
chr1,164577156,164577340,SRX5075169,SMARCA4,184
chr1,164577359,164577542,SRX5075176,SMARCA4,183
chr1,164577365,164577635,SRX5075170,SMARCA4,270
chr1,164577417,164577630,SRX5075169,SMARCA4,213
chr1,164588563,164588826,SRX5075170,SMARCA4,263
chr1,164588571,164588910,SRX5075176,SMARCA4,339
chr1,164588619,164588873,SRX5075169,SMARCA4,254
chr1,164588630,164589161,SRX20140895,INTS13,531
chr1,164589002,164589297,SRX5075168,SMARCA4,295
chr1,164589021,164589306,SRX5075174,SMARCA4,285
chr1,164591789,164592221,SRX5075174,SMARCA4,432
chr1,164591841,164592193,SRX5716464,SMARCA4,352
chr1,164591841,164592210,SRX5075168,SMARCA4,369
chr1,164591843,164592167,SRX5075181,SMARCA2,324
chr1,164591849,164592166,SRX5716467,SMARCA2,317
chr1,164591850,164592201,SRX5716470,SMARCA4,351
chr1,164591855,164592142,SRX5075170,SMARCA4,287
chr1,164591863,164592137,SRX5716469,SMARCA4,274
chr1,164591863,164592231,SRX5075169,SMARCA4,368
chr1,164591877,164592117,SRX5716468,SMARCA2,240
chr1,164591887,164592067,SRX5054308,FOSL2,180
chr1,164591887,164592168,SRX5716463,SMARCA4,281
chr1,164591894,164592209,SRX5054309,FOSL2,315
chr1,164591898,164592201,SRX5075176,SMARCA4,303
chr1,164591906,164592293,SRX5075175,SMARCA4,387
chr1,164602612,164603119,SRX5075169,SMARCA4,507
chr1,164602651,164603164,SRX5075170,SMARCA4,513
chr1,164602678,164603104,SRX5716470,SMARCA4,426
chr1,164602679,164603152,SRX5075176,SMARCA4,473
chr1,164602709,164603034,SRX5716467,SMARCA2,325
chr1,164602728,164603082,SRX5716469,SMARCA4,354
chr1,164602752,164603089,SRX5075174,SMARCA4,337
chr1,164602764,164603044,SRX5075175,SMARCA4,280
chr1,164602956,164603159,SRX5075168,SMARCA4,203
chr1,164604628,164604873,SRX5054309,FOSL2,245
chr1,164604660,164604850,SRX5054308,FOSL2,190
chr1,164608776,164609049,SRX5075169,SMARCA4,273
chr1,164608789,164609100,SRX5075175,SMARCA4,311
chr1,164608822,164609024,SRX5075176,SMARCA4,202
chr1,164608825,164609113,SRX5075170,SMARCA4,288
chr1,164611742,164612144,SRX5075170,SMARCA4,402
chr1,164611754,164612149,SRX5075174,SMARCA4,395
chr1,164611756,164612151,SRX5716470,SMARCA4,395
chr1,164611764,164612167,SRX5075176,SMARCA4,403
chr1,164611776,164612159,SRX5075168,SMARCA4,383
chr1,164611792,164612205,SRX5075169,SMARCA4,413
chr1,164611813,164612107,SRX5075175,SMARCA4,294
chr1,164611815,164612122,SRX5716469,SMARCA4,307
chr1,164611819,164612030,SRX5020211,SMARCA2,211
chr1,164611836,164612047,SRX5075182,SMARCA2,211
chr1,164617843,164618192,SRX16500060,CTCF,349
chr1,164617845,164618189,SRX16500059,CTCF,344
chr1,164617848,164618127,SRX16500062,CTCF,279
chr1,164617876,164618189,SRX16500061,CTCF,313
chr1,164624980,164625413,SRX16500062,CTCF,433
chr1,164625019,164625423,SRX16500060,CTCF,404
chr1,164625042,164625463,SRX16500061,CTCF,421
chr1,164625118,164625469,SRX16500059,CTCF,351
chr1,164635084,164635430,SRX5075168,SMARCA4,346
chr1,164635135,164635340,SRX5075174,SMARCA4,205
chr1,164637659,164638367,SRX5075176,SMARCA4,708
chr1,164637715,164638360,SRX5075168,SMARCA4,645
chr1,164637726,164638046,SRX5054309,FOSL2,320
chr1,164637726,164638188,SRX5075170,SMARCA4,462
chr1,164637728,164638043,SRX5075169,SMARCA4,315
chr1,164637729,164638038,SRX5054308,FOSL2,309
chr1,164637738,164638277,SRX5075174,SMARCA4,539
chr1,164637758,164638024,SRX5075175,SMARCA4,266
chr1,164637777,164638003,SRX5054307,FOSL2,226
chr1,164637786,164638174,SRX5716469,SMARCA4,388
chr1,164638005,164638222,SRX5716464,SMARCA4,217
chr1,164644749,164645240,SRX5075170,SMARCA4,491
chr1,164644791,164645004,SRX5716469,SMARCA4,213
chr1,164644850,164645288,SRX5075176,SMARCA4,438
chr1,164644862,164645286,SRX5054309,FOSL2,424
chr1,164644899,164645640,SRX5075168,SMARCA4,741
chr1,164644922,164645664,SRX5075174,SMARCA4,742
chr1,164644962,164645281,SRX5054308,FOSL2,319
chr1,164645080,164645564,SRX20140895,INTS13,484
chr1,164645144,164645631,SRX5716463,SMARCA4,487
chr1,164645145,164645458,SRX20140867,INTS10,313
chr1,164645184,164645523,SRX20140868,INTS10,339
chr1,164645290,164645514,SRX5716451,SOX2,224
chr1,164645354,164645466,SRX1424893,POU3F2,112
chr1,164645398,164645464,SRX1424891,POU3F2,66
chr1,164648800,164649116,SRX5054309,FOSL2,316
chr1,164651374,164651578,SRX5075168,SMARCA4,204
chr1,164671565,164671959,SRX5075168,SMARCA4,394
chr1,164671583,164671839,SRX5075174,SMARCA4,256
chr1,164673597,164673996,SRX16500059,CTCF,399
chr1,164673659,164673996,SRX16500060,CTCF,337
chr1,164673666,164673999,SRX16500062,CTCF,333
chr1,164673693,164673989,SRX16500061,CTCF,296
chr1,164690076,164690507,SRX5075168,SMARCA4,431
chr1,164690110,164690548,SRX5075174,SMARCA4,438
chr1,164704953,164705312,SRX16500061,CTCF,359
chr1,164705023,164705391,SRX16500059,CTCF,368
chr1,164705033,164705270,SRX16500060,CTCF,237
chr1,164705073,164705404,SRX16500062,CTCF,331
chr1,164726312,164726615,SRX5054309,FOSL2,303
chr1,164728709,164729111,SRX5716469,SMARCA4,402
chr1,164728725,164729095,SRX5075175,SMARCA4,370
chr1,164728725,164729139,SRX5075170,SMARCA4,414
chr1,164728729,164729100,SRX5075169,SMARCA4,371
chr1,164728731,164729046,SRX5716467,SMARCA2,315
chr1,164728749,164729085,SRX5716470,SMARCA4,336
chr1,164728764,164729105,SRX5075176,SMARCA4,341
chr1,164728795,164729033,SRX5716468,SMARCA2,238
chr1,164728816,164729037,SRX5020214,SMARCA2,221
chr1,164733189,164733372,SRX5054309,FOSL2,183
chr1,164748208,164748674,SRX5075169,SMARCA4,466
chr1,164748232,164748648,SRX5075168,SMARCA4,416
chr1,164748251,164748571,SRX5075174,SMARCA4,320
chr1,164748260,164748721,SRX5075170,SMARCA4,461
chr1,164748303,164748637,SRX5075176,SMARCA4,334
chr1,164748304,164748757,SRX5054309,FOSL2,453
chr1,164748318,164748580,SRX5716469,SMARCA4,262
chr1,164748336,164748660,SRX5716467,SMARCA2,324
chr1,164748367,164748674,SRX5054308,FOSL2,307
chr1,164748384,164748639,SRX5020214,SMARCA2,255
chr1,164748385,164748777,SRX5075175,SMARCA4,392
chr1,164748405,164748616,SRX5716470,SMARCA4,211
chr1,164765575,164765942,SRX5075174,SMARCA4,367
chr1,164765603,164766004,SRX5075168,SMARCA4,401
chr1,164765635,164765966,SRX5075169,SMARCA4,331
chr1,164765650,164765936,SRX5075170,SMARCA4,286
chr1,164765682,164765924,SRX5054309,FOSL2,242
chr1,164765723,164765941,SRX5075176,SMARCA4,218
chr1,164767516,164767696,SRX5054308,FOSL2,180
chr1,164767555,164767749,SRX5075169,SMARCA4,194
chr1,164771291,164771484,SRX5075168,SMARCA4,193
chr1,164771328,164772208,SRX5075174,SMARCA4,880
chr1,164771634,164772155,SRX5075176,SMARCA4,521
chr1,164771638,164772135,SRX5075170,SMARCA4,497
chr1,164771652,164772222,SRX5075168,SMARCA4,570
chr1,164771658,164771967,SRX5054309,FOSL2,309
chr1,164771687,164771886,SRX5054308,FOSL2,199
chr1,164771718,164771964,SRX5716470,SMARCA4,246
chr1,164771719,164771933,SRX5716468,SMARCA2,214
chr1,164771729,164772053,SRX5075175,SMARCA4,324
chr1,164771730,164772094,SRX5075169,SMARCA4,364
chr1,164771780,164772081,SRX5716469,SMARCA4,301
chr1,164771801,164772006,SRX5020214,SMARCA2,205
chr1,164771859,164772103,SRX5716464,SMARCA4,244
chr1,164772722,164773038,SRX5075169,SMARCA4,316
chr1,164772751,164773016,SRX5054309,FOSL2,265
chr1,164772757,164772966,SRX5075176,SMARCA4,209
chr1,164779857,164780455,SRX5075170,SMARCA4,598
chr1,164779950,164780360,SRX5075176,SMARCA4,410
chr1,164780945,164781208,SRX5075170,SMARCA4,263
chr1,164780951,164781215,SRX5075176,SMARCA4,264
chr1,164780957,164781206,SRX5054309,FOSL2,249
chr1,164780981,164781237,SRX5075169,SMARCA4,256
chr1,164780984,164781241,SRX5054308,FOSL2,257
chr1,164781010,164781197,SRX5075174,SMARCA4,187
chr1,164781039,164781226,SRX5075175,SMARCA4,187
chr1,164787233,164787752,SRX16500060,CTCF,519
chr1,164787256,164787730,SRX16500061,CTCF,474
chr1,164787273,164787751,SRX16500059,CTCF,478
chr1,164787297,164787707,SRX4174629,CTCF,410
chr1,164787298,164787679,SRX16500062,CTCF,381
chr1,164787313,164787676,SRX5075168,SMARCA4,363
chr1,164787314,164787724,SRX5075174,SMARCA4,410
chr1,164787331,164787618,SRX5075170,SMARCA4,287
chr1,164787339,164787550,SRX5716470,SMARCA4,211
chr1,164787347,164787690,SRX5075176,SMARCA4,343
chr1,164787367,164787722,SRX5716464,SMARCA4,355
chr1,164787398,164787587,SRX5075175,SMARCA4,189
chr1,164787403,164787723,SRX5716463,SMARCA4,320
chr1,164794301,164794727,SRX5075176,SMARCA4,426
chr1,164794312,164794702,SRX5054309,FOSL2,390
chr1,164794316,164794728,SRX5075170,SMARCA4,412
chr1,164794325,164794658,SRX5716460,Epitope tags,333
chr1,164794328,164794712,SRX5716470,SMARCA4,384
chr1,164794341,164794642,SRX5054308,FOSL2,301
chr1,164794348,164794673,SRX5075175,SMARCA4,325
chr1,164794349,164794733,SRX5075169,SMARCA4,384
chr1,164794354,164794627,SRX5716467,SMARCA2,273
chr1,164794366,164794703,SRX5716469,SMARCA4,337
chr1,164794415,164794665,SRX5020214,SMARCA2,250
chr1,164794431,164794636,SRX5020211,SMARCA2,205
chr1,164803493,164803708,SRX5075170,SMARCA4,215
chr1,164803493,164803739,SRX5054308,FOSL2,246
chr1,164803529,164803719,SRX5075176,SMARCA4,190
chr1,164803571,164803765,SRX5054309,FOSL2,194
chr1,164805432,164805647,SRX5075170,SMARCA4,215
chr1,164823574,164823944,SRX5075176,SMARCA4,370
chr1,164895495,164895892,SRX5075168,SMARCA4,397
chr1,164895541,164896006,SRX5075174,SMARCA4,465
chr1,165048072,165048323,SRX5075174,SMARCA4,251
chr1,165048132,165048324,SRX5075168,SMARCA4,192
chr1,165053027,165053271,SRX5075168,SMARCA4,244
chr1,165053316,165053712,SRX5075174,SMARCA4,396
chr1,165053363,165053688,SRX5075168,SMARCA4,325
chr1,165073318,165073817,SRX16500059,CTCF,499
chr1,165073330,165073658,SRX4174629,CTCF,328
chr1,165073339,165073838,SRX16500061,CTCF,499
chr1,165073349,165073653,SRX5075174,SMARCA4,304
chr1,165073358,165073820,SRX16500060,CTCF,462
chr1,165073366,165073812,SRX16500062,CTCF,446
chr1,165073402,165073673,SRX5075168,SMARCA4,271
chr1,165075760,165076106,SRX16500059,CTCF,346
chr1,165075777,165076135,SRX16500060,CTCF,358
chr1,165075813,165076113,SRX16500061,CTCF,300
chr1,165075817,165076116,SRX16500062,CTCF,299
chr1,165075821,165076017,SRX5075174,SMARCA4,196
chr1,165114231,165114729,SRX16500062,CTCF,498
chr1,165114236,165114709,SRX16500059,CTCF,473
chr1,165114238,165114724,SRX16500061,CTCF,486
chr1,165114250,165114756,SRX16500060,CTCF,506
chr1,165114368,165114671,SRX5075168,SMARCA4,303
chr1,165114391,165114643,SRX5075174,SMARCA4,252
chr1,165114451,165114682,SRX4174629,CTCF,231
chr1,165116691,165117030,SRX5054309,FOSL2,339
chr1,165129463,165129932,SRX16500060,CTCF,469
chr1,165129466,165129938,SRX16500061,CTCF,472
chr1,165129490,165129985,SRX16500059,CTCF,495
chr1,165129516,165129941,SRX16500062,CTCF,425
chr1,165129568,165129868,SRX5075174,SMARCA4,300
chr1,165129569,165129839,SRX4174629,CTCF,270
chr1,165129583,165129853,SRX5075168,SMARCA4,270
chr1,165129626,165129875,SRX5716463,SMARCA4,249
chr1,165129649,165129895,SRX5716464,SMARCA4,246
chr1,165144754,165145245,SRX16500060,CTCF,491
chr1,165144755,165145198,SRX16500061,CTCF,443
chr1,165144775,165145226,SRX16500059,CTCF,451
chr1,165144817,165145239,SRX16500062,CTCF,422
chr1,165144840,165145230,SRX4174629,CTCF,390
chr1,165144885,165145142,SRX5075174,SMARCA4,257
chr1,165144895,165145114,SRX5075168,SMARCA4,219
chr1,165152605,165153134,SRX16500060,CTCF,529
chr1,165152617,165153046,SRX16500062,CTCF,429
chr1,165152685,165153147,SRX16500059,CTCF,462
chr1,165152721,165153069,SRX16500061,CTCF,348
chr1,165152759,165153018,SRX4174629,CTCF,259
chr1,165235535,165235716,SRX5075168,SMARCA4,181
chr1,165235842,165236103,SRX20140881,CPSF3L,261
chr1,165235867,165236133,SRX20140869,INTS10,266
chr1,165235872,165236183,SRX20140896,INTS13,311
chr1,165236001,165236293,SRX5075174,SMARCA4,292
chr1,165257878,165258323,SRX16500059,CTCF,445
chr1,165257919,165258375,SRX16500061,CTCF,456
chr1,165257930,165258298,SRX16500062,CTCF,368
chr1,165257931,165258348,SRX16500060,CTCF,417
chr1,165258079,165258284,SRX5075168,SMARCA4,205
chr1,165279835,165280220,SRX20140867,INTS10,385
chr1,165279837,165280143,SRX20140881,CPSF3L,306
chr1,165279996,165280219,SRX5716463,SMARCA4,223
chr1,165367324,165367769,SRX16500059,CTCF,445
chr1,165367350,165367794,SRX16500062,CTCF,444
chr1,165367358,165367800,SRX16500060,CTCF,442
chr1,165367371,165367797,SRX16500061,CTCF,426
chr1,165367487,165367666,SRX5075174,SMARCA4,179
chr1,165367495,165367716,SRX4174629,CTCF,221
chr1,165369208,165369665,SRX16500060,CTCF,457
chr1,165369212,165369631,SRX16500061,CTCF,419
chr1,165369217,165369627,SRX16500062,CTCF,410
chr1,165369233,165369651,SRX16500059,CTCF,418
chr1,165369258,165369512,SRX5075174,SMARCA4,254
chr1,165369283,165369549,SRX5075168,SMARCA4,266
chr1,165369297,165369525,SRX5716464,SMARCA4,228
chr1,165375997,165377011,SRX5075176,SMARCA4,1014
chr1,165376069,165376326,SRX5716469,SMARCA4,257
chr1,165376100,165376281,SRX5075174,SMARCA4,181
chr1,165376116,165376591,SRX5075169,SMARCA4,475
chr1,165376145,165376843,SRX5075170,SMARCA4,698
chr1,165376222,165376560,SRX5716467,SMARCA2,338
chr1,165376228,165376491,SRX5075175,SMARCA4,263
chr1,165376273,165376575,SRX5716470,SMARCA4,302
chr1,165376346,165376550,SRX5054309,FOSL2,204
chr1,165376560,165376754,SRX5075174,SMARCA4,194
chr1,165383095,165383500,SRX5075170,SMARCA4,405
chr1,165383124,165383401,SRX5075169,SMARCA4,277
chr1,165383184,165383481,SRX5075176,SMARCA4,297
chr1,165383275,165383465,SRX5054309,FOSL2,190
chr1,165392755,165393289,SRX16500062,CTCF,534
chr1,165392760,165393308,SRX16500060,CTCF,548
chr1,165392803,165393381,SRX16500059,CTCF,578
chr1,165392819,165393329,SRX16500061,CTCF,510
chr1,165392889,165393267,SRX5075168,SMARCA4,378
chr1,165392900,165393274,SRX4174629,CTCF,374
chr1,165392934,165393172,SRX5716463,SMARCA4,238
chr1,165392944,165393289,SRX5075174,SMARCA4,345
chr1,165392947,165393359,SRX5075170,SMARCA4,412
chr1,165392952,165393399,SRX5716470,SMARCA4,447
chr1,165392953,165393256,SRX5716464,SMARCA4,303
chr1,165392966,165393392,SRX5075176,SMARCA4,426
chr1,165392984,165393374,SRX5075169,SMARCA4,390
chr1,165393000,165393331,SRX5716469,SMARCA4,331
chr1,165393000,165393385,SRX5075175,SMARCA4,385
chr1,165393024,165393374,SRX5716467,SMARCA2,350
chr1,165393048,165393272,SRX5054309,FOSL2,224
chr1,165393065,165393321,SRX5075181,SMARCA2,256
chr1,165393084,165393323,SRX5054308,FOSL2,239
chr1,165393101,165393341,SRX5020211,SMARCA2,240
chr1,165393122,165393327,SRX5020214,SMARCA2,205
chr1,165397869,165398350,SRX5075170,SMARCA4,481
chr1,165397884,165398332,SRX5075176,SMARCA4,448
chr1,165397911,165398149,SRX5020214,SMARCA2,238
chr1,165397925,165398359,SRX5075175,SMARCA4,434
chr1,165397937,165398296,SRX5054309,FOSL2,359
chr1,165397941,165398195,SRX5716470,SMARCA4,254
chr1,165397945,165398178,SRX5716469,SMARCA4,233
chr1,165397979,165398190,SRX5716468,SMARCA2,211
chr1,165397979,165398327,SRX5075169,SMARCA4,348
chr1,165397990,165398291,SRX5054308,FOSL2,301
chr1,165397992,165398222,SRX5716467,SMARCA2,230
chr1,165398050,165398237,SRX5075182,SMARCA2,187
chr1,165403846,165404306,SRX16500059,CTCF,460
chr1,165403870,165404287,SRX16500060,CTCF,417
chr1,165403896,165404251,SRX16500062,CTCF,355
chr1,165403901,165404265,SRX16500061,CTCF,364
chr1,165403987,165404279,SRX4174629,CTCF,292
chr1,165408580,165408886,SRX5054309,FOSL2,306
chr1,165408592,165408859,SRX16500059,CTCF,267
chr1,165408596,165408883,SRX16500060,CTCF,287
chr1,165408603,165408895,SRX5054308,FOSL2,292
chr1,165408607,165408853,SRX5075168,SMARCA4,246
chr1,165408630,165408839,SRX5075174,SMARCA4,209
chr1,165408635,165408893,SRX16500061,CTCF,258
chr1,165408652,165408831,SRX5054307,FOSL2,179
chr1,165434156,165434639,SRX5075168,SMARCA4,483
chr1,165434197,165434662,SRX5075174,SMARCA4,465
chr1,165434206,165434636,SRX5716463,SMARCA4,430
chr1,165434233,165434495,SRX5716464,SMARCA4,262
chr1,165444980,165445192,SRX5075168,SMARCA4,212
chr1,165445020,165445225,SRX5075174,SMARCA4,205
chr1,165445082,165445370,SRX5716463,SMARCA4,288
chr1,165482118,165482536,SRX5075170,SMARCA4,418
chr1,165482130,165482503,SRX5054309,FOSL2,373
chr1,165482158,165482524,SRX5075176,SMARCA4,366
chr1,165482178,165482512,SRX5075175,SMARCA4,334
chr1,165482182,165482483,SRX5075169,SMARCA4,301
chr1,165482197,165482513,SRX5054308,FOSL2,316
chr1,165482232,165482432,SRX5020211,SMARCA2,200
chr1,165482242,165482427,SRX5075174,SMARCA4,185
chr1,165482242,165482442,SRX5054307,FOSL2,200
chr1,165497127,165497400,SRX5054309,FOSL2,273
chr1,165502010,165502196,SRX5054309,FOSL2,186
chr1,165592872,165593474,SRX16500061,CTCF,602
chr1,165592885,165593388,SRX16500060,CTCF,503
chr1,165592889,165593437,SRX16500059,CTCF,548
chr1,165592895,165593375,SRX16500062,CTCF,480
chr1,165592979,165593154,SRX5075176,SMARCA4,175
chr1,165593036,165593246,SRX4174629,CTCF,210
chr1,165597798,165598422,SRX5054309,FOSL2,624
chr1,165597803,165598233,SRX5075169,SMARCA4,430
chr1,165597839,165598147,SRX5054308,FOSL2,308
chr1,165597873,165598392,SRX5075175,SMARCA4,519
chr1,165597876,165598550,SRX5075170,SMARCA4,674
chr1,165597930,165598319,SRX5716470,SMARCA4,389
chr1,165597933,165598266,SRX5716469,SMARCA4,333
chr1,165597955,165598605,SRX5075174,SMARCA4,650
chr1,165597980,165598638,SRX5075176,SMARCA4,658
chr1,165598008,165598575,SRX5075168,SMARCA4,567
chr1,165598041,165598424,SRX5716463,SMARCA4,383
chr1,165598151,165598395,SRX5716464,SMARCA4,244
chr1,165601499,165602044,SRX16500059,CTCF,545
chr1,165601554,165602036,SRX16500062,CTCF,482
chr1,165601561,165601997,SRX16500061,CTCF,436
chr1,165601573,165601992,SRX4174629,CTCF,419
chr1,165601588,165602008,SRX16500060,CTCF,420
chr1,165630573,165631304,SRX20140895,INTS13,731
chr1,165630664,165630855,SRX5075174,SMARCA4,191
chr1,165630729,165631351,SRX5075168,SMARCA4,622
chr1,165630774,165631118,SRX20140879,CPSF3L,344
chr1,165630889,165631272,SRX5716470,SMARCA4,383
chr1,165631017,165631313,SRX5075176,SMARCA4,296
chr1,165631049,165631370,SRX5075174,SMARCA4,321
chr1,165631127,165631330,SRX5075170,SMARCA4,203
chr1,165631611,165631810,SRX5075174,SMARCA4,199
chr1,165631834,165632203,SRX5054308,FOSL2,369
chr1,165631873,165632177,SRX5075176,SMARCA4,304
chr1,165631879,165632216,SRX5054309,FOSL2,337
chr1,165631905,165632164,SRX5075170,SMARCA4,259
chr1,165631912,165632244,SRX5075169,SMARCA4,332
chr1,165631931,165632234,SRX5075175,SMARCA4,303
chr1,165695987,165696174,SRX5075175,SMARCA4,187
chr1,165696044,165696227,SRX5075169,SMARCA4,183
chr1,165696657,165696827,SRX5075170,SMARCA4,170
chr1,165697754,165698069,SRX16500060,CTCF,315
chr1,165697799,165698188,SRX16500059,CTCF,389
chr1,165697817,165698127,SRX16500061,CTCF,310
chr1,165697923,165698189,SRX5075174,SMARCA4,266
chr1,165698159,165698846,SRX5075170,SMARCA4,687
chr1,165698218,165698910,SRX20140895,INTS13,692
chr1,165698263,165698938,SRX5075168,SMARCA4,675
chr1,165698284,165698531,SRX20140879,CPSF3L,247
chr1,165698296,165698614,SRX20140868,INTS10,318
chr1,165698312,165698499,SRX5075175,SMARCA4,187
chr1,165698314,165698520,SRX5075169,SMARCA4,206
chr1,165698339,165698561,SRX20140867,INTS10,222
chr1,165698341,165698702,SRX20140897,INTS13,361
chr1,165698353,165698901,SRX5075176,SMARCA4,548
chr1,165698369,165698819,SRX5716470,SMARCA4,450
chr1,165698385,165698900,SRX5075174,SMARCA4,515
chr1,165698449,165698931,SRX5716463,SMARCA4,482
chr1,165698571,165698828,SRX5716464,SMARCA4,257
chr1,165717824,165718288,SRX16500059,CTCF,464
chr1,165717870,165718289,SRX16500061,CTCF,419
chr1,165717919,165718292,SRX16500060,CTCF,373
chr1,165717958,165718328,SRX16500062,CTCF,370
chr1,165718025,165718285,SRX4174629,CTCF,260
chr1,165752475,165752528,SRX1424893,POU3F2,53
chr1,165752477,165752527,SRX1424891,POU3F2,50
chr1,165752479,165752529,SRX1424894,POU3F2,50
chr1,165752480,165752526,SRX1424892,POU3F2,46
chr1,165768662,165769350,SRX5075168,SMARCA4,688
chr1,165768721,165769259,SRX5075174,SMARCA4,538
chr1,165768725,165769429,SRX20140895,INTS13,704
chr1,165768754,165769296,SRX20140869,INTS10,542
chr1,165768814,165769276,SRX5716463,SMARCA4,462
chr1,165768838,165769036,SRX5716451,SOX2,198
chr1,165768841,165769046,SRX5716454,SOX3,205
chr1,165768882,165769479,SRX5075170,SMARCA4,597
chr1,165768886,165769337,SRX20140897,INTS13,451
chr1,165768968,165769285,SRX20140881,CPSF3L,317
chr1,165769001,165769291,SRX5716470,SMARCA4,290
chr1,165769022,165769229,SRX5075175,SMARCA4,207
chr1,165769028,165769416,SRX5075176,SMARCA4,388
chr1,165769078,165769445,SRX5075169,SMARCA4,367
chr1,165773427,165773667,SRX5075169,SMARCA4,240
chr1,165827385,165827723,SRX5075174,SMARCA4,338
chr1,165827393,165827736,SRX5075175,SMARCA4,343
chr1,165827394,165827709,SRX5075170,SMARCA4,315
chr1,165827451,165828575,SRX20140895,INTS13,1124
chr1,165827524,165828499,SRX20140868,INTS10,975
chr1,165827546,165828008,SRX20140897,INTS13,462
chr1,165827586,165828079,SRX20140867,INTS10,493
chr1,165827667,165827915,SRX16500062,CTCF,248
chr1,165828874,165829279,SRX20140895,INTS13,405
chr1,165828989,165829198,SRX5075176,SMARCA4,209
chr1,165829037,165829228,SRX5075174,SMARCA4,191
chr1,165829046,165829235,SRX5075170,SMARCA4,189
chr1,165829060,165829248,SRX5075168,SMARCA4,188
chr1,165829074,165829373,SRX5075175,SMARCA4,299
chr1,165841598,165841846,SRX5075169,SMARCA4,248
chr1,165843345,165843647,SRX5054309,FOSL2,302
chr1,165854061,165854479,SRX5075175,SMARCA4,418
chr1,165854063,165854506,SRX5075169,SMARCA4,443
chr1,165854125,165854422,SRX5716469,SMARCA4,297
chr1,165854127,165854515,SRX5075176,SMARCA4,388
chr1,165854147,165854524,SRX5054309,FOSL2,377
chr1,165854194,165854476,SRX5716467,SMARCA2,282
chr1,165854202,165854425,SRX5020211,SMARCA2,223
chr1,165854211,165854487,SRX5075170,SMARCA4,276
chr1,165854218,165854470,SRX5716470,SMARCA4,252
chr1,165854246,165854430,SRX5054308,FOSL2,184
chr1,165854254,165854519,SRX5020214,SMARCA2,265
chr1,165857037,165857294,SRX5075174,SMARCA4,257
chr1,165871403,165871634,SRX5075168,SMARCA4,231
chr1,165871484,165871691,SRX5075174,SMARCA4,207
chr1,165898777,165899234,SRX5075169,SMARCA4,457
chr1,165898805,165899262,SRX5075176,SMARCA4,457
chr1,165898808,165899168,SRX5075175,SMARCA4,360
chr1,165898837,165899174,SRX5716470,SMARCA4,337
chr1,165898853,165899166,SRX5054309,FOSL2,313
chr1,165898861,165899086,SRX5716467,SMARCA2,225
chr1,165898862,165899106,SRX5054308,FOSL2,244
chr1,165898868,165899159,SRX5075170,SMARCA4,291
chr1,165898890,165899161,SRX5020214,SMARCA2,271
chr1,165898922,165899152,SRX5716469,SMARCA4,230
chr1,165914120,165914615,SRX16500059,CTCF,495
chr1,165914124,165914600,SRX16500061,CTCF,476
chr1,165914126,165914621,SRX16500060,CTCF,495
chr1,165914140,165914492,SRX5075168,SMARCA4,352
chr1,165914145,165914618,SRX16500062,CTCF,473
chr1,165914166,165914478,SRX5075170,SMARCA4,312
chr1,165914206,165914480,SRX5075174,SMARCA4,274
chr1,165914231,165914580,SRX4174629,CTCF,349
chr1,165914241,165914481,SRX5075176,SMARCA4,240
chr1,165924611,165925078,SRX16500062,CTCF,467
chr1,165924615,165925139,SRX16500060,CTCF,524
chr1,165924631,165925092,SRX16500059,CTCF,461
chr1,165924658,165925084,SRX16500061,CTCF,426
chr1,165924759,165925092,SRX4174629,CTCF,333
chr1,165924773,165925018,SRX5075168,SMARCA4,245
chr1,165924783,165924979,SRX5075174,SMARCA4,196
chr1,165928164,165928403,SRX4174629,CTCF,239
chr1,165928221,165928482,SRX16500061,CTCF,261
chr1,165928226,165928493,SRX16500059,CTCF,267
chr1,165928228,165928489,SRX16500060,CTCF,261
chr1,165932836,165932877,SRX1424893,POU3F2,41
chr1,165949412,165949624,SRX5716469,SMARCA4,212
chr1,165949415,165949626,SRX5075174,SMARCA4,211
chr1,165949418,165949623,SRX5075176,SMARCA4,205
chr1,165949418,165949631,SRX5075175,SMARCA4,213
chr1,165949420,165949611,SRX5075169,SMARCA4,191
chr1,165954995,165955304,SRX5075175,SMARCA4,309
chr1,165954996,165955371,SRX5075169,SMARCA4,375
chr1,165955005,165955365,SRX5716470,SMARCA4,360
chr1,165955007,165955284,SRX5075170,SMARCA4,277
chr1,165955028,165955258,SRX5716468,SMARCA2,230
chr1,165955048,165955253,SRX5075176,SMARCA4,205
chr1,165955070,165955322,SRX5716469,SMARCA4,252
chr1,166133321,166133568,SRX16500062,CTCF,247
chr1,166133363,166133621,SRX16500059,CTCF,258
chr1,166133371,166133597,SRX16500060,CTCF,226
chr1,166164817,166165184,SRX16500059,CTCF,367
chr1,166164827,166165202,SRX16500060,CTCF,375
chr1,166164867,166165086,SRX16500061,CTCF,219
chr1,166164873,166165180,SRX16500062,CTCF,307
chr1,166164949,166165133,SRX5075174,SMARCA4,184
chr1,166164982,166165215,SRX5075169,SMARCA4,233
chr1,166165002,166165278,SRX5716470,SMARCA4,276
chr1,166165056,166165237,SRX5075170,SMARCA4,181
chr1,166391749,166391939,SRX5054309,FOSL2,190
chr1,166418653,166419045,SRX5075174,SMARCA4,392
chr1,166418707,166418967,SRX5075168,SMARCA4,260
chr1,166433676,166433989,SRX4174629,CTCF,313
chr1,166433703,166434041,SRX16500061,CTCF,338
chr1,166433730,166434091,SRX16500059,CTCF,361
chr1,166433750,166434076,SRX16500060,CTCF,326
chr1,166433767,166434050,SRX16500062,CTCF,283
chr1,166478804,166479434,SRX16500060,CTCF,630
chr1,166478938,166479477,SRX16500061,CTCF,539
chr1,166478942,166479537,SRX16500059,CTCF,595
chr1,166478949,166479545,SRX16500062,CTCF,596
chr1,166478966,166479254,SRX4174629,CTCF,288
chr1,166479137,166479328,SRX5075174,SMARCA4,191
chr1,166809030,166809282,SRX5716463,SMARCA4,252
chr1,166809049,166809277,SRX5075168,SMARCA4,228
chr1,166809065,166809370,SRX5075174,SMARCA4,305
chr1,166809068,166809322,SRX5716464,SMARCA4,254
chr1,166822383,166822685,SRX16500061,CTCF,302
chr1,166822420,166822756,SRX16500060,CTCF,336
chr1,166822465,166822804,SRX16500059,CTCF,339
chr1,166838983,166839521,SRX5075168,SMARCA4,538
chr1,166838987,166839543,SRX5075174,SMARCA4,556
chr1,166839020,166839655,SRX20140895,INTS13,635
chr1,166839038,166839503,SRX5075176,SMARCA4,465
chr1,166839060,166839516,SRX5075170,SMARCA4,456
chr1,166839064,166839405,SRX20140879,CPSF3L,341
chr1,166839064,166839508,SRX20140868,INTS10,444
chr1,166839104,166839546,SRX5075169,SMARCA4,442
chr1,166839111,166839682,SRX20140867,INTS10,571
chr1,166839130,166839508,SRX20140897,INTS13,378
chr1,166839134,166839361,SRX5716463,SMARCA4,227
chr1,166839161,166839528,SRX5075175,SMARCA4,367
chr1,166839992,166840374,SRX16500060,CTCF,382
chr1,166875765,166876677,SRX20140895,INTS13,912
chr1,166875942,166876410,SRX20140868,INTS10,468
chr1,166876001,166876586,SRX20140897,INTS13,585
chr1,166876032,166876419,SRX20140867,INTS10,387
chr1,166876040,166876676,SRX5075170,SMARCA4,636
chr1,166876110,166876631,SRX5075176,SMARCA4,521
chr1,166876110,166876762,SRX5075168,SMARCA4,652
chr1,166876142,166876722,SRX5075174,SMARCA4,580
chr1,166876150,166876466,SRX20140869,INTS10,316
chr1,166876298,166876638,SRX5716463,SMARCA4,340
chr1,166876306,166876496,SRX5716451,SOX2,190
chr1,166876308,166876627,SRX5716470,SMARCA4,319
chr1,166876356,166876628,SRX5075175,SMARCA4,272
chr1,166876359,166876670,SRX5075169,SMARCA4,311
chr1,166876469,166876787,SRX16500059,CTCF,318
chr1,166876479,166876752,SRX16500060,CTCF,273
chr1,166876505,166876767,SRX16500061,CTCF,262
chr1,166876547,166876757,SRX16500062,CTCF,210
chr1,166884274,166884715,SRX16500060,CTCF,441
chr1,166884289,166884759,SRX16500059,CTCF,470
chr1,166884295,166884660,SRX16500061,CTCF,365
chr1,166884344,166884692,SRX16500062,CTCF,348
chr1,166886419,166886703,SRX20140881,CPSF3L,284
chr1,166886838,166887050,SRX5075174,SMARCA4,212
chr1,166888635,166889256,SRX5075174,SMARCA4,621
chr1,166888662,166889237,SRX5075168,SMARCA4,575
chr1,166888778,166889142,SRX5716464,SMARCA4,364
chr1,166888794,166889175,SRX5716451,SOX2,381
chr1,166888796,166889214,SRX5716463,SMARCA4,418
chr1,166888811,166889093,SRX20140895,INTS13,282
chr1,166888844,166889098,SRX5716454,SOX3,254
chr1,166902335,166902550,SRX5054309,FOSL2,215
chr1,166905950,166906241,SRX5075170,SMARCA4,291
chr1,166905989,166906260,SRX5075169,SMARCA4,271
chr1,166906050,166906338,SRX5716470,SMARCA4,288
chr1,166906061,166906285,SRX5075175,SMARCA4,224
chr1,166910311,166910832,SRX16500060,CTCF,521
chr1,166910326,166910771,SRX16500061,CTCF,445
chr1,166910335,166910802,SRX16500059,CTCF,467
chr1,166910337,166910778,SRX16500062,CTCF,441
chr1,166910432,166910789,SRX5075174,SMARCA4,357
chr1,166910437,166910763,SRX4174629,CTCF,326
chr1,166910444,166910741,SRX5075168,SMARCA4,297
chr1,166910464,166910791,SRX5054309,FOSL2,327
chr1,166910501,166910789,SRX5054308,FOSL2,288
chr1,166910503,166910754,SRX5054307,FOSL2,251
chr1,166910507,166910717,SRX5075176,SMARCA4,210
chr1,166910536,166910733,SRX5075170,SMARCA4,197
chr1,166915984,166916286,SRX5075176,SMARCA4,302
chr1,166915998,166916280,SRX5075169,SMARCA4,282
chr1,166916018,166916265,SRX5075170,SMARCA4,247
chr1,166916019,166916326,SRX5075175,SMARCA4,307
chr1,166916040,166916250,SRX5054309,FOSL2,210
chr1,166916055,166916249,SRX5054308,FOSL2,194
chr1,166918294,166918521,SRX5075174,SMARCA4,227
chr1,166918715,166918924,SRX5075174,SMARCA4,209
chr1,166925703,166926469,SRX5075168,SMARCA4,766
chr1,166925754,166926083,SRX5054309,FOSL2,329
chr1,166925755,166926351,SRX5075174,SMARCA4,596
chr1,166925771,166926259,SRX5716464,SMARCA4,488
chr1,166925778,166926149,SRX5716463,SMARCA4,371
chr1,166925796,166926074,SRX5054308,FOSL2,278
chr1,166925819,166926250,SRX5075170,SMARCA4,431
chr1,166925824,166926161,SRX5075169,SMARCA4,337
chr1,166925842,166926022,SRX5075176,SMARCA4,180
chr1,166925860,166926076,SRX5075175,SMARCA4,216
chr1,166925910,166926145,SRX5716451,SOX2,235
chr1,166933638,166934010,SRX5716467,SMARCA2,372
chr1,166933663,166934041,SRX5075170,SMARCA4,378
chr1,166933666,166934027,SRX5075169,SMARCA4,361
chr1,166933680,166934036,SRX5054309,FOSL2,356
chr1,166933682,166934037,SRX5716469,SMARCA4,355
chr1,166933693,166934018,SRX5075176,SMARCA4,325
chr1,166933703,166934012,SRX5054308,FOSL2,309
chr1,166933726,166934093,SRX5075175,SMARCA4,367
chr1,166944663,166944848,SRX5054309,FOSL2,185
chr1,166947213,166947932,SRX20140895,INTS13,719
chr1,166947219,166947867,SRX20140868,INTS10,648
chr1,166947313,166947836,SRX20140867,INTS10,523
chr1,166947342,166947963,SRX5075174,SMARCA4,621
chr1,166947354,166947955,SRX5075168,SMARCA4,601
chr1,166947418,166947935,SRX5716463,SMARCA4,517
chr1,166947555,166947853,SRX20140881,CPSF3L,298
chr1,166947555,166947954,SRX5716470,SMARCA4,399
chr1,166947561,166947887,SRX5075175,SMARCA4,326
chr1,166947567,166947964,SRX5716464,SMARCA4,397
chr1,166947569,166947907,SRX5075170,SMARCA4,338
chr1,166947584,166947933,SRX5075169,SMARCA4,349
chr1,166947621,166947935,SRX5716469,SMARCA4,314
chr1,166947638,166947849,SRX5716468,SMARCA2,211
chr1,166947639,166947915,SRX5716451,SOX2,276
chr1,166947658,166947858,SRX5075176,SMARCA4,200
chr1,166950192,166950406,SRX5075174,SMARCA4,214
chr1,166950206,166950408,SRX5075168,SMARCA4,202
chr1,166952316,166952787,SRX5054309,FOSL2,471
chr1,166952369,166952775,SRX5075176,SMARCA4,406
chr1,166952381,166952787,SRX5075169,SMARCA4,406
chr1,166952382,166952849,SRX5075170,SMARCA4,467
chr1,166952391,166952785,SRX5054308,FOSL2,394
chr1,166952411,166952843,SRX5075174,SMARCA4,432
chr1,166952432,166952806,SRX5075168,SMARCA4,374
chr1,166952456,166952756,SRX5075175,SMARCA4,300
chr1,166952460,166952655,SRX5075182,SMARCA2,195
chr1,166952469,166952739,SRX5054307,FOSL2,270
chr1,166952473,166952763,SRX5020214,SMARCA2,290
chr1,166952496,166952780,SRX5716469,SMARCA4,284
chr1,166952525,166952781,SRX5716463,SMARCA4,256
chr1,166975516,166975921,SRX20140895,INTS13,405
chr1,166975523,166975955,SRX5075170,SMARCA4,432
chr1,166975533,166975774,SRX5075176,SMARCA4,241
chr1,166975548,166975985,SRX5075175,SMARCA4,437
chr1,166975564,166975811,SRX5716470,SMARCA4,247
chr1,166975588,166976085,SRX5075169,SMARCA4,497
chr1,166975618,166975941,SRX5075168,SMARCA4,323
chr1,167013550,167013771,SRX5075174,SMARCA4,221
chr1,167052469,167052912,SRX16500059,CTCF,443
chr1,167052477,167052869,SRX16500060,CTCF,392
chr1,167052487,167052778,SRX16500061,CTCF,291
chr1,167052545,167052812,SRX16500062,CTCF,267
chr1,167057116,167057554,SRX4174629,CTCF,438
chr1,167057243,167057568,SRX16500061,CTCF,325
chr1,167057245,167057616,SRX16500060,CTCF,371
chr1,167057246,167057578,SRX16500062,CTCF,332
chr1,167057268,167057518,SRX5075168,SMARCA4,250
chr1,167057282,167057602,SRX16500059,CTCF,320
chr1,167057315,167057611,SRX5075174,SMARCA4,296
chr1,167059078,167059594,SRX16500059,CTCF,516
chr1,167059111,167059532,SRX16500062,CTCF,421
chr1,167059114,167059557,SRX16500061,CTCF,443
chr1,167059117,167059528,SRX16500060,CTCF,411
chr1,167059135,167059460,SRX5075170,SMARCA4,325
chr1,167059160,167059363,SRX5075175,SMARCA4,203
chr1,167059172,167059455,SRX5075176,SMARCA4,283
chr1,167059174,167059446,SRX5075174,SMARCA4,272
chr1,167059176,167059402,SRX5054309,FOSL2,226
chr1,167059178,167059452,SRX5075168,SMARCA4,274
chr1,167059212,167059396,SRX5075169,SMARCA4,184
chr1,167059245,167059472,SRX4174629,CTCF,227
chr1,167066559,167067092,SRX16500060,CTCF,533
chr1,167066561,167067108,SRX16500059,CTCF,547
chr1,167066567,167067061,SRX16500062,CTCF,494
chr1,167066574,167067049,SRX16500061,CTCF,475
chr1,167066595,167067045,SRX4174629,CTCF,450
chr1,167066638,167067027,SRX5075174,SMARCA4,389
chr1,167066646,167067021,SRX5075170,SMARCA4,375
chr1,167066667,167067044,SRX5075168,SMARCA4,377
chr1,167066685,167066897,SRX5716469,SMARCA4,212
chr1,167066703,167067033,SRX5075176,SMARCA4,330
chr1,167066727,167066970,SRX5716464,SMARCA4,243
chr1,167066734,167066962,SRX5716470,SMARCA4,228
chr1,167066734,167066981,SRX5075169,SMARCA4,247
chr1,167066743,167067017,SRX5075175,SMARCA4,274
chr1,167066759,167067019,SRX5716463,SMARCA4,260
chr1,167095316,167095707,SRX5075176,SMARCA4,391
chr1,167095346,167095698,SRX5075170,SMARCA4,352
chr1,167095368,167095658,SRX5075175,SMARCA4,290
chr1,167095370,167095649,SRX5054309,FOSL2,279
chr1,167095396,167095675,SRX5054308,FOSL2,279
chr1,167095444,167095971,SRX5075169,SMARCA4,527
chr1,167095592,167095803,SRX5716470,SMARCA4,211
chr1,167103523,167103819,SRX5054309,FOSL2,296
chr1,167103544,167103853,SRX5075169,SMARCA4,309
chr1,167103546,167103738,SRX5075170,SMARCA4,192
chr1,167103558,167103827,SRX5075175,SMARCA4,269
chr1,167103583,167103811,SRX5075176,SMARCA4,228
chr1,167103591,167103793,SRX5054308,FOSL2,202
chr1,167103600,167103822,SRX5716469,SMARCA4,222
chr1,167121548,167121770,SRX5075175,SMARCA4,222
chr1,167121588,167121818,SRX5075169,SMARCA4,230
chr1,167121617,167121828,SRX5075170,SMARCA4,211
chr1,167121619,167121857,SRX5075176,SMARCA4,238
chr1,167124152,167124421,SRX16500060,CTCF,269
chr1,167124185,167124537,SRX5075168,SMARCA4,352
chr1,167124189,167124399,SRX16500062,CTCF,210
chr1,167124434,167124653,SRX5075174,SMARCA4,219
chr1,167136145,167136702,SRX5075169,SMARCA4,557
chr1,167136167,167136819,SRX5075168,SMARCA4,652
chr1,167136173,167136736,SRX5075174,SMARCA4,563
chr1,167136240,167136633,SRX5075175,SMARCA4,393
chr1,167136258,167136639,SRX5075170,SMARCA4,381
chr1,167136275,167136661,SRX5075176,SMARCA4,386
chr1,167136294,167136603,SRX5054308,FOSL2,309
chr1,167136301,167136612,SRX5716470,SMARCA4,311
chr1,167136304,167136552,SRX5020214,SMARCA2,248
chr1,167136311,167136582,SRX5716469,SMARCA4,271
chr1,167136325,167136625,SRX5054309,FOSL2,300
chr1,167136382,167136596,SRX5054307,FOSL2,214
chr1,167137337,167137690,SRX5075174,SMARCA4,353
chr1,167148388,167148833,SRX5075174,SMARCA4,445
chr1,167148399,167148764,SRX5075168,SMARCA4,365
chr1,167148451,167148798,SRX5075176,SMARCA4,347
chr1,167148475,167148790,SRX5075170,SMARCA4,315
chr1,167149727,167150215,SRX5075174,SMARCA4,488
chr1,167149780,167150106,SRX5075168,SMARCA4,326
chr1,167162988,167163157,SRX5075170,SMARCA4,169
chr1,167166161,167166701,SRX20140867,INTS10,540
chr1,167166240,167166749,SRX5075174,SMARCA4,509
chr1,167166253,167166743,SRX20140895,INTS13,490
chr1,167166267,167166705,SRX5716463,SMARCA4,438
chr1,167166282,167166590,SRX20140881,CPSF3L,308
chr1,167166311,167166814,SRX5075168,SMARCA4,503
chr1,167166329,167166726,SRX5716464,SMARCA4,397
chr1,167173551,167174137,SRX5075169,SMARCA4,586
chr1,167173566,167174044,SRX5075175,SMARCA4,478
chr1,167173578,167174128,SRX5054309,FOSL2,550
chr1,167173585,167174103,SRX5075174,SMARCA4,518
chr1,167173598,167173987,SRX5716469,SMARCA4,389
chr1,167173601,167174150,SRX5075176,SMARCA4,549
chr1,167173605,167173990,SRX5054308,FOSL2,385
chr1,167173635,167173858,SRX5075170,SMARCA4,223
chr1,167173722,167174192,SRX5075168,SMARCA4,470
chr1,167173729,167174028,SRX5716470,SMARCA4,299
chr1,167195851,167196020,SRX5075170,SMARCA4,169
chr1,167196203,167196456,SRX5075175,SMARCA4,253
chr1,167196216,167196615,SRX5075176,SMARCA4,399
chr1,167196228,167196532,SRX5075170,SMARCA4,304
chr1,167196242,167196536,SRX5054309,FOSL2,294
chr1,167196265,167196579,SRX5075169,SMARCA4,314
chr1,167196300,167196499,SRX5054308,FOSL2,199
chr1,167198490,167198951,SRX5075168,SMARCA4,461
chr1,167198562,167198875,SRX5075174,SMARCA4,313
chr1,167205360,167205589,SRX5054308,FOSL2,229
chr1,167205376,167205593,SRX5075175,SMARCA4,217
chr1,167205398,167205594,SRX5075169,SMARCA4,196
chr1,167208448,167208669,SRX16500060,CTCF,221
chr1,167219810,167220026,SRX5075170,SMARCA4,216
chr1,167219944,167220149,SRX5075174,SMARCA4,205
chr1,167220088,167220646,SRX20140895,INTS13,558
chr1,167220155,167220466,SRX20140868,INTS10,311
chr1,167220198,167220473,SRX20140867,INTS10,275
chr1,167220279,167220540,SRX20140879,CPSF3L,261
chr1,167220371,167220899,SRX5075168,SMARCA4,528
chr1,167220524,167220793,SRX5716463,SMARCA4,269
chr1,167220530,167221081,SRX16500059,CTCF,551
chr1,167220531,167220980,SRX5075174,SMARCA4,449
chr1,167220547,167220882,SRX16500060,CTCF,335
chr1,167220548,167220901,SRX16500062,CTCF,353
chr1,167220550,167220754,SRX5716451,SOX2,204
chr1,167220560,167220973,SRX5075170,SMARCA4,413
chr1,167220600,167220921,SRX5075176,SMARCA4,321
chr1,167220617,167220900,SRX16500061,CTCF,283
chr1,167220618,167220885,SRX4174629,CTCF,267
chr1,167220842,167221583,SRX20140895,INTS13,741
chr1,167221698,167222129,SRX20140895,INTS13,431
chr1,167231927,167232438,SRX5075168,SMARCA4,511
chr1,167231962,167232487,SRX5075174,SMARCA4,525
chr1,167232034,167232404,SRX5716463,SMARCA4,370
chr1,167232099,167232353,SRX5716451,SOX2,254
chr1,167232152,167232406,SRX5716454,SOX3,254
chr1,167262509,167262738,SRX5054309,FOSL2,229
chr1,167267772,167268290,SRX16500059,CTCF,518
chr1,167267795,167268296,SRX16500060,CTCF,501
chr1,167267806,167268243,SRX16500062,CTCF,437
chr1,167267817,167268313,SRX16500061,CTCF,496
chr1,167267864,167268097,SRX4174629,CTCF,233
chr1,167267884,167268173,SRX5075168,SMARCA4,289
chr1,167267885,167268196,SRX5075174,SMARCA4,311
chr1,167267891,167268183,SRX5075176,SMARCA4,292
chr1,167267914,167268162,SRX5075170,SMARCA4,248
chr1,167267926,167268180,SRX5716463,SMARCA4,254
chr1,167267930,167268146,SRX5075175,SMARCA4,216
chr1,167267944,167268139,SRX5075169,SMARCA4,195
chr1,167267952,167268132,SRX5054308,FOSL2,180
chr1,167267966,167268171,SRX5716464,SMARCA4,205
chr1,167267997,167268180,SRX5054309,FOSL2,183
chr1,167327686,167327731,SRX1424893,POU3F2,45
chr1,167327703,167327771,SRX1424892,POU3F2,68
chr1,167327749,167327805,SRX1424891,POU3F2,56
chr1,167329285,167329523,SRX5075174,SMARCA4,238
chr1,167344136,167344480,SRX5054308,FOSL2,344
chr1,167344149,167344495,SRX5054309,FOSL2,346
chr1,167344300,167344511,SRX5716470,SMARCA4,211
chr1,167401190,167401673,SRX16500060,CTCF,483
chr1,167401206,167401643,SRX16500062,CTCF,437
chr1,167401215,167401732,SRX16500059,CTCF,517
chr1,167401223,167401681,SRX16500061,CTCF,458
chr1,167401315,167401552,SRX5075174,SMARCA4,237
chr1,167401370,167401539,SRX5075170,SMARCA4,169
chr1,167401390,167401569,SRX5075168,SMARCA4,179
chr1,167439385,167439721,SRX5075174,SMARCA4,336
chr1,167442069,167442515,SRX16500062,CTCF,446
chr1,167442088,167442562,SRX16500059,CTCF,474
chr1,167442108,167442569,SRX16500060,CTCF,461
chr1,167442126,167442586,SRX16500061,CTCF,460
chr1,167442182,167442470,SRX4174629,CTCF,288
chr1,167442200,167442412,SRX5075174,SMARCA4,212
chr1,167442210,167442454,SRX5075168,SMARCA4,244
chr1,167455221,167455441,SRX5075169,SMARCA4,220
chr1,167455386,167455610,SRX5075170,SMARCA4,224
chr1,167455559,167455759,SRX5075175,SMARCA4,200
chr1,167489373,167490164,SRX20140895,INTS13,791
chr1,167489374,167490211,SRX5075168,SMARCA4,837
chr1,167489402,167490189,SRX5075174,SMARCA4,787
chr1,167489638,167490076,SRX20140867,INTS10,438
chr1,167489662,167489996,SRX20140894,INTS13,334
chr1,167489673,167490002,SRX20140881,CPSF3L,329
chr1,167489691,167490131,SRX20140868,INTS10,440
chr1,167489740,167490004,SRX20140879,CPSF3L,264
chr1,167489768,167490069,SRX5716463,SMARCA4,301
chr1,167496767,167497164,SRX5716464,SMARCA4,397
chr1,167496803,167497156,SRX5716463,SMARCA4,353
chr1,167496823,167497203,SRX5075168,SMARCA4,380
chr1,167496878,167497208,SRX5075174,SMARCA4,330
chr1,167530218,167530405,SRX5075176,SMARCA4,187
chr1,167533688,167534237,SRX16500062,CTCF,549
chr1,167533706,167534244,SRX16500059,CTCF,538
chr1,167533729,167534195,SRX16500061,CTCF,466
chr1,167533751,167534224,SRX16500060,CTCF,473
chr1,167533781,167534081,SRX5075168,SMARCA4,300
chr1,167533786,167534155,SRX4174629,CTCF,369
chr1,167533798,167534023,SRX5716463,SMARCA4,225
chr1,167533800,167534033,SRX5075176,SMARCA4,233
chr1,167533813,167534082,SRX5075174,SMARCA4,269
chr1,167533830,167534083,SRX5075170,SMARCA4,253
chr1,167540291,167540835,SRX16500060,CTCF,544
chr1,167540292,167540832,SRX16500061,CTCF,540
chr1,167540322,167540830,SRX16500059,CTCF,508
chr1,167540359,167540719,SRX5075168,SMARCA4,360
chr1,167540370,167540873,SRX16500062,CTCF,503
chr1,167540396,167540728,SRX5075174,SMARCA4,332
chr1,167540436,167540709,SRX5716464,SMARCA4,273
chr1,167540444,167540692,SRX5075169,SMARCA4,248
chr1,167540455,167540630,SRX5075176,SMARCA4,175
chr1,167540479,167540718,SRX5716463,SMARCA4,239
chr1,167553378,167553978,SRX20140895,INTS13,600
chr1,167553414,167554013,SRX5075169,SMARCA4,599
chr1,167553490,167554020,SRX5075176,SMARCA4,530
chr1,167553503,167553818,SRX5716470,SMARCA4,315
chr1,167553505,167554172,SRX5075174,SMARCA4,667
chr1,167553506,167553719,SRX5075175,SMARCA4,213
chr1,167553510,167554053,SRX5075168,SMARCA4,543
chr1,167553531,167554073,SRX5075170,SMARCA4,542
chr1,167553539,167553893,SRX20140897,INTS13,354
chr1,167553590,167553884,SRX5716469,SMARCA4,294
chr1,167553605,167553879,SRX20140867,INTS10,274
chr1,167553733,167554028,SRX5716463,SMARCA4,295
chr1,167553775,167554130,SRX5075175,SMARCA4,355
chr1,167556041,167556581,SRX16500060,CTCF,540
chr1,167556051,167556610,SRX16500061,CTCF,559
chr1,167556053,167556585,SRX16500059,CTCF,532
chr1,167556068,167556592,SRX16500062,CTCF,524
chr1,167556165,167556378,SRX5075168,SMARCA4,213
chr1,167556166,167556449,SRX4174629,CTCF,283
chr1,167556171,167556365,SRX5075174,SMARCA4,194
chr1,167556180,167556392,SRX5075176,SMARCA4,212
chr1,167600054,167600424,SRX16500060,CTCF,370
chr1,167600137,167600403,SRX16500059,CTCF,266
chr1,167600162,167600626,SRX5075170,SMARCA4,464
chr1,167600180,167600688,SRX5075176,SMARCA4,508
chr1,167600340,167600556,SRX5716470,SMARCA4,216
chr1,167600345,167600544,SRX5075169,SMARCA4,199
chr1,167617391,167617571,SRX5075169,SMARCA4,180
chr1,167617456,167617811,SRX5075170,SMARCA4,355
chr1,167617476,167617734,SRX5075176,SMARCA4,258
chr1,167617736,167617947,SRX5716470,SMARCA4,211
chr1,167617758,167618069,SRX5075174,SMARCA4,311
chr1,167617772,167618061,SRX5075168,SMARCA4,289
chr1,167617788,167618013,SRX5075176,SMARCA4,225
chr1,167617825,167618031,SRX5075169,SMARCA4,206
chr1,167630156,167630462,SRX5075168,SMARCA4,306
chr1,167635341,167635622,SRX5075176,SMARCA4,281
chr1,167635412,167635624,SRX5075170,SMARCA4,212
chr1,167655020,167655205,SRX5075176,SMARCA4,185
chr1,167661531,167661867,SRX5054309,FOSL2,336
chr1,167661541,167661841,SRX5075175,SMARCA4,300
chr1,167661541,167661883,SRX5075176,SMARCA4,342
chr1,167661544,167661899,SRX5075170,SMARCA4,355
chr1,167661588,167661851,SRX5075169,SMARCA4,263
chr1,167661594,167661835,SRX5020211,SMARCA2,241
chr1,167661604,167661851,SRX5054308,FOSL2,247
chr1,167663021,167663226,SRX5075170,SMARCA4,205
chr1,167663035,167663259,SRX5075168,SMARCA4,224
chr1,167663316,167663530,SRX20140867,INTS10,214
chr1,167683802,167684137,SRX5054308,FOSL2,335
chr1,167683816,167684130,SRX5075170,SMARCA4,314
chr1,167683881,167684103,SRX5075176,SMARCA4,222
chr1,167683908,167684113,SRX5075169,SMARCA4,205
chr1,167687816,167688326,SRX16500060,CTCF,510
chr1,167687857,167688330,SRX16500061,CTCF,473
chr1,167687857,167688338,SRX16500059,CTCF,481
chr1,167687876,167688315,SRX16500062,CTCF,439
chr1,167687912,167688233,SRX5716463,SMARCA4,321
chr1,167687933,167688257,SRX5075174,SMARCA4,324
chr1,167687936,167688245,SRX5075168,SMARCA4,309
chr1,167687943,167688184,SRX5075170,SMARCA4,241
chr1,167687957,167688217,SRX5075176,SMARCA4,260
chr1,167687959,167688146,SRX5075175,SMARCA4,187
chr1,167687959,167688166,SRX5075169,SMARCA4,207
chr1,167687964,167688215,SRX4174629,CTCF,251
chr1,167687978,167688263,SRX5716464,SMARCA4,285
chr1,167714172,167714905,SRX20140895,INTS13,733
chr1,167714230,167714504,SRX5075175,SMARCA4,274
chr1,167714288,167714749,SRX20140867,INTS10,461
chr1,167714293,167714588,SRX5075176,SMARCA4,295
chr1,167714319,167714877,SRX20140868,INTS10,558
chr1,167714351,167714566,SRX5075174,SMARCA4,215
chr1,167714378,167714677,SRX5075170,SMARCA4,299
chr1,167714400,167714742,SRX20140869,INTS10,342
chr1,167715314,167715838,SRX16500059,CTCF,524
chr1,167715345,167715860,SRX16500061,CTCF,515
chr1,167715386,167715830,SRX20140869,INTS10,444
chr1,167715388,167715985,SRX16500060,CTCF,597
chr1,167715389,167715870,SRX16500062,CTCF,481
chr1,167715404,167715621,SRX4174629,CTCF,217
chr1,167715419,167715708,SRX20140868,INTS10,289
chr1,167715421,167715740,SRX20140894,INTS13,319
chr1,167715523,167715750,SRX5075174,SMARCA4,227
chr1,167721074,167721307,SRX5075170,SMARCA4,233
chr1,167721564,167722590,SRX20140895,INTS13,1026
chr1,167721682,167721979,SRX5075174,SMARCA4,297
chr1,167721696,167721952,SRX5075176,SMARCA4,256
chr1,167721719,167721998,SRX5075168,SMARCA4,279
chr1,167722337,167722555,SRX5075174,SMARCA4,218
chr1,167722449,167722700,SRX5075168,SMARCA4,251
chr1,167742560,167742729,SRX5075170,SMARCA4,169
chr1,167751743,167751923,SRX5054308,FOSL2,180
chr1,167761493,167761729,SRX5075169,SMARCA4,236
chr1,167761507,167761732,SRX5020211,SMARCA2,225
chr1,167763584,167764005,SRX5075174,SMARCA4,421
chr1,167763667,167763893,SRX5075168,SMARCA4,226
chr1,167776164,167776364,SRX5020211,SMARCA2,200
chr1,167791675,167792302,SRX5075169,SMARCA4,627
chr1,167791693,167792311,SRX5075176,SMARCA4,618
chr1,167791754,167792335,SRX5075170,SMARCA4,581
chr1,167791764,167792279,SRX5716470,SMARCA4,515
chr1,167791854,167792267,SRX5716469,SMARCA4,413
chr1,167791868,167792206,SRX5020211,SMARCA2,338
chr1,167791876,167792315,SRX5075175,SMARCA4,439
chr1,167791878,167792198,SRX5716468,SMARCA2,320
chr1,167791879,167792069,SRX5054308,FOSL2,190
chr1,167791936,167792187,SRX5716467,SMARCA2,251
chr1,167796987,167797525,SRX5075169,SMARCA4,538
chr1,167796992,167797516,SRX5075176,SMARCA4,524
chr1,167797033,167797431,SRX5716468,SMARCA2,398
chr1,167797039,167797461,SRX5075170,SMARCA4,422
chr1,167797047,167797495,SRX5716469,SMARCA4,448
chr1,167797053,167797452,SRX5054309,FOSL2,399
chr1,167797072,167797562,SRX5075175,SMARCA4,490
chr1,167797077,167797468,SRX5716470,SMARCA4,391
chr1,167797102,167797443,SRX5054308,FOSL2,341
chr1,167797106,167797475,SRX5716467,SMARCA2,369
chr1,167797136,167797451,SRX5020211,SMARCA2,315
chr1,167797163,167797474,SRX5020214,SMARCA2,311
chr1,167803207,167803738,SRX16500059,CTCF,531
chr1,167803238,167803714,SRX16500061,CTCF,476
chr1,167803255,167803724,SRX16500060,CTCF,469
chr1,167803262,167803736,SRX16500062,CTCF,474
chr1,167803277,167803661,SRX5075168,SMARCA4,384
chr1,167803281,167803554,SRX5716464,SMARCA4,273
chr1,167803287,167803664,SRX5075174,SMARCA4,377
chr1,167803295,167803623,SRX4174629,CTCF,328
chr1,167803303,167803616,SRX5075170,SMARCA4,313
chr1,167803307,167803617,SRX5716469,SMARCA4,310
chr1,167803327,167803630,SRX5075175,SMARCA4,303
chr1,167803327,167803678,SRX5075176,SMARCA4,351
chr1,167803335,167803555,SRX5716470,SMARCA4,220
chr1,167803356,167803589,SRX5075169,SMARCA4,233
chr1,167803368,167803619,SRX5716463,SMARCA4,251
chr1,167819891,167820346,SRX5054309,FOSL2,455
chr1,167819924,167820271,SRX5054308,FOSL2,347
chr1,167819936,167820367,SRX5075169,SMARCA4,431
chr1,167819952,167820450,SRX5075170,SMARCA4,498
chr1,167819960,167820387,SRX5075176,SMARCA4,427
chr1,167819971,167820375,SRX5075175,SMARCA4,404
chr1,167819986,167820338,SRX5020214,SMARCA2,352
chr1,167820031,167820358,SRX5716469,SMARCA4,327
chr1,167820052,167820414,SRX5075174,SMARCA4,362
chr1,167820118,167820437,SRX5716470,SMARCA4,319
chr1,167820133,167820416,SRX5075168,SMARCA4,283
chr1,167862762,167862968,SRX5075175,SMARCA4,206
chr1,167862821,167863002,SRX5075169,SMARCA4,181
chr1,167904600,167904822,SRX5054308,FOSL2,222
chr1,167904606,167904877,SRX5075169,SMARCA4,271
chr1,167904607,167905001,SRX5075174,SMARCA4,394
chr1,167904633,167904831,SRX5054309,FOSL2,198
chr1,167905212,167905621,SRX5075168,SMARCA4,409
chr1,167905214,167905586,SRX20140895,INTS13,372
chr1,167905226,167905527,SRX5075174,SMARCA4,301
chr1,167935889,167936076,SRX5075175,SMARCA4,187
chr1,167935895,167936221,SRX5075174,SMARCA4,326
chr1,167935963,167937040,SRX20140895,INTS13,1077
chr1,167935986,167936284,SRX5075176,SMARCA4,298
chr1,167935989,167936186,SRX5075170,SMARCA4,197
chr1,167936000,167936299,SRX5075168,SMARCA4,299
chr1,167936046,167936939,SRX20140868,INTS10,893
chr1,167936102,167936966,SRX20140869,INTS10,864
chr1,167936149,167936964,SRX20140867,INTS10,815
chr1,167936245,167936904,SRX20140897,INTS13,659
chr1,167936298,167936893,SRX20140879,CPSF3L,595
chr1,167936299,167936987,SRX20140881,CPSF3L,688
chr1,167936332,167936774,SRX5075174,SMARCA4,442
chr1,167936600,167936975,SRX20140896,INTS13,375
chr1,167937556,167937756,SRX5075174,SMARCA4,200
chr1,167937559,167937808,SRX5075170,SMARCA4,249
chr1,168050325,168050542,SRX5716470,SMARCA4,217
chr1,168079790,168079973,SRX5054309,FOSL2,183
chr1,168079828,168080011,SRX5075169,SMARCA4,183
chr1,168082138,168082625,SRX16500060,CTCF,487
chr1,168082218,168082615,SRX5075174,SMARCA4,397
chr1,168082223,168082713,SRX16500059,CTCF,490
chr1,168082237,168082570,SRX5075168,SMARCA4,333
chr1,168082247,168082663,SRX16500061,CTCF,416
chr1,168082259,168082614,SRX16500062,CTCF,355
chr1,168082269,168082495,SRX5716470,SMARCA4,226
chr1,168082280,168082519,SRX5075176,SMARCA4,239
chr1,168082288,168082500,SRX5716463,SMARCA4,212
chr1,168082296,168082542,SRX4174629,CTCF,246
chr1,168082303,168082531,SRX5075170,SMARCA4,228
chr1,168084707,168085145,SRX16500059,CTCF,438
chr1,168084734,168085116,SRX16500062,CTCF,382
chr1,168084738,168085105,SRX16500061,CTCF,367
chr1,168084741,168085114,SRX16500060,CTCF,373
chr1,168112939,168113311,SRX5716469,SMARCA4,372
chr1,168112943,168113376,SRX5075175,SMARCA4,433
chr1,168112962,168113365,SRX5075170,SMARCA4,403
chr1,168112963,168113316,SRX5075176,SMARCA4,353
chr1,168113033,168113261,SRX5075169,SMARCA4,228
chr1,168113050,168113282,SRX5716470,SMARCA4,232
chr1,168113087,168113286,SRX5054309,FOSL2,199
chr1,168121439,168122035,SRX5075176,SMARCA4,596
chr1,168121480,168122029,SRX5716470,SMARCA4,549
chr1,168121502,168122005,SRX5075175,SMARCA4,503
chr1,168121553,168121943,SRX5075169,SMARCA4,390
chr1,168121595,168121980,SRX5075170,SMARCA4,385
chr1,168121619,168121924,SRX5716467,SMARCA2,305
chr1,168121654,168122009,SRX5716468,SMARCA2,355
chr1,168121718,168121970,SRX5716469,SMARCA4,252
chr1,168125998,168126175,SRX5075176,SMARCA4,177
chr1,168136422,168137041,SRX20140895,INTS13,619
chr1,168136649,168136909,SRX20140867,INTS10,260
chr1,168137283,168137608,SRX5075169,SMARCA4,325
chr1,168137324,168137632,SRX20140895,INTS13,308
chr1,168145643,168146108,SRX16500060,CTCF,465
chr1,168145646,168146119,SRX16500059,CTCF,473
chr1,168145715,168146116,SRX16500062,CTCF,401
chr1,168145738,168146126,SRX16500061,CTCF,388
chr1,168145778,168146079,SRX5075174,SMARCA4,301
chr1,168145791,168146073,SRX5075168,SMARCA4,282
chr1,168145814,168146075,SRX5716470,SMARCA4,261
chr1,168145831,168146063,SRX5075170,SMARCA4,232
chr1,168145866,168146046,SRX5075169,SMARCA4,180
chr1,168145875,168146075,SRX5075176,SMARCA4,200
chr1,168178479,168179153,SRX5716470,SMARCA4,674
chr1,168178498,168179164,SRX5075170,SMARCA4,666
chr1,168178504,168179084,SRX5075176,SMARCA4,580
chr1,168178506,168178860,SRX5716469,SMARCA4,354
chr1,168178513,168179104,SRX5075169,SMARCA4,591
chr1,168178518,168178913,SRX5054309,FOSL2,395
chr1,168178536,168179118,SRX5075174,SMARCA4,582
chr1,168178555,168179038,SRX5075175,SMARCA4,483
chr1,168178561,168179172,SRX5716463,SMARCA4,611
chr1,168178579,168179172,SRX5075168,SMARCA4,593
chr1,168178615,168178905,SRX5054308,FOSL2,290
chr1,168178631,168178943,SRX5716464,SMARCA4,312
chr1,168178666,168179139,SRX16500059,CTCF,473
chr1,168178668,168178901,SRX5054307,FOSL2,233
chr1,168178687,168178895,SRX5020211,SMARCA2,208
chr1,168178705,168179207,SRX16500060,CTCF,502
chr1,168178720,168179154,SRX16500062,CTCF,434
chr1,168178726,168179170,SRX16500061,CTCF,444
chr1,168178726,168179300,SRX20140895,INTS13,574
chr1,168178801,168179133,SRX20140881,CPSF3L,332
chr1,168178835,168179157,SRX20140867,INTS10,322
chr1,168178845,168179146,SRX20140897,INTS13,301
chr1,168218766,168218945,SRX5075168,SMARCA4,179
chr1,168225567,168225991,SRX20140867,INTS10,424
chr1,168225573,168226056,SRX20140868,INTS10,483
chr1,168225573,168226358,SRX20140895,INTS13,785
chr1,168225651,168225964,SRX20140897,INTS13,313
chr1,168225683,168226116,SRX5075168,SMARCA4,433
chr1,168225684,168226260,SRX20140869,INTS10,576
chr1,168225728,168226091,SRX5075170,SMARCA4,363
chr1,168225764,168226162,SRX5075174,SMARCA4,398
chr1,168225769,168226071,SRX5075175,SMARCA4,302
chr1,168225772,168225999,SRX5716470,SMARCA4,227
chr1,168225779,168226089,SRX5075176,SMARCA4,310
chr1,168225835,168226232,SRX5075169,SMARCA4,397
chr1,168235206,168235594,SRX16500061,CTCF,388
chr1,168235232,168235636,SRX16500062,CTCF,404
chr1,168235239,168235673,SRX16500060,CTCF,434
chr1,168235240,168235606,SRX16500059,CTCF,366
chr1,168243212,168243423,SRX5716470,SMARCA4,211
chr1,168243287,168243543,SRX5075170,SMARCA4,256
chr1,168261315,168261804,SRX5716469,SMARCA4,489
chr1,168261370,168261853,SRX5716470,SMARCA4,483
chr1,168261376,168261802,SRX5075170,SMARCA4,426
chr1,168261389,168261902,SRX5075169,SMARCA4,513
chr1,168261414,168261880,SRX5075176,SMARCA4,466
chr1,168261432,168261744,SRX5054309,FOSL2,312
chr1,168261432,168261782,SRX5716467,SMARCA2,350
chr1,168261438,168261756,SRX5054308,FOSL2,318
chr1,168261443,168261668,SRX5716468,SMARCA2,225
chr1,168261452,168261786,SRX5020211,SMARCA2,334
chr1,168261452,168261824,SRX5075175,SMARCA4,372
chr1,168261485,168261709,SRX5075181,SMARCA2,224
chr1,168261489,168261813,SRX5020214,SMARCA2,324
chr1,168273615,168273863,SRX5020211,SMARCA2,248
chr1,168273634,168273898,SRX5075169,SMARCA4,264
chr1,168273653,168273864,SRX5075176,SMARCA4,211
chr1,168273675,168273933,SRX5716469,SMARCA4,258
chr1,168285408,168285733,SRX5716470,SMARCA4,325
chr1,168285433,168285719,SRX5075170,SMARCA4,286
chr1,168285439,168285717,SRX5075176,SMARCA4,278
chr1,168285443,168285669,SRX5075175,SMARCA4,226
chr1,168285455,168285668,SRX5075169,SMARCA4,213
chr1,168285470,168285670,SRX5020211,SMARCA2,200
chr1,168285479,168285711,SRX5075181,SMARCA2,232
chr1,168285482,168285723,SRX5716469,SMARCA4,241
chr1,168287211,168287442,SRX5054308,FOSL2,231
chr1,168287227,168287434,SRX5075174,SMARCA4,207
chr1,168287253,168287476,SRX5054309,FOSL2,223
chr1,168301573,168301903,SRX5075174,SMARCA4,330
chr1,168301624,168301924,SRX5054309,FOSL2,300
chr1,168301645,168302020,SRX5075170,SMARCA4,375
chr1,168301646,168302071,SRX5075169,SMARCA4,425
chr1,168301651,168301863,SRX5716469,SMARCA4,212
chr1,168301654,168301877,SRX5054308,FOSL2,223
chr1,168301664,168302077,SRX5075175,SMARCA4,413
chr1,168301668,168301928,SRX5075168,SMARCA4,260
chr1,168301676,168302090,SRX5075176,SMARCA4,414
chr1,168301756,168302007,SRX5716470,SMARCA4,251
chr1,168304907,168305200,SRX5075176,SMARCA4,293
chr1,168304961,168305218,SRX5075170,SMARCA4,257
chr1,168320866,168321370,SRX5075170,SMARCA4,504
chr1,168320927,168321311,SRX5716459,Epitope tags,384
chr1,168320929,168321408,SRX5075176,SMARCA4,479
chr1,168320961,168321373,SRX5716460,Epitope tags,412
chr1,168320966,168321318,SRX5054308,FOSL2,352
chr1,168320969,168321425,SRX5075175,SMARCA4,456
chr1,168320979,168321371,SRX5054309,FOSL2,392
chr1,168320997,168321382,SRX5075169,SMARCA4,385
chr1,168320998,168321355,SRX5716469,SMARCA4,357
chr1,168320998,168321362,SRX5075168,SMARCA4,364
chr1,168321003,168321337,SRX5075174,SMARCA4,334
chr1,168321005,168321299,SRX5716467,SMARCA2,294
chr1,168321053,168321353,SRX5716470,SMARCA4,300
chr1,168335604,168335880,SRX5054308,FOSL2,276
chr1,168335610,168335796,SRX5075176,SMARCA4,186
chr1,168342638,168343181,SRX16500059,CTCF,543
chr1,168342645,168343084,SRX16500060,CTCF,439
chr1,168342648,168343094,SRX16500062,CTCF,446
chr1,168342666,168343085,SRX16500061,CTCF,419
chr1,168342683,168343075,SRX5075168,SMARCA4,392
chr1,168342696,168343049,SRX5075176,SMARCA4,353
chr1,168342717,168342982,SRX5054309,FOSL2,265
chr1,168342723,168343006,SRX5716463,SMARCA4,283
chr1,168342723,168343068,SRX5075175,SMARCA4,345
chr1,168342727,168343047,SRX5075170,SMARCA4,320
chr1,168342733,168343076,SRX4174629,CTCF,343
chr1,168342734,168343044,SRX5075169,SMARCA4,310
chr1,168342735,168343084,SRX5075174,SMARCA4,349
chr1,168342755,168343078,SRX5716464,SMARCA4,323
chr1,168342807,168343042,SRX5716469,SMARCA4,235
chr1,168348983,168349025,SRX1424894,POU3F2,42
chr1,168348986,168349029,SRX1424891,POU3F2,43
chr1,168348987,168349028,SRX1424893,POU3F2,41
chr1,168377796,168378184,SRX5075174,SMARCA4,388
chr1,168377800,168378129,SRX5716463,SMARCA4,329
chr1,168377809,168378200,SRX5075168,SMARCA4,391
chr1,168377913,168378126,SRX5716464,SMARCA4,213
chr1,168398946,168399442,SRX5075168,SMARCA4,496
chr1,168398989,168399458,SRX5075174,SMARCA4,469
chr1,168398990,168399416,SRX5716469,SMARCA4,426
chr1,168399016,168399370,SRX5075170,SMARCA4,354
chr1,168399016,168399412,SRX5075176,SMARCA4,396
chr1,168399024,168399368,SRX5054308,FOSL2,344
chr1,168399034,168399397,SRX5054309,FOSL2,363
chr1,168399036,168399362,SRX5054307,FOSL2,326
chr1,168399038,168399275,SRX5716467,SMARCA2,237
chr1,168399050,168399346,SRX5716470,SMARCA4,296
chr1,168399059,168399403,SRX5716463,SMARCA4,344
chr1,168399068,168399375,SRX5075169,SMARCA4,307
chr1,168399082,168399344,SRX5075175,SMARCA4,262
chr1,168408885,168409166,SRX5054309,FOSL2,281
chr1,168408902,168409195,SRX5075168,SMARCA4,293
chr1,168408903,168409202,SRX5075174,SMARCA4,299
chr1,168408922,168409249,SRX5075176,SMARCA4,327
chr1,168408935,168409201,SRX5075170,SMARCA4,266
chr1,168408955,168409189,SRX5054308,FOSL2,234
chr1,168408969,168409222,SRX5075169,SMARCA4,253
chr1,168408994,168409183,SRX5075175,SMARCA4,189
chr1,168428153,168428481,SRX5075170,SMARCA4,328
chr1,168428160,168428507,SRX5075174,SMARCA4,347
chr1,168428198,168428508,SRX5075175,SMARCA4,310
chr1,168428235,168428480,SRX5075176,SMARCA4,245
chr1,168428301,168428500,SRX5054309,FOSL2,199
chr1,168439624,168440163,SRX16500059,CTCF,539
chr1,168439713,168440166,SRX16500060,CTCF,453
chr1,168439715,168440131,SRX4174629,CTCF,416
chr1,168439742,168440215,SRX16500061,CTCF,473
chr1,168439756,168440166,SRX16500062,CTCF,410
chr1,168439759,168440184,SRX5075174,SMARCA4,425
chr1,168439802,168440137,SRX5075168,SMARCA4,335
chr1,168439809,168440087,SRX5716463,SMARCA4,278
chr1,168439828,168440081,SRX5075169,SMARCA4,253
chr1,168439845,168440177,SRX5075176,SMARCA4,332
chr1,168439857,168440076,SRX5075175,SMARCA4,219
chr1,168439871,168440208,SRX5075170,SMARCA4,337
chr1,168439887,168440092,SRX5716464,SMARCA4,205
chr1,168466080,168466498,SRX5075176,SMARCA4,418
chr1,168466108,168466528,SRX5075170,SMARCA4,420
chr1,168468015,168468336,SRX5716463,SMARCA4,321
chr1,168468110,168468339,SRX5075174,SMARCA4,229
chr1,168469736,168469925,SRX5075176,SMARCA4,189
chr1,168469740,168469964,SRX5075170,SMARCA4,224
chr1,168470963,168471507,SRX5075175,SMARCA4,544
chr1,168470964,168471530,SRX5075176,SMARCA4,566
chr1,168471037,168471459,SRX5716469,SMARCA4,422
chr1,168471129,168471509,SRX5075170,SMARCA4,380
chr1,168471134,168471483,SRX5075169,SMARCA4,349
chr1,168471134,168471505,SRX5716467,SMARCA2,371
chr1,168471137,168471537,SRX5054308,FOSL2,400
chr1,168471138,168471434,SRX5075168,SMARCA4,296
chr1,168471149,168471430,SRX5020214,SMARCA2,281
chr1,168471151,168471470,SRX5716470,SMARCA4,319
chr1,168471169,168471495,SRX5054309,FOSL2,326
chr1,168471175,168471520,SRX5020211,SMARCA2,345
chr1,168471176,168471513,SRX5716460,Epitope tags,337
chr1,168471185,168471444,SRX5075174,SMARCA4,259
chr1,168471276,168471543,SRX5716459,Epitope tags,267
chr1,168482171,168482576,SRX5075174,SMARCA4,405
chr1,168482243,168482579,SRX5716463,SMARCA4,336
chr1,168482248,168482592,SRX5075168,SMARCA4,344
chr1,168482347,168482552,SRX5716464,SMARCA4,205
chr1,168483636,168483882,SRX5054309,FOSL2,246
chr1,168488071,168488647,SRX5075176,SMARCA4,576
chr1,168488080,168488668,SRX5075170,SMARCA4,588
chr1,168488125,168488600,SRX5075169,SMARCA4,475
chr1,168488189,168488626,SRX5716470,SMARCA4,437
chr1,168488209,168488542,SRX5054308,FOSL2,333
chr1,168488227,168488650,SRX5716469,SMARCA4,423
chr1,168488234,168488617,SRX5075175,SMARCA4,383
chr1,168488284,168488540,SRX5716468,SMARCA2,256
chr1,168488310,168488621,SRX5716467,SMARCA2,311
chr1,168498193,168498676,SRX5075176,SMARCA4,483
chr1,168498207,168498571,SRX5716469,SMARCA4,364
chr1,168498209,168498501,SRX5075168,SMARCA4,292
chr1,168498283,168498646,SRX5716470,SMARCA4,363
chr1,168498285,168498632,SRX5075169,SMARCA4,347
chr1,168498326,168498698,SRX5075170,SMARCA4,372
chr1,168498390,168498618,SRX5075175,SMARCA4,228
chr1,168506538,168506754,SRX5075176,SMARCA4,216
chr1,168506553,168506810,SRX5075169,SMARCA4,257
chr1,168545927,168546339,SRX16500059,CTCF,412
chr1,168545933,168546253,SRX16500062,CTCF,320
chr1,168545935,168546298,SRX16500061,CTCF,363
chr1,168545942,168546320,SRX16500060,CTCF,378
chr1,168546006,168546179,SRX5075174,SMARCA4,173
chr1,168546023,168546245,SRX5075168,SMARCA4,222
chr1,168574163,168574683,SRX16500060,CTCF,520
chr1,168574243,168574653,SRX16500062,CTCF,410
chr1,168574274,168574705,SRX16500061,CTCF,431
chr1,168574285,168574653,SRX16500059,CTCF,368
chr1,168574332,168574568,SRX5075168,SMARCA4,236
chr1,168574360,168574533,SRX5075174,SMARCA4,173
chr1,168582984,168583205,SRX5075169,SMARCA4,221
chr1,168582991,168583280,SRX5075170,SMARCA4,289
chr1,168583049,168583287,SRX5075176,SMARCA4,238
chr1,168585253,168585477,SRX5054308,FOSL2,224
chr1,168585287,168585484,SRX5075170,SMARCA4,197
chr1,168601164,168601344,SRX5054308,FOSL2,180
chr1,168603422,168603878,SRX16500059,CTCF,456
chr1,168603433,168603880,SRX16500060,CTCF,447
chr1,168603468,168603862,SRX16500061,CTCF,394
chr1,168603479,168603901,SRX16500062,CTCF,422
chr1,168603544,168603874,SRX4174629,CTCF,330
chr1,168603611,168603812,SRX5075168,SMARCA4,201
chr1,168613504,168614161,SRX5075170,SMARCA4,657
chr1,168613527,168614248,SRX5075176,SMARCA4,721
chr1,168613566,168613914,SRX5054309,FOSL2,348
chr1,168613569,168613949,SRX5054308,FOSL2,380
chr1,168613570,168614328,SRX5075174,SMARCA4,758
chr1,168613585,168614163,SRX5075169,SMARCA4,578
chr1,168613586,168614086,SRX5075175,SMARCA4,500
chr1,168613586,168614105,SRX5716470,SMARCA4,519
chr1,168613589,168614170,SRX5716469,SMARCA4,581
chr1,168613589,168614282,SRX5075168,SMARCA4,693
chr1,168613648,168614066,SRX5716467,SMARCA2,418
chr1,168613656,168614112,SRX5716464,SMARCA4,456
chr1,168613677,168614014,SRX5716468,SMARCA2,337
chr1,168613715,168614047,SRX20140895,INTS13,332
chr1,168613746,168614097,SRX20140879,CPSF3L,351
chr1,168613760,168614110,SRX20140868,INTS10,350
chr1,168613775,168614115,SRX5716463,SMARCA4,340
chr1,168613777,168614195,SRX20140867,INTS10,418
chr1,168613793,168614054,SRX20140881,CPSF3L,261
chr1,168613827,168614030,SRX5716451,SOX2,203
chr1,168613878,168614078,SRX5054307,FOSL2,200
chr1,168621348,168621759,SRX5075174,SMARCA4,411
chr1,168621397,168621735,SRX5716463,SMARCA4,338
chr1,168621411,168621744,SRX5075168,SMARCA4,333
chr1,168621500,168621712,SRX5716464,SMARCA4,212
chr1,168623170,168623468,SRX5054309,FOSL2,298
chr1,168623184,168623494,SRX5054308,FOSL2,310
chr1,168623238,168623486,SRX5075170,SMARCA4,248
chr1,168623257,168623500,SRX5075176,SMARCA4,243
chr1,168623265,168623475,SRX5075175,SMARCA4,210
chr1,168623289,168623490,SRX5075169,SMARCA4,201
chr1,168628816,168629048,SRX5075170,SMARCA4,232
chr1,168628891,168629087,SRX5054309,FOSL2,196
chr1,168637368,168637746,SRX16500062,CTCF,378
chr1,168637380,168637806,SRX16500060,CTCF,426
chr1,168637391,168637768,SRX16500061,CTCF,377
chr1,168637451,168637823,SRX16500059,CTCF,372
chr1,168637563,168637742,SRX5075168,SMARCA4,179
chr1,168654528,168654907,SRX5054309,FOSL2,379
chr1,168654577,168654774,SRX5075175,SMARCA4,197
chr1,168709135,168709702,SRX5054308,FOSL2,567
chr1,168709183,168709798,SRX5075175,SMARCA4,615
chr1,168709203,168709839,SRX5075169,SMARCA4,636
chr1,168709241,168709746,SRX5716470,SMARCA4,505
chr1,168709329,168709773,SRX5075176,SMARCA4,444
chr1,168709341,168709720,SRX5075170,SMARCA4,379
chr1,168709368,168709653,SRX5716467,SMARCA2,285
chr1,168709385,168709711,SRX5716468,SMARCA2,326
chr1,168709386,168709811,SRX5716469,SMARCA4,425
chr1,168709437,168709755,SRX5075181,SMARCA2,318
chr1,168709524,168709755,SRX5020211,SMARCA2,231
chr1,168709978,168710289,SRX5054309,FOSL2,311
chr1,168709978,168710302,SRX5075169,SMARCA4,324
chr1,168709981,168710247,SRX5075175,SMARCA4,266
chr1,168709992,168710208,SRX5075176,SMARCA4,216
chr1,168710000,168710251,SRX5054308,FOSL2,251
chr1,168710036,168710270,SRX5075170,SMARCA4,234
chr1,168710061,168710288,SRX5075174,SMARCA4,227
chr1,168751203,168751460,SRX5075174,SMARCA4,257
chr1,168752095,168752387,SRX5054309,FOSL2,292
chr1,168752258,168752440,SRX5054308,FOSL2,182
chr1,168767978,168768176,SRX5075170,SMARCA4,198
chr1,168768015,168768288,SRX5075176,SMARCA4,273
chr1,168768108,168768319,SRX5716470,SMARCA4,211
chr1,168804029,168804559,SRX5075174,SMARCA4,530
chr1,168804109,168804510,SRX5075168,SMARCA4,401
chr1,168804167,168804401,SRX5716463,SMARCA4,234
chr1,168804179,168804420,SRX20140867,INTS10,241
chr1,168826790,168827088,SRX5075176,SMARCA4,298
chr1,168826884,168827080,SRX5075170,SMARCA4,196
chr1,168918811,168919630,SRX5075174,SMARCA4,819
chr1,168918910,168919512,SRX5075168,SMARCA4,602
chr1,168918945,168919477,SRX5716463,SMARCA4,532
chr1,168918974,168919236,SRX5716451,SOX2,262
chr1,168918974,168919249,SRX5716454,SOX3,275
chr1,169087126,169087380,SRX5716469,SMARCA4,254
chr1,169102580,169102905,SRX5054309,FOSL2,325
chr1,169102582,169102921,SRX5075175,SMARCA4,339
chr1,169102584,169102954,SRX5075176,SMARCA4,370
chr1,169102587,169102888,SRX5075174,SMARCA4,301
chr1,169102599,169102908,SRX5075168,SMARCA4,309
chr1,169102600,169102919,SRX5716469,SMARCA4,319
chr1,169102602,169102874,SRX5054307,FOSL2,272
chr1,169102602,169102883,SRX5054308,FOSL2,281
chr1,169102623,169102942,SRX5075170,SMARCA4,319
chr1,169102630,169102874,SRX5075169,SMARCA4,244
chr1,169102717,169102928,SRX5716470,SMARCA4,211
chr1,169105576,169106941,SRX20140895,INTS13,1365
chr1,169105909,169106872,SRX20140868,INTS10,963
chr1,169106024,169106501,SRX16500059,CTCF,477
chr1,169106062,169106520,SRX16500060,CTCF,458
chr1,169106065,169106496,SRX16500062,CTCF,431
chr1,169106093,169106509,SRX16500061,CTCF,416
chr1,169106093,169106867,SRX20140867,INTS10,774
chr1,169106140,169106594,SRX20140879,CPSF3L,454
chr1,169106176,169106612,SRX20140897,INTS13,436
chr1,169106192,169106580,SRX20140894,INTS13,388
chr1,169106206,169106571,SRX5075174,SMARCA4,365
chr1,169106266,169106523,SRX20140880,CPSF3L,257
chr1,169106408,169106675,SRX20140881,CPSF3L,267
chr1,169113560,169114005,SRX5054309,FOSL2,445
chr1,169113610,169113932,SRX5075169,SMARCA4,322
chr1,169113610,169113987,SRX5075175,SMARCA4,377
chr1,169113627,169113984,SRX5054308,FOSL2,357
chr1,169113635,169113948,SRX5075176,SMARCA4,313
chr1,169113637,169113937,SRX5075170,SMARCA4,300
chr1,169113643,169113848,SRX5020214,SMARCA2,205
chr1,169119531,169119727,SRX5075175,SMARCA4,196
chr1,169161247,169161721,SRX5075170,SMARCA4,474
chr1,169161249,169161496,SRX5716469,SMARCA4,247
chr1,169161256,169161436,SRX5075169,SMARCA4,180
chr1,169161260,169161460,SRX5075176,SMARCA4,200
chr1,169161392,169161598,SRX5054309,FOSL2,206
chr1,169201305,169201511,SRX5075175,SMARCA4,206
chr1,169287931,169288263,SRX5075169,SMARCA4,332
chr1,169287939,169288264,SRX5054309,FOSL2,325
chr1,169287954,169288179,SRX5075175,SMARCA4,225
chr1,169288052,169288232,SRX5054308,FOSL2,180
chr1,169307119,169307360,SRX5075176,SMARCA4,241
chr1,169309298,169309658,SRX5075168,SMARCA4,360
chr1,169309333,169309749,SRX5075174,SMARCA4,416
chr1,169309436,169309641,SRX5716454,SOX3,205
chr1,169312108,169312590,SRX5075169,SMARCA4,482
chr1,169312114,169312506,SRX5075170,SMARCA4,392
chr1,169312125,169312571,SRX5054308,FOSL2,446
chr1,169312127,169312611,SRX5075175,SMARCA4,484
chr1,169312130,169312580,SRX5054309,FOSL2,450
chr1,169312155,169312559,SRX5075176,SMARCA4,404
chr1,169312168,169312551,SRX5716470,SMARCA4,383
chr1,169312190,169312483,SRX5020211,SMARCA2,293
chr1,169312212,169312520,SRX5716467,SMARCA2,308
chr1,169312224,169312475,SRX5020214,SMARCA2,251
chr1,169312227,169312569,SRX5716469,SMARCA4,342
chr1,169312257,169312486,SRX5716468,SMARCA2,229
chr1,169312261,169312636,SRX5716459,Epitope tags,375
chr1,169318623,169318914,SRX5075170,SMARCA4,291
chr1,169318630,169318912,SRX5075176,SMARCA4,282
chr1,169321622,169321856,SRX5054309,FOSL2,234
chr1,169321689,169321894,SRX5054308,FOSL2,205
chr1,169326941,169327224,SRX5054309,FOSL2,283
chr1,169326968,169327202,SRX5054308,FOSL2,234
chr1,169348353,169348862,SRX16500059,CTCF,509
chr1,169348362,169348871,SRX16500062,CTCF,509
chr1,169348372,169348875,SRX16500060,CTCF,503
chr1,169348417,169348850,SRX16500061,CTCF,433
chr1,169348499,169348714,SRX5075174,SMARCA4,215
chr1,169348522,169348721,SRX5075168,SMARCA4,199
chr1,169348524,169348709,SRX5075176,SMARCA4,185
chr1,169363188,169363696,SRX5054309,FOSL2,508
chr1,169363352,169363666,SRX5054308,FOSL2,314
chr1,169363409,169363596,SRX5075175,SMARCA4,187
chr1,169367535,169368101,SRX5075174,SMARCA4,566
chr1,169367617,169367921,SRX5075168,SMARCA4,304
chr1,169367625,169367797,SRX5075170,SMARCA4,172
chr1,169367656,169368027,SRX5075176,SMARCA4,371
chr1,169367767,169367946,SRX5054307,FOSL2,179
chr1,169367786,169367976,SRX5716451,SOX2,190
chr1,169367797,169368182,SRX20140895,INTS13,385
chr1,169367971,169368323,SRX5075170,SMARCA4,352
chr1,169427104,169427613,SRX5716470,SMARCA4,509
chr1,169427127,169427745,SRX20140895,INTS13,618
chr1,169427244,169427420,SRX5075176,SMARCA4,176
chr1,169427245,169427825,SRX5075174,SMARCA4,580
chr1,169427261,169427671,SRX5075175,SMARCA4,410
chr1,169427271,169427854,SRX5075168,SMARCA4,583
chr1,169427299,169427735,SRX5716463,SMARCA4,436
chr1,169427372,169427761,SRX5716464,SMARCA4,389
chr1,169427394,169427596,SRX5075170,SMARCA4,202
chr1,169427396,169427665,SRX5075169,SMARCA4,269
chr1,169427446,169427691,SRX5716454,SOX3,245
chr1,169427458,169427709,SRX5716451,SOX2,251
chr1,169427529,169427709,SRX5075176,SMARCA4,180
chr1,169436820,169437073,SRX5075174,SMARCA4,253
chr1,169466274,169466636,SRX16500061,CTCF,362
chr1,169466319,169466643,SRX16500059,CTCF,324
chr1,169466335,169466574,SRX16500062,CTCF,239
chr1,169466337,169466614,SRX16500060,CTCF,277
chr1,169485377,169486437,SRX20140895,INTS13,1060
chr1,169485575,169485775,SRX5075170,SMARCA4,200
chr1,169485614,169486421,SRX20140881,CPSF3L,807
chr1,169485672,169486434,SRX20140868,INTS10,762
chr1,169485701,169486401,SRX20140867,INTS10,700
chr1,169485714,169486133,SRX16500061,CTCF,419
chr1,169485733,169486044,SRX16500060,CTCF,311
chr1,169485778,169486296,SRX20140879,CPSF3L,518
chr1,169485907,169486344,SRX20140897,INTS13,437
chr1,169485921,169486148,SRX5075168,SMARCA4,227
chr1,169485928,169486258,SRX20140896,INTS13,330
chr1,169485932,169486377,SRX5075174,SMARCA4,445
chr1,169485964,169486160,SRX5054307,FOSL2,196
chr1,169485993,169486491,SRX5075170,SMARCA4,498
chr1,169486028,169486418,SRX5075176,SMARCA4,390
chr1,169486058,169486473,SRX5716470,SMARCA4,415
chr1,169486159,169486489,SRX5075175,SMARCA4,330
chr1,169486191,169486476,SRX5075169,SMARCA4,285
chr1,169486224,169486483,SRX5716469,SMARCA4,259
chr1,169486237,169486420,SRX5054309,FOSL2,183
chr1,169539070,169539355,SRX5054309,FOSL2,285
chr1,169546326,169546772,SRX16500059,CTCF,446
chr1,169546358,169546757,SRX16500060,CTCF,399
chr1,169546398,169546788,SRX16500062,CTCF,390
chr1,169546398,169546820,SRX16500061,CTCF,422
chr1,169546406,169546777,SRX4174629,CTCF,371
chr1,169546461,169546640,SRX5075168,SMARCA4,179
chr1,169546494,169546721,SRX5075174,SMARCA4,227
chr1,169550341,169550572,SRX16500062,CTCF,231
chr1,169550361,169550626,SRX16500059,CTCF,265
chr1,169550366,169550612,SRX16500060,CTCF,246
chr1,169550397,169550627,SRX16500061,CTCF,230
chr1,169586423,169586611,SRX5075174,SMARCA4,188
chr1,169601072,169601462,SRX16500061,CTCF,390
chr1,169601087,169601467,SRX16500059,CTCF,380
chr1,169601122,169601485,SRX16500060,CTCF,363
chr1,169601146,169601460,SRX16500062,CTCF,314
chr1,169650618,169650851,SRX5075168,SMARCA4,233
chr1,169711916,169712399,SRX16500061,CTCF,483
chr1,169711921,169712409,SRX16500062,CTCF,488
chr1,169711986,169712454,SRX16500060,CTCF,468
chr1,169712012,169712469,SRX16500059,CTCF,457
chr1,169712090,169712349,SRX5075168,SMARCA4,259
chr1,169712099,169712299,SRX5075176,SMARCA4,200
chr1,169712106,169712362,SRX5075174,SMARCA4,256
chr1,169741550,169741921,SRX5075175,SMARCA4,371
chr1,169741739,169741984,SRX5716470,SMARCA4,245
chr1,169741744,169742032,SRX5075176,SMARCA4,288
chr1,169741772,169742022,SRX5075169,SMARCA4,250
chr1,169741793,169741974,SRX5075170,SMARCA4,181
chr1,169741806,169742050,SRX5716469,SMARCA4,244
chr1,169745545,169745935,SRX5054308,FOSL2,390
chr1,169745629,169745974,SRX5054309,FOSL2,345
chr1,169779194,169779431,SRX5020211,SMARCA2,237
chr1,169794536,169795076,SRX20140895,INTS13,540
chr1,169794584,169795126,SRX5075176,SMARCA4,542
chr1,169794724,169794935,SRX5716470,SMARCA4,211
chr1,169794769,169795276,SRX5075174,SMARCA4,507
chr1,169794782,169795057,SRX5075170,SMARCA4,275
chr1,169794802,169795068,SRX5075168,SMARCA4,266
chr1,169794823,169795028,SRX5716464,SMARCA4,205
chr1,169809606,169810009,SRX16500062,CTCF,403
chr1,169809612,169810052,SRX16500059,CTCF,440
chr1,169809613,169810146,SRX16500060,CTCF,533
chr1,169809627,169810080,SRX16500061,CTCF,453
chr1,169809721,169809896,SRX5075176,SMARCA4,175
chr1,169809947,169810187,SRX4174629,CTCF,240
chr1,169893225,169893437,SRX5075170,SMARCA4,212
chr1,169893379,169893814,SRX5075176,SMARCA4,435
chr1,169893382,169893707,SRX5075169,SMARCA4,325
chr1,169893392,169893627,SRX5716470,SMARCA4,235
chr1,169893395,169894316,SRX20140895,INTS13,921
chr1,169893455,169893878,SRX5075174,SMARCA4,423
chr1,169893475,169893684,SRX5075168,SMARCA4,209
chr1,169893504,169893831,SRX5075170,SMARCA4,327
chr1,169893509,169893832,SRX5075175,SMARCA4,323
chr1,169893548,169894163,SRX20140867,INTS10,615
chr1,169893642,169893868,SRX5716463,SMARCA4,226
chr1,169893664,169894117,SRX20140868,INTS10,453
chr1,169893744,169894044,SRX20140869,INTS10,300
chr1,169893764,169894105,SRX20140897,INTS13,341
chr1,169893769,169894055,SRX20140881,CPSF3L,286
chr1,169894277,169894567,SRX5075168,SMARCA4,290
chr1,169894307,169894524,SRX5075174,SMARCA4,217
chr1,169914417,169914834,SRX5075170,SMARCA4,417
chr1,169914505,169914848,SRX5075169,SMARCA4,343
chr1,169914551,169914907,SRX5054309,FOSL2,356
chr1,169914575,169914852,SRX5075176,SMARCA4,277
chr1,169914576,169914929,SRX5075175,SMARCA4,353
chr1,169914587,169914889,SRX5054308,FOSL2,302
chr1,169928809,169929338,SRX16500059,CTCF,529
chr1,169928848,169929346,SRX16500060,CTCF,498
chr1,169928857,169929348,SRX16500062,CTCF,491
chr1,169928887,169929340,SRX16500061,CTCF,453
chr1,169928948,169929166,SRX5075168,SMARCA4,218
chr1,169931812,169932238,SRX5075169,SMARCA4,426
chr1,169931876,169932231,SRX5075170,SMARCA4,355
chr1,169931881,169932222,SRX5075176,SMARCA4,341
chr1,169931920,169932212,SRX5075175,SMARCA4,292
chr1,169931972,169932233,SRX5054309,FOSL2,261
chr1,169934469,169934666,SRX5075175,SMARCA4,197
chr1,169934547,169934760,SRX5075169,SMARCA4,213
chr1,169942396,169942804,SRX5075175,SMARCA4,408
chr1,169942414,169942856,SRX5075170,SMARCA4,442
chr1,169942441,169942812,SRX5716470,SMARCA4,371
chr1,169942442,169942870,SRX5075169,SMARCA4,428
chr1,169942467,169942818,SRX5716469,SMARCA4,351
chr1,169942480,169942899,SRX5075176,SMARCA4,419
chr1,169942492,169942776,SRX5716468,SMARCA2,284
chr1,169942521,169942793,SRX5020214,SMARCA2,272
chr1,169942573,169942799,SRX5716467,SMARCA2,226
chr1,169949232,169949508,SRX5075169,SMARCA4,276
chr1,169949241,169949555,SRX5075175,SMARCA4,314
chr1,169949246,169949510,SRX5716469,SMARCA4,264
chr1,169949265,169949514,SRX5075176,SMARCA4,249
chr1,169949273,169949544,SRX5075170,SMARCA4,271
chr1,169959783,169959963,SRX5075170,SMARCA4,180
chr1,169999252,169999814,SRX5075176,SMARCA4,562
chr1,169999255,169999921,SRX5075169,SMARCA4,666
chr1,169999257,169999751,SRX5075170,SMARCA4,494
chr1,169999299,169999916,SRX5075175,SMARCA4,617
chr1,169999335,169999780,SRX5716469,SMARCA4,445
chr1,169999351,169999742,SRX5716467,SMARCA2,391
chr1,169999459,169999839,SRX5054309,FOSL2,380
chr1,169999504,169999846,SRX5054308,FOSL2,342
chr1,170010451,170010753,SRX16500060,CTCF,302
chr1,170010542,170010812,SRX16500059,CTCF,270
chr1,170010549,170010862,SRX16500061,CTCF,313
chr1,170010567,170010834,SRX16500062,CTCF,267
chr1,170032501,170032892,SRX5075175,SMARCA4,391
chr1,170032505,170032982,SRX5075170,SMARCA4,477
chr1,170032543,170032830,SRX5075169,SMARCA4,287
chr1,170032572,170032985,SRX5075176,SMARCA4,413
chr1,170032590,170032829,SRX5054309,FOSL2,239
chr1,170074257,170074684,SRX5075175,SMARCA4,427
chr1,170074338,170074957,SRX5075174,SMARCA4,619
chr1,170074387,170074915,SRX5075169,SMARCA4,528
chr1,170074408,170074987,SRX5075168,SMARCA4,579
chr1,170074418,170074993,SRX5075176,SMARCA4,575
chr1,170074454,170074966,SRX5075170,SMARCA4,512
chr1,170074505,170074901,SRX5716470,SMARCA4,396
chr1,170074537,170075031,SRX16500060,CTCF,494
chr1,170074541,170074870,SRX5716463,SMARCA4,329
chr1,170074543,170074930,SRX20140895,INTS13,387
chr1,170074613,170075107,SRX16500062,CTCF,494
chr1,170074648,170075098,SRX16500059,CTCF,450
chr1,170074662,170074930,SRX5716464,SMARCA4,268
chr1,170074698,170075086,SRX16500061,CTCF,388
chr1,170114966,170115214,SRX5075176,SMARCA4,248
chr1,170114973,170115212,SRX5075170,SMARCA4,239
chr1,170115004,170115189,SRX5075169,SMARCA4,185
chr1,170126674,170127070,SRX5075175,SMARCA4,396
chr1,170126684,170126982,SRX5075169,SMARCA4,298
chr1,170126712,170127000,SRX5054309,FOSL2,288
chr1,170126715,170126927,SRX5716469,SMARCA4,212
chr1,170145743,170146451,SRX5075174,SMARCA4,708
chr1,170145881,170146482,SRX5075168,SMARCA4,601
chr1,170146026,170146267,SRX20140867,INTS10,241
chr1,170146032,170146360,SRX20140879,CPSF3L,328
chr1,170146068,170146355,SRX5054309,FOSL2,287
chr1,170146176,170146409,SRX5054308,FOSL2,233
chr1,170146944,170147172,SRX5075174,SMARCA4,228
chr1,170147016,170147203,SRX5075168,SMARCA4,187
chr1,170162729,170163259,SRX5075169,SMARCA4,530
chr1,170162749,170163225,SRX5075176,SMARCA4,476
chr1,170162764,170163203,SRX5716470,SMARCA4,439
chr1,170162781,170163057,SRX5054308,FOSL2,276
chr1,170162812,170163227,SRX5075170,SMARCA4,415
chr1,170162836,170163198,SRX5075175,SMARCA4,362
chr1,170162841,170163052,SRX5716468,SMARCA2,211
chr1,170162882,170163164,SRX5054309,FOSL2,282
chr1,170162895,170163131,SRX5716469,SMARCA4,236
chr1,170162914,170163125,SRX5020214,SMARCA2,211
chr1,170162920,170163185,SRX5716467,SMARCA2,265
chr1,170162937,170163251,SRX5075174,SMARCA4,314
chr1,170162983,170163186,SRX5075168,SMARCA4,203
chr1,170168341,170168631,SRX5075169,SMARCA4,290
chr1,170168352,170168687,SRX5075176,SMARCA4,335
chr1,170168374,170168652,SRX5075175,SMARCA4,278
chr1,170168374,170168722,SRX5075170,SMARCA4,348
chr1,170196623,170196868,SRX5075176,SMARCA4,245
chr1,170196673,170196842,SRX5075170,SMARCA4,169
chr1,170203956,170204535,SRX5075176,SMARCA4,579
chr1,170204085,170204479,SRX5716470,SMARCA4,394
chr1,170204102,170204529,SRX5075175,SMARCA4,427
chr1,170204131,170204541,SRX5075170,SMARCA4,410
chr1,170204140,170204409,SRX5716469,SMARCA4,269
chr1,170204151,170204334,SRX5054309,FOSL2,183
chr1,170204205,170204521,SRX5075169,SMARCA4,316
chr1,170209177,170209472,SRX5075174,SMARCA4,295
chr1,170209280,170209499,SRX5075168,SMARCA4,219
chr1,170214104,170214374,SRX5020211,SMARCA2,270
chr1,170214110,170214398,SRX5716469,SMARCA4,288
chr1,170214115,170214399,SRX5054309,FOSL2,284
chr1,170214144,170214526,SRX5075170,SMARCA4,382
chr1,170214149,170214354,SRX5020214,SMARCA2,205
chr1,170214157,170214418,SRX5716470,SMARCA4,261
chr1,170214181,170214469,SRX5075176,SMARCA4,288
chr1,170214211,170214409,SRX5075175,SMARCA4,198
chr1,170215147,170215459,SRX5075170,SMARCA4,312
chr1,170215159,170215502,SRX5075169,SMARCA4,343
chr1,170215164,170215408,SRX5716470,SMARCA4,244
chr1,170215190,170215461,SRX5075176,SMARCA4,271
chr1,170215231,170215501,SRX5075175,SMARCA4,270
chr1,170225694,170226500,SRX5075176,SMARCA4,806
chr1,170225753,170226064,SRX5075169,SMARCA4,311
chr1,170225761,170226531,SRX5075170,SMARCA4,770
chr1,170225809,170226036,SRX5054309,FOSL2,227
chr1,170225809,170226522,SRX5716470,SMARCA4,713
chr1,170225851,170226435,SRX5716469,SMARCA4,584
chr1,170226193,170226408,SRX5716467,SMARCA2,215
chr1,170226263,170226443,SRX5075169,SMARCA4,180
chr1,170233897,170234150,SRX5054309,FOSL2,253
chr1,170248082,170248386,SRX5020211,SMARCA2,304
chr1,170248180,170248371,SRX5075169,SMARCA4,191
chr1,170261606,170262352,SRX5075176,SMARCA4,746
chr1,170261615,170262282,SRX5075170,SMARCA4,667
chr1,170261647,170262122,SRX5716468,SMARCA2,475
chr1,170261651,170262237,SRX5716467,SMARCA2,586
chr1,170261682,170262361,SRX5075169,SMARCA4,679
chr1,170261703,170261989,SRX5054308,FOSL2,286
chr1,170261713,170262228,SRX5075175,SMARCA4,515
chr1,170261747,170262135,SRX5716469,SMARCA4,388
chr1,170261751,170262380,SRX5716470,SMARCA4,629
chr1,170261759,170262035,SRX5020214,SMARCA2,276
chr1,170261782,170262025,SRX5075182,SMARCA2,243
chr1,170261794,170262083,SRX5020211,SMARCA2,289
chr1,170261934,170262181,SRX5054309,FOSL2,247
chr1,170273347,170273709,SRX5020211,SMARCA2,362
chr1,170273409,170274441,SRX5075170,SMARCA4,1032
chr1,170273424,170274489,SRX5075176,SMARCA4,1065
chr1,170273483,170273950,SRX5054308,FOSL2,467
chr1,170273604,170273841,SRX5054309,FOSL2,237
chr1,170273606,170274428,SRX5075169,SMARCA4,822
chr1,170273611,170273879,SRX5075175,SMARCA4,268
chr1,170273636,170274246,SRX5716467,SMARCA2,610
chr1,170273750,170274534,SRX5716470,SMARCA4,784
chr1,170273865,170274339,SRX5716468,SMARCA2,474
chr1,170285108,170285324,SRX5075176,SMARCA4,216
chr1,170290934,170291357,SRX5075170,SMARCA4,423
chr1,170290939,170291331,SRX5054309,FOSL2,392
chr1,170290983,170291372,SRX5075176,SMARCA4,389
chr1,170291017,170291283,SRX5054308,FOSL2,266
chr1,170291019,170291338,SRX5075175,SMARCA4,319
chr1,170291023,170291365,SRX5075169,SMARCA4,342
chr1,170291046,170291261,SRX5716467,SMARCA2,215
chr1,170291048,170291300,SRX5020211,SMARCA2,252
chr1,170291051,170291275,SRX5020214,SMARCA2,224
chr1,170309392,170310035,SRX5716470,SMARCA4,643
chr1,170309436,170310066,SRX5054309,FOSL2,630
chr1,170309447,170310065,SRX5075176,SMARCA4,618
chr1,170309473,170310071,SRX5075170,SMARCA4,598
chr1,170309479,170310041,SRX5716469,SMARCA4,562
chr1,170309488,170310045,SRX5075175,SMARCA4,557
chr1,170309489,170310064,SRX5075169,SMARCA4,575
chr1,170309567,170309794,SRX5716468,SMARCA2,227
chr1,170309570,170309970,SRX5020214,SMARCA2,400
chr1,170309608,170310050,SRX5054308,FOSL2,442
chr1,170309707,170309989,SRX5716467,SMARCA2,282
chr1,170309723,170310037,SRX5075174,SMARCA4,314
chr1,170309802,170310122,SRX5716460,Epitope tags,320
chr1,170309807,170310036,SRX5075168,SMARCA4,229
chr1,170311048,170311293,SRX5075169,SMARCA4,245
chr1,170311077,170311309,SRX5716467,SMARCA2,232
chr1,170311081,170311368,SRX5075176,SMARCA4,287
chr1,170311110,170311308,SRX5075181,SMARCA2,198
chr1,170321196,170321375,SRX5075170,SMARCA4,179
chr1,170346931,170347507,SRX5075170,SMARCA4,576
chr1,170346973,170347168,SRX5075176,SMARCA4,195
chr1,170347273,170347476,SRX5075176,SMARCA4,203
chr1,170395805,170396130,SRX5054308,FOSL2,325
chr1,170395821,170396061,SRX5054309,FOSL2,240
chr1,170398839,170399286,SRX5075174,SMARCA4,447
chr1,170398978,170399233,SRX5075168,SMARCA4,255
chr1,170402628,170402849,SRX5075170,SMARCA4,221
chr1,170402663,170402866,SRX5075176,SMARCA4,203
chr1,170410399,170410796,SRX5075175,SMARCA4,397
chr1,170410418,170410812,SRX5075169,SMARCA4,394
chr1,170410419,170411168,SRX5075176,SMARCA4,749
chr1,170410446,170411150,SRX5075170,SMARCA4,704
chr1,170410448,170410829,SRX5054309,FOSL2,381
chr1,170410474,170411032,SRX5054308,FOSL2,558
chr1,170410476,170410912,SRX5716470,SMARCA4,436
chr1,170410478,170410736,SRX5716467,SMARCA2,258
chr1,170410494,170410965,SRX5716469,SMARCA4,471
chr1,170410509,170410715,SRX5020214,SMARCA2,206
chr1,170410872,170411063,SRX5075169,SMARCA4,191
chr1,170415785,170416204,SRX5075176,SMARCA4,419
chr1,170415806,170416217,SRX5075170,SMARCA4,411
chr1,170445097,170445365,SRX5054309,FOSL2,268
chr1,170445145,170445378,SRX5075176,SMARCA4,233
chr1,170445193,170445380,SRX5075169,SMARCA4,187
chr1,170449886,170450191,SRX5075168,SMARCA4,305
chr1,170449907,170450256,SRX5075174,SMARCA4,349
chr1,170460447,170460677,SRX5075169,SMARCA4,230
chr1,170460463,170460696,SRX5716470,SMARCA4,233
chr1,170460483,170460790,SRX5075176,SMARCA4,307
chr1,170460519,170460717,SRX5075175,SMARCA4,198
chr1,170460551,170460879,SRX5075170,SMARCA4,328
chr1,170461397,170461609,SRX5716470,SMARCA4,212
chr1,170461446,170461721,SRX5075170,SMARCA4,275
chr1,170461496,170461789,SRX5054309,FOSL2,293
chr1,170471323,170471603,SRX5716470,SMARCA4,280
chr1,170471334,170471737,SRX5075169,SMARCA4,403
chr1,170471335,170471761,SRX5075175,SMARCA4,426
chr1,170471372,170471911,SRX5075170,SMARCA4,539
chr1,170471410,170471750,SRX5054309,FOSL2,340
chr1,170471412,170471912,SRX5075176,SMARCA4,500
chr1,170471415,170471849,SRX5054308,FOSL2,434
chr1,170471428,170471756,SRX5716467,SMARCA2,328
chr1,170471434,170471681,SRX5075181,SMARCA2,247
chr1,170471436,170471932,SRX5716469,SMARCA4,496
chr1,170471443,170471851,SRX5020211,SMARCA2,408
chr1,170494456,170494651,SRX5075174,SMARCA4,195
chr1,170494461,170494708,SRX5075170,SMARCA4,247
chr1,170494494,170494676,SRX5075176,SMARCA4,182
chr1,170520591,170520991,SRX5075176,SMARCA4,400
chr1,170520674,170520958,SRX5075170,SMARCA4,284
chr1,170520678,170520976,SRX5075169,SMARCA4,298
chr1,170520714,170520941,SRX5075175,SMARCA4,227
chr1,170531683,170532435,SRX20140895,INTS13,752
chr1,170531722,170532249,SRX5075169,SMARCA4,527
chr1,170531733,170532240,SRX5075170,SMARCA4,507
chr1,170531753,170532362,SRX20140897,INTS13,609
chr1,170531759,170532041,SRX5716470,SMARCA4,282
chr1,170531763,170532445,SRX20140869,INTS10,682
chr1,170531764,170532741,SRX5075174,SMARCA4,977
chr1,170531796,170532204,SRX20140879,CPSF3L,408
chr1,170531832,170532288,SRX5075176,SMARCA4,456
chr1,170531836,170532182,SRX20140881,CPSF3L,346
chr1,170531854,170532320,SRX20140868,INTS10,466
chr1,170531858,170532660,SRX5075168,SMARCA4,802
chr1,170531910,170532273,SRX20140867,INTS10,363
chr1,170532153,170532357,SRX5716463,SMARCA4,204
chr1,170532185,170532429,SRX5075175,SMARCA4,244
chr1,170532325,170532667,SRX5075170,SMARCA4,342
chr1,170532342,170532702,SRX5716470,SMARCA4,360
chr1,170532390,170532666,SRX5075176,SMARCA4,276
chr1,170532458,170532680,SRX5075169,SMARCA4,222
chr1,170538301,170538528,SRX5054308,FOSL2,227
chr1,170538334,170538578,SRX5075169,SMARCA4,244
chr1,170538353,170538569,SRX5075170,SMARCA4,216
chr1,170545422,170545759,SRX5716469,SMARCA4,337
chr1,170545458,170545779,SRX5075169,SMARCA4,321
chr1,170545478,170545770,SRX5054309,FOSL2,292
chr1,170545485,170545780,SRX5075175,SMARCA4,295
chr1,170545511,170545756,SRX5075176,SMARCA4,245
chr1,170545511,170545805,SRX5054308,FOSL2,294
chr1,170545520,170545763,SRX5716467,SMARCA2,243
chr1,170545525,170545698,SRX5075170,SMARCA4,173
chr1,170545553,170545816,SRX5716470,SMARCA4,263
chr1,170562789,170563464,SRX5075174,SMARCA4,675
chr1,170562794,170563391,SRX5075170,SMARCA4,597
chr1,170562846,170563412,SRX5075168,SMARCA4,566
chr1,170562892,170563414,SRX5075176,SMARCA4,522
chr1,170562916,170563354,SRX5075169,SMARCA4,438
chr1,170562947,170563351,SRX5716469,SMARCA4,404
chr1,170562963,170563330,SRX5716470,SMARCA4,367
chr1,170562964,170563361,SRX5075175,SMARCA4,397
chr1,170562972,170563366,SRX5054308,FOSL2,394
chr1,170562987,170563224,SRX5716468,SMARCA2,237
chr1,170562993,170563300,SRX5716463,SMARCA4,307
chr1,170562999,170563374,SRX5054309,FOSL2,375
chr1,170563020,170563265,SRX5020214,SMARCA2,245
chr1,170563032,170563337,SRX5716467,SMARCA2,305
chr1,170563043,170563318,SRX5054307,FOSL2,275
chr1,170563099,170563285,SRX5075182,SMARCA2,186
chr1,170565564,170565739,SRX5075176,SMARCA4,175
chr1,170565569,170565767,SRX5075169,SMARCA4,198
chr1,170565584,170565805,SRX5075170,SMARCA4,221
chr1,170578454,170578675,SRX5054309,FOSL2,221
chr1,170580994,170581168,SRX5075170,SMARCA4,174
chr1,170581094,170581274,SRX5075169,SMARCA4,180
chr1,170581098,170581340,SRX5075176,SMARCA4,242
chr1,170585939,170586871,SRX5075174,SMARCA4,932
chr1,170586093,170586818,SRX5075168,SMARCA4,725
chr1,170586254,170586792,SRX5075176,SMARCA4,538
chr1,170586270,170586757,SRX20140895,INTS13,487
chr1,170586277,170586796,SRX5075170,SMARCA4,519
chr1,170586512,170586760,SRX5716459,Epitope tags,248
chr1,170586961,170587365,SRX5075176,SMARCA4,404
chr1,170593313,170593493,SRX5075170,SMARCA4,180
chr1,170619272,170619483,SRX5716470,SMARCA4,211
chr1,170619292,170619664,SRX5075175,SMARCA4,372
chr1,170619295,170619790,SRX5075176,SMARCA4,495
chr1,170619297,170619686,SRX5075170,SMARCA4,389
chr1,170619305,170619555,SRX5716469,SMARCA4,250
chr1,170619382,170619635,SRX5054309,FOSL2,253
chr1,170619418,170619679,SRX5075169,SMARCA4,261
chr1,170619434,170619614,SRX5054308,FOSL2,180
chr1,170620145,170620480,SRX5075176,SMARCA4,335
chr1,170623205,170623442,SRX5054309,FOSL2,237
chr1,170634351,170634659,SRX5075169,SMARCA4,308
chr1,170634366,170634679,SRX5054309,FOSL2,313
chr1,170634368,170634655,SRX5054308,FOSL2,287
chr1,170634386,170634649,SRX5075170,SMARCA4,263
chr1,170634398,170634759,SRX5075175,SMARCA4,361
chr1,170634421,170634703,SRX5075176,SMARCA4,282
chr1,170662912,170663117,SRX5075170,SMARCA4,205
chr1,170671311,170671798,SRX16500059,CTCF,487
chr1,170671318,170671787,SRX16500061,CTCF,469
chr1,170671324,170671838,SRX16500060,CTCF,514
chr1,170671329,170671763,SRX16500062,CTCF,434
chr1,170671373,170671629,SRX4174629,CTCF,256
chr1,170671428,170671669,SRX5075168,SMARCA4,241
chr1,170671458,170671642,SRX5075170,SMARCA4,184
chr1,170680403,170680650,SRX5075169,SMARCA4,247
chr1,170680420,170680759,SRX5075175,SMARCA4,339
chr1,170680460,170680640,SRX5075170,SMARCA4,180
chr1,170680485,170680660,SRX5075176,SMARCA4,175
chr1,170686321,170686695,SRX5075174,SMARCA4,374
chr1,170686414,170686628,SRX5075168,SMARCA4,214
chr1,170687777,170687984,SRX5075176,SMARCA4,207
chr1,170689345,170689806,SRX16500060,CTCF,461
chr1,170689366,170689813,SRX16500062,CTCF,447
chr1,170689483,170689725,SRX16500061,CTCF,242
chr1,170689515,170689779,SRX16500059,CTCF,264
chr1,170692870,170693541,SRX5075176,SMARCA4,671
chr1,170692900,170693540,SRX5075170,SMARCA4,640
chr1,170692948,170693561,SRX5075169,SMARCA4,613
chr1,170693258,170693527,SRX5075175,SMARCA4,269
chr1,170698744,170699358,SRX5075176,SMARCA4,614
chr1,170698753,170699344,SRX5075170,SMARCA4,591
chr1,170698856,170699319,SRX5075175,SMARCA4,463
chr1,170698866,170699277,SRX5075169,SMARCA4,411
chr1,170698875,170699255,SRX5716469,SMARCA4,380
chr1,170698913,170699216,SRX5075168,SMARCA4,303
chr1,170698920,170699256,SRX5716470,SMARCA4,336
chr1,170698971,170699252,SRX5716468,SMARCA2,281
chr1,170698976,170699218,SRX5020211,SMARCA2,242
chr1,170698980,170699235,SRX5054308,FOSL2,255
chr1,170699001,170699208,SRX5075174,SMARCA4,207
chr1,170699020,170699209,SRX5054309,FOSL2,189
chr1,170699020,170699299,SRX5716467,SMARCA2,279
chr1,170700914,170701270,SRX5054309,FOSL2,356
chr1,170700924,170701153,SRX5075169,SMARCA4,229
chr1,170700932,170701295,SRX5054308,FOSL2,363
chr1,170707963,170708400,SRX5075170,SMARCA4,437
chr1,170708003,170708382,SRX5054309,FOSL2,379
chr1,170708009,170708542,SRX5075176,SMARCA4,533
chr1,170708016,170708358,SRX5075175,SMARCA4,342
chr1,170708039,170708338,SRX5054308,FOSL2,299
chr1,170708042,170708376,SRX5075169,SMARCA4,334
chr1,170708073,170708436,SRX5716469,SMARCA4,363
chr1,170708079,170708368,SRX5075168,SMARCA4,289
chr1,170708098,170708282,SRX5075174,SMARCA4,184
chr1,170717081,170717501,SRX5020211,SMARCA2,420
chr1,170717122,170717397,SRX5075181,SMARCA2,275
chr1,170717135,170717405,SRX5075169,SMARCA4,270
chr1,170717137,170717361,SRX5054308,FOSL2,224
chr1,170717202,170717408,SRX5075170,SMARCA4,206
chr1,170732334,170732514,SRX5075170,SMARCA4,180
chr1,170765687,170766116,SRX16500060,CTCF,429
chr1,170765687,170766132,SRX16500059,CTCF,445
chr1,170765721,170765933,SRX5716469,SMARCA4,212
chr1,170765740,170766083,SRX16500061,CTCF,343
chr1,170765752,170766061,SRX16500062,CTCF,309
chr1,170765754,170766037,SRX5075170,SMARCA4,283
chr1,170765758,170765957,SRX5075169,SMARCA4,199
chr1,170765778,170766006,SRX5075176,SMARCA4,228
chr1,170776911,170777220,SRX5075170,SMARCA4,309
chr1,170792008,170792211,SRX5075170,SMARCA4,203
chr1,170799479,170799702,SRX5075176,SMARCA4,223
chr1,170807526,170807780,SRX5075169,SMARCA4,254
chr1,170807565,170807775,SRX5054309,FOSL2,210
chr1,170823191,170823391,SRX5054308,FOSL2,200
chr1,170836124,170836508,SRX5054309,FOSL2,384
chr1,170836248,170836460,SRX5054308,FOSL2,212
chr1,170852049,170852315,SRX5075176,SMARCA4,266
chr1,170852102,170852302,SRX5020211,SMARCA2,200
chr1,170852124,170852466,SRX5054309,FOSL2,342
chr1,170852143,170852334,SRX5054308,FOSL2,191
chr1,170857998,170858360,SRX5075168,SMARCA4,362
chr1,170858008,170858263,SRX5075174,SMARCA4,255
chr1,170864134,170864629,SRX5075170,SMARCA4,495
chr1,170864213,170864618,SRX5075176,SMARCA4,405
chr1,170864292,170864529,SRX5716469,SMARCA4,237
chr1,170864301,170864574,SRX5075169,SMARCA4,273
chr1,170864307,170864512,SRX5054308,FOSL2,205
chr1,170864307,170864518,SRX5020211,SMARCA2,211
chr1,170864368,170864590,SRX5075175,SMARCA4,222
chr1,170864972,170865300,SRX5075174,SMARCA4,328
chr1,170874756,170874977,SRX5075174,SMARCA4,221
chr1,170881778,170882242,SRX5075170,SMARCA4,464
chr1,170881818,170882158,SRX5075175,SMARCA4,340
chr1,170881838,170882173,SRX5716469,SMARCA4,335
chr1,170881910,170882183,SRX5075169,SMARCA4,273
chr1,170881913,170882356,SRX16500059,CTCF,443
chr1,170881918,170882260,SRX16500060,CTCF,342
chr1,170881935,170882207,SRX5075176,SMARCA4,272
chr1,170881949,170882274,SRX16500061,CTCF,325
chr1,170881950,170882290,SRX16500062,CTCF,340
chr1,170893664,170893925,SRX5075176,SMARCA4,261
chr1,170893712,170893957,SRX5075170,SMARCA4,245
chr1,170895693,170896262,SRX5075175,SMARCA4,569
chr1,170895736,170896276,SRX5054309,FOSL2,540
chr1,170895852,170896079,SRX5075169,SMARCA4,227
chr1,170895903,170896283,SRX5054308,FOSL2,380
chr1,170910443,170910656,SRX5054309,FOSL2,213
chr1,170910462,170910695,SRX5075169,SMARCA4,233
chr1,170929316,170929622,SRX5054309,FOSL2,306
chr1,170929551,170930077,SRX5075169,SMARCA4,526
chr1,170929631,170930097,SRX5075176,SMARCA4,466
chr1,170929667,170930146,SRX16500060,CTCF,479
chr1,170929684,170930159,SRX16500059,CTCF,475
chr1,170929691,170930079,SRX5716470,SMARCA4,388
chr1,170929692,170930236,SRX16500061,CTCF,544
chr1,170929699,170930090,SRX5716469,SMARCA4,391
chr1,170929732,170930171,SRX5075170,SMARCA4,439
chr1,170929734,170930161,SRX16500062,CTCF,427
chr1,170929742,170930160,SRX4174629,CTCF,418
chr1,170929752,170930041,SRX5075175,SMARCA4,289
chr1,170929761,170930079,SRX5075168,SMARCA4,318
chr1,170929766,170930016,SRX5716463,SMARCA4,250
chr1,170929785,170930077,SRX5075174,SMARCA4,292
chr1,170929788,170929993,SRX5716464,SMARCA4,205
chr1,170958034,170958080,SRX1424891,POU3F2,46
chr1,170967017,170967457,SRX16500061,CTCF,440
chr1,170967021,170967491,SRX16500059,CTCF,470
chr1,170967033,170967482,SRX16500060,CTCF,449
chr1,170967053,170967496,SRX16500062,CTCF,443
chr1,170967131,170967362,SRX5075168,SMARCA4,231
chr1,170967138,170967320,SRX5075174,SMARCA4,182
chr1,170967163,170967440,SRX5075176,SMARCA4,277
chr1,170967171,170967387,SRX5075169,SMARCA4,216
chr1,170967180,170967392,SRX5075170,SMARCA4,212
chr1,171009650,171009894,SRX5054309,FOSL2,244
chr1,171037533,171037856,SRX5075176,SMARCA4,323
chr1,171037612,171037911,SRX5075170,SMARCA4,299
chr1,171037644,171037901,SRX5054309,FOSL2,257
chr1,171037654,171037891,SRX5075169,SMARCA4,237
chr1,171037655,171037866,SRX5716470,SMARCA4,211
chr1,171037692,171037889,SRX5075175,SMARCA4,197
chr1,171037694,171037906,SRX5716469,SMARCA4,212
chr1,171037699,171037929,SRX5054308,FOSL2,230
chr1,171038181,171038674,SRX5075170,SMARCA4,493
chr1,171038255,171038761,SRX5075176,SMARCA4,506
chr1,171038297,171038644,SRX5054309,FOSL2,347
chr1,171038316,171038563,SRX5075175,SMARCA4,247
chr1,171038318,171038627,SRX5075169,SMARCA4,309
chr1,171038401,171038606,SRX5054308,FOSL2,205
chr1,171081161,171081593,SRX16500060,CTCF,432
chr1,171081172,171081626,SRX16500061,CTCF,454
chr1,171081191,171081608,SRX16500059,CTCF,417
chr1,171081241,171081680,SRX16500062,CTCF,439
chr1,171081357,171081654,SRX5075176,SMARCA4,297
chr1,171081361,171081662,SRX5716470,SMARCA4,301
chr1,171110961,171111386,SRX5075169,SMARCA4,425
chr1,171110978,171111328,SRX5075170,SMARCA4,350
chr1,171110979,171111366,SRX5075176,SMARCA4,387
chr1,171110984,171111340,SRX5716467,SMARCA2,356
chr1,171111002,171111372,SRX5716470,SMARCA4,370
chr1,171111003,171111327,SRX5054309,FOSL2,324
chr1,171111018,171111344,SRX5075175,SMARCA4,326
chr1,171111031,171111359,SRX5054308,FOSL2,328
chr1,171111039,171111312,SRX5716468,SMARCA2,273
chr1,171111081,171111348,SRX5716469,SMARCA4,267
chr1,171111096,171111325,SRX5020211,SMARCA2,229
chr1,171127413,171127832,SRX5054308,FOSL2,419
chr1,171127444,171127862,SRX5054309,FOSL2,418
chr1,171127473,171127871,SRX5075176,SMARCA4,398
chr1,171127494,171127892,SRX5075169,SMARCA4,398
chr1,171127523,171127946,SRX5716469,SMARCA4,423
chr1,171127555,171127886,SRX5020211,SMARCA2,331
chr1,171127561,171127954,SRX5075175,SMARCA4,393
chr1,171127565,171127888,SRX5716470,SMARCA4,323
chr1,171127576,171127897,SRX5075170,SMARCA4,321
chr1,171127582,171127873,SRX5716468,SMARCA2,291
chr1,171127585,171127801,SRX5020214,SMARCA2,216
chr1,171127617,171127811,SRX5075181,SMARCA2,194
chr1,171127636,171127858,SRX5716467,SMARCA2,222
chr1,171141298,171141898,SRX5075175,SMARCA4,600
chr1,171141334,171142026,SRX5075176,SMARCA4,692
chr1,171141394,171142062,SRX5075170,SMARCA4,668
chr1,171141466,171142034,SRX5716470,SMARCA4,568
chr1,171141500,171142068,SRX5075169,SMARCA4,568
chr1,171141501,171141988,SRX5716469,SMARCA4,487
chr1,171141550,171141947,SRX5716467,SMARCA2,397
chr1,171141586,171141937,SRX5716468,SMARCA2,351
chr1,171141597,171141918,SRX5020211,SMARCA2,321
chr1,171141608,171141840,SRX5075181,SMARCA2,232
chr1,171141617,171141837,SRX5054308,FOSL2,220
chr1,171141620,171141832,SRX5054309,FOSL2,212
chr1,171142168,171142381,SRX5075170,SMARCA4,213
chr1,171180675,171181090,SRX5075176,SMARCA4,415
chr1,171180725,171181032,SRX5075170,SMARCA4,307
chr1,171180731,171180990,SRX5716469,SMARCA4,259
chr1,171180778,171180966,SRX5075169,SMARCA4,188
chr1,171180855,171181048,SRX5075175,SMARCA4,193
chr1,171188623,171189004,SRX16500062,CTCF,381
chr1,171188639,171188977,SRX16500060,CTCF,338
chr1,171188646,171189003,SRX16500061,CTCF,357
chr1,171188707,171188980,SRX5075174,SMARCA4,273
chr1,171188711,171188963,SRX16500059,CTCF,252
chr1,171188724,171188914,SRX5075168,SMARCA4,190
chr1,171210460,171210629,SRX5075170,SMARCA4,169
chr1,171210489,171210711,SRX5075174,SMARCA4,222
chr1,171210599,171210943,SRX5075168,SMARCA4,344
chr1,171220075,171220321,SRX5054309,FOSL2,246
chr1,171220094,171220331,SRX5716467,SMARCA2,237
chr1,171220137,171220382,SRX5075169,SMARCA4,245
chr1,171220149,171220414,SRX5075175,SMARCA4,265
chr1,171220511,171220897,SRX5075168,SMARCA4,386
chr1,171220600,171220922,SRX5075174,SMARCA4,322
chr1,171220625,171220985,SRX5075170,SMARCA4,360
chr1,171220627,171220986,SRX20140895,INTS13,359
chr1,171220638,171221011,SRX5075176,SMARCA4,373
chr1,171220728,171220949,SRX5716464,SMARCA4,221
chr1,171220729,171220995,SRX5716469,SMARCA4,266
chr1,171220748,171221011,SRX5716470,SMARCA4,263
chr1,171220757,171221138,SRX5075175,SMARCA4,381
chr1,171226645,171227204,SRX16500060,CTCF,559
chr1,171226688,171227175,SRX16500061,CTCF,487
chr1,171226699,171227236,SRX16500062,CTCF,537
chr1,171226725,171227225,SRX16500059,CTCF,500
chr1,171226761,171227022,SRX4174629,CTCF,261
chr1,171226766,171226997,SRX5075170,SMARCA4,231
chr1,171226775,171227025,SRX5075168,SMARCA4,250
chr1,171226795,171227083,SRX5075174,SMARCA4,288
chr1,171245431,171245882,SRX16500060,CTCF,451
chr1,171245438,171245922,SRX16500059,CTCF,484
chr1,171245496,171245856,SRX16500062,CTCF,360
chr1,171245522,171245795,SRX5075174,SMARCA4,273
chr1,171245522,171245910,SRX16500061,CTCF,388
chr1,171245556,171245756,SRX5075170,SMARCA4,200
chr1,171245562,171245845,SRX5075168,SMARCA4,283
chr1,171245583,171245766,SRX5075176,SMARCA4,183
chr1,171245588,171245799,SRX5716470,SMARCA4,211
chr1,171251400,171251985,SRX5075176,SMARCA4,585
chr1,171251405,171252009,SRX5075170,SMARCA4,604
chr1,171251512,171251920,SRX5716470,SMARCA4,408
chr1,171251588,171252128,SRX16500059,CTCF,540
chr1,171251596,171252014,SRX5075174,SMARCA4,418
chr1,171251626,171251982,SRX5075169,SMARCA4,356
chr1,171251631,171252142,SRX16500060,CTCF,511
chr1,171251634,171252123,SRX16500061,CTCF,489
chr1,171251725,171251937,SRX4174629,CTCF,212
chr1,171251727,171252111,SRX16500062,CTCF,384
chr1,171251761,171252019,SRX5075168,SMARCA4,258
chr1,171254950,171255243,SRX5054309,FOSL2,293
chr1,171259104,171259273,SRX5075170,SMARCA4,169
chr1,171263956,171264254,SRX5075176,SMARCA4,298
chr1,171263975,171264261,SRX5075170,SMARCA4,286
chr1,171267315,171267747,SRX5075170,SMARCA4,432
chr1,171267395,171267776,SRX5075176,SMARCA4,381
chr1,171267461,171267707,SRX5075175,SMARCA4,246
chr1,171267468,171267690,SRX5054308,FOSL2,222
chr1,171267471,171267718,SRX5716469,SMARCA4,247
chr1,171267476,171267744,SRX5075169,SMARCA4,268
chr1,171267505,171267752,SRX5054309,FOSL2,247
chr1,171286346,171286640,SRX5054308,FOSL2,294
chr1,171286381,171286689,SRX5054309,FOSL2,308
chr1,171292795,171293055,SRX5075176,SMARCA4,260
chr1,171292899,171293114,SRX5075170,SMARCA4,215
chr1,171295498,171295712,SRX5075170,SMARCA4,214
chr1,171313621,171314206,SRX16500060,CTCF,585
chr1,171313632,171314246,SRX16500059,CTCF,614
chr1,171313647,171314314,SRX5075170,SMARCA4,667
chr1,171313664,171314189,SRX4174629,CTCF,525
chr1,171313670,171314327,SRX5075176,SMARCA4,657
chr1,171313692,171314269,SRX5075174,SMARCA4,577
chr1,171313747,171314305,SRX5075169,SMARCA4,558
chr1,171313755,171314198,SRX16500061,CTCF,443
chr1,171313757,171313957,SRX5075181,SMARCA2,200
chr1,171313759,171314287,SRX5716470,SMARCA4,528
chr1,171313760,171314207,SRX16500062,CTCF,447
chr1,171313769,171314067,SRX5020214,SMARCA2,298
chr1,171313769,171314279,SRX5716469,SMARCA4,510
chr1,171313782,171314286,SRX5716464,SMARCA4,504
chr1,171313787,171314187,SRX5716463,SMARCA4,400
chr1,171313796,171314262,SRX5075168,SMARCA4,466
chr1,171313816,171314075,SRX5716467,SMARCA2,259
chr1,171313822,171314290,SRX5075175,SMARCA4,468
chr1,171313825,171314196,SRX5054308,FOSL2,371
chr1,171313829,171314225,SRX5054309,FOSL2,396
chr1,171345564,171345777,SRX5075176,SMARCA4,213
chr1,171405170,171405419,SRX16500060,CTCF,249
chr1,171433471,171433747,SRX5075176,SMARCA4,276
chr1,171433475,171433760,SRX5054308,FOSL2,285
chr1,171433479,171433753,SRX5054309,FOSL2,274
chr1,171433496,171433830,SRX5075175,SMARCA4,334
chr1,171433508,171433790,SRX5075170,SMARCA4,282
chr1,171433523,171433769,SRX5075169,SMARCA4,246
chr1,171434813,171435206,SRX5075170,SMARCA4,393
chr1,171434816,171435161,SRX5075176,SMARCA4,345
chr1,171434818,171435109,SRX5075175,SMARCA4,291
chr1,171434824,171435144,SRX5054309,FOSL2,320
chr1,171434853,171435185,SRX5075169,SMARCA4,332
chr1,171434872,171435169,SRX5054308,FOSL2,297
chr1,171438475,171438852,SRX5075176,SMARCA4,377
chr1,171438483,171438901,SRX5075170,SMARCA4,418
chr1,171438499,171438766,SRX5716469,SMARCA4,267
chr1,171438500,171438898,SRX5054308,FOSL2,398
chr1,171438501,171438783,SRX5716470,SMARCA4,282
chr1,171438511,171438898,SRX5054309,FOSL2,387
chr1,171438513,171438849,SRX5075169,SMARCA4,336
chr1,171438515,171438879,SRX5075175,SMARCA4,364
chr1,171438518,171438838,SRX5716467,SMARCA2,320
chr1,171438584,171438829,SRX5020211,SMARCA2,245
chr1,171441338,171441549,SRX5054308,FOSL2,211
chr1,171441364,171441593,SRX5075176,SMARCA4,229
chr1,171482512,171482781,SRX5716464,SMARCA4,269
chr1,171482526,171482815,SRX5716463,SMARCA4,289
chr1,171484966,171485388,SRX5075169,SMARCA4,422
chr1,171485068,171485626,SRX16500059,CTCF,558
chr1,171485107,171485361,SRX5075175,SMARCA4,254
chr1,171485113,171485325,SRX5716469,SMARCA4,212
chr1,171485121,171485607,SRX16500060,CTCF,486
chr1,171485135,171485609,SRX16500061,CTCF,474
chr1,171485136,171485575,SRX16500062,CTCF,439
chr1,171485148,171485621,SRX5075170,SMARCA4,473
chr1,171485161,171485645,SRX5075174,SMARCA4,484
chr1,171485164,171485695,SRX5716470,SMARCA4,531
chr1,171485178,171485540,SRX4174629,CTCF,362
chr1,171485188,171485533,SRX5716464,SMARCA4,345
chr1,171485197,171485869,SRX20140895,INTS13,672
chr1,171485198,171485575,SRX5075168,SMARCA4,377
chr1,171485208,171485589,SRX5075176,SMARCA4,381
chr1,171485258,171485782,SRX20140897,INTS13,524
chr1,171485313,171485551,SRX5716463,SMARCA4,238
chr1,171485576,171485836,SRX5716469,SMARCA4,260
chr1,171485609,171485973,SRX20140869,INTS10,364
chr1,171563713,171563959,SRX5054308,FOSL2,246
chr1,171563757,171563948,SRX5075169,SMARCA4,191
chr1,171569309,171569577,SRX5054308,FOSL2,268
chr1,171569317,171569574,SRX5054309,FOSL2,257
chr1,171569333,171569579,SRX5075175,SMARCA4,246
chr1,171569343,171569634,SRX5075176,SMARCA4,291
chr1,171569347,171569619,SRX5075170,SMARCA4,272
chr1,171569364,171569626,SRX5075169,SMARCA4,262
chr1,171590018,171590223,SRX5054309,FOSL2,205
chr1,171590024,171590234,SRX5054308,FOSL2,210
chr1,171644741,171645401,SRX16500059,CTCF,660
chr1,171644827,171645347,SRX16500060,CTCF,520
chr1,171644854,171645373,SRX16500061,CTCF,519
chr1,171644882,171645301,SRX16500062,CTCF,419
chr1,171644883,171645267,SRX5075168,SMARCA4,384
chr1,171644909,171645258,SRX4174629,CTCF,349
chr1,171644929,171645264,SRX5075174,SMARCA4,335
chr1,171644963,171645249,SRX5075176,SMARCA4,286
chr1,171644968,171645316,SRX5716463,SMARCA4,348
chr1,171644976,171645188,SRX5075170,SMARCA4,212
chr1,171644990,171645295,SRX5716464,SMARCA4,305
chr1,171645001,171645304,SRX5716470,SMARCA4,303
chr1,171645017,171645207,SRX5075169,SMARCA4,190
chr1,171655292,171655492,SRX5075170,SMARCA4,200
chr1,171655498,171655819,SRX16500061,CTCF,321
chr1,171655519,171655903,SRX16500059,CTCF,384
chr1,171655541,171655868,SRX16500060,CTCF,327
chr1,171655548,171655829,SRX16500062,CTCF,281
chr1,171715839,171716228,SRX16500060,CTCF,389
chr1,171715878,171716227,SRX16500062,CTCF,349
chr1,171715914,171716205,SRX16500061,CTCF,291
chr1,171715928,171716280,SRX16500059,CTCF,352
chr1,171715952,171716199,SRX5075176,SMARCA4,247
chr1,171715988,171716212,SRX5075170,SMARCA4,224
chr1,171730165,171730396,SRX5075170,SMARCA4,231
chr1,171739664,171739925,SRX5054308,FOSL2,261
chr1,171739705,171739920,SRX5054309,FOSL2,215
chr1,171739712,171739958,SRX5075176,SMARCA4,246
chr1,171739742,171739911,SRX5075170,SMARCA4,169
chr1,171741723,171742556,SRX20140895,INTS13,833
chr1,171741758,171742456,SRX20140881,CPSF3L,698
chr1,171741825,171742283,SRX5075174,SMARCA4,458
chr1,171741899,171742238,SRX5075170,SMARCA4,339
chr1,171741907,171742362,SRX5075168,SMARCA4,455
chr1,171741939,171742145,SRX5075176,SMARCA4,206
chr1,171741946,171742172,SRX5075175,SMARCA4,226
chr1,171741966,171742183,SRX5075169,SMARCA4,217
chr1,171741977,171742420,SRX20140867,INTS10,443
chr1,171742129,171742350,SRX5716470,SMARCA4,221
chr1,171780934,171781479,SRX20140869,INTS10,545
chr1,171780959,171781446,SRX20140879,CPSF3L,487
chr1,171780963,171781604,SRX20140868,INTS10,641
chr1,171780984,171781261,SRX5716469,SMARCA4,277
chr1,171781011,171781463,SRX20140881,CPSF3L,452
chr1,171781027,171781329,SRX20140894,INTS13,302
chr1,171781030,171781811,SRX5075176,SMARCA4,781
chr1,171781032,171781806,SRX20140895,INTS13,774
chr1,171781041,171781566,SRX5075170,SMARCA4,525
chr1,171781044,171781608,SRX5075169,SMARCA4,564
chr1,171781067,171781482,SRX20140867,INTS10,415
chr1,171781074,171781520,SRX20140897,INTS13,446
chr1,171781092,171781871,SRX5075174,SMARCA4,779
chr1,171781104,171781720,SRX5075168,SMARCA4,616
chr1,171781162,171781437,SRX5075175,SMARCA4,275
chr1,171781177,171781527,SRX20140896,INTS13,350
chr1,171781193,171781448,SRX5054309,FOSL2,255
chr1,171781196,171781500,SRX5716464,SMARCA4,304
chr1,171781204,171781597,SRX5054308,FOSL2,393
chr1,171781323,171781631,SRX5716451,SOX2,308
chr1,171781333,171781698,SRX5054307,FOSL2,365
chr1,171781346,171781710,SRX5716463,SMARCA4,364
chr1,171781626,171781826,SRX5075170,SMARCA4,200
chr1,171794087,171794356,SRX5075169,SMARCA4,269
chr1,171794167,171794363,SRX5075176,SMARCA4,196
chr1,171794190,171794391,SRX5075175,SMARCA4,201
chr1,171801300,171801864,SRX16500062,CTCF,564
chr1,171801325,171801808,SRX16500060,CTCF,483
chr1,171801360,171801850,SRX16500061,CTCF,490
chr1,171801366,171801904,SRX16500059,CTCF,538
chr1,171801469,171801776,SRX4174629,CTCF,307
chr1,171801503,171801714,SRX5075174,SMARCA4,211
chr1,171801511,171801736,SRX5075168,SMARCA4,225
chr1,171801516,171801776,SRX5075176,SMARCA4,260
chr1,171801516,171801790,SRX5075170,SMARCA4,274
chr1,171817556,171818051,SRX5075168,SMARCA4,495
chr1,171817597,171818083,SRX5075174,SMARCA4,486
chr1,171817678,171818021,SRX5075170,SMARCA4,343
chr1,171817700,171817937,SRX5075169,SMARCA4,237
chr1,171817720,171817995,SRX5075176,SMARCA4,275
chr1,171817723,171818019,SRX5054307,FOSL2,296
chr1,171817731,171817986,SRX5054309,FOSL2,255
chr1,171817814,171818037,SRX5075175,SMARCA4,223
chr1,171841105,171841780,SRX20140895,INTS13,675
chr1,171841143,171841609,SRX5075175,SMARCA4,466
chr1,171841164,171841715,SRX5075174,SMARCA4,551
chr1,171841168,171841753,SRX5075176,SMARCA4,585
chr1,171841178,171841783,SRX5075168,SMARCA4,605
chr1,171841196,171841762,SRX5075169,SMARCA4,566
chr1,171841197,171841606,SRX5716464,SMARCA4,409
chr1,171841198,171841594,SRX5075170,SMARCA4,396
chr1,171841253,171841787,SRX5716470,SMARCA4,534
chr1,171841260,171841705,SRX5716463,SMARCA4,445
chr1,171841282,171841692,SRX20140867,INTS10,410
chr1,171869186,171869527,SRX5075176,SMARCA4,341
chr1,171869224,171869568,SRX5075170,SMARCA4,344
chr1,171877716,171878132,SRX5075168,SMARCA4,416
chr1,171877731,171878098,SRX5075174,SMARCA4,367
chr1,171898849,171899413,SRX20140895,INTS13,564
chr1,171898879,171899350,SRX5075174,SMARCA4,471
chr1,171898879,171899422,SRX5075168,SMARCA4,543
chr1,171898897,171899253,SRX5716451,SOX2,356
chr1,171898927,171899371,SRX20140868,INTS10,444
chr1,171898931,171899336,SRX5716463,SMARCA4,405
chr1,171898956,171899244,SRX5716464,SMARCA4,288
chr1,171909701,171910112,SRX5075174,SMARCA4,411
chr1,171909721,171910036,SRX5075168,SMARCA4,315
chr1,171909721,171910075,SRX5716463,SMARCA4,354
chr1,171916522,171916791,SRX5075168,SMARCA4,269
chr1,171929158,171929393,SRX16500059,CTCF,235
chr1,171929243,171929471,SRX16500060,CTCF,228
chr1,171936804,171937075,SRX5075174,SMARCA4,271
chr1,171981338,171981621,SRX5075176,SMARCA4,283
chr1,171981376,171981585,SRX5075170,SMARCA4,209
chr1,171984792,171985307,SRX16500059,CTCF,515
chr1,171984812,171985248,SRX16500061,CTCF,436
chr1,171984813,171985325,SRX16500060,CTCF,512
chr1,171984853,171985340,SRX16500062,CTCF,487
chr1,171984921,171985191,SRX5075168,SMARCA4,270
chr1,171984923,171985140,SRX4174629,CTCF,217
chr1,171984944,171985157,SRX5075174,SMARCA4,213
chr1,171984993,171985197,SRX5716463,SMARCA4,204
chr1,171990349,171990722,SRX5716463,SMARCA4,373
chr1,171990378,171990783,SRX5075174,SMARCA4,405
chr1,171990436,171990716,SRX5716464,SMARCA4,280
chr1,171990453,171990765,SRX5075168,SMARCA4,312
chr1,172002692,172003105,SRX16500062,CTCF,413
chr1,172002703,172003184,SRX16500059,CTCF,481
chr1,172002707,172003154,SRX16500060,CTCF,447
chr1,172002725,172003140,SRX16500061,CTCF,415
chr1,172002811,172003033,SRX5075170,SMARCA4,222
chr1,172002816,172003072,SRX5075176,SMARCA4,256
chr1,172002836,172003063,SRX5075174,SMARCA4,227
chr1,172002855,172003051,SRX5075168,SMARCA4,196
chr1,172004279,172004487,SRX5075175,SMARCA4,208
chr1,172040479,172040834,SRX5075169,SMARCA4,355
chr1,172040494,172040773,SRX5054309,FOSL2,279
chr1,172040510,172040754,SRX5075170,SMARCA4,244
chr1,172040510,172040852,SRX5075175,SMARCA4,342
chr1,172040524,172040781,SRX5716469,SMARCA4,257
chr1,172040542,172040849,SRX5075176,SMARCA4,307
chr1,172041673,172041920,SRX16500059,CTCF,247
chr1,172041703,172042015,SRX16500060,CTCF,312
chr1,172041715,172042056,SRX16500061,CTCF,341
chr1,172041771,172041987,SRX16500062,CTCF,216
chr1,172041845,172042022,SRX5075170,SMARCA4,177
chr1,172054236,172054428,SRX5075176,SMARCA4,192
chr1,172090180,172090565,SRX16500059,CTCF,385
chr1,172090230,172090628,SRX16500061,CTCF,398
chr1,172090236,172090546,SRX4174629,CTCF,310
chr1,172090251,172090526,SRX16500062,CTCF,275
chr1,172090266,172090546,SRX16500060,CTCF,280
chr1,172099850,172100060,SRX5075174,SMARCA4,210
chr1,172108523,172108832,SRX5075170,SMARCA4,309
chr1,172108543,172108867,SRX5075176,SMARCA4,324
chr1,172108619,172108902,SRX5075169,SMARCA4,283
chr1,172109365,172109820,SRX5075170,SMARCA4,455
chr1,172109371,172109801,SRX5075176,SMARCA4,430
chr1,172109422,172109755,SRX5075169,SMARCA4,333
chr1,172109434,172109786,SRX5020211,SMARCA2,352
chr1,172109454,172109861,SRX5075175,SMARCA4,407
chr1,172109471,172109753,SRX5716469,SMARCA4,282
chr1,172109477,172109765,SRX5716470,SMARCA4,288
chr1,172109480,172109726,SRX5054308,FOSL2,246
chr1,172109504,172109710,SRX5054309,FOSL2,206
chr1,172135045,172135438,SRX16500059,CTCF,393
chr1,172135098,172135392,SRX16500062,CTCF,294
chr1,172135141,172135451,SRX16500060,CTCF,310
chr1,172136018,172136205,SRX5075175,SMARCA4,187
chr1,172144713,172145055,SRX5054309,FOSL2,342
chr1,172144720,172145128,SRX5075170,SMARCA4,408
chr1,172144725,172145061,SRX5054308,FOSL2,336
chr1,172144730,172145127,SRX5075176,SMARCA4,397
chr1,172144768,172145009,SRX5716467,SMARCA2,241
chr1,172144802,172145004,SRX5020211,SMARCA2,202
chr1,172144802,172145220,SRX5075169,SMARCA4,418
chr1,172144820,172145112,SRX5075175,SMARCA4,292
chr1,172144827,172145119,SRX5716470,SMARCA4,292
chr1,172145341,172145709,SRX5716470,SMARCA4,368
chr1,172145373,172145694,SRX5075170,SMARCA4,321
chr1,172145399,172145619,SRX5075175,SMARCA4,220
chr1,172145400,172145706,SRX5075176,SMARCA4,306
chr1,172145425,172145637,SRX5716469,SMARCA4,212
chr1,172145443,172145702,SRX5054309,FOSL2,259
chr1,172154459,172154919,SRX5716469,SMARCA4,460
chr1,172154483,172154905,SRX5075170,SMARCA4,422
chr1,172154528,172154880,SRX5054309,FOSL2,352
chr1,172154529,172154885,SRX5075175,SMARCA4,356
chr1,172154565,172154946,SRX5075176,SMARCA4,381
chr1,172154568,172154882,SRX5716470,SMARCA4,314
chr1,172154581,172154894,SRX5054308,FOSL2,313
chr1,172154601,172154978,SRX5075169,SMARCA4,377
chr1,172162169,172162461,SRX5716469,SMARCA4,292
chr1,172162284,172162573,SRX5075170,SMARCA4,289
chr1,172162305,172162542,SRX5075176,SMARCA4,237
chr1,172162315,172162530,SRX5716467,SMARCA2,215
chr1,172168163,172168868,SRX5075176,SMARCA4,705
chr1,172168247,172168702,SRX5020211,SMARCA2,455
chr1,172168259,172168817,SRX5075170,SMARCA4,558
chr1,172168300,172168703,SRX5075169,SMARCA4,403
chr1,172168319,172168743,SRX5716467,SMARCA2,424
chr1,172168329,172168706,SRX5054308,FOSL2,377
chr1,172168350,172168659,SRX5716468,SMARCA2,309
chr1,172168371,172168728,SRX5716469,SMARCA4,357
chr1,172168374,172168658,SRX5075181,SMARCA2,284
chr1,172168379,172168784,SRX5075175,SMARCA4,405
chr1,172168386,172168744,SRX5716470,SMARCA4,358
chr1,172168403,172168667,SRX5020214,SMARCA2,264
chr1,172168424,172168688,SRX5054309,FOSL2,264
chr1,172168438,172168618,SRX5075182,SMARCA2,180
chr1,172181462,172181896,SRX5075170,SMARCA4,434
chr1,172181486,172181868,SRX5716470,SMARCA4,382
chr1,172181533,172181954,SRX5075169,SMARCA4,421
chr1,172181540,172181791,SRX5716469,SMARCA4,251
chr1,172181544,172181897,SRX5075176,SMARCA4,353
chr1,172181551,172181890,SRX5075175,SMARCA4,339
chr1,172181623,172181981,SRX5054309,FOSL2,358
chr1,172181779,172181959,SRX5054308,FOSL2,180
chr1,172185284,172185698,SRX5075170,SMARCA4,414
chr1,172185348,172185603,SRX5075169,SMARCA4,255
chr1,172185378,172185666,SRX5716467,SMARCA2,288
chr1,172185399,172185692,SRX5075176,SMARCA4,293
chr1,172185423,172185623,SRX5020211,SMARCA2,200
chr1,172185424,172185670,SRX5716470,SMARCA4,246
chr1,172185443,172185635,SRX5075175,SMARCA4,192
chr1,172185471,172185709,SRX5716468,SMARCA2,238
chr1,172224432,172224763,SRX5075176,SMARCA4,331
chr1,172239795,172240204,SRX5075176,SMARCA4,409
chr1,172239813,172240298,SRX5075170,SMARCA4,485
chr1,172239856,172240067,SRX5716470,SMARCA4,211
chr1,172252307,172252611,SRX5075169,SMARCA4,304
chr1,172252359,172252624,SRX5075176,SMARCA4,265
chr1,172252362,172252612,SRX5075175,SMARCA4,250
chr1,172252363,172252635,SRX5075170,SMARCA4,272
chr1,172252383,172252654,SRX5054309,FOSL2,271
chr1,172252396,172252611,SRX5054308,FOSL2,215
chr1,172254887,172255305,SRX5716469,SMARCA4,418
chr1,172254889,172255295,SRX5054309,FOSL2,406
chr1,172254890,172255280,SRX5054308,FOSL2,390
chr1,172254906,172255221,SRX5020211,SMARCA2,315
chr1,172254918,172255251,SRX5075169,SMARCA4,333
chr1,172254927,172255315,SRX5075176,SMARCA4,388
chr1,172254939,172255229,SRX5075175,SMARCA4,290
chr1,172254942,172255242,SRX5716470,SMARCA4,300
chr1,172254948,172255263,SRX5075170,SMARCA4,315
chr1,172254968,172255197,SRX5020214,SMARCA2,229
chr1,172255008,172255206,SRX5075182,SMARCA2,198
chr1,172255015,172255206,SRX5075174,SMARCA4,191
chr1,172270595,172270770,SRX5075176,SMARCA4,175
chr1,172270613,172270830,SRX5075169,SMARCA4,217
chr1,172278332,172278841,SRX5075175,SMARCA4,509
chr1,172278382,172278822,SRX5075169,SMARCA4,440
chr1,172278446,172278947,SRX5075176,SMARCA4,501
chr1,172278449,172278763,SRX5716469,SMARCA4,314
chr1,172278451,172278720,SRX5716470,SMARCA4,269
chr1,172278455,172278687,SRX5054308,FOSL2,232
chr1,172278469,172279033,SRX5075170,SMARCA4,564
chr1,172278484,172278793,SRX5716467,SMARCA2,309
chr1,172278509,172278780,SRX5075168,SMARCA4,271
chr1,172278514,172278871,SRX5075174,SMARCA4,357
chr1,172278530,172278785,SRX5054309,FOSL2,255
chr1,172286626,172287084,SRX5075170,SMARCA4,458
chr1,172286675,172287106,SRX5075176,SMARCA4,431
chr1,172286683,172287106,SRX5075169,SMARCA4,423
chr1,172286765,172287172,SRX5075175,SMARCA4,407
chr1,172286771,172287169,SRX5716469,SMARCA4,398
chr1,172286796,172287065,SRX5716470,SMARCA4,269
chr1,172286821,172287049,SRX5054308,FOSL2,228
chr1,172286828,172287241,SRX5716460,Epitope tags,413
chr1,172287225,172287620,SRX5075176,SMARCA4,395
chr1,172287243,172287587,SRX5075169,SMARCA4,344
chr1,172287310,172287521,SRX5716470,SMARCA4,211
chr1,172287333,172287575,SRX5075175,SMARCA4,242
chr1,172287348,172287594,SRX5075170,SMARCA4,246
chr1,172287367,172287550,SRX5054309,FOSL2,183
chr1,172293665,172293867,SRX5054308,FOSL2,202
chr1,172293714,172293937,SRX5075169,SMARCA4,223
chr1,172293747,172293941,SRX5075181,SMARCA2,194
chr1,172308615,172308872,SRX5075176,SMARCA4,257
chr1,172308654,172308841,SRX5075175,SMARCA4,187
chr1,172308657,172308860,SRX5075170,SMARCA4,203
chr1,172308698,172308882,SRX5075169,SMARCA4,184
chr1,172320942,172321148,SRX5054309,FOSL2,206
chr1,172322154,172323035,SRX5075170,SMARCA4,881
chr1,172322193,172323008,SRX5075169,SMARCA4,815
chr1,172322225,172323063,SRX5075176,SMARCA4,838
chr1,172322248,172322624,SRX5054308,FOSL2,376
chr1,172322251,172322644,SRX5054309,FOSL2,393
chr1,172322262,172322652,SRX5716470,SMARCA4,390
chr1,172322277,172322485,SRX5020211,SMARCA2,208
chr1,172322278,172322996,SRX5075175,SMARCA4,718
chr1,172322281,172322558,SRX5716467,SMARCA2,277
chr1,172322294,172322937,SRX5716468,SMARCA2,643
chr1,172322302,172322541,SRX5716469,SMARCA4,239
chr1,172322615,172322971,SRX5716469,SMARCA4,356
chr1,172322705,172323045,SRX5716470,SMARCA4,340
chr1,172325513,172325901,SRX5075170,SMARCA4,388
chr1,172325528,172325908,SRX5075176,SMARCA4,380
chr1,172325543,172325839,SRX5716467,SMARCA2,296
chr1,172325551,172325801,SRX5716469,SMARCA4,250
chr1,172325585,172325819,SRX5716470,SMARCA4,234
chr1,172325587,172325858,SRX5075169,SMARCA4,271
chr1,172325593,172325812,SRX5075175,SMARCA4,219
chr1,172325617,172325853,SRX5075174,SMARCA4,236
chr1,172325625,172325902,SRX5054308,FOSL2,277
chr1,172343348,172343696,SRX5716469,SMARCA4,348
chr1,172343349,172344265,SRX5075170,SMARCA4,916
chr1,172343357,172344211,SRX5075176,SMARCA4,854
chr1,172343428,172344184,SRX5075175,SMARCA4,756
chr1,172343445,172344140,SRX5054309,FOSL2,695
chr1,172343467,172344224,SRX5075169,SMARCA4,757
chr1,172343482,172344138,SRX5054308,FOSL2,656
chr1,172343502,172343707,SRX5020214,SMARCA2,205
chr1,172343584,172344115,SRX5716470,SMARCA4,531
chr1,172343771,172344171,SRX5020211,SMARCA2,400
chr1,172343792,172344080,SRX5075182,SMARCA2,288
chr1,172343805,172344279,SRX5716467,SMARCA2,474
chr1,172343814,172344086,SRX5054307,FOSL2,272
chr1,172343827,172344108,SRX5075174,SMARCA4,281
chr1,172343906,172344172,SRX5716469,SMARCA4,266
chr1,172351395,172352245,SRX5075176,SMARCA4,850
chr1,172351424,172351603,SRX5075168,SMARCA4,179
chr1,172351425,172352271,SRX5075170,SMARCA4,846
chr1,172351453,172352213,SRX5716470,SMARCA4,760
chr1,172351482,172351674,SRX5075169,SMARCA4,192
chr1,172351726,172352233,SRX5075175,SMARCA4,507
chr1,172351735,172352248,SRX5075169,SMARCA4,513
chr1,172351746,172352201,SRX5716469,SMARCA4,455
chr1,172351766,172352184,SRX5716468,SMARCA2,418
chr1,172351778,172352185,SRX5716467,SMARCA2,407
chr1,172351853,172352232,SRX5054309,FOSL2,379
chr1,172351909,172352176,SRX5054308,FOSL2,267
chr1,172351951,172352163,SRX5020211,SMARCA2,212
chr1,172357908,172358323,SRX5075170,SMARCA4,415
chr1,172357938,172358172,SRX5075169,SMARCA4,234
chr1,172357949,172358207,SRX5075176,SMARCA4,258
chr1,172358036,172358270,SRX5716468,SMARCA2,234
chr1,172358041,172358258,SRX5716467,SMARCA2,217
chr1,172358402,172359387,SRX5075169,SMARCA4,985
chr1,172358455,172358827,SRX5716469,SMARCA4,372
chr1,172358530,172358891,SRX5075170,SMARCA4,361
chr1,172358610,172359080,SRX5075175,SMARCA4,470
chr1,172358677,172359052,SRX5054308,FOSL2,375
chr1,172358789,172359369,SRX5075176,SMARCA4,580
chr1,172358793,172359092,SRX5054309,FOSL2,299
chr1,172358926,172359166,SRX5716469,SMARCA4,240
chr1,172359008,172359268,SRX5716470,SMARCA4,260
chr1,172359015,172359373,SRX5075170,SMARCA4,358
chr1,172359610,172359865,SRX5020211,SMARCA2,255
chr1,172359621,172359842,SRX5716470,SMARCA4,221
chr1,172359651,172359881,SRX5716469,SMARCA4,230
chr1,172359653,172359969,SRX5075176,SMARCA4,316
chr1,172359655,172359889,SRX5075181,SMARCA2,234
chr1,172359686,172359932,SRX5075169,SMARCA4,246
chr1,172359733,172359974,SRX5075175,SMARCA4,241
chr1,172360507,172360776,SRX5716463,SMARCA4,269
chr1,172360513,172360809,SRX5075174,SMARCA4,296
chr1,172373963,172374166,SRX5054309,FOSL2,203
chr1,172378100,172378382,SRX5075176,SMARCA4,282
chr1,172378453,172378666,SRX5075176,SMARCA4,213
chr1,172380810,172381050,SRX5075175,SMARCA4,240
chr1,172383556,172383910,SRX5075170,SMARCA4,354
chr1,172383594,172383891,SRX5075174,SMARCA4,297
chr1,172383603,172383906,SRX5075176,SMARCA4,303
chr1,172383621,172383982,SRX5716469,SMARCA4,361
chr1,172383632,172383892,SRX5716467,SMARCA2,260
chr1,172383633,172383909,SRX5075169,SMARCA4,276
chr1,172383633,172383909,SRX5075175,SMARCA4,276
chr1,172383633,172383915,SRX5020211,SMARCA2,282
chr1,172383647,172383915,SRX5054308,FOSL2,268
chr1,172383652,172383891,SRX5054309,FOSL2,239
chr1,172383656,172383890,SRX5716470,SMARCA4,234
chr1,172390279,172390461,SRX5075174,SMARCA4,182
chr1,172397346,172397545,SRX5054308,FOSL2,199
chr1,172397362,172397622,SRX5054309,FOSL2,260
chr1,172397376,172397559,SRX5075169,SMARCA4,183
chr1,172399097,172399748,SRX5075176,SMARCA4,651
chr1,172399381,172399754,SRX5075170,SMARCA4,373
chr1,172399401,172399837,SRX16500062,CTCF,436
chr1,172399415,172399743,SRX5054308,FOSL2,328
chr1,172399423,172399927,SRX16500060,CTCF,504
chr1,172399433,172399723,SRX5075174,SMARCA4,290
chr1,172399436,172399891,SRX16500059,CTCF,455
chr1,172399445,172399682,SRX5054309,FOSL2,237
chr1,172399465,172399685,SRX5075169,SMARCA4,220
chr1,172399508,172399941,SRX16500061,CTCF,433
chr1,172399512,172399754,SRX5075168,SMARCA4,242
chr1,172409049,172409346,SRX5075170,SMARCA4,297
chr1,172409074,172409316,SRX5075176,SMARCA4,242
chr1,172409120,172409302,SRX5075169,SMARCA4,182
chr1,172429255,172429752,SRX16500059,CTCF,497
chr1,172429297,172429685,SRX16500061,CTCF,388
chr1,172429304,172429709,SRX16500062,CTCF,405
chr1,172429325,172429721,SRX16500060,CTCF,396
chr1,172429352,172429634,SRX5075176,SMARCA4,282
chr1,172429357,172429605,SRX4174629,CTCF,248
chr1,172429360,172429655,SRX5075170,SMARCA4,295
chr1,172429362,172429688,SRX5075175,SMARCA4,326
chr1,172429374,172429670,SRX5075168,SMARCA4,296
chr1,172429382,172429635,SRX5075169,SMARCA4,253
chr1,172429383,172429632,SRX5075174,SMARCA4,249
chr1,172429389,172429655,SRX5716470,SMARCA4,266
chr1,172443666,172444253,SRX5075169,SMARCA4,587
chr1,172443692,172444228,SRX5716470,SMARCA4,536
chr1,172443720,172444311,SRX5075170,SMARCA4,591
chr1,172443871,172444315,SRX5716469,SMARCA4,444
chr1,172443883,172444190,SRX20140895,INTS13,307
chr1,172443909,172444282,SRX5075176,SMARCA4,373
chr1,172443918,172444404,SRX16500060,CTCF,486
chr1,172443927,172444330,SRX5075168,SMARCA4,403
chr1,172443929,172444383,SRX16500061,CTCF,454
chr1,172443932,172444410,SRX16500059,CTCF,478
chr1,172443954,172444386,SRX16500062,CTCF,432
chr1,172443974,172444303,SRX5716464,SMARCA4,329
chr1,172443980,172444293,SRX4174629,CTCF,313
chr1,172443994,172444378,SRX5075174,SMARCA4,384
chr1,172444100,172444291,SRX5075175,SMARCA4,191
chr1,172449876,172450319,SRX16500061,CTCF,443
chr1,172449880,172450317,SRX16500059,CTCF,437
chr1,172449895,172450303,SRX16500062,CTCF,408
chr1,172449907,172450386,SRX16500060,CTCF,479
chr1,172449963,172450232,SRX5075174,SMARCA4,269
chr1,172449967,172450252,SRX5075168,SMARCA4,285
chr1,172449982,172450169,SRX5075169,SMARCA4,187
chr1,172449984,172450254,SRX5075170,SMARCA4,270
chr1,172449991,172450236,SRX5075175,SMARCA4,245
chr1,172450041,172450305,SRX5075176,SMARCA4,264
chr1,172460787,172461273,SRX5075174,SMARCA4,486
chr1,172460800,172461332,SRX5075168,SMARCA4,532
chr1,172461100,172461351,SRX5075170,SMARCA4,251
chr1,172461206,172461381,SRX5075176,SMARCA4,175
chr1,172496968,172497643,SRX5075174,SMARCA4,675
chr1,172497108,172497655,SRX5075168,SMARCA4,547
chr1,172497164,172497490,SRX5716464,SMARCA4,326
chr1,172497164,172497579,SRX5716463,SMARCA4,415
chr1,172532138,172532326,SRX5075168,SMARCA4,188
chr1,172532236,172532405,SRX5075170,SMARCA4,169
chr1,172532667,172533355,SRX5075174,SMARCA4,688
chr1,172532702,172533008,SRX5716451,SOX2,306
chr1,172532753,172533272,SRX5075168,SMARCA4,519
chr1,172532857,172533075,SRX5054308,FOSL2,218
chr1,172532857,172533224,SRX5716463,SMARCA4,367
chr1,172532866,172533133,SRX5054309,FOSL2,267
chr1,172532876,172533166,SRX5075176,SMARCA4,290
chr1,172532887,172533527,SRX20140895,INTS13,640
chr1,172532920,172533400,SRX20140867,INTS10,480
chr1,172532928,172533470,SRX20140868,INTS10,542
chr1,172532940,172533119,SRX5054307,FOSL2,179
chr1,172532972,172533433,SRX20140897,INTS13,461
chr1,172533009,172533395,SRX20140896,INTS13,386
chr1,172533019,172533445,SRX20140881,CPSF3L,426
chr1,172533078,172533397,SRX20140879,CPSF3L,319
chr1,172533088,172533336,SRX20140894,INTS13,248
chr1,172533242,172533466,SRX5075175,SMARCA4,224
chr1,172585435,172585661,SRX5054308,FOSL2,226
chr1,172585447,172585630,SRX5054309,FOSL2,183
chr1,172588712,172589066,SRX5054308,FOSL2,354
chr1,172588713,172589196,SRX5054309,FOSL2,483
chr1,172588724,172589195,SRX5075169,SMARCA4,471
chr1,172588728,172589090,SRX5716469,SMARCA4,362
chr1,172588732,172589064,SRX5075175,SMARCA4,332
chr1,172588751,172589083,SRX5075170,SMARCA4,332
chr1,172588762,172589108,SRX5075176,SMARCA4,346
chr1,172588827,172589101,SRX5020214,SMARCA2,274
chr1,172609618,172609871,SRX16500061,CTCF,253
chr1,172637554,172637852,SRX5075168,SMARCA4,298
chr1,172637573,172637873,SRX5075174,SMARCA4,300
chr1,172637604,172637784,SRX5054308,FOSL2,180
chr1,172637605,172637836,SRX5054309,FOSL2,231
chr1,172637694,172637875,SRX5075176,SMARCA4,181
chr1,172638801,172639142,SRX5075175,SMARCA4,341
chr1,172638853,172639121,SRX5054308,FOSL2,268
chr1,172638862,172639211,SRX5054309,FOSL2,349
chr1,172638872,172639186,SRX5075169,SMARCA4,314
chr1,172638872,172639199,SRX5075176,SMARCA4,327
chr1,172662894,172663074,SRX5054308,FOSL2,180
chr1,172682734,172683223,SRX5075168,SMARCA4,489
chr1,172682779,172683158,SRX5075174,SMARCA4,379
chr1,172704547,172704720,SRX5075174,SMARCA4,173
chr1,172719504,172720006,SRX16500060,CTCF,502
chr1,172719524,172720027,SRX16500059,CTCF,503
chr1,172719568,172719991,SRX16500062,CTCF,423
chr1,172719584,172720011,SRX16500061,CTCF,427
chr1,172719694,172719873,SRX5075168,SMARCA4,179
chr1,172719703,172719942,SRX5075174,SMARCA4,239
chr1,172727957,172728298,SRX16500061,CTCF,341
chr1,172727971,172728262,SRX16500059,CTCF,291
chr1,172728020,172728351,SRX16500060,CTCF,331
chr1,172728089,172728361,SRX16500062,CTCF,272
chr1,172728098,172728289,SRX5075174,SMARCA4,191
chr1,172742564,172743005,SRX16500059,CTCF,441
chr1,172742565,172743010,SRX16500060,CTCF,445
chr1,172742602,172742996,SRX16500061,CTCF,394
chr1,172742632,172742995,SRX16500062,CTCF,363
chr1,172744969,172745256,SRX16500060,CTCF,287
chr1,172744971,172745238,SRX16500059,CTCF,267
chr1,172745010,172745338,SRX16500062,CTCF,328
chr1,172745012,172745266,SRX16500061,CTCF,254
chr1,172745066,172745271,SRX5075170,SMARCA4,205
chr1,172745067,172745288,SRX5075169,SMARCA4,221
chr1,172745081,172745260,SRX5075168,SMARCA4,179
chr1,172746203,172746680,SRX5075175,SMARCA4,477
chr1,172746262,172746666,SRX5054309,FOSL2,404
chr1,172746272,172746635,SRX5716469,SMARCA4,363
chr1,172746308,172746717,SRX5054308,FOSL2,409
chr1,172746323,172746685,SRX5075176,SMARCA4,362
chr1,172746340,172746712,SRX5075169,SMARCA4,372
chr1,172746344,172746610,SRX5716470,SMARCA4,266
chr1,172746354,172746635,SRX5075170,SMARCA4,281
chr1,172761768,172762002,SRX5054308,FOSL2,234
chr1,172761804,172762032,SRX5054309,FOSL2,228
chr1,172823562,172823887,SRX5075169,SMARCA4,325
chr1,172823592,172823804,SRX5054309,FOSL2,212
chr1,172823595,172823832,SRX5075175,SMARCA4,237
chr1,172823634,172823827,SRX5054308,FOSL2,193
chr1,172825980,172826454,SRX16500059,CTCF,474
chr1,172826021,172826468,SRX16500060,CTCF,447
chr1,172826024,172826350,SRX16500061,CTCF,326
chr1,172826043,172826474,SRX16500062,CTCF,431
chr1,172826069,172826332,SRX5075174,SMARCA4,263
chr1,172826106,172826429,SRX5075176,SMARCA4,323
chr1,172826165,172826462,SRX5075175,SMARCA4,297
chr1,172826172,172826432,SRX5075170,SMARCA4,260
chr1,172826175,172826366,SRX5075169,SMARCA4,191
chr1,172826182,172826379,SRX5075168,SMARCA4,197
chr1,172826198,172826502,SRX5716470,SMARCA4,304
chr1,172859049,172859501,SRX5054309,FOSL2,452
chr1,172859172,172859559,SRX5075169,SMARCA4,387
chr1,172859189,172859584,SRX5075175,SMARCA4,395
chr1,172859193,172859550,SRX5716470,SMARCA4,357
chr1,172859194,172859634,SRX5716469,SMARCA4,440
chr1,172859210,172859516,SRX5054308,FOSL2,306
chr1,172859239,172859507,SRX5716467,SMARCA2,268
chr1,172859272,172859617,SRX5075170,SMARCA4,345
chr1,172859276,172859583,SRX5075176,SMARCA4,307
chr1,172871235,172871418,SRX5054309,FOSL2,183
chr1,172883939,172884291,SRX5075170,SMARCA4,352
chr1,172883967,172884215,SRX5075176,SMARCA4,248
chr1,172885495,172885689,SRX5075169,SMARCA4,194
chr1,172885979,172886166,SRX5075169,SMARCA4,187
chr1,172886003,172886252,SRX5054309,FOSL2,249
chr1,172886004,172886180,SRX5075176,SMARCA4,176
chr1,172893505,172893803,SRX5075176,SMARCA4,298
chr1,172893508,172893811,SRX5075170,SMARCA4,303
chr1,172893594,172893776,SRX5075169,SMARCA4,182
chr1,172897765,172898095,SRX5075174,SMARCA4,330
chr1,172897767,172897991,SRX5075175,SMARCA4,224
chr1,172897770,172898064,SRX5054309,FOSL2,294
chr1,172897782,172898043,SRX5075168,SMARCA4,261
chr1,172897804,172897984,SRX5054308,FOSL2,180
chr1,172897879,172898113,SRX5716469,SMARCA4,234
chr1,172898942,172899155,SRX5075174,SMARCA4,213
chr1,172898984,172899219,SRX5075168,SMARCA4,235
chr1,172902832,172903210,SRX5054309,FOSL2,378
chr1,172902921,172903136,SRX5075169,SMARCA4,215
chr1,172903604,172904011,SRX5075169,SMARCA4,407
chr1,172903656,172903871,SRX5054308,FOSL2,215
chr1,172903659,172903892,SRX5716467,SMARCA2,233
chr1,172903663,172903922,SRX5075175,SMARCA4,259
chr1,172903668,172903949,SRX5054309,FOSL2,281
chr1,172903676,172903938,SRX5075176,SMARCA4,262
chr1,172903689,172903926,SRX5075170,SMARCA4,237
chr1,172907468,172907651,SRX5075176,SMARCA4,183
chr1,172909540,172909827,SRX5054309,FOSL2,287
chr1,172909558,172909791,SRX5054308,FOSL2,233
chr1,172909597,172909836,SRX5075169,SMARCA4,239
chr1,172914572,172914800,SRX5716469,SMARCA4,228
chr1,172914588,172914865,SRX5716470,SMARCA4,277
chr1,172914596,172914966,SRX5075170,SMARCA4,370
chr1,172914596,172915025,SRX5075176,SMARCA4,429
chr1,172914602,172915020,SRX5716468,SMARCA2,418
chr1,172914612,172914930,SRX5716467,SMARCA2,318
chr1,172914620,172914895,SRX5075181,SMARCA2,275
chr1,172914649,172914852,SRX5075175,SMARCA4,203
chr1,172914653,172914901,SRX5075169,SMARCA4,248
chr1,172914687,172914927,SRX5020211,SMARCA2,240
chr1,172917891,172918288,SRX5716470,SMARCA4,397
chr1,172917906,172918367,SRX5075170,SMARCA4,461
chr1,172917914,172918340,SRX5075174,SMARCA4,426
chr1,172917944,172918391,SRX5075176,SMARCA4,447
chr1,172917948,172918294,SRX5075168,SMARCA4,346
chr1,172917950,172918325,SRX5716469,SMARCA4,375
chr1,172917953,172918383,SRX5054309,FOSL2,430
chr1,172917954,172918402,SRX5075169,SMARCA4,448
chr1,172917961,172918322,SRX5054308,FOSL2,361
chr1,172917961,172918356,SRX5075175,SMARCA4,395
chr1,172917971,172918290,SRX5020214,SMARCA2,319
chr1,172917977,172918244,SRX5054307,FOSL2,267
chr1,172917982,172918290,SRX5716467,SMARCA2,308
chr1,172918011,172918263,SRX5020211,SMARCA2,252
chr1,172918079,172918285,SRX5075182,SMARCA2,206
chr1,172928486,172928843,SRX5075170,SMARCA4,357
chr1,172928495,172928758,SRX5075175,SMARCA4,263
chr1,172928499,172928782,SRX5075169,SMARCA4,283
chr1,172928520,172928732,SRX5716469,SMARCA4,212
chr1,172928536,172928726,SRX5075176,SMARCA4,190
chr1,172933740,172934398,SRX5075170,SMARCA4,658
chr1,172933794,172934516,SRX5075176,SMARCA4,722
chr1,172933799,172934280,SRX5075175,SMARCA4,481
chr1,172933817,172934253,SRX5020214,SMARCA2,436
chr1,172933818,172934266,SRX5054308,FOSL2,448
chr1,172933825,172934153,SRX5716460,Epitope tags,328
chr1,172933830,172934503,SRX5075174,SMARCA4,673
chr1,172933834,172934313,SRX5054309,FOSL2,479
chr1,172933835,172934406,SRX5075169,SMARCA4,571
chr1,172933836,172934210,SRX5020211,SMARCA2,374
chr1,172933838,172934514,SRX5075168,SMARCA4,676
chr1,172933886,172934261,SRX5716470,SMARCA4,375
chr1,172933906,172934343,SRX5716469,SMARCA4,437
chr1,172933927,172934188,SRX5054307,FOSL2,261
chr1,172933947,172934167,SRX5716467,SMARCA2,220
chr1,172933951,172934195,SRX5075182,SMARCA2,244
chr1,172933952,172934184,SRX5716468,SMARCA2,232
chr1,172940301,172941008,SRX5075174,SMARCA4,707
chr1,172940359,172940853,SRX5716464,SMARCA4,494
chr1,172940366,172940830,SRX5075168,SMARCA4,464
chr1,172940433,172940809,SRX5716470,SMARCA4,376
chr1,172940437,172940884,SRX5716463,SMARCA4,447
chr1,172940462,172940779,SRX5054309,FOSL2,317
chr1,172940467,172940813,SRX5075169,SMARCA4,346
chr1,172940482,172940782,SRX5716467,SMARCA2,300
chr1,172940498,172940849,SRX5075176,SMARCA4,351
chr1,172940501,172940755,SRX5075175,SMARCA4,254
chr1,172940525,172940736,SRX5716468,SMARCA2,211
chr1,172940527,172940771,SRX5075170,SMARCA4,244
chr1,172940538,172940787,SRX5716469,SMARCA4,249
chr1,172948515,172948740,SRX5075175,SMARCA4,225
chr1,172948516,172948730,SRX5075176,SMARCA4,214
chr1,172948538,172948735,SRX5075170,SMARCA4,197
chr1,172948570,172948782,SRX5075169,SMARCA4,212
chr1,172955468,172955649,SRX5054308,FOSL2,181
chr1,172970277,172970491,SRX5075174,SMARCA4,214
chr1,172970337,172970566,SRX5075170,SMARCA4,229
chr1,172976307,172976866,SRX5075169,SMARCA4,559
chr1,172976340,172976741,SRX5716470,SMARCA4,401
chr1,172976384,172976677,SRX5075170,SMARCA4,293
chr1,172976417,172976762,SRX5075176,SMARCA4,345
chr1,172976420,172976751,SRX5075175,SMARCA4,331
chr1,172976429,172976786,SRX5716469,SMARCA4,357
chr1,172976459,172976801,SRX5054308,FOSL2,342
chr1,172976476,172976750,SRX5716467,SMARCA2,274
chr1,172990628,172990982,SRX5716470,SMARCA4,354
chr1,172990632,172991011,SRX5075175,SMARCA4,379
chr1,172990651,172990894,SRX5716469,SMARCA4,243
chr1,172990653,172991046,SRX5054309,FOSL2,393
chr1,172990689,172990971,SRX5075169,SMARCA4,282
chr1,172990706,172990925,SRX5075170,SMARCA4,219
chr1,172990709,172990961,SRX5716468,SMARCA2,252
chr1,173042951,173043219,SRX5075170,SMARCA4,268
chr1,173043010,173043196,SRX5075174,SMARCA4,186
chr1,173043115,173043697,SRX5075176,SMARCA4,582
chr1,173043308,173043581,SRX5075175,SMARCA4,273
chr1,173043322,173043590,SRX5054308,FOSL2,268
chr1,173043337,173043685,SRX5075169,SMARCA4,348
chr1,173043351,173043641,SRX5054309,FOSL2,290
chr1,173043375,173043649,SRX5075170,SMARCA4,274
chr1,173050869,173051212,SRX5075170,SMARCA4,343
chr1,173050955,173051235,SRX5075176,SMARCA4,280
chr1,173050964,173051176,SRX5716469,SMARCA4,212
chr1,173050964,173051185,SRX5075175,SMARCA4,221
chr1,173051022,173051205,SRX5075169,SMARCA4,183
chr1,173062138,173062610,SRX5054309,FOSL2,472
chr1,173062158,173062532,SRX5054308,FOSL2,374
chr1,173062196,173062456,SRX5020214,SMARCA2,260
chr1,173062211,173062531,SRX5075170,SMARCA4,320
chr1,173062218,173062459,SRX5075176,SMARCA4,241
chr1,173062218,173062554,SRX5716469,SMARCA4,336
chr1,173062226,173062537,SRX5075169,SMARCA4,311
chr1,173062227,173062540,SRX5075175,SMARCA4,313
chr1,173062310,173062544,SRX5716470,SMARCA4,234
chr1,173122840,173123682,SRX5075176,SMARCA4,842
chr1,173122886,173123543,SRX5075170,SMARCA4,657
chr1,173122910,173123503,SRX5075169,SMARCA4,593
chr1,173122912,173123461,SRX5716470,SMARCA4,549
chr1,173122923,173123465,SRX5716469,SMARCA4,542
chr1,173122986,173123415,SRX5075175,SMARCA4,429
chr1,173122997,173123418,SRX5716467,SMARCA2,421
chr1,173123068,173123389,SRX5716468,SMARCA2,321
chr1,173123119,173123300,SRX5054308,FOSL2,181
chr1,173134149,173134392,SRX5054309,FOSL2,243
chr1,173134197,173134397,SRX5075170,SMARCA4,200
chr1,173161826,173162107,SRX5075175,SMARCA4,281
chr1,173161837,173162105,SRX5054309,FOSL2,268
chr1,173161862,173162158,SRX5075169,SMARCA4,296
chr1,173161875,173162176,SRX5075176,SMARCA4,301
chr1,173161879,173162169,SRX5075170,SMARCA4,290
chr1,173161944,173162129,SRX5054308,FOSL2,185
chr1,173190402,173190966,SRX5075176,SMARCA4,564
chr1,173190463,173190821,SRX5716470,SMARCA4,358
chr1,173190526,173190949,SRX5075170,SMARCA4,423
chr1,173190539,173190861,SRX5075169,SMARCA4,322
chr1,173190641,173190918,SRX5075175,SMARCA4,277
chr1,173202347,173202774,SRX16500059,CTCF,427
chr1,173202353,173202741,SRX16500060,CTCF,388
chr1,173202377,173202750,SRX16500061,CTCF,373
chr1,173202409,173202721,SRX16500062,CTCF,312
chr1,173202411,173202727,SRX5075169,SMARCA4,316
chr1,173202434,173202799,SRX5075176,SMARCA4,365
chr1,173202485,173202784,SRX5075170,SMARCA4,299
chr1,173202552,173202858,SRX5054309,FOSL2,306
chr1,173202590,173202821,SRX5054308,FOSL2,231
chr1,173216303,173216488,SRX5075170,SMARCA4,185
chr1,173224219,173224640,SRX5075176,SMARCA4,421
chr1,173224220,173224650,SRX5075170,SMARCA4,430
chr1,173224241,173224660,SRX5075169,SMARCA4,419
chr1,173224259,173224786,SRX20140869,INTS10,527
chr1,173224282,173224725,SRX5054309,FOSL2,443
chr1,173224328,173224521,SRX5075175,SMARCA4,193
chr1,173224374,173224586,SRX5716469,SMARCA4,212
chr1,173253152,173253346,SRX5054308,FOSL2,194
chr1,173255129,173255567,SRX16500060,CTCF,438
chr1,173255146,173255538,SRX16500061,CTCF,392
chr1,173255157,173255625,SRX16500059,CTCF,468
chr1,173255223,173255550,SRX16500062,CTCF,327
chr1,173255236,173255531,SRX5075168,SMARCA4,295
chr1,173255281,173255454,SRX5075174,SMARCA4,173
chr1,173255309,173255508,SRX5075176,SMARCA4,199
chr1,173255335,173255543,SRX5075170,SMARCA4,208
chr1,173257964,173258138,SRX5075174,SMARCA4,174
chr1,173267358,173267793,SRX5054308,FOSL2,435
chr1,173267397,173267735,SRX5020214,SMARCA2,338
chr1,173267406,173267826,SRX5054309,FOSL2,420
chr1,173267482,173267773,SRX5075175,SMARCA4,291
chr1,173267540,173267813,SRX5075169,SMARCA4,273
chr1,173267549,173267755,SRX5020211,SMARCA2,206
chr1,173267568,173267743,SRX5075170,SMARCA4,175
chr1,173267589,173267791,SRX5075176,SMARCA4,202
chr1,173269452,173269776,SRX5075174,SMARCA4,324
chr1,173269453,173269987,SRX5075169,SMARCA4,534
chr1,173269463,173270130,SRX5075170,SMARCA4,667
chr1,173269474,173269772,SRX5054309,FOSL2,298
chr1,173269480,173270150,SRX5075176,SMARCA4,670
chr1,173269483,173270054,SRX5075175,SMARCA4,571
chr1,173269487,173269744,SRX5075168,SMARCA4,257
chr1,173269501,173270077,SRX5716470,SMARCA4,576
chr1,173269511,173269775,SRX5716469,SMARCA4,264
chr1,173330385,173330737,SRX5075176,SMARCA4,352
chr1,173330397,173330755,SRX5075170,SMARCA4,358
chr1,173330401,173330724,SRX5075175,SMARCA4,323
chr1,173330402,173330762,SRX5075169,SMARCA4,360
chr1,173330405,173330697,SRX5054309,FOSL2,292
chr1,173330409,173330711,SRX5054308,FOSL2,302
chr1,173330430,173330642,SRX5716469,SMARCA4,212
chr1,173330465,173330691,SRX5020211,SMARCA2,226
chr1,173330475,173330707,SRX5716470,SMARCA4,232
chr1,173341293,173341674,SRX5075170,SMARCA4,381
chr1,173341307,173341550,SRX5075169,SMARCA4,243
chr1,173341352,173341636,SRX5075176,SMARCA4,284
chr1,173341381,173341645,SRX5716469,SMARCA4,264
chr1,173341408,173341615,SRX5075175,SMARCA4,207
chr1,173347373,173347654,SRX5716463,SMARCA4,281
chr1,173347389,173347710,SRX5075174,SMARCA4,321
chr1,173347439,173347682,SRX5075168,SMARCA4,243
chr1,173383253,173383780,SRX5075176,SMARCA4,527
chr1,173383303,173383709,SRX5020211,SMARCA2,406
chr1,173383321,173383728,SRX5075175,SMARCA4,407
chr1,173383336,173383808,SRX5075170,SMARCA4,472
chr1,173383367,173383725,SRX5054308,FOSL2,358
chr1,173383384,173383645,SRX5716468,SMARCA2,261
chr1,173383398,173383780,SRX5716470,SMARCA4,382
chr1,173383406,173383724,SRX5054309,FOSL2,318
chr1,173383419,173383660,SRX5020214,SMARCA2,241
chr1,173383433,173383821,SRX5075169,SMARCA4,388
chr1,173383465,173383690,SRX5716469,SMARCA4,225
chr1,173393114,173393465,SRX5054309,FOSL2,351
chr1,173393146,173393434,SRX5075170,SMARCA4,288
chr1,173393152,173393559,SRX5075176,SMARCA4,407
chr1,173393160,173393450,SRX5054308,FOSL2,290
chr1,173393186,173393444,SRX5075175,SMARCA4,258
chr1,173393204,173393468,SRX5075169,SMARCA4,264
chr1,173393216,173393465,SRX5075174,SMARCA4,249
chr1,173393217,173393523,SRX5716469,SMARCA4,306
chr1,173405809,173406024,SRX5075176,SMARCA4,215
chr1,173405834,173406017,SRX5075169,SMARCA4,183
chr1,173405836,173406019,SRX5054309,FOSL2,183
chr1,173409627,173409928,SRX5716470,SMARCA4,301
chr1,173409640,173409927,SRX5075176,SMARCA4,287
chr1,173409689,173409936,SRX5075170,SMARCA4,247
chr1,173409705,173409892,SRX5075175,SMARCA4,187
chr1,173409710,173409980,SRX5075169,SMARCA4,270
chr1,173420258,173420759,SRX16500061,CTCF,501
chr1,173420268,173420771,SRX16500059,CTCF,503
chr1,173420306,173420691,SRX5075168,SMARCA4,385
chr1,173420308,173420742,SRX16500060,CTCF,434
chr1,173420314,173420737,SRX16500062,CTCF,423
chr1,173420328,173420644,SRX5075170,SMARCA4,316
chr1,173420338,173420611,SRX4174629,CTCF,273
chr1,173420348,173420675,SRX5075174,SMARCA4,327
chr1,173420349,173420632,SRX5075175,SMARCA4,283
chr1,173420351,173420666,SRX5075176,SMARCA4,315
chr1,173420367,173420684,SRX5075169,SMARCA4,317
chr1,173420473,173420707,SRX5716470,SMARCA4,234
chr1,173429516,173430338,SRX20140895,INTS13,822
chr1,173429573,173429823,SRX16500060,CTCF,250
chr1,173429625,173430253,SRX5075176,SMARCA4,628
chr1,173429627,173429913,SRX16500061,CTCF,286
chr1,173429801,173430260,SRX5075169,SMARCA4,459
chr1,173429890,173430248,SRX5716469,SMARCA4,358
chr1,173429894,173430216,SRX5054309,FOSL2,322
chr1,173429895,173430225,SRX5054308,FOSL2,330
chr1,173429897,173430304,SRX5716470,SMARCA4,407
chr1,173429899,173430253,SRX5075175,SMARCA4,354
chr1,173429901,173430310,SRX5075170,SMARCA4,409
chr1,173429906,173430295,SRX5075174,SMARCA4,389
chr1,173429925,173430177,SRX5020214,SMARCA2,252
chr1,173429950,173430247,SRX5716468,SMARCA2,297
chr1,173429964,173430216,SRX5020211,SMARCA2,252
chr1,173429966,173430290,SRX5075168,SMARCA4,324
chr1,173429989,173430194,SRX5075181,SMARCA2,205
chr1,173429993,173430311,SRX5716467,SMARCA2,318
chr1,173430100,173430304,SRX5716463,SMARCA4,204
chr1,173431115,173431593,SRX16500059,CTCF,478
chr1,173431148,173431593,SRX16500060,CTCF,445
chr1,173431155,173431624,SRX16500062,CTCF,469
chr1,173431166,173431553,SRX16500061,CTCF,387
chr1,173431225,173431509,SRX5075168,SMARCA4,284
chr1,173431255,173431469,SRX5716463,SMARCA4,214
chr1,173431258,173431469,SRX5716470,SMARCA4,211
chr1,173431258,173431576,SRX5075174,SMARCA4,318
chr1,173431285,173431509,SRX5075176,SMARCA4,224
chr1,173431306,173431548,SRX5075170,SMARCA4,242
chr1,173431343,173431555,SRX5716469,SMARCA4,212
chr1,173473520,173473766,SRX5075175,SMARCA4,246
chr1,173473528,173473772,SRX5054309,FOSL2,244
chr1,173473622,173473828,SRX5054308,FOSL2,206
chr1,173476725,173477218,SRX20140895,INTS13,493
chr1,173476776,173476977,SRX5075175,SMARCA4,201
chr1,173476797,173477156,SRX5075174,SMARCA4,359
chr1,173476830,173477087,SRX20140897,INTS13,257
chr1,173476839,173477128,SRX5075168,SMARCA4,289
chr1,173476846,173477067,SRX5075176,SMARCA4,221
chr1,173477329,173477686,SRX20140867,INTS10,357
chr1,173477331,173477625,SRX5075168,SMARCA4,294
chr1,173477376,173477742,SRX20140895,INTS13,366
chr1,173477429,173477706,SRX20140868,INTS10,277
chr1,173506491,173506772,SRX16500061,CTCF,281
chr1,173506507,173506772,SRX16500059,CTCF,265
chr1,173507059,173507817,SRX5716469,SMARCA4,758
chr1,173507087,173508141,SRX5075174,SMARCA4,1054
chr1,173507098,173507729,SRX5075169,SMARCA4,631
chr1,173507101,173507833,SRX5075168,SMARCA4,732
chr1,173507114,173507692,SRX5075170,SMARCA4,578
chr1,173507115,173507726,SRX5716463,SMARCA4,611
chr1,173507124,173507659,SRX5075175,SMARCA4,535
chr1,173507125,173507723,SRX5075176,SMARCA4,598
chr1,173507129,173507401,SRX5716467,SMARCA2,272
chr1,173507144,173507495,SRX5054309,FOSL2,351
chr1,173507165,173507442,SRX5054308,FOSL2,277
chr1,173507193,173507770,SRX5716470,SMARCA4,577
chr1,173507219,173507526,SRX5054307,FOSL2,307
chr1,173507285,173507645,SRX5716451,SOX2,360
chr1,173507303,173507562,SRX5716464,SMARCA4,259
chr1,173507308,173507882,SRX20140895,INTS13,574
chr1,173507316,173507610,SRX5716454,SOX3,294
chr1,173507469,173507731,SRX20140881,CPSF3L,262
chr1,173507713,173507927,SRX20140867,INTS10,214
chr1,173507929,173508149,SRX5075168,SMARCA4,220
chr1,173518536,173519007,SRX5075174,SMARCA4,471
chr1,173518626,173519087,SRX5075168,SMARCA4,461
chr1,173530749,173530956,SRX5075168,SMARCA4,207
chr1,173530886,173531090,SRX5075174,SMARCA4,204
chr1,173637269,173637591,SRX5716467,SMARCA2,322
chr1,173637283,173637665,SRX5075168,SMARCA4,382
chr1,173637310,173637677,SRX5075170,SMARCA4,367
chr1,173637321,173637768,SRX5075174,SMARCA4,447
chr1,173637324,173637624,SRX5716470,SMARCA4,300
chr1,173637331,173637761,SRX5075176,SMARCA4,430
chr1,173637379,173637600,SRX5716463,SMARCA4,221
chr1,173637384,173637706,SRX5716451,SOX2,322
chr1,173637427,173637698,SRX5054308,FOSL2,271
chr1,173637437,173637704,SRX5054307,FOSL2,267
chr1,173637497,173637712,SRX5054309,FOSL2,215
chr1,173642557,173642738,SRX5075169,SMARCA4,181
chr1,173642559,173642938,SRX5075168,SMARCA4,379
chr1,173642595,173642839,SRX5075174,SMARCA4,244
chr1,173642616,173642861,SRX5054309,FOSL2,245
chr1,173642637,173642883,SRX5716451,SOX2,246
chr1,173642640,173642945,SRX5054308,FOSL2,305
chr1,173642642,173642968,SRX5075170,SMARCA4,326
chr1,173642659,173642904,SRX5054307,FOSL2,245
chr1,173642710,173642972,SRX5716454,SOX3,262
chr1,173669512,173670015,SRX20140895,INTS13,503
chr1,173691135,173691527,SRX16500060,CTCF,392
chr1,173691189,173691510,SRX16500059,CTCF,321
chr1,173691238,173691461,SRX16500061,CTCF,223
chr1,173714584,173715297,SRX20140869,INTS10,713
chr1,173714668,173715213,SRX20140868,INTS10,545
chr1,173714691,173715349,SRX20140895,INTS13,658
chr1,173714753,173715161,SRX5075168,SMARCA4,408
chr1,173714766,173715257,SRX5075170,SMARCA4,491
chr1,173714776,173715188,SRX20140867,INTS10,412
chr1,173714780,173715059,SRX20140881,CPSF3L,279
chr1,173714804,173715172,SRX5075176,SMARCA4,368
chr1,173714814,173715305,SRX5075174,SMARCA4,491
chr1,173715146,173715454,SRX5716470,SMARCA4,308
chr1,173824096,173825089,SRX20140895,INTS13,993
chr1,173824100,173824624,SRX5075168,SMARCA4,524
chr1,173824208,173824498,SRX20140868,INTS10,290
chr1,173824223,173824876,SRX5075174,SMARCA4,653
chr1,173824296,173824586,SRX5075176,SMARCA4,290
chr1,173824365,173825000,SRX20140897,INTS13,635
chr1,173824421,173825073,SRX20140869,INTS10,652
chr1,173824434,173825078,SRX20140867,INTS10,644
chr1,173824554,173824825,SRX20140896,INTS13,271
chr1,173824643,173824842,SRX5075169,SMARCA4,199
chr1,173824725,173825172,SRX5075170,SMARCA4,447
chr1,173824840,173825287,SRX4174629,CTCF,447
chr1,173824864,173825381,SRX16500060,CTCF,517
chr1,173824896,173825196,SRX5716470,SMARCA4,300
chr1,173824917,173825405,SRX16500059,CTCF,488
chr1,173824973,173825325,SRX16500062,CTCF,352
chr1,173824986,173825205,SRX5075169,SMARCA4,219
chr1,173824989,173825393,SRX16500061,CTCF,404
chr1,173824999,173825304,SRX5075174,SMARCA4,305
chr1,173867549,173868512,SRX20140895,INTS13,963
chr1,173867583,173868183,SRX20140881,CPSF3L,600
chr1,173867586,173868231,SRX20140868,INTS10,645
chr1,173867597,173868135,SRX20140869,INTS10,538
chr1,173867624,173868165,SRX20140879,CPSF3L,541
chr1,173867657,173868366,SRX20140897,INTS13,709
chr1,173867687,173868085,SRX20140880,CPSF3L,398
chr1,173867716,173868111,SRX20140894,INTS13,395
chr1,173867722,173868183,SRX20140867,INTS10,461
chr1,173867736,173868234,SRX20140896,INTS13,498
chr1,173867758,173868119,SRX20140882,CPSF3L,361
chr1,173867876,173868343,SRX5075174,SMARCA4,467
chr1,173867877,173868294,SRX5075168,SMARCA4,417
chr1,173867932,173868247,SRX5716451,SOX2,315
chr1,173867959,173868262,SRX5054307,FOSL2,303
chr1,173867988,173868168,SRX5054308,FOSL2,180
chr1,173868014,173868338,SRX5075170,SMARCA4,324
chr1,173868017,173868245,SRX5716454,SOX3,228
chr1,173868048,173868511,SRX5075176,SMARCA4,463
chr1,173868132,173868374,SRX5716470,SMARCA4,242
chr1,173868325,173868539,SRX20140867,INTS10,214
chr1,173868645,173868897,SRX5075168,SMARCA4,252
chr1,173914263,173914560,SRX16500062,CTCF,297
chr1,173914273,173914647,SRX16500059,CTCF,374
chr1,173914295,173914678,SRX16500060,CTCF,383
chr1,173914346,173914663,SRX16500061,CTCF,317
chr1,174000552,174000744,SRX5075176,SMARCA4,192
chr1,174005056,174005403,SRX5075169,SMARCA4,347
chr1,174005092,174005390,SRX5716470,SMARCA4,298
chr1,174005099,174005459,SRX5075175,SMARCA4,360
chr1,174005115,174005350,SRX5020211,SMARCA2,235
chr1,174005121,174005392,SRX5054309,FOSL2,271
chr1,174005123,174005449,SRX5054308,FOSL2,326
chr1,174005131,174005383,SRX5075176,SMARCA4,252
chr1,174005132,174005379,SRX5075170,SMARCA4,247
chr1,174021857,174022772,SRX20140895,INTS13,915
chr1,174021952,174022675,SRX20140868,INTS10,723
chr1,174022046,174022487,SRX20140896,INTS13,441
chr1,174022105,174022733,SRX20140867,INTS10,628
chr1,174022215,174022700,SRX5075174,SMARCA4,485
chr1,174022236,174022654,SRX20140897,INTS13,418
chr1,174022271,174022671,SRX5716463,SMARCA4,400
chr1,174022275,174022608,SRX20140881,CPSF3L,333
chr1,174022280,174022678,SRX5075168,SMARCA4,398
chr1,174022296,174022573,SRX5716464,SMARCA4,277
chr1,174022302,174022691,SRX5075170,SMARCA4,389
chr1,174022315,174022666,SRX5075176,SMARCA4,351
chr1,174022322,174022689,SRX5054309,FOSL2,367
chr1,174022336,174022669,SRX5054308,FOSL2,333
chr1,174022347,174022644,SRX5054307,FOSL2,297
chr1,174022376,174022660,SRX20140879,CPSF3L,284
chr1,174022397,174022738,SRX5075169,SMARCA4,341
chr1,174022441,174022713,SRX5716470,SMARCA4,272
chr1,174022465,174022732,SRX5716469,SMARCA4,267
chr1,174022474,174022788,SRX5075175,SMARCA4,314
chr1,174040356,174040749,SRX5075170,SMARCA4,393
chr1,174040394,174040805,SRX5075175,SMARCA4,411
chr1,174040417,174040734,SRX5075176,SMARCA4,317
chr1,174040458,174040820,SRX5075169,SMARCA4,362
chr1,174051873,174052341,SRX5075174,SMARCA4,468
chr1,174051971,174052358,SRX5075168,SMARCA4,387
chr1,174058709,174058935,SRX5075175,SMARCA4,226
chr1,174074747,174075135,SRX16500060,CTCF,388
chr1,174074757,174075104,SRX16500062,CTCF,347
chr1,174074759,174075084,SRX16500061,CTCF,325
chr1,174114777,174115200,SRX16500062,CTCF,423
chr1,174114779,174115202,SRX16500059,CTCF,423
chr1,174114780,174115251,SRX16500061,CTCF,471
chr1,174114793,174115278,SRX16500060,CTCF,485
chr1,174114831,174115170,SRX5716463,SMARCA4,339
chr1,174114833,174115241,SRX5075168,SMARCA4,408
chr1,174114894,174115194,SRX5075174,SMARCA4,300
chr1,174135250,174135456,SRX5075175,SMARCA4,206
chr1,174135319,174135501,SRX5075176,SMARCA4,182
chr1,174159020,174159980,SRX20140895,INTS13,960
chr1,174159051,174159658,SRX5075176,SMARCA4,607
chr1,174159068,174159569,SRX5075168,SMARCA4,501
chr1,174159071,174159691,SRX5075170,SMARCA4,620
chr1,174159075,174159339,SRX20140879,CPSF3L,264
chr1,174159085,174159651,SRX5075174,SMARCA4,566
chr1,174159107,174159803,SRX5716470,SMARCA4,696
chr1,174159111,174159792,SRX5075175,SMARCA4,681
chr1,174159130,174159937,SRX20140868,INTS10,807
chr1,174159178,174159576,SRX5716463,SMARCA4,398
chr1,174159218,174159528,SRX5716469,SMARCA4,310
chr1,174159232,174159621,SRX5716464,SMARCA4,389
chr1,174159233,174159435,SRX5075169,SMARCA4,202
chr1,174159371,174159737,SRX20140896,INTS13,366
chr1,174159381,174159774,SRX20140897,INTS13,393
chr1,174159394,174159793,SRX20140867,INTS10,399
chr1,174159466,174159713,SRX20140894,INTS13,247
chr1,174159481,174159891,SRX20140881,CPSF3L,410
chr1,174159493,174159835,SRX20140879,CPSF3L,342
chr1,174159499,174159822,SRX20140869,INTS10,323
chr1,174217642,174218104,SRX16500062,CTCF,462
chr1,174217660,174218124,SRX16500060,CTCF,464
chr1,174217662,174218135,SRX16500061,CTCF,473
chr1,174217677,174218133,SRX16500059,CTCF,456
chr1,174217748,174217944,SRX5075170,SMARCA4,196
chr1,174217757,174218035,SRX5075168,SMARCA4,278
chr1,174217806,174217995,SRX5075176,SMARCA4,189
chr1,174257990,174258420,SRX16500062,CTCF,430
chr1,174258013,174258488,SRX16500059,CTCF,475
chr1,174258016,174258432,SRX16500060,CTCF,416
chr1,174258023,174258491,SRX16500061,CTCF,468
chr1,174258139,174258401,SRX5075174,SMARCA4,262
chr1,174262651,174263061,SRX16500060,CTCF,410
chr1,174262670,174263081,SRX16500059,CTCF,411
chr1,174262702,174263032,SRX5075168,SMARCA4,330
chr1,174262722,174263092,SRX16500061,CTCF,370
chr1,174262741,174263038,SRX16500062,CTCF,297
chr1,174262744,174263016,SRX5075174,SMARCA4,272
chr1,174262763,174263048,SRX5075170,SMARCA4,285
chr1,174262766,174263062,SRX5075169,SMARCA4,296
chr1,174262779,174263012,SRX5075176,SMARCA4,233
chr1,174262855,174263109,SRX4174629,CTCF,254
chr1,174367082,174367265,SRX5075168,SMARCA4,183
chr1,174367097,174367492,SRX5075174,SMARCA4,395
chr1,174398288,174398611,SRX5054309,FOSL2,323
chr1,174398365,174398593,SRX5054308,FOSL2,228
chr1,174413728,174413981,SRX16500062,CTCF,253
chr1,174433509,174433723,SRX5075169,SMARCA4,214
chr1,174497391,174497913,SRX5075174,SMARCA4,522
chr1,174497475,174498012,SRX5075168,SMARCA4,537
chr1,174497488,174497905,SRX5716463,SMARCA4,417
chr1,174497598,174497826,SRX5716454,SOX3,228
chr1,174497599,174497864,SRX5716451,SOX2,265
chr1,174497628,174497890,SRX5716464,SMARCA4,262
chr1,174626189,174626371,SRX5075174,SMARCA4,182
chr1,174626225,174626456,SRX5075168,SMARCA4,231
chr1,174652993,174653250,SRX5075168,SMARCA4,257
chr1,174652998,174653303,SRX5075174,SMARCA4,305
chr1,174653017,174653221,SRX5716463,SMARCA4,204
chr1,174692331,174692664,SRX5075174,SMARCA4,333
chr1,174692370,174692594,SRX5054308,FOSL2,224
chr1,174692384,174692613,SRX5054309,FOSL2,229
chr1,174700741,174701049,SRX5075170,SMARCA4,308
chr1,174700772,174700998,SRX5716470,SMARCA4,226
chr1,174700772,174701055,SRX5075176,SMARCA4,283
chr1,174713819,174714262,SRX5075176,SMARCA4,443
chr1,174713939,174714199,SRX5075170,SMARCA4,260
chr1,174713953,174714166,SRX5075169,SMARCA4,213
chr1,174713977,174714234,SRX5716469,SMARCA4,257
chr1,174713981,174714220,SRX5020211,SMARCA2,239
chr1,174726399,174726960,SRX16500060,CTCF,561
chr1,174726446,174726921,SRX16500062,CTCF,475
chr1,174726460,174726936,SRX16500059,CTCF,476
chr1,174726512,174726936,SRX16500061,CTCF,424
chr1,174743856,174744450,SRX16500059,CTCF,594
chr1,174743929,174744416,SRX16500060,CTCF,487
chr1,174743939,174744383,SRX16500062,CTCF,444
chr1,174743946,174744471,SRX16500061,CTCF,525
chr1,174743997,174744253,SRX5716470,SMARCA4,256
chr1,174744024,174744251,SRX5075176,SMARCA4,227
chr1,174744025,174744252,SRX5075170,SMARCA4,227
chr1,174744041,174744296,SRX5075174,SMARCA4,255
chr1,174764273,174764566,SRX5075170,SMARCA4,293
chr1,174764286,174764595,SRX5075176,SMARCA4,309
chr1,174769869,174770461,SRX16500060,CTCF,592
chr1,174769913,174770391,SRX16500061,CTCF,478
chr1,174769939,174770355,SRX16500062,CTCF,416
chr1,174769942,174770412,SRX16500059,CTCF,470
chr1,174770039,174770289,SRX5075176,SMARCA4,250
chr1,174770044,174770274,SRX5075170,SMARCA4,230
chr1,174770079,174770317,SRX5075174,SMARCA4,238
chr1,174770086,174770337,SRX5075168,SMARCA4,251
chr1,174788953,174789763,SRX5054309,FOSL2,810
chr1,174788999,174789391,SRX5075169,SMARCA4,392
chr1,174789031,174789275,SRX5075181,SMARCA2,244
chr1,174789031,174789338,SRX5716469,SMARCA4,307
chr1,174789036,174789339,SRX5054308,FOSL2,303
chr1,174789038,174789243,SRX5020214,SMARCA2,205
chr1,174789041,174789343,SRX5075170,SMARCA4,302
chr1,174789046,174789826,SRX5075176,SMARCA4,780
chr1,174789079,174789420,SRX5075175,SMARCA4,341
chr1,174789337,174789623,SRX5716459,Epitope tags,286
chr1,174789447,174789727,SRX5716469,SMARCA4,280
chr1,174789454,174789719,SRX5716467,SMARCA2,265
chr1,174789463,174789767,SRX5054308,FOSL2,304
chr1,174789468,174789812,SRX5075169,SMARCA4,344
chr1,174789483,174789722,SRX5020214,SMARCA2,239
chr1,174789496,174789757,SRX5075170,SMARCA4,261
chr1,174789511,174789791,SRX5075175,SMARCA4,280
chr1,174789595,174789806,SRX5716470,SMARCA4,211
chr1,174795958,174796174,SRX5054309,FOSL2,216
chr1,174795976,174796192,SRX5054308,FOSL2,216
chr1,174799369,174799878,SRX20140895,INTS13,509
chr1,174799448,174799969,SRX5075176,SMARCA4,521
chr1,174799451,174800021,SRX5075174,SMARCA4,570
chr1,174799454,174800036,SRX5075168,SMARCA4,582
chr1,174799476,174799885,SRX5716463,SMARCA4,409
chr1,174799487,174799921,SRX5075169,SMARCA4,434
chr1,174799488,174800088,SRX5075170,SMARCA4,600
chr1,174799502,174799887,SRX5054309,FOSL2,385
chr1,174799515,174800050,SRX5716470,SMARCA4,535
chr1,174799517,174800036,SRX5716469,SMARCA4,519
chr1,174799521,174799977,SRX5075175,SMARCA4,456
chr1,174799529,174799870,SRX5054308,FOSL2,341
chr1,174799538,174799768,SRX5716464,SMARCA4,230
chr1,174799550,174799908,SRX5716451,SOX2,358
chr1,174799576,174799785,SRX1424893,POU3F2,209
chr1,174799643,174799714,SRX1424894,POU3F2,71
chr1,174812636,174813214,SRX20140895,INTS13,578
chr1,174812739,174813100,SRX5075168,SMARCA4,361
chr1,174812750,174813197,SRX5075174,SMARCA4,447
chr1,174968675,174968980,SRX5054309,FOSL2,305
chr1,174968698,174969019,SRX5075169,SMARCA4,321
chr1,174968728,174968942,SRX5054308,FOSL2,214
chr1,174983134,174983687,SRX16500061,CTCF,553
chr1,174983138,174983625,SRX16500059,CTCF,487
chr1,174983154,174983660,SRX16500060,CTCF,506
chr1,174983163,174983601,SRX16500062,CTCF,438
chr1,174996556,174996809,SRX5054309,FOSL2,253
chr1,174996581,174996802,SRX5054308,FOSL2,221
chr1,174998362,174998906,SRX16500061,CTCF,544
chr1,174998389,174998963,SRX16500059,CTCF,574
chr1,174998407,174998918,SRX16500062,CTCF,511
chr1,174998418,174998923,SRX16500060,CTCF,505
chr1,174998551,174998900,SRX4174629,CTCF,349
chr1,174998867,174999676,SRX20140869,INTS10,809
chr1,174998974,174999587,SRX20140881,CPSF3L,613
chr1,174999024,174999810,SRX20140895,INTS13,786
chr1,174999051,174999665,SRX20140879,CPSF3L,614
chr1,174999074,174999759,SRX20140897,INTS13,685
chr1,174999076,174999728,SRX20140868,INTS10,652
chr1,174999079,174999632,SRX20140894,INTS13,553
chr1,174999085,174999624,SRX20140896,INTS13,539
chr1,174999089,174999702,SRX20140867,INTS10,613
chr1,174999144,175000058,SRX5075174,SMARCA4,914
chr1,174999470,175000134,SRX5075168,SMARCA4,664
chr1,174999670,175000132,SRX5716463,SMARCA4,462
chr1,174999673,174999906,SRX5716454,SOX3,233
chr1,174999680,174999919,SRX5716451,SOX2,239
chr1,174999699,175000002,SRX5716464,SMARCA4,303
chr1,174999801,174999980,SRX5054307,FOSL2,179
chr1,174999920,175000218,SRX5075170,SMARCA4,298
chr1,175023173,175023784,SRX5075168,SMARCA4,611
chr1,175023191,175023462,SRX5716470,SMARCA4,271
chr1,175023204,175023809,SRX20140897,INTS13,605
chr1,175023211,175023858,SRX20140895,INTS13,647
chr1,175023238,175023820,SRX5075174,SMARCA4,582
chr1,175023242,175023814,SRX5075176,SMARCA4,572
chr1,175023288,175023555,SRX5075175,SMARCA4,267
chr1,175023297,175023808,SRX20140867,INTS10,511
chr1,175023309,175023773,SRX20140869,INTS10,464
chr1,175023353,175023566,SRX5716451,SOX2,213
chr1,175023363,175023756,SRX20140868,INTS10,393
chr1,175023371,175023755,SRX5716463,SMARCA4,384
chr1,175023403,175023846,SRX5075170,SMARCA4,443
chr1,175023426,175023791,SRX5716464,SMARCA4,365
chr1,175023432,175023687,SRX5054309,FOSL2,255
chr1,175023493,175023673,SRX5075169,SMARCA4,180
chr1,175023558,175023850,SRX5716470,SMARCA4,292
chr1,175029684,175030060,SRX5075175,SMARCA4,376
chr1,175029691,175030135,SRX4174629,CTCF,444
chr1,175029708,175030003,SRX16500062,CTCF,295
chr1,175029715,175030059,SRX5075174,SMARCA4,344
chr1,175029720,175030032,SRX16500061,CTCF,312
chr1,175029724,175030003,SRX16500059,CTCF,279
chr1,175029725,175030046,SRX5075170,SMARCA4,321
chr1,175029732,175030022,SRX16500060,CTCF,290
chr1,175029737,175030036,SRX5075176,SMARCA4,299
chr1,175029758,175030048,SRX5716469,SMARCA4,290
chr1,175029759,175030001,SRX5075168,SMARCA4,242
chr1,175029789,175029988,SRX5075169,SMARCA4,199
chr1,175029790,175030151,SRX5716470,SMARCA4,361
chr1,175029832,175030154,SRX5716463,SMARCA4,322
chr1,175043706,175044267,SRX5075174,SMARCA4,561
chr1,175043732,175044273,SRX5075168,SMARCA4,541
chr1,175043739,175044161,SRX5716463,SMARCA4,422
chr1,175043789,175044184,SRX5716464,SMARCA4,395
chr1,175043827,175044078,SRX5075176,SMARCA4,251
chr1,175043854,175044044,SRX5716451,SOX2,190
chr1,175069995,175070189,SRX5075174,SMARCA4,194
chr1,175070067,175070246,SRX5075168,SMARCA4,179
chr1,175072340,175072668,SRX5075174,SMARCA4,328
chr1,175072366,175073134,SRX5075176,SMARCA4,768
chr1,175072369,175072944,SRX5075169,SMARCA4,575
chr1,175072375,175073111,SRX5075170,SMARCA4,736
chr1,175072389,175072632,SRX5075168,SMARCA4,243
chr1,175072408,175073097,SRX5716470,SMARCA4,689
chr1,175072419,175072788,SRX5054309,FOSL2,369
chr1,175072450,175072656,SRX5054308,FOSL2,206
chr1,175072475,175072951,SRX5075175,SMARCA4,476
chr1,175072518,175072905,SRX5020211,SMARCA2,387
chr1,175072522,175072727,SRX5020214,SMARCA2,205
chr1,175072542,175072721,SRX5075182,SMARCA2,179
chr1,175072590,175072959,SRX5716469,SMARCA4,369
chr1,175072629,175073009,SRX5716468,SMARCA2,380
chr1,175072676,175072915,SRX5075181,SMARCA2,239
chr1,175072678,175073024,SRX5716467,SMARCA2,346
chr1,175089263,175089702,SRX5075174,SMARCA4,439
chr1,175089282,175089797,SRX5075168,SMARCA4,515
chr1,175089363,175089620,SRX5716463,SMARCA4,257
chr1,175089467,175089694,SRX5716451,SOX2,227
chr1,175125199,175125658,SRX16500060,CTCF,459
chr1,175125262,175125649,SRX16500061,CTCF,387
chr1,175125267,175125659,SRX16500059,CTCF,392
chr1,175125271,175125591,SRX5075174,SMARCA4,320
chr1,175125293,175125588,SRX5075168,SMARCA4,295
chr1,175125293,175125670,SRX16500062,CTCF,377
chr1,175125299,175125565,SRX5716463,SMARCA4,266
chr1,175125303,175125527,SRX5075170,SMARCA4,224
chr1,175125303,175125559,SRX5716464,SMARCA4,256
chr1,175125333,175125522,SRX5075176,SMARCA4,189
chr1,175125344,175125538,SRX5075169,SMARCA4,194
chr1,175129228,175129575,SRX5075176,SMARCA4,347
chr1,175129231,175129467,SRX5075170,SMARCA4,236
chr1,175129965,175130338,SRX5075174,SMARCA4,373
chr1,175130273,175130556,SRX5075168,SMARCA4,283
chr1,175132506,175132691,SRX5054309,FOSL2,185
chr1,175146478,175146956,SRX16500060,CTCF,478
chr1,175146494,175146932,SRX16500061,CTCF,438
chr1,175146520,175146978,SRX16500059,CTCF,458
chr1,175146543,175146969,SRX16500062,CTCF,426
chr1,175146572,175146860,SRX5075174,SMARCA4,288
chr1,175146576,175146876,SRX4174629,CTCF,300
chr1,175146635,175146880,SRX5075168,SMARCA4,245
chr1,175151991,175152449,SRX16500061,CTCF,458
chr1,175151994,175152445,SRX16500059,CTCF,451
chr1,175152033,175152438,SRX16500060,CTCF,405
chr1,175152043,175152396,SRX16500062,CTCF,353
chr1,175152079,175152397,SRX4174629,CTCF,318
chr1,175152146,175152418,SRX5075174,SMARCA4,272
chr1,175152179,175152403,SRX5075168,SMARCA4,224
chr1,175154821,175155250,SRX16500062,CTCF,429
chr1,175154833,175155262,SRX16500060,CTCF,429
chr1,175154840,175155274,SRX16500061,CTCF,434
chr1,175154856,175155268,SRX16500059,CTCF,412
chr1,175154951,175155161,SRX5075174,SMARCA4,210
chr1,175154953,175155225,SRX4174629,CTCF,272
chr1,175162996,175163320,SRX5075170,SMARCA4,324
chr1,175162998,175163287,SRX5716467,SMARCA2,289
chr1,175163017,175163257,SRX5075176,SMARCA4,240
chr1,175164714,175165136,SRX5075174,SMARCA4,422
chr1,175164798,175165066,SRX5075168,SMARCA4,268
chr1,175192866,175193204,SRX16500060,CTCF,338
chr1,175192972,175193257,SRX5075168,SMARCA4,285
chr1,175317335,175317607,SRX16500059,CTCF,272
chr1,175319594,175320066,SRX16500059,CTCF,472
chr1,175319614,175319900,SRX4174629,CTCF,286
chr1,175319623,175320030,SRX16500062,CTCF,407
chr1,175319623,175320073,SRX16500060,CTCF,450
chr1,175319628,175320026,SRX16500061,CTCF,398
chr1,175319697,175319891,SRX5075168,SMARCA4,194
chr1,175319701,175319935,SRX5075174,SMARCA4,234
chr1,175338389,175338894,SRX16500060,CTCF,505
chr1,175338412,175338830,SRX16500059,CTCF,418
chr1,175338449,175338829,SRX16500062,CTCF,380
chr1,175338501,175338850,SRX16500061,CTCF,349
chr1,175373744,175374200,SRX16500060,CTCF,456
chr1,175373755,175374279,SRX16500059,CTCF,524
chr1,175373769,175374186,SRX16500061,CTCF,417
chr1,175373772,175374216,SRX16500062,CTCF,444
chr1,175373831,175374261,SRX4174629,CTCF,430
chr1,175388224,175388732,SRX5075168,SMARCA4,508
chr1,175388339,175388661,SRX5075176,SMARCA4,322
chr1,175388370,175388673,SRX5075170,SMARCA4,303
chr1,175388377,175388655,SRX5075174,SMARCA4,278
chr1,175404253,175404548,SRX5075174,SMARCA4,295
chr1,175434359,175434580,SRX16500060,CTCF,221
chr1,175470167,175470378,SRX5075174,SMARCA4,211
chr1,175481065,175481519,SRX16500061,CTCF,454
chr1,175481066,175481574,SRX16500060,CTCF,508
chr1,175481079,175481662,SRX16500059,CTCF,583
chr1,175481152,175481618,SRX16500062,CTCF,466
chr1,175508816,175509013,SRX5054309,FOSL2,197
chr1,175536457,175536800,SRX5075169,SMARCA4,343
chr1,175548712,175549163,SRX5075176,SMARCA4,451
chr1,175548759,175549080,SRX5075170,SMARCA4,321
chr1,175548765,175549072,SRX5075169,SMARCA4,307
chr1,175548789,175548995,SRX5054309,FOSL2,206
chr1,175555291,175555576,SRX5075175,SMARCA4,285
chr1,175555316,175555592,SRX5075176,SMARCA4,276
chr1,175555322,175555640,SRX5075169,SMARCA4,318
chr1,175555332,175555611,SRX5075170,SMARCA4,279
chr1,175555337,175555574,SRX5054308,FOSL2,237
chr1,175555371,175555601,SRX5054309,FOSL2,230
chr1,175563403,175563902,SRX5075170,SMARCA4,499
chr1,175563414,175563808,SRX5075176,SMARCA4,394
chr1,175599232,175599471,SRX5075174,SMARCA4,239
chr1,175629209,175629487,SRX5716464,SMARCA4,278
chr1,175629279,175629580,SRX5075174,SMARCA4,301
chr1,175629325,175629574,SRX5075168,SMARCA4,249
chr1,175673257,175673819,SRX5075168,SMARCA4,562
chr1,175673452,175673844,SRX5075174,SMARCA4,392
chr1,175725765,175725980,SRX5716464,SMARCA4,215
chr1,175725774,175726005,SRX5075174,SMARCA4,231
chr1,175743035,175743266,SRX5075174,SMARCA4,231
chr1,175743069,175743247,SRX5075170,SMARCA4,178
chr1,175743070,175743271,SRX5075168,SMARCA4,201
chr1,175743455,175743971,SRX16500059,CTCF,516
chr1,175743461,175743982,SRX16500062,CTCF,521
chr1,175743505,175744134,SRX16500060,CTCF,629
chr1,175743566,175743957,SRX16500061,CTCF,391
chr1,175743663,175743943,SRX4174629,CTCF,280
chr1,175744861,175745099,SRX16500059,CTCF,238
chr1,175744885,175745143,SRX16500060,CTCF,258
chr1,175744894,175745104,SRX16500062,CTCF,210
chr1,175744899,175745207,SRX16500061,CTCF,308
chr1,175757333,175757802,SRX16500062,CTCF,469
chr1,175757343,175757789,SRX16500060,CTCF,446
chr1,175757354,175757840,SRX16500059,CTCF,486
chr1,175757360,175757823,SRX16500061,CTCF,463
chr1,175757375,175757707,SRX5075168,SMARCA4,332
chr1,175757422,175757722,SRX5075174,SMARCA4,300
chr1,175784991,175785209,SRX5075174,SMARCA4,218
chr1,175830375,175830554,SRX5075168,SMARCA4,179
chr1,175848426,175848706,SRX20140895,INTS13,280
chr1,175848520,175848698,SRX5075174,SMARCA4,178
chr1,175865417,175865624,SRX5075174,SMARCA4,207
chr1,175885345,175885653,SRX5075176,SMARCA4,308
chr1,175885353,175885593,SRX5716470,SMARCA4,240
chr1,175885474,175885945,SRX5075174,SMARCA4,471
chr1,175885505,175885977,SRX5075168,SMARCA4,472
chr1,175887792,175888373,SRX16500059,CTCF,581
chr1,175887848,175888418,SRX16500060,CTCF,570
chr1,175887856,175888371,SRX16500061,CTCF,515
chr1,175887890,175888374,SRX16500062,CTCF,484
chr1,175888019,175888354,SRX4174629,CTCF,335
chr1,175978298,175978588,SRX5075176,SMARCA4,290
chr1,175978398,175978632,SRX5075170,SMARCA4,234
chr1,176033507,176033736,SRX5054309,FOSL2,229
chr1,176033509,176033781,SRX5054308,FOSL2,272
chr1,176034001,176034287,SRX5075176,SMARCA4,286
chr1,176034034,176034208,SRX5075170,SMARCA4,174
chr1,176058822,176058995,SRX5075174,SMARCA4,173
chr1,176073446,176074053,SRX16500060,CTCF,607
chr1,176073473,176074003,SRX16500061,CTCF,530
chr1,176073489,176073994,SRX16500059,CTCF,505
chr1,176073529,176073989,SRX16500062,CTCF,460
chr1,176073554,176073804,SRX5075176,SMARCA4,250
chr1,176073572,176073823,SRX5075170,SMARCA4,251
chr1,176073582,176073889,SRX5075168,SMARCA4,307
chr1,176073592,176073834,SRX5075174,SMARCA4,242
chr1,176073726,176073974,SRX4174629,CTCF,248
chr1,176160171,176160358,SRX5075168,SMARCA4,187
chr1,176206679,176207683,SRX20140895,INTS13,1004
chr1,176206684,176206878,SRX5075175,SMARCA4,194
chr1,176206810,176207578,SRX20140868,INTS10,768
chr1,176207027,176207621,SRX20140879,CPSF3L,594
chr1,176207054,176207489,SRX20140867,INTS10,435
chr1,176207102,176207856,SRX5075168,SMARCA4,754
chr1,176207117,176207534,SRX5075174,SMARCA4,417
chr1,176207164,176207333,SRX5075170,SMARCA4,169
chr1,176207418,176207708,SRX16500062,CTCF,290
chr1,176207439,176207728,SRX16500059,CTCF,289
chr1,176207563,176207789,SRX5716464,SMARCA4,226
chr1,176207580,176207863,SRX5075170,SMARCA4,283
chr1,176207612,176207852,SRX5075174,SMARCA4,240
chr1,176241454,176241693,SRX5075169,SMARCA4,239
chr1,176241494,176241726,SRX5054309,FOSL2,232
chr1,176241513,176241693,SRX5054308,FOSL2,180
chr1,176374883,176375405,SRX16500059,CTCF,522
chr1,176374928,176375417,SRX16500060,CTCF,489
chr1,176374946,176375370,SRX16500062,CTCF,424
chr1,176374960,176375369,SRX16500061,CTCF,409
chr1,176375003,176375367,SRX4174629,CTCF,364
chr1,176375061,176375334,SRX5075174,SMARCA4,273
chr1,176466505,176466910,SRX16500060,CTCF,405
chr1,176466562,176466915,SRX16500061,CTCF,353
chr1,176466584,176466932,SRX16500059,CTCF,348
chr1,176466607,176466901,SRX16500062,CTCF,294
chr1,176515269,176515600,SRX5075174,SMARCA4,331
chr1,176515390,176515692,SRX5054309,FOSL2,302
chr1,176515408,176515670,SRX5054308,FOSL2,262
chr1,176559693,176560222,SRX16500061,CTCF,529
chr1,176559761,176560198,SRX16500062,CTCF,437
chr1,176559777,176560226,SRX16500060,CTCF,449
chr1,176559779,176560225,SRX16500059,CTCF,446
chr1,176559814,176560208,SRX4174629,CTCF,394
chr1,176559851,176560176,SRX5716463,SMARCA4,325
chr1,176559875,176560166,SRX5075174,SMARCA4,291
chr1,176559883,176560162,SRX5075168,SMARCA4,279
chr1,176559905,176560181,SRX5716464,SMARCA4,276
chr1,176559913,176560114,SRX5075176,SMARCA4,201
chr1,176559918,176560149,SRX5716470,SMARCA4,231
chr1,176559928,176560189,SRX5075170,SMARCA4,261
chr1,176559941,176560170,SRX5075169,SMARCA4,229
chr1,176567249,176567559,SRX5054309,FOSL2,310
chr1,176567312,176567600,SRX5054308,FOSL2,288
chr1,176609931,176610185,SRX5054308,FOSL2,254
chr1,176609943,176610225,SRX5054309,FOSL2,282
chr1,176643578,176643853,SRX5054308,FOSL2,275
chr1,176643600,176643832,SRX5054309,FOSL2,232
chr1,176656282,176656711,SRX5075175,SMARCA4,429
chr1,176656329,176656585,SRX5075169,SMARCA4,256
chr1,176656329,176656622,SRX5075168,SMARCA4,293
chr1,176656349,176656550,SRX5054309,FOSL2,201
chr1,176656353,176656722,SRX5075174,SMARCA4,369
chr1,176656379,176656653,SRX5075170,SMARCA4,274
chr1,176691566,176692082,SRX16500059,CTCF,516
chr1,176691591,176692104,SRX16500060,CTCF,513
chr1,176691633,176691978,SRX5075168,SMARCA4,345
chr1,176691634,176692029,SRX4174629,CTCF,395
chr1,176691644,176691959,SRX5075174,SMARCA4,315
chr1,176691644,176692032,SRX16500062,CTCF,388
chr1,176691656,176692088,SRX16500061,CTCF,432
chr1,176691703,176691917,SRX5716463,SMARCA4,214
chr1,176801783,176802005,SRX5075174,SMARCA4,222
chr1,176801818,176802014,SRX5075168,SMARCA4,196
chr1,176811977,176812307,SRX5075174,SMARCA4,330
chr1,176812000,176812251,SRX5075168,SMARCA4,251
chr1,176843689,176844105,SRX16500062,CTCF,416
chr1,176843706,176844147,SRX16500059,CTCF,441
chr1,176843712,176844107,SRX16500060,CTCF,395
chr1,176843713,176843984,SRX4174629,CTCF,271
chr1,176843721,176844106,SRX16500061,CTCF,385
chr1,176843825,176844033,SRX5075168,SMARCA4,208
chr1,176843837,176844067,SRX5075174,SMARCA4,230
chr1,176858544,176859018,SRX5075174,SMARCA4,474
chr1,176858578,176858996,SRX5075168,SMARCA4,418
chr1,176880924,176881491,SRX16500061,CTCF,567
chr1,176880929,176881446,SRX16500060,CTCF,517
chr1,176880962,176881427,SRX16500059,CTCF,465
chr1,176880962,176881428,SRX16500062,CTCF,466
chr1,176880964,176881334,SRX4174629,CTCF,370
chr1,176880995,176881293,SRX5075168,SMARCA4,298
chr1,176880996,176881244,SRX5075170,SMARCA4,248
chr1,176880998,176881318,SRX5075174,SMARCA4,320
chr1,176881019,176881326,SRX5716463,SMARCA4,307
chr1,176881031,176881241,SRX5075176,SMARCA4,210
chr1,176881080,176881271,SRX5075175,SMARCA4,191
chr1,176881087,176881273,SRX5075169,SMARCA4,186
chr1,176897331,176898158,SRX16500060,CTCF,827
chr1,176897362,176898205,SRX16500059,CTCF,843
chr1,176897410,176898156,SRX16500061,CTCF,746
chr1,176897411,176898183,SRX16500062,CTCF,772
chr1,176897445,176898182,SRX4174629,CTCF,737
chr1,176897458,176897631,SRX5075174,SMARCA4,173
chr1,176897863,176898118,SRX5075174,SMARCA4,255
chr1,176948942,176949402,SRX16500060,CTCF,460
chr1,176948993,176949414,SRX4174629,CTCF,421
chr1,176949001,176949449,SRX16500062,CTCF,448
chr1,176949016,176949454,SRX16500059,CTCF,438
chr1,176949054,176949438,SRX16500061,CTCF,384
chr1,176949122,176949328,SRX5075174,SMARCA4,206
chr1,176954352,176954579,SRX16500060,CTCF,227
chr1,176983651,176984048,SRX5075174,SMARCA4,397
chr1,176983734,176984019,SRX20140867,INTS10,285
chr1,176983875,176984248,SRX5075168,SMARCA4,373
chr1,176996524,176996823,SRX5075174,SMARCA4,299
chr1,176996534,176996937,SRX20140881,CPSF3L,403
chr1,176996609,176997020,SRX5075168,SMARCA4,411
chr1,176996646,176996896,SRX20140867,INTS10,250
chr1,177142741,177142967,SRX5075174,SMARCA4,226
chr1,177164475,177164648,SRX5075174,SMARCA4,173
chr1,177164510,177164827,SRX20140895,INTS13,317
chr1,177164561,177164780,SRX5075168,SMARCA4,219
chr1,177170701,177171072,SRX5075168,SMARCA4,371
chr1,177170754,177171123,SRX5075174,SMARCA4,369
chr1,177181523,177182068,SRX16500060,CTCF,545
chr1,177181554,177182077,SRX16500059,CTCF,523
chr1,177181584,177182087,SRX16500062,CTCF,503
chr1,177181589,177182045,SRX5075174,SMARCA4,456
chr1,177181624,177182009,SRX20140868,INTS10,385
chr1,177181626,177182051,SRX4174629,CTCF,425
chr1,177181658,177182056,SRX16500061,CTCF,398
chr1,177181711,177181953,SRX5075170,SMARCA4,242
chr1,177181727,177182025,SRX5075168,SMARCA4,298
chr1,177181730,177181923,SRX5075176,SMARCA4,193
chr1,177185274,177185508,SRX16500060,CTCF,234
chr1,177185290,177185544,SRX16500059,CTCF,254
chr1,177185298,177185521,SRX16500061,CTCF,223
chr1,177209209,177209708,SRX5075169,SMARCA4,499
chr1,177209249,177209784,SRX5075176,SMARCA4,535
chr1,177209278,177209723,SRX5075170,SMARCA4,445
chr1,177209304,177209682,SRX5075175,SMARCA4,378
chr1,177209325,177209604,SRX5054309,FOSL2,279
chr1,177209326,177209611,SRX5716469,SMARCA4,285
chr1,177256259,177256751,SRX5054309,FOSL2,492
chr1,177256265,177256682,SRX5075175,SMARCA4,417
chr1,177256276,177256689,SRX5054308,FOSL2,413
chr1,177256301,177256674,SRX5075176,SMARCA4,373
chr1,177256307,177256656,SRX5075169,SMARCA4,349
chr1,177256339,177256676,SRX5075170,SMARCA4,337
chr1,177256344,177256535,SRX5075168,SMARCA4,191
chr1,177256376,177256580,SRX5075174,SMARCA4,204
chr1,177256379,177256613,SRX5716469,SMARCA4,234
chr1,177256388,177256599,SRX5716470,SMARCA4,211
chr1,177256435,177256635,SRX5020211,SMARCA2,200
chr1,177274803,177275105,SRX5075176,SMARCA4,302
chr1,177274852,177275163,SRX5075170,SMARCA4,311
chr1,177274895,177275134,SRX5716470,SMARCA4,239
chr1,177274925,177275180,SRX5075169,SMARCA4,255
chr1,177307796,177308108,SRX5054309,FOSL2,312
chr1,177310358,177310707,SRX5075174,SMARCA4,349
chr1,177310413,177310592,SRX5075168,SMARCA4,179
chr1,177311260,177311439,SRX5075168,SMARCA4,179
chr1,177328293,177328524,SRX5054309,FOSL2,231
chr1,177355585,177355932,SRX16500059,CTCF,347
chr1,177355610,177355989,SRX16500060,CTCF,379
chr1,177355620,177355944,SRX16500061,CTCF,324
chr1,177355627,177355931,SRX16500062,CTCF,304
chr1,177368325,177368604,SRX5075168,SMARCA4,279
chr1,177368338,177368535,SRX5075174,SMARCA4,197
chr1,177414205,177414488,SRX5075168,SMARCA4,283
chr1,177433011,177433232,SRX16500060,CTCF,221
chr1,177567552,177567803,SRX16500059,CTCF,251
chr1,177586488,177586752,SRX5054309,FOSL2,264
chr1,177599200,177599373,SRX5075170,SMARCA4,173
chr1,177599218,177599427,SRX5075168,SMARCA4,209
chr1,177780084,177780375,SRX4174629,CTCF,291
chr1,177780108,177780493,SRX16500062,CTCF,385
chr1,177780108,177780500,SRX16500060,CTCF,392
chr1,177780117,177780529,SRX16500059,CTCF,412
chr1,177780142,177780558,SRX16500061,CTCF,416
chr1,177780193,177780380,SRX5075174,SMARCA4,187
chr1,177785128,177785382,SRX5075174,SMARCA4,254
chr1,177839009,177839285,SRX5075174,SMARCA4,276
chr1,177839090,177839364,SRX5716464,SMARCA4,274
chr1,177839112,177839301,SRX5075168,SMARCA4,189
chr1,177873219,177873663,SRX5075170,SMARCA4,444
chr1,177873232,177873611,SRX5075176,SMARCA4,379
chr1,177873234,177873616,SRX5075169,SMARCA4,382
chr1,177873244,177873590,SRX5716469,SMARCA4,346
chr1,177873266,177873653,SRX5054309,FOSL2,387
chr1,177873270,177873615,SRX5075175,SMARCA4,345
chr1,177873276,177873546,SRX5716470,SMARCA4,270
chr1,177873289,177873625,SRX5075168,SMARCA4,336
chr1,177873303,177873523,SRX5020211,SMARCA2,220
chr1,177873307,177873624,SRX5054308,FOSL2,317
chr1,177873331,177873574,SRX5075174,SMARCA4,243
chr1,177913651,177913998,SRX16500061,CTCF,347
chr1,177913706,177914067,SRX16500059,CTCF,361
chr1,177913758,177914005,SRX16500062,CTCF,247
chr1,177926993,177927218,SRX5054308,FOSL2,225
chr1,177926999,177927281,SRX5054309,FOSL2,282
chr1,177927000,177927272,SRX5075169,SMARCA4,272
chr1,177928276,177928500,SRX5075168,SMARCA4,224
chr1,177928289,177928476,SRX5075174,SMARCA4,187
chr1,177945909,177946359,SRX16500059,CTCF,450
chr1,177945917,177946247,SRX4174629,CTCF,330
chr1,177945926,177946358,SRX16500060,CTCF,432
chr1,177945928,177946343,SRX16500061,CTCF,415
chr1,177945944,177946359,SRX16500062,CTCF,415
chr1,177946006,177946217,SRX5075174,SMARCA4,211
chr1,177948286,177948690,SRX4174629,CTCF,404
chr1,177948314,177948774,SRX16500059,CTCF,460
chr1,177948344,177948794,SRX16500061,CTCF,450
chr1,177948346,177948758,SRX16500060,CTCF,412
chr1,177948359,177948732,SRX5075168,SMARCA4,373
chr1,177948368,177948754,SRX16500062,CTCF,386
chr1,177948372,177948724,SRX5075170,SMARCA4,352
chr1,177948379,177948778,SRX5075174,SMARCA4,399
chr1,177948380,177948750,SRX5716463,SMARCA4,370
chr1,177948396,177948705,SRX5075176,SMARCA4,309
chr1,177948396,177948719,SRX5716470,SMARCA4,323
chr1,177948399,177948716,SRX5075169,SMARCA4,317
chr1,177948409,177948725,SRX5075175,SMARCA4,316
chr1,177948431,177948744,SRX5716469,SMARCA4,313
chr1,177948435,177948684,SRX5020211,SMARCA2,249
chr1,177948441,177948715,SRX5716464,SMARCA4,274
chr1,177959702,177960081,SRX16500060,CTCF,379
chr1,177959740,177960078,SRX16500059,CTCF,338
chr1,177959743,177960057,SRX16500061,CTCF,314
chr1,177959796,177960158,SRX5075170,SMARCA4,362
chr1,177959814,177960356,SRX5075174,SMARCA4,542
chr1,177959833,177960044,SRX5716470,SMARCA4,211
chr1,177959834,177960240,SRX5716464,SMARCA4,406
chr1,177959845,177960356,SRX5075168,SMARCA4,511
chr1,177959877,177960141,SRX5075176,SMARCA4,264
chr1,177959885,177960223,SRX5716463,SMARCA4,338
chr1,177959945,177960231,SRX5075169,SMARCA4,286
chr1,177976123,177976620,SRX5075170,SMARCA4,497
chr1,177976146,177976663,SRX5075176,SMARCA4,517
chr1,177976171,177976611,SRX5075175,SMARCA4,440
chr1,177976179,177976472,SRX20140881,CPSF3L,293
chr1,177976182,177976589,SRX5075169,SMARCA4,407
chr1,177976198,177976551,SRX5075174,SMARCA4,353
chr1,177976235,177976498,SRX5075168,SMARCA4,263
chr1,177976240,177976550,SRX5716469,SMARCA4,310
chr1,177976245,177976604,SRX5716470,SMARCA4,359
chr1,177976249,177976540,SRX5054309,FOSL2,291
chr1,177976250,177976538,SRX5054308,FOSL2,288
chr1,177983743,177984479,SRX5075169,SMARCA4,736
chr1,177983770,177984495,SRX5716470,SMARCA4,725
chr1,177983788,177984502,SRX5075176,SMARCA4,714
chr1,177983791,177984486,SRX5716469,SMARCA4,695
chr1,177983797,177984026,SRX5716467,SMARCA2,229
chr1,177983803,177984508,SRX5075175,SMARCA4,705
chr1,177983806,177984498,SRX5075170,SMARCA4,692
chr1,177983816,177984130,SRX5716468,SMARCA2,314
chr1,177984167,177984497,SRX5054309,FOSL2,330
chr1,177984194,177984485,SRX5054308,FOSL2,291
chr1,178004947,178005298,SRX5075169,SMARCA4,351
chr1,178004948,178005260,SRX5075170,SMARCA4,312
chr1,178004988,178005245,SRX5075176,SMARCA4,257
chr1,178005017,178005239,SRX5075175,SMARCA4,222
chr1,178005029,178005209,SRX5054308,FOSL2,180
chr1,178011335,178011763,SRX5075176,SMARCA4,428
chr1,178011435,178011823,SRX5075170,SMARCA4,388
chr1,178011465,178011790,SRX5075169,SMARCA4,325
chr1,178011506,178011757,SRX5054308,FOSL2,251
chr1,178011574,178011799,SRX5075175,SMARCA4,225
chr1,178031736,178032267,SRX16500061,CTCF,531
chr1,178031740,178032234,SRX16500062,CTCF,494
chr1,178031740,178032239,SRX16500059,CTCF,499
chr1,178031750,178032210,SRX16500060,CTCF,460
chr1,178031785,178032197,SRX4174629,CTCF,412
chr1,178031867,178032205,SRX5075174,SMARCA4,338
chr1,178031892,178032239,SRX5075170,SMARCA4,347
chr1,178031901,178032273,SRX5075176,SMARCA4,372
chr1,178031912,178032174,SRX5075168,SMARCA4,262
chr1,178031913,178032158,SRX5075169,SMARCA4,245
chr1,178031915,178032255,SRX5075175,SMARCA4,340
chr1,178031934,178032186,SRX5716470,SMARCA4,252
chr1,178037913,178038134,SRX5075175,SMARCA4,221
chr1,178037918,178038145,SRX5075169,SMARCA4,227
chr1,178048406,178048907,SRX5075176,SMARCA4,501
chr1,178048415,178048871,SRX5075170,SMARCA4,456
chr1,178048449,178048822,SRX5075169,SMARCA4,373
chr1,178053055,178053433,SRX5075176,SMARCA4,378
chr1,178053071,178053476,SRX5054308,FOSL2,405
chr1,178053071,178053604,SRX5075170,SMARCA4,533
chr1,178053089,178053504,SRX5054309,FOSL2,415
chr1,178053116,178053382,SRX5075169,SMARCA4,266
chr1,178053134,178053442,SRX5075175,SMARCA4,308
chr1,178058138,178058411,SRX20140897,INTS13,273
chr1,178058151,178058460,SRX5716469,SMARCA4,309
chr1,178058198,178058433,SRX5075170,SMARCA4,235
chr1,178058220,178058407,SRX5075175,SMARCA4,187
chr1,178058265,178058462,SRX5075176,SMARCA4,197
chr1,178060874,178061305,SRX5054309,FOSL2,431
chr1,178060890,178061487,SRX5075170,SMARCA4,597
chr1,178060963,178061396,SRX5075176,SMARCA4,433
chr1,178061007,178061248,SRX5054308,FOSL2,241
chr1,178061203,178061447,SRX5075174,SMARCA4,244
chr1,178093227,178093414,SRX5075176,SMARCA4,187
chr1,178093266,178093760,SRX5075168,SMARCA4,494
chr1,178093323,178093748,SRX5075170,SMARCA4,425
chr1,178093360,178094630,SRX20140895,INTS13,1270
chr1,178093390,178093756,SRX20140868,INTS10,366
chr1,178093392,178093767,SRX5075174,SMARCA4,375
chr1,178093466,178093733,SRX20140879,CPSF3L,267
chr1,178093483,178093721,SRX5716464,SMARCA4,238
chr1,178093496,178093753,SRX5075176,SMARCA4,257
chr1,178093512,178093704,SRX5716451,SOX2,192
chr1,178093548,178093952,SRX20140867,INTS10,404
chr1,178093588,178093905,SRX5716463,SMARCA4,317
chr1,178094379,178094567,SRX5075168,SMARCA4,188
chr1,178101725,178101986,SRX5716468,SMARCA2,261
chr1,178101728,178101929,SRX5075175,SMARCA4,201
chr1,178101738,178101967,SRX5054308,FOSL2,229
chr1,178101749,178101986,SRX5020211,SMARCA2,237
chr1,178101757,178101982,SRX5075170,SMARCA4,225
chr1,178101762,178101983,SRX5075176,SMARCA4,221
chr1,178109430,178109727,SRX5054309,FOSL2,297
chr1,178109474,178109750,SRX5075169,SMARCA4,276
chr1,178109477,178109681,SRX5075175,SMARCA4,204
chr1,178109483,178109731,SRX5054308,FOSL2,248
chr1,178109486,178109674,SRX5075170,SMARCA4,188
chr1,178109502,178109713,SRX5075176,SMARCA4,211
chr1,178121797,178122375,SRX5075168,SMARCA4,578
chr1,178121921,178122356,SRX5075174,SMARCA4,435
chr1,178121936,178122329,SRX5716463,SMARCA4,393
chr1,178121991,178122250,SRX5716451,SOX2,259
chr1,178122019,178122224,SRX5716454,SOX3,205
chr1,178126761,178127102,SRX5075175,SMARCA4,341
chr1,178126763,178127139,SRX5075169,SMARCA4,376
chr1,178126805,178126974,SRX5075170,SMARCA4,169
chr1,178126818,178127087,SRX5054309,FOSL2,269
chr1,178134049,178134333,SRX5075170,SMARCA4,284
chr1,178134087,178134309,SRX5075169,SMARCA4,222
chr1,178134098,178134335,SRX5075175,SMARCA4,237
chr1,178134104,178134302,SRX5075176,SMARCA4,198
chr1,178150714,178150925,SRX5075169,SMARCA4,211
chr1,178155942,178156111,SRX5075170,SMARCA4,169
chr1,178155990,178156234,SRX5075169,SMARCA4,244
chr1,178168658,178168878,SRX5054309,FOSL2,220
chr1,178172991,178173311,SRX5075168,SMARCA4,320
chr1,178173058,178173335,SRX5075174,SMARCA4,277
chr1,178173139,178173314,SRX5075176,SMARCA4,175
chr1,178189833,178190144,SRX16500061,CTCF,311
chr1,178189833,178190168,SRX16500060,CTCF,335
chr1,178189843,178190127,SRX16500059,CTCF,284
chr1,178189864,178190139,SRX16500062,CTCF,275
chr1,178189909,178190137,SRX5075174,SMARCA4,228
chr1,178192757,178193086,SRX5075175,SMARCA4,329
chr1,178192761,178193143,SRX5075169,SMARCA4,382
chr1,178192824,178193035,SRX5075170,SMARCA4,211
chr1,178238642,178239145,SRX5075170,SMARCA4,503
chr1,178238659,178239386,SRX5075176,SMARCA4,727
chr1,178238685,178239420,SRX5075169,SMARCA4,735
chr1,178238698,178239119,SRX5020211,SMARCA2,421
chr1,178238704,178239311,SRX5716470,SMARCA4,607
chr1,178238706,178239332,SRX5716469,SMARCA4,626
chr1,178238727,178239400,SRX5075175,SMARCA4,673
chr1,178238736,178239105,SRX5054308,FOSL2,369
chr1,178238737,178239208,SRX5054309,FOSL2,471
chr1,178238754,178239313,SRX5716467,SMARCA2,559
chr1,178238761,178238999,SRX5075181,SMARCA2,238
chr1,178238787,178239089,SRX5075182,SMARCA2,302
chr1,178238795,178239395,SRX5020214,SMARCA2,600
chr1,178238813,178239075,SRX5716468,SMARCA2,262
chr1,178239174,178239393,SRX5075181,SMARCA2,219
chr1,178241156,178241357,SRX5075169,SMARCA4,201
chr1,178262008,178262485,SRX5075174,SMARCA4,477
chr1,178262020,178262568,SRX5075168,SMARCA4,548
chr1,178262071,178262506,SRX5075169,SMARCA4,435
chr1,178262085,178262535,SRX5075170,SMARCA4,450
chr1,178262086,178262449,SRX5716451,SOX2,363
chr1,178262111,178262477,SRX5716463,SMARCA4,366
chr1,178262119,178262623,SRX5716469,SMARCA4,504
chr1,178262130,178262434,SRX5716454,SOX3,304
chr1,178262142,178262498,SRX5716470,SMARCA4,356
chr1,178262156,178262599,SRX5075176,SMARCA4,443
chr1,178262159,178262465,SRX5075175,SMARCA4,306
chr1,178267649,178268044,SRX5054309,FOSL2,395
chr1,178282802,178283203,SRX16500059,CTCF,401
chr1,178282817,178283213,SRX16500061,CTCF,396
chr1,178282844,178283223,SRX16500060,CTCF,379
chr1,178282859,178283204,SRX16500062,CTCF,345
chr1,178282963,178283145,SRX5075176,SMARCA4,182
chr1,178283012,178283219,SRX5075170,SMARCA4,207
chr1,178294599,178294947,SRX5716463,SMARCA4,348
chr1,178294599,178295030,SRX5075174,SMARCA4,431
chr1,178294602,178295036,SRX5075168,SMARCA4,434
chr1,178294715,178294943,SRX5716451,SOX2,228
chr1,178294729,178295059,SRX16500062,CTCF,330
chr1,178294736,178295129,SRX16500059,CTCF,393
chr1,178294790,178295152,SRX16500060,CTCF,362
chr1,178294833,178295124,SRX16500061,CTCF,291
chr1,178299829,178300379,SRX16500059,CTCF,550
chr1,178299882,178300378,SRX16500061,CTCF,496
chr1,178299890,178300394,SRX16500062,CTCF,504
chr1,178299895,178300171,SRX4174629,CTCF,276
chr1,178299912,178300339,SRX16500060,CTCF,427
chr1,178299974,178300247,SRX5075168,SMARCA4,273
chr1,178299975,178300296,SRX5075176,SMARCA4,321
chr1,178299978,178300303,SRX5075170,SMARCA4,325
chr1,178299999,178300330,SRX5075174,SMARCA4,331
chr1,178300019,178300221,SRX5075175,SMARCA4,202
chr1,178300032,178300339,SRX5716464,SMARCA4,307
chr1,178300060,178300291,SRX5075169,SMARCA4,231
chr1,178300066,178300277,SRX5716470,SMARCA4,211
chr1,178300102,178300314,SRX5716469,SMARCA4,212
chr1,178300120,178300335,SRX5716467,SMARCA2,215
chr1,178310560,178311091,SRX16500060,CTCF,531
chr1,178310586,178311056,SRX16500062,CTCF,470
chr1,178310590,178311081,SRX16500061,CTCF,491
chr1,178310590,178311088,SRX16500059,CTCF,498
chr1,178310629,178310903,SRX4174629,CTCF,274
chr1,178310683,178311038,SRX5075168,SMARCA4,355
chr1,178310698,178311060,SRX5075174,SMARCA4,362
chr1,178310713,178311039,SRX5075170,SMARCA4,326
chr1,178310769,178311018,SRX5716463,SMARCA4,249
chr1,178310771,178311045,SRX5075176,SMARCA4,274
chr1,178310782,178310993,SRX5716470,SMARCA4,211
chr1,178310808,178311007,SRX5075169,SMARCA4,199
chr1,178310827,178311039,SRX5716469,SMARCA4,212
chr1,178341177,178341557,SRX5075174,SMARCA4,380
chr1,178341203,178341622,SRX5075168,SMARCA4,419
chr1,178341206,178341538,SRX20140895,INTS13,332
chr1,178341208,178341607,SRX5075175,SMARCA4,399
chr1,178341221,178341470,SRX20140867,INTS10,249
chr1,178341221,178341637,SRX5075170,SMARCA4,416
chr1,178341225,178341647,SRX5075176,SMARCA4,422
chr1,178341254,178341586,SRX5075169,SMARCA4,332
chr1,178341266,178341527,SRX5716464,SMARCA4,261
chr1,178341274,178341582,SRX5716463,SMARCA4,308
chr1,178341309,178341542,SRX5716469,SMARCA4,233
chr1,178341334,178341524,SRX5716451,SOX2,190
chr1,178341384,178341599,SRX5716467,SMARCA2,215
chr1,178344349,178344738,SRX5075174,SMARCA4,389
chr1,178344396,178344872,SRX16500062,CTCF,476
chr1,178344400,178344690,SRX5716463,SMARCA4,290
chr1,178344412,178344734,SRX5075168,SMARCA4,322
chr1,178344440,178344860,SRX16500060,CTCF,420
chr1,178344445,178344802,SRX16500061,CTCF,357
chr1,178344463,178345042,SRX5075170,SMARCA4,579
chr1,178344466,178344913,SRX16500059,CTCF,447
chr1,178344481,178345094,SRX5075175,SMARCA4,613
chr1,178344488,178345077,SRX5075169,SMARCA4,589
chr1,178344506,178344743,SRX5716470,SMARCA4,237
chr1,178344510,178345142,SRX5075176,SMARCA4,632
chr1,178344524,178344974,SRX5716469,SMARCA4,450
chr1,178344673,178345059,SRX5054309,FOSL2,386
chr1,178344680,178345043,SRX5054308,FOSL2,363
chr1,178344774,178345053,SRX5020214,SMARCA2,279
chr1,178344788,178345005,SRX5716467,SMARCA2,217
chr1,178344805,178345147,SRX5075168,SMARCA4,342
chr1,178344909,178345170,SRX5075174,SMARCA4,261
chr1,178350471,178350694,SRX5075170,SMARCA4,223
chr1,178350477,178350729,SRX5075176,SMARCA4,252
chr1,178371317,178371659,SRX5075176,SMARCA4,342
chr1,178371358,178371581,SRX5075174,SMARCA4,223
chr1,178371367,178371664,SRX5075170,SMARCA4,297
chr1,178371370,178371667,SRX5075168,SMARCA4,297
chr1,178371401,178371607,SRX5075169,SMARCA4,206
chr1,178372082,178372329,SRX5075174,SMARCA4,247
chr1,178372095,178372332,SRX5075168,SMARCA4,237
chr1,178372125,178372445,SRX5075170,SMARCA4,320
chr1,178372137,178372394,SRX5075176,SMARCA4,257
chr1,178379737,178380149,SRX16500060,CTCF,412
chr1,178379806,178380118,SRX16500061,CTCF,312
chr1,178379819,178380188,SRX16500059,CTCF,369
chr1,178379835,178380146,SRX16500062,CTCF,311
chr1,178388505,178388723,SRX5075169,SMARCA4,218
chr1,178388635,178388914,SRX5075170,SMARCA4,279
chr1,178388767,178389142,SRX5075168,SMARCA4,375
chr1,178388868,178389155,SRX5075174,SMARCA4,287
chr1,178389492,178389740,SRX5054309,FOSL2,248
chr1,178397748,178397971,SRX5075169,SMARCA4,223
chr1,178407717,178407956,SRX5075176,SMARCA4,239
chr1,178407731,178407962,SRX5075170,SMARCA4,231
chr1,178417813,178418257,SRX5054309,FOSL2,444
chr1,178417868,178418228,SRX5054308,FOSL2,360
chr1,178417875,178418317,SRX5075169,SMARCA4,442
chr1,178417875,178418317,SRX5075176,SMARCA4,442
chr1,178417883,178418243,SRX5075170,SMARCA4,360
chr1,178417898,178418335,SRX5075175,SMARCA4,437
chr1,178417904,178418229,SRX5716469,SMARCA4,325
chr1,178417934,178418151,SRX5020214,SMARCA2,217
chr1,178417943,178418199,SRX5716467,SMARCA2,256
chr1,178417976,178418311,SRX5716470,SMARCA4,335
chr1,178438409,178439004,SRX5075174,SMARCA4,595
chr1,178438453,178439039,SRX5075168,SMARCA4,586
chr1,178438536,178438840,SRX5716463,SMARCA4,304
chr1,178438639,178438864,SRX5716454,SOX3,225
chr1,178438693,178438918,SRX5716451,SOX2,225
chr1,178451640,178451823,SRX5054309,FOSL2,183
chr1,178461228,178461407,SRX5075174,SMARCA4,179
chr1,178464992,178465403,SRX5054309,FOSL2,411
chr1,178465069,178465486,SRX5075169,SMARCA4,417
chr1,178465071,178465271,SRX5075170,SMARCA4,200
chr1,178465108,178465418,SRX5054308,FOSL2,310
chr1,178485736,178485948,SRX5054309,FOSL2,212
chr1,178501664,178502203,SRX16500060,CTCF,539
chr1,178501677,178502150,SRX16500059,CTCF,473
chr1,178501710,178502073,SRX4174629,CTCF,363
chr1,178501711,178502118,SRX16500062,CTCF,407
chr1,178501713,178502162,SRX16500061,CTCF,449
chr1,178501737,178502074,SRX5716463,SMARCA4,337
chr1,178501738,178502061,SRX5075168,SMARCA4,323
chr1,178501744,178502079,SRX5075170,SMARCA4,335
chr1,178501745,178502091,SRX5075174,SMARCA4,346
chr1,178501755,178502074,SRX5075176,SMARCA4,319
chr1,178501757,178502072,SRX5716464,SMARCA4,315
chr1,178501762,178502060,SRX5075169,SMARCA4,298
chr1,178501778,178502059,SRX5075175,SMARCA4,281
chr1,178501783,178502049,SRX5716470,SMARCA4,266
chr1,178525323,178525501,SRX5075174,SMARCA4,178
chr1,178525336,178525656,SRX5075168,SMARCA4,320
chr1,178530032,178530315,SRX5075170,SMARCA4,283
chr1,178530032,178530352,SRX5075175,SMARCA4,320
chr1,178530071,178530388,SRX5075176,SMARCA4,317
chr1,178530072,178530427,SRX5716469,SMARCA4,355
chr1,178530075,178530315,SRX5054308,FOSL2,240
chr1,178530089,178530377,SRX5054309,FOSL2,288
chr1,178530103,178530375,SRX5075169,SMARCA4,272
chr1,178532233,178532694,SRX16500062,CTCF,461
chr1,178532248,178532754,SRX16500060,CTCF,506
chr1,178532255,178532728,SRX16500061,CTCF,473
chr1,178532263,178532762,SRX16500059,CTCF,499
chr1,178532267,178532658,SRX4174629,CTCF,391
chr1,178532324,178532709,SRX5075174,SMARCA4,385
chr1,178532345,178532731,SRX5075168,SMARCA4,386
chr1,178532390,178532641,SRX5075170,SMARCA4,251
chr1,178532396,178532592,SRX5075175,SMARCA4,196
chr1,178532415,178532597,SRX5075176,SMARCA4,182
chr1,178532433,178532661,SRX5716463,SMARCA4,228
chr1,178532484,178532689,SRX5716464,SMARCA4,205
chr1,178536955,178537352,SRX5075169,SMARCA4,397
chr1,178536977,178537460,SRX5075176,SMARCA4,483
chr1,178537072,178537379,SRX5075175,SMARCA4,307
chr1,178537072,178537426,SRX5075170,SMARCA4,354
chr1,178537080,178537375,SRX5716469,SMARCA4,295
chr1,178537097,178537340,SRX5054309,FOSL2,243
chr1,178537140,178537387,SRX5054308,FOSL2,247
chr1,178538538,178538729,SRX5054309,FOSL2,191
chr1,178538572,178538813,SRX5075176,SMARCA4,241
chr1,178538580,178538795,SRX5075170,SMARCA4,215
chr1,178542344,178542949,SRX16500061,CTCF,605
chr1,178542377,178542988,SRX16500062,CTCF,611
chr1,178542384,178543157,SRX16500059,CTCF,773
chr1,178542412,178543206,SRX16500060,CTCF,794
chr1,178542448,178543340,SRX5075168,SMARCA4,892
chr1,178542549,178543064,SRX5075175,SMARCA4,515
chr1,178542552,178543223,SRX20140868,INTS10,671
chr1,178542563,178543312,SRX20140895,INTS13,749
chr1,178542571,178543017,SRX5075170,SMARCA4,446
chr1,178542578,178543081,SRX5716470,SMARCA4,503
chr1,178542583,178543107,SRX5075174,SMARCA4,524
chr1,178542592,178542883,SRX5075176,SMARCA4,291
chr1,178542597,178543247,SRX4174629,CTCF,650
chr1,178542624,178543011,SRX5075169,SMARCA4,387
chr1,178542630,178542899,SRX5716469,SMARCA4,269
chr1,178542664,178543199,SRX20140879,CPSF3L,535
chr1,178542665,178542878,SRX5716468,SMARCA2,213
chr1,178542696,178543064,SRX20140867,INTS10,368
chr1,178542755,178543025,SRX20140869,INTS10,270
chr1,178542802,178543196,SRX20140881,CPSF3L,394
chr1,178543160,178543341,SRX5075174,SMARCA4,181
chr1,178564139,178564415,SRX5075176,SMARCA4,276
chr1,178564149,178564449,SRX5075170,SMARCA4,300
chr1,178564169,178564401,SRX5716468,SMARCA2,232
chr1,178564240,178564482,SRX5716470,SMARCA4,242
chr1,178576019,178576396,SRX5716469,SMARCA4,377
chr1,178576053,178576290,SRX5075169,SMARCA4,237
chr1,178576064,178576256,SRX5075176,SMARCA4,192
chr1,178576114,178576355,SRX5075170,SMARCA4,241
chr1,178576172,178576359,SRX5075175,SMARCA4,187
chr1,178593585,178593984,SRX5075174,SMARCA4,399
chr1,178593607,178593858,SRX5075168,SMARCA4,251
chr1,178609042,178609237,SRX5075176,SMARCA4,195
chr1,178609051,178609361,SRX5054309,FOSL2,310
chr1,178609058,178609327,SRX5054308,FOSL2,269
chr1,178610597,178610965,SRX5716469,SMARCA4,368
chr1,178610604,178610919,SRX5075176,SMARCA4,315
chr1,178610610,178610903,SRX5716470,SMARCA4,293
chr1,178610613,178610932,SRX5716468,SMARCA2,319
chr1,178610626,178610950,SRX5075170,SMARCA4,324
chr1,178610645,178610923,SRX5075169,SMARCA4,278
chr1,178610645,178610939,SRX5075175,SMARCA4,294
chr1,178610648,178610915,SRX5716467,SMARCA2,267
chr1,178612284,178612670,SRX5054309,FOSL2,386
chr1,178612305,178612574,SRX5075169,SMARCA4,269
chr1,178612330,178612609,SRX5054308,FOSL2,279
chr1,178625683,178625903,SRX5075176,SMARCA4,220
chr1,178629189,178629544,SRX5716469,SMARCA4,355
chr1,178629210,178629518,SRX5075175,SMARCA4,308
chr1,178629212,178629609,SRX5716470,SMARCA4,397
chr1,178629215,178629575,SRX5075170,SMARCA4,360
chr1,178629217,178629558,SRX5075176,SMARCA4,341
chr1,178629246,178629447,SRX5075169,SMARCA4,201
chr1,178629252,178629471,SRX5716467,SMARCA2,219
chr1,178632687,178633420,SRX5054309,FOSL2,733
chr1,178632697,178633098,SRX5716469,SMARCA4,401
chr1,178632703,178633294,SRX5075176,SMARCA4,591
chr1,178632706,178633323,SRX5075169,SMARCA4,617
chr1,178632765,178633342,SRX5075175,SMARCA4,577
chr1,178632774,178633385,SRX5075170,SMARCA4,611
chr1,178632786,178633112,SRX5716470,SMARCA4,326
chr1,178632786,178633249,SRX5716467,SMARCA2,463
chr1,178632802,178633347,SRX5054308,FOSL2,545
chr1,178634433,178634723,SRX5075169,SMARCA4,290
chr1,178634504,178634765,SRX5716468,SMARCA2,261
chr1,178645314,178645535,SRX5075170,SMARCA4,221
chr1,178645348,178645865,SRX5716469,SMARCA4,517
chr1,178645352,178645804,SRX5075176,SMARCA4,452
chr1,178645394,178645705,SRX5075174,SMARCA4,311
chr1,178645403,178645836,SRX5075169,SMARCA4,433
chr1,178645441,178645946,SRX5716470,SMARCA4,505
chr1,178645458,178645734,SRX5716467,SMARCA2,276
chr1,178645486,178645772,SRX5075168,SMARCA4,286
chr1,178645500,178645687,SRX5075175,SMARCA4,187
chr1,178645611,178645818,SRX5075170,SMARCA4,207
chr1,178645832,178646167,SRX5054309,FOSL2,335
chr1,178645948,178646136,SRX5075169,SMARCA4,188
chr1,178650856,178651446,SRX5075168,SMARCA4,590
chr1,178650881,178651292,SRX5075174,SMARCA4,411
chr1,178651040,178651229,SRX5075176,SMARCA4,189
chr1,178651055,178651274,SRX5075169,SMARCA4,219
chr1,178651100,178651513,SRX20140895,INTS13,413
chr1,178684612,178685099,SRX5075169,SMARCA4,487
chr1,178684630,178685014,SRX5716468,SMARCA2,384
chr1,178684633,178685121,SRX5075176,SMARCA4,488
chr1,178684634,178685097,SRX5716470,SMARCA4,463
chr1,178684666,178685052,SRX5075175,SMARCA4,386
chr1,178684669,178685107,SRX5054309,FOSL2,438
chr1,178684707,178685100,SRX5054308,FOSL2,393
chr1,178684708,178685068,SRX5716469,SMARCA4,360
chr1,178684711,178685036,SRX5716467,SMARCA2,325
chr1,178684718,178684991,SRX5020211,SMARCA2,273
chr1,178684718,178685039,SRX5075182,SMARCA2,321
chr1,178684722,178685078,SRX5075170,SMARCA4,356
chr1,178684771,178685034,SRX5020214,SMARCA2,263
chr1,178693515,178693728,SRX5075174,SMARCA4,213
chr1,178706375,178706747,SRX5020211,SMARCA2,372
chr1,178706468,178706755,SRX5075170,SMARCA4,287
chr1,178706507,178706741,SRX5716470,SMARCA4,234
chr1,178706521,178706696,SRX5075176,SMARCA4,175
chr1,178724795,178725643,SRX20140895,INTS13,848
chr1,178724933,178725349,SRX5075174,SMARCA4,416
chr1,178724965,178725310,SRX5075176,SMARCA4,345
chr1,178724999,178725318,SRX5075168,SMARCA4,319
chr1,178725025,178725376,SRX5716470,SMARCA4,351
chr1,178725054,178725312,SRX5075170,SMARCA4,258
chr1,178725205,178725499,SRX20140868,INTS10,294
chr1,178725527,178725908,SRX16500060,CTCF,381
chr1,178726333,178726534,SRX5075174,SMARCA4,201
chr1,178734106,178734325,SRX16500061,CTCF,219
chr1,178768333,178768657,SRX16500060,CTCF,324
chr1,178768397,178768626,SRX16500061,CTCF,229
chr1,178768420,178768713,SRX16500059,CTCF,293
chr1,178768449,178768668,SRX16500062,CTCF,219
chr1,178774285,178774664,SRX16500059,CTCF,379
chr1,178774294,178774674,SRX16500060,CTCF,380
chr1,178774309,178774637,SRX16500062,CTCF,328
chr1,178774333,178774725,SRX16500061,CTCF,392
chr1,178774423,178774621,SRX5075176,SMARCA4,198
chr1,178784071,178784251,SRX5054308,FOSL2,180
chr1,178818458,178818686,SRX5075170,SMARCA4,228
chr1,178847424,178847883,SRX5054309,FOSL2,459
chr1,178847546,178847871,SRX5075176,SMARCA4,325
chr1,178847597,178847931,SRX5075175,SMARCA4,334
chr1,178847624,178847931,SRX5054308,FOSL2,307
chr1,178847638,178847851,SRX5075170,SMARCA4,213
chr1,178847664,178847859,SRX5075169,SMARCA4,195
chr1,178870892,178871337,SRX5075170,SMARCA4,445
chr1,178870932,178871403,SRX5075168,SMARCA4,471
chr1,178870958,178871413,SRX5075174,SMARCA4,455
chr1,178870961,178871248,SRX5075169,SMARCA4,287
chr1,178870963,178871361,SRX5075176,SMARCA4,398
chr1,178871029,178871272,SRX5716469,SMARCA4,243
chr1,178871064,178871381,SRX5716470,SMARCA4,317
chr1,178871119,178871306,SRX5075175,SMARCA4,187
chr1,178932024,178932249,SRX5716467,SMARCA2,225
chr1,178932046,178932226,SRX5075169,SMARCA4,180
chr1,178932100,178932529,SRX5075170,SMARCA4,429
chr1,178932123,178932603,SRX5075175,SMARCA4,480
chr1,178932219,178932513,SRX5716470,SMARCA4,294
chr1,178932271,178932590,SRX5716469,SMARCA4,319
chr1,178932307,178932554,SRX5075176,SMARCA4,247
chr1,178937631,178938199,SRX5075170,SMARCA4,568
chr1,178937666,178938189,SRX5075176,SMARCA4,523
chr1,178937667,178938185,SRX5075169,SMARCA4,518
chr1,178937696,178938146,SRX5716470,SMARCA4,450
chr1,178937721,178938030,SRX5020211,SMARCA2,309
chr1,178937737,178937955,SRX5020214,SMARCA2,218
chr1,178937798,178938028,SRX5716469,SMARCA4,230
chr1,178937819,178938071,SRX5716468,SMARCA2,252
chr1,178937829,178938064,SRX5716467,SMARCA2,235
chr1,178937829,178938126,SRX5075175,SMARCA4,297
chr1,178937842,178938021,SRX5075168,SMARCA4,179
chr1,178938862,178939334,SRX5075170,SMARCA4,472
chr1,178938887,178939314,SRX5075176,SMARCA4,427
chr1,178938938,178939329,SRX5075169,SMARCA4,391
chr1,178938953,178939331,SRX5075175,SMARCA4,378
chr1,178939010,178939331,SRX5716467,SMARCA2,321
chr1,178939033,178939351,SRX5716469,SMARCA4,318
chr1,178939049,178939364,SRX5716470,SMARCA4,315
chr1,178940074,178940339,SRX5054309,FOSL2,265
chr1,178940080,178940365,SRX5075176,SMARCA4,285
chr1,178952663,178952707,SRX1424893,POU3F2,44
chr1,178952664,178952704,SRX1424894,POU3F2,40
chr1,178952941,178953345,SRX5075170,SMARCA4,404
chr1,178952967,178953459,SRX5075176,SMARCA4,492
chr1,178952976,178953262,SRX5020211,SMARCA2,286
chr1,178953010,178953214,SRX5054308,FOSL2,204
chr1,178953019,178953241,SRX5716467,SMARCA2,222
chr1,178953076,178953321,SRX5075175,SMARCA4,245
chr1,178953111,178953358,SRX5075169,SMARCA4,247
chr1,178960512,178960733,SRX5075176,SMARCA4,221
chr1,178961078,178961272,SRX5075176,SMARCA4,194
chr1,178973087,178974235,SRX5075170,SMARCA4,1148
chr1,178973097,178973451,SRX5075168,SMARCA4,354
chr1,178973097,178973515,SRX5716470,SMARCA4,418
chr1,178973130,178974228,SRX5075169,SMARCA4,1098
chr1,178973146,178974274,SRX5075176,SMARCA4,1128
chr1,178973149,178973535,SRX5716469,SMARCA4,386
chr1,178973159,178973398,SRX5075174,SMARCA4,239
chr1,178973220,178973556,SRX5716467,SMARCA2,336
chr1,178973223,178973528,SRX5075175,SMARCA4,305
chr1,178973611,178974121,SRX5020211,SMARCA2,510
chr1,178973620,178974224,SRX5716470,SMARCA4,604
chr1,178973648,178974204,SRX5075174,SMARCA4,556
chr1,178973656,178974179,SRX5075175,SMARCA4,523
chr1,178973660,178974170,SRX5716469,SMARCA4,510
chr1,178973729,178974100,SRX5716468,SMARCA2,371
chr1,178973760,178974211,SRX5075168,SMARCA4,451
chr1,178973762,178974133,SRX5075181,SMARCA2,371
chr1,178973769,178974168,SRX5716467,SMARCA2,399
chr1,179002426,179002922,SRX5075175,SMARCA4,496
chr1,179002469,179003075,SRX5075176,SMARCA4,606
chr1,179002482,179002874,SRX20140895,INTS13,392
chr1,179002495,179002966,SRX5075170,SMARCA4,471
chr1,179002530,179002888,SRX20140868,INTS10,358
chr1,179002531,179002994,SRX5075174,SMARCA4,463
chr1,179002532,179003143,SRX16500060,CTCF,611
chr1,179002548,179002979,SRX5075168,SMARCA4,431
chr1,179002559,179002884,SRX5716469,SMARCA4,325
chr1,179002581,179003163,SRX16500059,CTCF,582
chr1,179002586,179002879,SRX5716464,SMARCA4,293
chr1,179002590,179003111,SRX16500061,CTCF,521
chr1,179002613,179003110,SRX16500062,CTCF,497
chr1,179002628,179002873,SRX5716463,SMARCA4,245
chr1,179002638,179002867,SRX5716467,SMARCA2,229
chr1,179002647,179003170,SRX4174629,CTCF,523
chr1,179002682,179002909,SRX5716470,SMARCA4,227
chr1,179002685,179002937,SRX5075169,SMARCA4,252
chr1,179012136,179012342,SRX5075170,SMARCA4,206
chr1,179012150,179012370,SRX5075176,SMARCA4,220
chr1,179017009,179017453,SRX5075175,SMARCA4,444
chr1,179017026,179017438,SRX5075169,SMARCA4,412
chr1,179017072,179017426,SRX5075170,SMARCA4,354
chr1,179017093,179017467,SRX5075176,SMARCA4,374
chr1,179017094,179017363,SRX5716469,SMARCA4,269
chr1,179017097,179017312,SRX5716467,SMARCA2,215
chr1,179017136,179017357,SRX5716470,SMARCA4,221
chr1,179025459,179025650,SRX5075168,SMARCA4,191
chr1,179025606,179025882,SRX5075174,SMARCA4,276
chr1,179025766,179026171,SRX20140867,INTS10,405
chr1,179025773,179026747,SRX20140895,INTS13,974
chr1,179026154,179026673,SRX20140868,INTS10,519
chr1,179026260,179026453,SRX5075170,SMARCA4,193
chr1,179026284,179026520,SRX5075174,SMARCA4,236
chr1,179026579,179026768,SRX5075174,SMARCA4,189
chr1,179047513,179047904,SRX5075170,SMARCA4,391
chr1,179047714,179048018,SRX5716470,SMARCA4,304
chr1,179047719,179047899,SRX5075169,SMARCA4,180
chr1,179058651,179059009,SRX5075169,SMARCA4,358
chr1,179058717,179058993,SRX5716470,SMARCA4,276
chr1,179061485,179061688,SRX5054308,FOSL2,203
chr1,179079120,179079617,SRX16500059,CTCF,497
chr1,179079140,179079545,SRX16500060,CTCF,405
chr1,179079165,179079521,SRX16500061,CTCF,356
chr1,179079191,179079516,SRX16500062,CTCF,325
chr1,179079216,179079505,SRX4174629,CTCF,289
chr1,179079282,179079470,SRX5075168,SMARCA4,188
chr1,179079282,179079481,SRX5075176,SMARCA4,199
chr1,179081711,179082426,SRX20140895,INTS13,715
chr1,179081712,179082289,SRX20140897,INTS13,577
chr1,179081725,179082146,SRX5075174,SMARCA4,421
chr1,179081757,179082223,SRX5075176,SMARCA4,466
chr1,179081818,179082278,SRX20140868,INTS10,460
chr1,179081832,179082113,SRX5075168,SMARCA4,281
chr1,179081869,179082173,SRX5075170,SMARCA4,304
chr1,179081950,179082282,SRX20140867,INTS10,332
chr1,179082021,179082375,SRX20140869,INTS10,354
chr1,179082533,179082713,SRX5075174,SMARCA4,180
chr1,179105349,179105583,SRX16500062,CTCF,234
chr1,179121095,179121518,SRX16500062,CTCF,423
chr1,179121121,179121430,SRX16500060,CTCF,309
chr1,179121125,179121577,SRX16500059,CTCF,452
chr1,179121135,179121490,SRX16500061,CTCF,355
chr1,179121141,179121407,SRX4174629,CTCF,266
chr1,179121212,179121568,SRX5075176,SMARCA4,356
chr1,179121260,179121530,SRX5075170,SMARCA4,270
chr1,179121290,179121525,SRX5716470,SMARCA4,235
chr1,179121291,179121525,SRX5075169,SMARCA4,234
chr1,179127202,179127470,SRX5075176,SMARCA4,268
chr1,179127216,179127438,SRX5075170,SMARCA4,222
chr1,179127255,179127497,SRX5054308,FOSL2,242
chr1,179127260,179127497,SRX5054309,FOSL2,237
chr1,179127276,179127606,SRX5075169,SMARCA4,330
chr1,179141238,179141517,SRX5075168,SMARCA4,279
chr1,179141521,179142064,SRX5075174,SMARCA4,543
chr1,179141600,179142118,SRX5075168,SMARCA4,518
chr1,179141634,179141850,SRX5075176,SMARCA4,216
chr1,179142978,179143733,SRX5075170,SMARCA4,755
chr1,179142990,179143733,SRX5075176,SMARCA4,743
chr1,179143023,179143695,SRX5075169,SMARCA4,672
chr1,179143024,179143706,SRX5716470,SMARCA4,682
chr1,179143034,179143692,SRX5075175,SMARCA4,658
chr1,179143043,179143671,SRX5054309,FOSL2,628
chr1,179143059,179143751,SRX5716469,SMARCA4,692
chr1,179143062,179143705,SRX5054308,FOSL2,643
chr1,179143087,179143338,SRX5075181,SMARCA2,251
chr1,179143153,179143648,SRX5716467,SMARCA2,495
chr1,179143393,179143610,SRX5716468,SMARCA2,217
chr1,179143404,179143607,SRX5020211,SMARCA2,203
chr1,179143420,179143625,SRX5075181,SMARCA2,205
chr1,179153239,179153411,SRX5075170,SMARCA4,172
chr1,179164442,179164918,SRX5075176,SMARCA4,476
chr1,179164453,179164851,SRX5075168,SMARCA4,398
chr1,179164467,179164847,SRX5020211,SMARCA2,380
chr1,179164486,179164844,SRX5716469,SMARCA4,358
chr1,179164488,179164881,SRX5075174,SMARCA4,393
chr1,179164498,179164892,SRX5075169,SMARCA4,394
chr1,179164508,179164882,SRX5075170,SMARCA4,374
chr1,179164518,179164908,SRX5054308,FOSL2,390
chr1,179164523,179164918,SRX5075175,SMARCA4,395
chr1,179164534,179164883,SRX5054309,FOSL2,349
chr1,179164554,179164868,SRX5716467,SMARCA2,314
chr1,179164557,179164850,SRX5716463,SMARCA4,293
chr1,179164560,179164769,SRX5020214,SMARCA2,209
chr1,179164562,179164830,SRX5716464,SMARCA4,268
chr1,179164575,179164866,SRX5716470,SMARCA4,291
chr1,179166724,179167086,SRX5075170,SMARCA4,362
chr1,179166752,179167259,SRX5075169,SMARCA4,507
chr1,179166761,179166947,SRX5075176,SMARCA4,186
chr1,179166766,179166976,SRX5020211,SMARCA2,210
chr1,179166770,179166968,SRX5075175,SMARCA4,198
chr1,179169609,179169933,SRX5054309,FOSL2,324
chr1,179169651,179169912,SRX5054308,FOSL2,261
chr1,179169658,179169901,SRX5075175,SMARCA4,243
chr1,179169670,179169965,SRX5075169,SMARCA4,295
chr1,179169687,179169882,SRX5075176,SMARCA4,195
chr1,179169697,179169887,SRX5075170,SMARCA4,190
chr1,179175455,179175954,SRX5075168,SMARCA4,499
chr1,179175615,179175930,SRX5075174,SMARCA4,315
chr1,179178940,179179273,SRX5054309,FOSL2,333
chr1,179178987,179179266,SRX5075170,SMARCA4,279
chr1,179179000,179179271,SRX5054308,FOSL2,271
chr1,179179025,179179228,SRX5075176,SMARCA4,203
chr1,179179049,179179246,SRX5075169,SMARCA4,197
chr1,179193772,179194297,SRX16500060,CTCF,525
chr1,179193779,179194119,SRX16500062,CTCF,340
chr1,179193793,179194243,SRX16500061,CTCF,450
chr1,179193823,179194234,SRX16500059,CTCF,411
chr1,179193837,179194062,SRX5075170,SMARCA4,225
chr1,179218007,179218250,SRX5054308,FOSL2,243
chr1,179218019,179218251,SRX5075170,SMARCA4,232
chr1,179218032,179218313,SRX5075176,SMARCA4,281
chr1,179218059,179218263,SRX5075169,SMARCA4,204
chr1,179229212,179229882,SRX20140895,INTS13,670
chr1,179229398,179229894,SRX20140868,INTS10,496
chr1,179229411,179229588,SRX5075174,SMARCA4,177
chr1,179230390,179230645,SRX5054309,FOSL2,255
chr1,179230423,179230649,SRX5075176,SMARCA4,226
chr1,179241606,179241983,SRX5075168,SMARCA4,377
chr1,179241627,179241945,SRX5075174,SMARCA4,318
chr1,179247178,179247374,SRX5075174,SMARCA4,196
chr1,179247206,179247422,SRX5075168,SMARCA4,216
chr1,179251736,179251994,SRX16500062,CTCF,258
chr1,179251771,179252016,SRX16500060,CTCF,245
chr1,179251793,179252060,SRX16500059,CTCF,267
chr1,179292423,179292658,SRX16500059,CTCF,235
chr1,179293394,179294019,SRX5075176,SMARCA4,625
chr1,179293445,179293976,SRX5075169,SMARCA4,531
chr1,179293448,179294117,SRX5075174,SMARCA4,669
chr1,179293464,179293697,SRX5075170,SMARCA4,233
chr1,179293465,179294066,SRX5075168,SMARCA4,601
chr1,179293491,179293735,SRX5716470,SMARCA4,244
chr1,179293505,179294251,SRX20140895,INTS13,746
chr1,179293539,179293742,SRX5075175,SMARCA4,203
chr1,179293549,179293902,SRX5716464,SMARCA4,353
chr1,179293601,179293794,SRX5054307,FOSL2,193
chr1,179293663,179294197,SRX20140868,INTS10,534
chr1,179293672,179294087,SRX20140867,INTS10,415
chr1,179293741,179293985,SRX20140897,INTS13,244
chr1,179293761,179294073,SRX20140894,INTS13,312
chr1,179293811,179294059,SRX20140879,CPSF3L,248
chr1,179293811,179294072,SRX20140881,CPSF3L,261
chr1,179293847,179294036,SRX5075175,SMARCA4,189
chr1,179294985,179295165,SRX5054308,FOSL2,180
chr1,179294990,179295211,SRX5054309,FOSL2,221
chr1,179305466,179305746,SRX5054308,FOSL2,280
chr1,179305492,179305743,SRX5054309,FOSL2,251
chr1,179310679,179311054,SRX5075170,SMARCA4,375
chr1,179310710,179311024,SRX5075169,SMARCA4,314
chr1,179310718,179311145,SRX5075175,SMARCA4,427
chr1,179310768,179311067,SRX5075176,SMARCA4,299
chr1,179310779,179311032,SRX5716469,SMARCA4,253
chr1,179310785,179311047,SRX5054309,FOSL2,262
chr1,179318494,179318810,SRX5075168,SMARCA4,316
chr1,179318538,179318865,SRX5075174,SMARCA4,327
chr1,179318562,179318780,SRX5716463,SMARCA4,218
chr1,179318613,179318835,SRX5716451,SOX2,222
chr1,179353663,179353858,SRX5054308,FOSL2,195
chr1,179353671,179353904,SRX5054309,FOSL2,233
chr1,179353682,179353901,SRX5075169,SMARCA4,219
chr1,179365520,179365790,SRX5075175,SMARCA4,270
chr1,179365522,179365812,SRX5054308,FOSL2,290
chr1,179365528,179366132,SRX20140895,INTS13,604
chr1,179365540,179365778,SRX5075168,SMARCA4,238
chr1,179365546,179365895,SRX5054309,FOSL2,349
chr1,179365548,179366061,SRX5075170,SMARCA4,513
chr1,179365557,179365834,SRX5716463,SMARCA4,277
chr1,179365559,179366122,SRX5075169,SMARCA4,563
chr1,179365585,179365811,SRX5054307,FOSL2,226
chr1,179365587,179366227,SRX5075174,SMARCA4,640
chr1,179365642,179365856,SRX20140867,INTS10,214
chr1,179365652,179366040,SRX20140868,INTS10,388
chr1,179365676,179365950,SRX20140897,INTS13,274
chr1,179365684,179365909,SRX5716470,SMARCA4,225
chr1,179365687,179366159,SRX20140869,INTS10,472
chr1,179365774,179366315,SRX5075176,SMARCA4,541
chr1,179365866,179366138,SRX5075168,SMARCA4,272
chr1,179369593,179370149,SRX16500061,CTCF,556
chr1,179369642,179370178,SRX16500059,CTCF,536
chr1,179369646,179370172,SRX16500060,CTCF,526
chr1,179369675,179370146,SRX16500062,CTCF,471
chr1,179529451,179529892,SRX5075168,SMARCA4,441
chr1,179529491,179529862,SRX5075174,SMARCA4,371
chr1,179550840,179551090,SRX5054309,FOSL2,250
chr1,179551409,179551613,SRX5054308,FOSL2,204
chr1,179586213,179586514,SRX5075176,SMARCA4,301
chr1,179586256,179586551,SRX5075168,SMARCA4,295
chr1,179586273,179586649,SRX16500060,CTCF,376
chr1,179586341,179586654,SRX16500059,CTCF,313
chr1,179599626,179600007,SRX16500061,CTCF,381
chr1,179599665,179600033,SRX16500059,CTCF,368
chr1,179599676,179600094,SRX16500060,CTCF,418
chr1,179599689,179599989,SRX16500062,CTCF,300
chr1,179599702,179599924,SRX5075168,SMARCA4,222
chr1,179599751,179599936,SRX5075174,SMARCA4,185
chr1,179706186,179706761,SRX16500061,CTCF,575
chr1,179706263,179706762,SRX16500059,CTCF,499
chr1,179706321,179706789,SRX16500060,CTCF,468
chr1,179706329,179706790,SRX16500062,CTCF,461
chr1,179706394,179706573,SRX5075168,SMARCA4,179
chr1,179706411,179706728,SRX4174629,CTCF,317
chr1,179706424,179706661,SRX5075174,SMARCA4,237
chr1,179706442,179706641,SRX5075176,SMARCA4,199
chr1,179809730,179810211,SRX16500061,CTCF,481
chr1,179809735,179810208,SRX16500062,CTCF,473
chr1,179809762,179810242,SRX16500059,CTCF,480
chr1,179809771,179810163,SRX4174629,CTCF,392
chr1,179809786,179810230,SRX16500060,CTCF,444
chr1,179809835,179810098,SRX5075168,SMARCA4,263
chr1,179809879,179810111,SRX5075174,SMARCA4,232
chr1,179814668,179815228,SRX5075176,SMARCA4,560
chr1,179814678,179815083,SRX5716470,SMARCA4,405
chr1,179814684,179815095,SRX16500059,CTCF,411
chr1,179814698,179815191,SRX5075174,SMARCA4,493
chr1,179814704,179815101,SRX16500061,CTCF,397
chr1,179814708,179815123,SRX5716463,SMARCA4,415
chr1,179814711,179815152,SRX5075175,SMARCA4,441
chr1,179814715,179815187,SRX5075168,SMARCA4,472
chr1,179814716,179815099,SRX5716469,SMARCA4,383
chr1,179814730,179815117,SRX16500062,CTCF,387
chr1,179814730,179815125,SRX16500060,CTCF,395
chr1,179814739,179814995,SRX5075181,SMARCA2,256
chr1,179814740,179815134,SRX5075170,SMARCA4,394
chr1,179814741,179815169,SRX5075169,SMARCA4,428
chr1,179814745,179815038,SRX5716464,SMARCA4,293
chr1,179814761,179814988,SRX5716467,SMARCA2,227
chr1,179814772,179814999,SRX5716468,SMARCA2,227
chr1,179814785,179815132,SRX4174629,CTCF,347
chr1,179814830,179815052,SRX5020211,SMARCA2,222
chr1,179814832,179815045,SRX5075182,SMARCA2,213
chr1,179858623,179858913,SRX5075168,SMARCA4,290
chr1,179858630,179858944,SRX5075174,SMARCA4,314
chr1,179867675,179868063,SRX16500061,CTCF,388
chr1,179867718,179868094,SRX16500059,CTCF,376
chr1,179867737,179868129,SRX16500060,CTCF,392
chr1,179867775,179868105,SRX16500062,CTCF,330
chr1,179876302,179876570,SRX5054308,FOSL2,268
chr1,179876313,179876496,SRX5054309,FOSL2,183
chr1,179877553,179877847,SRX20140879,CPSF3L,294
chr1,179877603,179877997,SRX20140895,INTS13,394
chr1,179877655,179878011,SRX5075168,SMARCA4,356
chr1,179877678,179878053,SRX5075174,SMARCA4,375
chr1,179877688,179877880,SRX5075176,SMARCA4,192
chr1,179877725,179877994,SRX5716463,SMARCA4,269
chr1,179881934,179882380,SRX5075170,SMARCA4,446
chr1,179881953,179882473,SRX5716470,SMARCA4,520
chr1,179881994,179882449,SRX5075176,SMARCA4,455
chr1,179882069,179883201,SRX20140895,INTS13,1132
chr1,179882079,179883202,SRX20140867,INTS10,1123
chr1,179882134,179882916,SRX20140869,INTS10,782
chr1,179882150,179883077,SRX20140897,INTS13,927
chr1,179882196,179882553,SRX20140896,INTS13,357
chr1,179882230,179883069,SRX20140868,INTS10,839
chr1,179882241,179883076,SRX20140881,CPSF3L,835
chr1,179882430,179883069,SRX5075174,SMARCA4,639
chr1,179882491,179883082,SRX16500062,CTCF,591
chr1,179882511,179882869,SRX5075168,SMARCA4,358
chr1,179882530,179883144,SRX16500061,CTCF,614
chr1,179882549,179883086,SRX16500060,CTCF,537
chr1,179882562,179883014,SRX16500059,CTCF,452
chr1,179882629,179883123,SRX5075176,SMARCA4,494
chr1,179882632,179883049,SRX5716463,SMARCA4,417
chr1,179882640,179882833,SRX5716451,SOX2,193
chr1,179882693,179882950,SRX5716464,SMARCA4,257
chr1,179882727,179883030,SRX20140879,CPSF3L,303
chr1,179882885,179883129,SRX5075170,SMARCA4,244
chr1,179921532,179921808,SRX5075174,SMARCA4,276
chr1,179921537,179921863,SRX5075168,SMARCA4,326
chr1,179926595,179926785,SRX5054309,FOSL2,190
chr1,179954212,179954423,SRX5716470,SMARCA4,211
chr1,179954287,179954846,SRX5075168,SMARCA4,559
chr1,179954290,179954792,SRX5075176,SMARCA4,502
chr1,179954329,179954769,SRX5075169,SMARCA4,440
chr1,179954366,179954861,SRX5075174,SMARCA4,495
chr1,179954386,179954715,SRX5075170,SMARCA4,329
chr1,179954434,179955287,SRX20140895,INTS13,853
chr1,179954453,179954883,SRX5716463,SMARCA4,430
chr1,179954481,179954963,SRX20140897,INTS13,482
chr1,179954559,179954748,SRX5054308,FOSL2,189
chr1,179954605,179955014,SRX20140867,INTS10,409
chr1,179954640,179955061,SRX20140868,INTS10,421
chr1,179954648,179954892,SRX5716470,SMARCA4,244
chr1,179954666,179955069,SRX20140881,CPSF3L,403
chr1,179954673,179955005,SRX20140896,INTS13,332
chr1,179954681,179955079,SRX20140879,CPSF3L,398
chr1,180026701,180026919,SRX5054309,FOSL2,218
chr1,180028046,180028400,SRX5075169,SMARCA4,354
chr1,180028051,180028263,SRX5716469,SMARCA4,212
chr1,180028055,180028359,SRX5075175,SMARCA4,304
chr1,180028064,180028381,SRX5054309,FOSL2,317
chr1,180028094,180028340,SRX5075176,SMARCA4,246
chr1,180028106,180028338,SRX5075170,SMARCA4,232
chr1,180028113,180028324,SRX5054308,FOSL2,211
chr1,180028133,180028376,SRX5716467,SMARCA2,243
chr1,180031594,180032072,SRX5075174,SMARCA4,478
chr1,180031631,180032050,SRX5716463,SMARCA4,419
chr1,180031678,180032144,SRX5075168,SMARCA4,466
chr1,180031688,180032012,SRX5716464,SMARCA4,324
chr1,180031738,180032010,SRX5716454,SOX3,272
chr1,180031739,180032081,SRX5716451,SOX2,342
chr1,180040141,180040335,SRX5075175,SMARCA4,194
chr1,180040185,180040502,SRX5075169,SMARCA4,317
chr1,180117872,180118114,SRX5075169,SMARCA4,242
chr1,180117882,180118136,SRX5054309,FOSL2,254
chr1,180131467,180131738,SRX5075175,SMARCA4,271
chr1,180151494,180151892,SRX5054309,FOSL2,398
chr1,180151527,180151887,SRX5075175,SMARCA4,360
chr1,180151587,180151762,SRX5075176,SMARCA4,175
chr1,180151588,180151918,SRX5054308,FOSL2,330
chr1,180151594,180151879,SRX5075169,SMARCA4,285
chr1,180154307,180155211,SRX20140895,INTS13,904
chr1,180154413,180155079,SRX5075168,SMARCA4,666
chr1,180154444,180155122,SRX20140867,INTS10,678
chr1,180154445,180155061,SRX5075174,SMARCA4,616
chr1,180154457,180155081,SRX20140868,INTS10,624
chr1,180154501,180155119,SRX5075176,SMARCA4,618
chr1,180154510,180155089,SRX5075170,SMARCA4,579
chr1,180154519,180154739,SRX5716470,SMARCA4,220
chr1,180154541,180155142,SRX20140897,INTS13,601
chr1,180154566,180154780,SRX5716464,SMARCA4,214
chr1,180154567,180155025,SRX5716463,SMARCA4,458
chr1,180154583,180155113,SRX16500059,CTCF,530
chr1,180154671,180155069,SRX16500060,CTCF,398
chr1,180154724,180154986,SRX16500061,CTCF,262
chr1,180154818,180155039,SRX5075169,SMARCA4,221
chr1,180167307,180167518,SRX5716470,SMARCA4,211
chr1,180168666,180169092,SRX16500059,CTCF,426
chr1,180168679,180169032,SRX16500062,CTCF,353
chr1,180168682,180169066,SRX16500061,CTCF,384
chr1,180168705,180169069,SRX16500060,CTCF,364
chr1,180178769,180179261,SRX16500059,CTCF,492
chr1,180178826,180179256,SRX16500060,CTCF,430
chr1,180178838,180179212,SRX16500062,CTCF,374
chr1,180178842,180179150,SRX4174629,CTCF,308
chr1,180178844,180179245,SRX16500061,CTCF,401
chr1,180178909,180179150,SRX5075168,SMARCA4,241
chr1,180178930,180179103,SRX5075174,SMARCA4,173
chr1,180181060,180181400,SRX16500061,CTCF,340
chr1,180181099,180181379,SRX16500062,CTCF,280
chr1,180181112,180181429,SRX16500060,CTCF,317
chr1,180181150,180181427,SRX16500059,CTCF,277
chr1,180188070,180188600,SRX16500059,CTCF,530
chr1,180188081,180188587,SRX16500062,CTCF,506
chr1,180188140,180188573,SRX16500060,CTCF,433
chr1,180188191,180188586,SRX16500061,CTCF,395
chr1,180188218,180188529,SRX5075168,SMARCA4,311
chr1,180188231,180188625,SRX4174629,CTCF,394
chr1,180188339,180188516,SRX5075174,SMARCA4,177
chr1,180210241,180210682,SRX20140895,INTS13,441
chr1,180210289,180210592,SRX5075168,SMARCA4,303
chr1,180210342,180210628,SRX5075174,SMARCA4,286
chr1,180242034,180242203,SRX5075170,SMARCA4,169
chr1,180252538,180253052,SRX16500062,CTCF,514
chr1,180252538,180253094,SRX16500060,CTCF,556
chr1,180252547,180253051,SRX16500059,CTCF,504
chr1,180252601,180253013,SRX16500061,CTCF,412
chr1,180252708,180252928,SRX5075174,SMARCA4,220
chr1,180252720,180252966,SRX4174629,CTCF,246
chr1,180261852,180262152,SRX5716470,SMARCA4,300
chr1,180261918,180262327,SRX5716469,SMARCA4,409
chr1,180271241,180271548,SRX5054308,FOSL2,307
chr1,180271262,180271503,SRX5716469,SMARCA4,241
chr1,180271281,180271504,SRX5020211,SMARCA2,223
chr1,180271282,180271528,SRX5075175,SMARCA4,246
chr1,180271292,180271533,SRX5075169,SMARCA4,241
chr1,180271295,180271478,SRX5054309,FOSL2,183
chr1,180271303,180271583,SRX5075170,SMARCA4,280
chr1,180301409,180301606,SRX5054309,FOSL2,197
chr1,180301457,180301642,SRX5054308,FOSL2,185
chr1,180309276,180309552,SRX5054308,FOSL2,276
chr1,180309283,180309588,SRX5075175,SMARCA4,305
chr1,180309287,180309551,SRX5075170,SMARCA4,264
chr1,180309300,180309567,SRX5716469,SMARCA4,267
chr1,180309310,180309600,SRX5075169,SMARCA4,290
chr1,180309313,180309575,SRX5054309,FOSL2,262
chr1,180309345,180309584,SRX5075176,SMARCA4,239
chr1,180354003,180354238,SRX5716463,SMARCA4,235
chr1,180354062,180354339,SRX5075174,SMARCA4,277
chr1,180354074,180354290,SRX5075168,SMARCA4,216
chr1,180415927,180416501,SRX16500060,CTCF,574
chr1,180415959,180416470,SRX16500059,CTCF,511
chr1,180415977,180416441,SRX16500061,CTCF,464
chr1,180416016,180416460,SRX16500062,CTCF,444
chr1,180416042,180416251,SRX5075174,SMARCA4,209
chr1,180416048,180416253,SRX5075168,SMARCA4,205
chr1,180426057,180426240,SRX5075174,SMARCA4,183
chr1,180439318,180439358,SRX1424894,POU3F2,40
chr1,180439320,180439361,SRX1424893,POU3F2,41
chr1,180478100,180478560,SRX16500059,CTCF,460
chr1,180478156,180478592,SRX16500060,CTCF,436
chr1,180478194,180478514,SRX16500062,CTCF,320
chr1,180478200,180478504,SRX16500061,CTCF,304
chr1,180478226,180478477,SRX5075174,SMARCA4,251
chr1,180478238,180478467,SRX5075168,SMARCA4,229
chr1,180478242,180478484,SRX5075170,SMARCA4,242
chr1,180478251,180478495,SRX5075176,SMARCA4,244
chr1,180482319,180482866,SRX16500060,CTCF,547
chr1,180482325,180482816,SRX16500062,CTCF,491
chr1,180482326,180482874,SRX16500059,CTCF,548
chr1,180482352,180482871,SRX16500061,CTCF,519
chr1,180482505,180482712,SRX5075168,SMARCA4,207
chr1,180482523,180482718,SRX5075174,SMARCA4,195
chr1,180482542,180482711,SRX5075170,SMARCA4,169
chr1,180482558,180482745,SRX5075176,SMARCA4,187
chr1,180502039,180502413,SRX5075174,SMARCA4,374
chr1,180502111,180503047,SRX20140895,INTS13,936
chr1,180502190,180502917,SRX20140897,INTS13,727
chr1,180502232,180502491,SRX5075169,SMARCA4,259
chr1,180502262,180502899,SRX5075168,SMARCA4,637
chr1,180502318,180503027,SRX20140868,INTS10,709
chr1,180502330,180502675,SRX20140896,INTS13,345
chr1,180502362,180502625,SRX5075176,SMARCA4,263
chr1,180502400,180502953,SRX20140867,INTS10,553
chr1,180502407,180502812,SRX20140869,INTS10,405
chr1,180502450,180502656,SRX5716464,SMARCA4,206
chr1,180502492,180503096,SRX5075174,SMARCA4,604
chr1,180502494,180502945,SRX20140879,CPSF3L,451
chr1,180502518,180502771,SRX20140894,INTS13,253
chr1,180502528,180502811,SRX20140881,CPSF3L,283
chr1,180502616,180503079,SRX5075170,SMARCA4,463
chr1,180502763,180503158,SRX5075176,SMARCA4,395
chr1,180508006,180508258,SRX5054308,FOSL2,252
chr1,180508053,180508243,SRX5054309,FOSL2,190
chr1,180515757,180516272,SRX16500059,CTCF,515
chr1,180515758,180516265,SRX16500060,CTCF,507
chr1,180515766,180516239,SRX16500062,CTCF,473
chr1,180515775,180516237,SRX16500061,CTCF,462
chr1,180515785,180516197,SRX4174629,CTCF,412
chr1,180515798,180516231,SRX5075168,SMARCA4,433
chr1,180515840,180516222,SRX5075169,SMARCA4,382
chr1,180515846,180516218,SRX5075176,SMARCA4,372
chr1,180515853,180516188,SRX5075174,SMARCA4,335
chr1,180515855,180516218,SRX5075175,SMARCA4,363
chr1,180515856,180516260,SRX5075170,SMARCA4,404
chr1,180515869,180516125,SRX5716470,SMARCA4,256
chr1,180515876,180516098,SRX5716463,SMARCA4,222
chr1,180515877,180516210,SRX5716464,SMARCA4,333
chr1,180515925,180516175,SRX5716469,SMARCA4,250
chr1,180515970,180516168,SRX5075181,SMARCA2,198
chr1,180516003,180516193,SRX5716451,SOX2,190
chr1,180527470,180527679,SRX5075168,SMARCA4,209
chr1,180533410,180533919,SRX16500060,CTCF,509
chr1,180533437,180533967,SRX16500061,CTCF,530
chr1,180533438,180533906,SRX16500062,CTCF,468
chr1,180533442,180533958,SRX16500059,CTCF,516
chr1,180533490,180533844,SRX4174629,CTCF,354
chr1,180533515,180533862,SRX5075168,SMARCA4,347
chr1,180533580,180533850,SRX5075174,SMARCA4,270
chr1,180533592,180533810,SRX5075170,SMARCA4,218
chr1,180533650,180533854,SRX5716463,SMARCA4,204
chr1,180542774,180542950,SRX5075170,SMARCA4,176
chr1,180542815,180542994,SRX5075168,SMARCA4,179
chr1,180548976,180549347,SRX20140868,INTS10,371
chr1,180548979,180549198,SRX5716451,SOX2,219
chr1,180548984,180549189,SRX5716464,SMARCA4,205
chr1,180548989,180549359,SRX5075168,SMARCA4,370
chr1,180548990,180549268,SRX5075174,SMARCA4,278
chr1,180549020,180549243,SRX5716454,SOX3,223
chr1,180580006,180580611,SRX5075174,SMARCA4,605
chr1,180580110,180580610,SRX5075168,SMARCA4,500
chr1,180580117,180580556,SRX20140895,INTS13,439
chr1,180580234,180580525,SRX5716464,SMARCA4,291
chr1,180580276,180580480,SRX5716463,SMARCA4,204
chr1,180585565,180585748,SRX5054309,FOSL2,183
chr1,180586732,180587122,SRX5075176,SMARCA4,390
chr1,180586818,180587065,SRX5716469,SMARCA4,247
chr1,180586834,180587067,SRX5075174,SMARCA4,233
chr1,180586878,180587067,SRX5075175,SMARCA4,189
chr1,180586880,180587063,SRX5054309,FOSL2,183
chr1,180586883,180587105,SRX5075168,SMARCA4,222
chr1,180586890,180587156,SRX5075169,SMARCA4,266
chr1,180594692,180595246,SRX5075168,SMARCA4,554
chr1,180594703,180595297,SRX5075174,SMARCA4,594
chr1,180594764,180595077,SRX5716464,SMARCA4,313
chr1,180594798,180595150,SRX20140895,INTS13,352
chr1,180594825,180595194,SRX5716463,SMARCA4,369
chr1,180594866,180595106,SRX5054307,FOSL2,240
chr1,180594881,180595210,SRX20140868,INTS10,329
chr1,180594896,180595107,SRX5716451,SOX2,211
chr1,180594925,180595150,SRX5716454,SOX3,225
chr1,180598703,180598880,SRX5075174,SMARCA4,177
chr1,180606151,180606515,SRX5075174,SMARCA4,364
chr1,180606156,180606549,SRX5075168,SMARCA4,393
chr1,180606186,180606514,SRX5716463,SMARCA4,328
chr1,180611226,180611511,SRX5075168,SMARCA4,285
chr1,180611354,180611559,SRX5075174,SMARCA4,205
chr1,180611500,180611795,SRX5716469,SMARCA4,295
chr1,180623978,180624210,SRX16500060,CTCF,232
chr1,180624000,180624233,SRX16500062,CTCF,233
chr1,180631700,180632120,SRX5075176,SMARCA4,420
chr1,180631704,180632167,SRX5075174,SMARCA4,463
chr1,180631725,180632062,SRX5716470,SMARCA4,337
chr1,180631725,180632178,SRX5075168,SMARCA4,453
chr1,180631761,180631989,SRX5716469,SMARCA4,228
chr1,180631769,180632132,SRX5716464,SMARCA4,363
chr1,180631777,180632312,SRX5075170,SMARCA4,535
chr1,180631794,180632116,SRX5075175,SMARCA4,322
chr1,180631796,180632202,SRX5716463,SMARCA4,406
chr1,180631822,180632643,SRX20140895,INTS13,821
chr1,180631909,180632221,SRX20140897,INTS13,312
chr1,180631934,180632344,SRX20140868,INTS10,410
chr1,180631943,180632245,SRX20140881,CPSF3L,302
chr1,180631951,180632365,SRX20140867,INTS10,414
chr1,180632326,180632609,SRX5716469,SMARCA4,283
chr1,180632361,180632689,SRX5075169,SMARCA4,328
chr1,180632410,180632619,SRX5075170,SMARCA4,209
chr1,180632415,180632784,SRX5075168,SMARCA4,369
chr1,180632432,180632760,SRX5075175,SMARCA4,328
chr1,180675638,180675954,SRX5075174,SMARCA4,316
chr1,180675652,180675904,SRX5075170,SMARCA4,252
chr1,180675666,180675926,SRX5054309,FOSL2,260
chr1,180675673,180675926,SRX5054308,FOSL2,253
chr1,180675677,180675883,SRX5075176,SMARCA4,206
chr1,180675749,180676023,SRX5075168,SMARCA4,274
chr1,180691558,180691737,SRX5075168,SMARCA4,179
chr1,180691615,180691843,SRX5075174,SMARCA4,228
chr1,180691668,180691907,SRX5716463,SMARCA4,239
chr1,180773490,180773814,SRX5075175,SMARCA4,324
chr1,180773529,180773820,SRX5075169,SMARCA4,291
chr1,180773540,180773842,SRX5054309,FOSL2,302
chr1,180773541,180773740,SRX5075174,SMARCA4,199
chr1,180773605,180773774,SRX5075170,SMARCA4,169
chr1,180780115,180780370,SRX5075170,SMARCA4,255
chr1,180780121,180780340,SRX5075176,SMARCA4,219
chr1,180780133,180780331,SRX5054308,FOSL2,198
chr1,180780161,180780395,SRX5075175,SMARCA4,234
chr1,180780164,180780419,SRX5075169,SMARCA4,255
chr1,180827269,180827576,SRX5075170,SMARCA4,307
chr1,180827276,180827529,SRX5075176,SMARCA4,253
chr1,180827300,180827486,SRX5075169,SMARCA4,186
chr1,180827334,180827527,SRX5075175,SMARCA4,193
chr1,180836397,180836765,SRX5075174,SMARCA4,368
chr1,180836426,180837436,SRX5075168,SMARCA4,1010
chr1,180836486,180836731,SRX5716463,SMARCA4,245
chr1,180836942,180837485,SRX5075174,SMARCA4,543
chr1,180836980,180837379,SRX5716463,SMARCA4,399
chr1,180837049,180837303,SRX5716464,SMARCA4,254
chr1,180842075,180842449,SRX5075168,SMARCA4,374
chr1,180842080,180842492,SRX5075174,SMARCA4,412
chr1,180842096,180842472,SRX5075176,SMARCA4,376
chr1,180842111,180842379,SRX5075170,SMARCA4,268
chr1,180842121,180842392,SRX5054309,FOSL2,271
chr1,180842131,180842475,SRX5075169,SMARCA4,344
chr1,180842152,180842365,SRX5716469,SMARCA4,213
chr1,180842154,180842389,SRX5716470,SMARCA4,235
chr1,180842160,180842392,SRX5054308,FOSL2,232
chr1,180842256,180842552,SRX5075175,SMARCA4,296
chr1,180842559,180842757,SRX5075176,SMARCA4,198
chr1,180842986,180843215,SRX5075174,SMARCA4,229
chr1,180853939,180854427,SRX5075170,SMARCA4,488
chr1,180854066,180854713,SRX5075168,SMARCA4,647
chr1,180854088,180854708,SRX5075174,SMARCA4,620
chr1,180854095,180854329,SRX5716467,SMARCA2,234
chr1,180854117,180854529,SRX5716463,SMARCA4,412
chr1,180854124,180854692,SRX5075176,SMARCA4,568
chr1,180854145,180854378,SRX5075175,SMARCA4,233
chr1,180854177,180854592,SRX5716469,SMARCA4,415
chr1,180854199,180854403,SRX5075169,SMARCA4,204
chr1,180854226,180854506,SRX5716464,SMARCA4,280
chr1,180854241,180854520,SRX5716468,SMARCA2,279
chr1,180854321,180854656,SRX5716470,SMARCA4,335
chr1,180863094,180863627,SRX16500060,CTCF,533
chr1,180863099,180863650,SRX16500061,CTCF,551
chr1,180863101,180863697,SRX16500059,CTCF,596
chr1,180863133,180863594,SRX16500062,CTCF,461
chr1,180863170,180863411,SRX5075169,SMARCA4,241
chr1,180863178,180863403,SRX5716470,SMARCA4,225
chr1,180863182,180863407,SRX5716469,SMARCA4,225
chr1,180863194,180863490,SRX5075174,SMARCA4,296
chr1,180863209,180863495,SRX5075168,SMARCA4,286
chr1,180863212,180863451,SRX5075176,SMARCA4,239
chr1,180863220,180863463,SRX5716464,SMARCA4,243
chr1,180863244,180863447,SRX5075170,SMARCA4,203
chr1,180872501,180872756,SRX9989505,GFP,255
chr1,180881854,180882271,SRX16500062,CTCF,417
chr1,180881881,180882340,SRX4174629,CTCF,459
chr1,180881886,180882357,SRX16500060,CTCF,471
chr1,180881893,180882373,SRX16500059,CTCF,480
chr1,180881910,180882174,SRX5075168,SMARCA4,264
chr1,180881953,180882351,SRX16500061,CTCF,398
chr1,180881989,180882245,SRX5075174,SMARCA4,256
chr1,180882019,180882224,SRX5716464,SMARCA4,205
chr1,180882046,180882305,SRX5075176,SMARCA4,259
chr1,180882069,180882252,SRX5075169,SMARCA4,183
chr1,180882089,180882258,SRX5075170,SMARCA4,169
chr1,180912365,180912693,SRX5075170,SMARCA4,328
chr1,180912367,180912719,SRX5075176,SMARCA4,352
chr1,180912376,180912797,SRX5716470,SMARCA4,421
chr1,180912586,180912791,SRX5075169,SMARCA4,205
chr1,180912887,180913061,SRX5075170,SMARCA4,174
chr1,180920769,180921007,SRX16500062,CTCF,238
chr1,180923109,180923558,SRX5716463,SMARCA4,449
chr1,180923127,180923563,SRX5075174,SMARCA4,436
chr1,180923167,180923428,SRX5075168,SMARCA4,261
chr1,180923215,180923452,SRX5716464,SMARCA4,237
chr1,180926395,180926954,SRX5075170,SMARCA4,559
chr1,180926423,180926978,SRX5075176,SMARCA4,555
chr1,180926499,180926901,SRX5716469,SMARCA4,402
chr1,180926510,180926846,SRX5075175,SMARCA4,336
chr1,180926520,180926913,SRX5075169,SMARCA4,393
chr1,180926540,180926889,SRX5716470,SMARCA4,349
chr1,180926565,180926969,SRX20140895,INTS13,404
chr1,180926689,180926900,SRX5716468,SMARCA2,211
chr1,180981615,180981990,SRX5075176,SMARCA4,375
chr1,180981694,180982003,SRX5075169,SMARCA4,309
chr1,180981703,180981924,SRX5075175,SMARCA4,221
chr1,180981707,180981971,SRX5075170,SMARCA4,264
chr1,180981716,180982213,SRX5716470,SMARCA4,497
chr1,180988305,180988666,SRX5075176,SMARCA4,361
chr1,180988441,180988767,SRX5075170,SMARCA4,326
chr1,180988460,180988800,SRX20140895,INTS13,340
chr1,181010871,181011093,SRX5716470,SMARCA4,222
chr1,181021894,181022219,SRX5075176,SMARCA4,325
chr1,181021895,181022137,SRX5075175,SMARCA4,242
chr1,181021933,181022112,SRX5075168,SMARCA4,179
chr1,181022514,181023268,SRX20140895,INTS13,754
chr1,181022583,181023128,SRX20140868,INTS10,545
chr1,181022596,181023027,SRX20140881,CPSF3L,431
chr1,181022714,181023069,SRX20140867,INTS10,355
chr1,181022764,181023263,SRX20140897,INTS13,499
chr1,181022767,181023226,SRX5075176,SMARCA4,459
chr1,181022768,181023021,SRX5075168,SMARCA4,253
chr1,181022924,181023195,SRX20140896,INTS13,271
chr1,181022980,181023346,SRX5075170,SMARCA4,366
chr1,181022990,181023226,SRX5075175,SMARCA4,236
chr1,181023124,181023424,SRX5075174,SMARCA4,300
chr1,181023147,181023380,SRX5075168,SMARCA4,233
chr1,181038357,181038795,SRX16500062,CTCF,438
chr1,181038401,181038839,SRX16500059,CTCF,438
chr1,181038414,181038754,SRX16500061,CTCF,340
chr1,181038436,181038812,SRX16500060,CTCF,376
chr1,181038486,181038743,SRX5075174,SMARCA4,257
chr1,181077613,181077965,SRX5054309,FOSL2,352
chr1,181077633,181077997,SRX5054308,FOSL2,364
chr1,181077635,181078083,SRX5075176,SMARCA4,448
chr1,181077668,181078106,SRX5075170,SMARCA4,438
chr1,181077692,181077958,SRX5075175,SMARCA4,266
chr1,181077698,181078020,SRX5075169,SMARCA4,322
chr1,181086968,181087295,SRX5054309,FOSL2,327
chr1,181088392,181088984,SRX20140868,INTS10,592
chr1,181088397,181089139,SRX20140895,INTS13,742
chr1,181088411,181088811,SRX5075168,SMARCA4,400
chr1,181088422,181089033,SRX20140897,INTS13,611
chr1,181088436,181088818,SRX5075174,SMARCA4,382
chr1,181088448,181088987,SRX20140867,INTS10,539
chr1,181088455,181088712,SRX5075170,SMARCA4,257
chr1,181088460,181089047,SRX20140869,INTS10,587
chr1,181088461,181088666,SRX5716464,SMARCA4,205
chr1,181088466,181088980,SRX20140881,CPSF3L,514
chr1,181088472,181088980,SRX20140879,CPSF3L,508
chr1,181088491,181088671,SRX5075176,SMARCA4,180
chr1,181088498,181088748,SRX5054307,FOSL2,250
chr1,181088508,181088894,SRX20140894,INTS13,386
chr1,181088523,181088890,SRX20140896,INTS13,367
chr1,181088564,181088949,SRX20140880,CPSF3L,385
chr1,181088575,181088862,SRX20140882,CPSF3L,287
chr1,181094844,181095122,SRX5716467,SMARCA2,278
chr1,181094859,181095135,SRX5075181,SMARCA2,276
chr1,181094860,181095139,SRX5075175,SMARCA4,279
chr1,181094862,181095180,SRX5075169,SMARCA4,318
chr1,181094874,181095158,SRX5075170,SMARCA4,284
chr1,181094885,181095152,SRX5075176,SMARCA4,267
chr1,181094897,181095177,SRX5716470,SMARCA4,280
chr1,181094900,181095148,SRX5716468,SMARCA2,248
chr1,181094923,181095143,SRX5716469,SMARCA4,220
chr1,181094944,181095134,SRX5054308,FOSL2,190
chr1,181094946,181095140,SRX5054309,FOSL2,194
chr1,181096251,181096665,SRX5075170,SMARCA4,414
chr1,181096255,181096700,SRX5075169,SMARCA4,445
chr1,181096256,181096718,SRX5075176,SMARCA4,462
chr1,181096314,181096547,SRX5716469,SMARCA4,233
chr1,181096330,181096594,SRX5075175,SMARCA4,264
chr1,181096364,181096601,SRX5054309,FOSL2,237
chr1,181096384,181096601,SRX5716468,SMARCA2,217
chr1,181101498,181101953,SRX5075176,SMARCA4,455
chr1,181101539,181101964,SRX5716469,SMARCA4,425
chr1,181101547,181101787,SRX5020214,SMARCA2,240
chr1,181101548,181101858,SRX5075175,SMARCA4,310
chr1,181101551,181101870,SRX5075169,SMARCA4,319
chr1,181101565,181101800,SRX5075168,SMARCA4,235
chr1,181101566,181101849,SRX5075170,SMARCA4,283
chr1,181101566,181101866,SRX5054309,FOSL2,300
chr1,181101570,181101811,SRX5716470,SMARCA4,241
chr1,181101578,181101957,SRX5054308,FOSL2,379
chr1,181101612,181101820,SRX5075182,SMARCA2,208
chr1,181104701,181104987,SRX16500059,CTCF,286
chr1,181104711,181105912,SRX20140895,INTS13,1201
chr1,181104811,181105653,SRX20140868,INTS10,842
chr1,181104934,181105279,SRX20140881,CPSF3L,345
chr1,181104969,181105758,SRX20140867,INTS10,789
chr1,181104974,181105219,SRX20140879,CPSF3L,245
chr1,181104974,181105284,SRX20140869,INTS10,310
chr1,181105023,181105276,SRX20140897,INTS13,253
chr1,181105083,181105363,SRX5716469,SMARCA4,280
chr1,181105106,181105478,SRX5075174,SMARCA4,372
chr1,181105160,181105377,SRX5075170,SMARCA4,217
chr1,181105189,181105469,SRX5075168,SMARCA4,280
chr1,181105202,181105420,SRX5075175,SMARCA4,218
chr1,181105537,181105834,SRX5075168,SMARCA4,297
chr1,181112427,181112860,SRX5075169,SMARCA4,433
chr1,181112434,181112778,SRX5075176,SMARCA4,344
chr1,181112447,181112741,SRX5075170,SMARCA4,294
chr1,181112480,181112753,SRX5054309,FOSL2,273
chr1,181112502,181112753,SRX5716469,SMARCA4,251
chr1,181112503,181112752,SRX5075175,SMARCA4,249
chr1,181112507,181112726,SRX5054308,FOSL2,219
chr1,181117707,181117995,SRX5075170,SMARCA4,288
chr1,181117776,181118076,SRX5075176,SMARCA4,300
chr1,181117932,181118200,SRX5075168,SMARCA4,268
chr1,181128619,181129059,SRX20140895,INTS13,440
chr1,181128645,181128951,SRX20140868,INTS10,306
chr1,181128760,181128953,SRX5075174,SMARCA4,193
chr1,181128767,181128936,SRX5075170,SMARCA4,169
chr1,181135415,181135663,SRX16500061,CTCF,248
chr1,181135755,181136470,SRX5075170,SMARCA4,715
chr1,181135905,181136404,SRX5075169,SMARCA4,499
chr1,181135947,181136271,SRX5716469,SMARCA4,324
chr1,181135973,181136410,SRX5075174,SMARCA4,437
chr1,181136059,181136470,SRX5075176,SMARCA4,411
chr1,181136070,181136439,SRX5054309,FOSL2,369
chr1,181136071,181136427,SRX5075168,SMARCA4,356
chr1,181136109,181136385,SRX5716470,SMARCA4,276
chr1,181136111,181136413,SRX5075175,SMARCA4,302
chr1,181136156,181136438,SRX5054308,FOSL2,282
chr1,181141585,181141768,SRX5054309,FOSL2,183
chr1,181142318,181142739,SRX5716469,SMARCA4,421
chr1,181142355,181142837,SRX4174629,CTCF,482
chr1,181142356,181142720,SRX20140895,INTS13,364
chr1,181142364,181142830,SRX5075168,SMARCA4,466
chr1,181142396,181142855,SRX5075174,SMARCA4,459
chr1,181142396,181142866,SRX16500062,CTCF,470
chr1,181142402,181142955,SRX16500060,CTCF,553
chr1,181142404,181142895,SRX16500061,CTCF,491
chr1,181142406,181142918,SRX16500059,CTCF,512
chr1,181142416,181142673,SRX5716454,SOX3,257
chr1,181142421,181142732,SRX5716463,SMARCA4,311
chr1,181142441,181142734,SRX5716464,SMARCA4,293
chr1,181142441,181142817,SRX5075170,SMARCA4,376
chr1,181142450,181142695,SRX5716470,SMARCA4,245
chr1,181142459,181142847,SRX5075176,SMARCA4,388
chr1,181142461,181142776,SRX5075175,SMARCA4,315
chr1,181142485,181142761,SRX5075169,SMARCA4,276
chr1,181142498,181142710,SRX5716451,SOX2,212
chr1,181166467,181167017,SRX16500059,CTCF,550
chr1,181166492,181167032,SRX16500060,CTCF,540
chr1,181166503,181166999,SRX16500062,CTCF,496
chr1,181166535,181167097,SRX16500061,CTCF,562
chr1,181166536,181166919,SRX5075174,SMARCA4,383
chr1,181166564,181166825,SRX4174629,CTCF,261
chr1,181166574,181166871,SRX5075168,SMARCA4,297
chr1,181166596,181166820,SRX5716470,SMARCA4,224
chr1,181166613,181166870,SRX5075176,SMARCA4,257
chr1,181166614,181166873,SRX5716464,SMARCA4,259
chr1,181166619,181166873,SRX5075170,SMARCA4,254
chr1,181179810,181180333,SRX5075174,SMARCA4,523
chr1,181179898,181180348,SRX5075168,SMARCA4,450
chr1,181179986,181180280,SRX5716469,SMARCA4,294
chr1,181179988,181180343,SRX5075176,SMARCA4,355
chr1,181180013,181180374,SRX20140895,INTS13,361
chr1,181180046,181180343,SRX5716464,SMARCA4,297
chr1,181180068,181180380,SRX5075170,SMARCA4,312
chr1,181180089,181180284,SRX5075169,SMARCA4,195
chr1,181180112,181180370,SRX5716470,SMARCA4,258
chr1,181189736,181190306,SRX16500059,CTCF,570
chr1,181189778,181190329,SRX16500060,CTCF,551
chr1,181189786,181190271,SRX16500061,CTCF,485
chr1,181189818,181190326,SRX16500062,CTCF,508
chr1,181189865,181190162,SRX4174629,CTCF,297
chr1,181189913,181190271,SRX5075174,SMARCA4,358
chr1,181189939,181190245,SRX5075168,SMARCA4,306
chr1,181189967,181190249,SRX5075176,SMARCA4,282
chr1,181189972,181190270,SRX5716463,SMARCA4,298
chr1,181189976,181190216,SRX5075170,SMARCA4,240
chr1,181189978,181190203,SRX5716470,SMARCA4,225
chr1,181190017,181190222,SRX5716464,SMARCA4,205
chr1,181216457,181216805,SRX5716464,SMARCA4,348
chr1,181251051,181251392,SRX5075170,SMARCA4,341
chr1,181251108,181251303,SRX5075169,SMARCA4,195
chr1,181251113,181251309,SRX5075176,SMARCA4,196
chr1,181251146,181251329,SRX5054308,FOSL2,183
chr1,181255602,181255782,SRX5054308,FOSL2,180
chr1,181255607,181255808,SRX5054309,FOSL2,201
chr1,181255621,181255802,SRX5075169,SMARCA4,181
chr1,181315032,181315308,SRX5075168,SMARCA4,276
chr1,181315035,181315274,SRX5075174,SMARCA4,239
chr1,181423658,181423882,SRX16500062,CTCF,224
chr1,181424791,181425361,SRX16500059,CTCF,570
chr1,181424793,181425392,SRX16500062,CTCF,599
chr1,181424812,181425371,SRX16500060,CTCF,559
chr1,181424823,181425347,SRX4174629,CTCF,524
chr1,181424823,181425404,SRX16500061,CTCF,581
chr1,181424845,181425265,SRX5075168,SMARCA4,420
chr1,181424940,181425244,SRX5716464,SMARCA4,304
chr1,181424947,181425195,SRX5716463,SMARCA4,248
chr1,181424952,181425278,SRX5075174,SMARCA4,326
chr1,181424964,181425171,SRX5075170,SMARCA4,207
chr1,181424995,181425175,SRX5075169,SMARCA4,180
chr1,181425007,181425209,SRX5075176,SMARCA4,202
chr1,181469846,181470129,SRX5054309,FOSL2,283
chr1,181469922,181470138,SRX5075168,SMARCA4,216
chr1,181479104,181479517,SRX16500061,CTCF,413
chr1,181479108,181479562,SRX16500059,CTCF,454
chr1,181479119,181479638,SRX16500060,CTCF,519
chr1,181479157,181479588,SRX4174629,CTCF,431
chr1,181479160,181479571,SRX16500062,CTCF,411
chr1,181482576,181482766,SRX5075174,SMARCA4,190
chr1,181482696,181482875,SRX5075168,SMARCA4,179
chr1,181486024,181486259,SRX16500059,CTCF,235
chr1,181486097,181486404,SRX16500060,CTCF,307
chr1,181504269,181504623,SRX16500062,CTCF,354
chr1,181504279,181504692,SRX16500059,CTCF,413
chr1,181504288,181504659,SRX16500060,CTCF,371
chr1,181504331,181504651,SRX16500061,CTCF,320
chr1,181520836,181521009,SRX5075174,SMARCA4,173
chr1,181551232,181551565,SRX5075168,SMARCA4,333
chr1,181551240,181551537,SRX5716464,SMARCA4,297
chr1,181551333,181551659,SRX5075174,SMARCA4,326
chr1,181587831,181588124,SRX16500060,CTCF,293
chr1,181659252,181659601,SRX5075174,SMARCA4,349
chr1,181659370,181659679,SRX5075168,SMARCA4,309
chr1,181675567,181676142,SRX5075174,SMARCA4,575
chr1,181675599,181676113,SRX5075168,SMARCA4,514
chr1,181675623,181676010,SRX20140895,INTS13,387
chr1,181675639,181676025,SRX5716463,SMARCA4,386
chr1,181675707,181675912,SRX5716454,SOX3,205
chr1,181675741,181675993,SRX5716451,SOX2,252
chr1,181675747,181676057,SRX5716464,SMARCA4,310
chr1,181676242,181676722,SRX16500059,CTCF,480
chr1,181676246,181676616,SRX16500061,CTCF,370
chr1,181676253,181676675,SRX16500060,CTCF,422
chr1,181676314,181676625,SRX16500062,CTCF,311
chr1,181676373,181676588,SRX4174629,CTCF,215
chr1,181696216,181696429,SRX5075174,SMARCA4,213
chr1,181704532,181705025,SRX5075168,SMARCA4,493
chr1,181704536,181704951,SRX5075174,SMARCA4,415
chr1,181714478,181714993,SRX5075174,SMARCA4,515
chr1,181714488,181714813,SRX5075168,SMARCA4,325
chr1,181910981,181911216,SRX16500059,CTCF,235
chr1,181936908,181937507,SRX16500060,CTCF,599
chr1,181936910,181937382,SRX16500061,CTCF,472
chr1,181936925,181937399,SRX16500059,CTCF,474
chr1,181936938,181937339,SRX16500062,CTCF,401
chr1,181936970,181937457,SRX4174629,CTCF,487
chr1,181937039,181937310,SRX5075174,SMARCA4,271
chr1,182029393,182030300,SRX20140895,INTS13,907
chr1,182029466,182029738,SRX5075168,SMARCA4,272
chr1,182029502,182030267,SRX5075174,SMARCA4,765
chr1,182029534,182030007,SRX20140897,INTS13,473
chr1,182029673,182029960,SRX5054307,FOSL2,287
chr1,182029678,182030183,SRX5075170,SMARCA4,505
chr1,182029718,182030118,SRX5716463,SMARCA4,400
chr1,182029759,182030095,SRX5716464,SMARCA4,336
chr1,182029779,182030222,SRX5075176,SMARCA4,443
chr1,182029798,182030253,SRX5075168,SMARCA4,455
chr1,182029824,182030265,SRX16500062,CTCF,441
chr1,182029833,182030106,SRX5716470,SMARCA4,273
chr1,182029841,182030062,SRX20140867,INTS10,221
chr1,182029845,182030250,SRX16500061,CTCF,405
chr1,182029853,182030043,SRX5716451,SOX2,190
chr1,182029865,182030292,SRX16500059,CTCF,427
chr1,182029868,182030295,SRX16500060,CTCF,427
chr1,182029870,182030082,SRX5716469,SMARCA4,212
chr1,182029907,182030227,SRX5075175,SMARCA4,320
chr1,182029936,182030263,SRX5075169,SMARCA4,327
chr1,182035452,182035729,SRX16500060,CTCF,277
chr1,182054685,182055051,SRX16500062,CTCF,366
chr1,182054720,182055025,SRX5075174,SMARCA4,305
chr1,182054740,182055087,SRX16500061,CTCF,347
chr1,182054751,182055160,SRX16500060,CTCF,409
chr1,182054783,182055040,SRX5075168,SMARCA4,257
chr1,182054834,182055099,SRX16500059,CTCF,265
chr1,182068991,182069372,SRX16500060,CTCF,381
chr1,182069005,182069380,SRX16500062,CTCF,375
chr1,182069011,182069418,SRX16500061,CTCF,407
chr1,182069011,182069461,SRX16500059,CTCF,450
chr1,182069027,182069308,SRX5075174,SMARCA4,281
chr1,182069039,182069312,SRX5075168,SMARCA4,273
chr1,182069086,182069331,SRX5716463,SMARCA4,245
chr1,182081001,182081351,SRX16500059,CTCF,350
chr1,182081005,182081279,SRX16500062,CTCF,274
chr1,182081007,182081334,SRX16500061,CTCF,327
chr1,182081008,182081294,SRX16500060,CTCF,286
chr1,182081033,182081206,SRX5075174,SMARCA4,173
chr1,182084410,182085302,SRX16500060,CTCF,892
chr1,182084428,182085299,SRX16500061,CTCF,871
chr1,182084435,182084756,SRX16500062,CTCF,321
chr1,182084442,182084701,SRX5075174,SMARCA4,259
chr1,182084447,182085299,SRX16500059,CTCF,852
chr1,182084475,182084734,SRX5075176,SMARCA4,259
chr1,182084488,182084705,SRX5075170,SMARCA4,217
chr1,182084566,182085171,SRX4174629,CTCF,605
chr1,182084849,182085285,SRX16500062,CTCF,436
chr1,182084892,182085209,SRX5075168,SMARCA4,317
chr1,182084922,182085164,SRX5075174,SMARCA4,242
chr1,182101402,182101627,SRX20140867,INTS10,225
chr1,182101408,182101802,SRX5075168,SMARCA4,394
chr1,182101428,182101853,SRX5075174,SMARCA4,425
chr1,182101445,182101815,SRX20140881,CPSF3L,370
chr1,182101463,182101776,SRX5716463,SMARCA4,313
chr1,182101475,182101784,SRX20140869,INTS10,309
chr1,182101518,182101760,SRX5716464,SMARCA4,242
chr1,182114227,182114577,SRX5075174,SMARCA4,350
chr1,182114289,182114498,SRX5075168,SMARCA4,209
chr1,182114295,182114592,SRX20140895,INTS13,297
chr1,182143062,182143597,SRX16500060,CTCF,535
chr1,182143110,182143584,SRX16500061,CTCF,474
chr1,182143119,182143672,SRX16500059,CTCF,553
chr1,182143125,182143626,SRX16500062,CTCF,501
chr1,182143206,182143434,SRX5716463,SMARCA4,228
chr1,182143208,182143554,SRX5075168,SMARCA4,346
chr1,182143208,182143578,SRX5716469,SMARCA4,370
chr1,182143215,182143527,SRX5075174,SMARCA4,312
chr1,182143222,182143509,SRX5716470,SMARCA4,287
chr1,182143235,182143484,SRX5075176,SMARCA4,249
chr1,182143235,182143507,SRX5075169,SMARCA4,272
chr1,182143236,182143625,SRX4174629,CTCF,389
chr1,182143239,182143550,SRX5075170,SMARCA4,311
chr1,182143247,182143446,SRX5075175,SMARCA4,199
chr1,182143748,182144126,SRX20140895,INTS13,378
chr1,182149416,182149850,SRX5075174,SMARCA4,434
chr1,182149476,182149827,SRX5075168,SMARCA4,351
chr1,182149603,182149799,SRX5075170,SMARCA4,196
chr1,182186213,182186787,SRX5075176,SMARCA4,574
chr1,182186218,182186778,SRX5075174,SMARCA4,560
chr1,182186238,182186808,SRX5075168,SMARCA4,570
chr1,182186270,182186670,SRX5716463,SMARCA4,400
chr1,182186308,182186668,SRX5054309,FOSL2,360
chr1,182186347,182186772,SRX5075169,SMARCA4,425
chr1,182186350,182186762,SRX5075170,SMARCA4,412
chr1,182186355,182186564,SRX5716464,SMARCA4,209
chr1,182186357,182186733,SRX5075175,SMARCA4,376
chr1,182186358,182186633,SRX5054307,FOSL2,275
chr1,182186368,182186704,SRX5054308,FOSL2,336
chr1,182186384,182186682,SRX5716469,SMARCA4,298
chr1,182186397,182186685,SRX5716470,SMARCA4,288
chr1,182186451,182186659,SRX5020214,SMARCA2,208
chr1,182229957,182230215,SRX5075170,SMARCA4,258
chr1,182230008,182230183,SRX5075176,SMARCA4,175
chr1,182236179,182236451,SRX5075170,SMARCA4,272
chr1,182236273,182236448,SRX5075176,SMARCA4,175
chr1,182236299,182236486,SRX5075169,SMARCA4,187
chr1,182279605,182280171,SRX5075168,SMARCA4,566
chr1,182279631,182280071,SRX20140868,INTS10,440
chr1,182279648,182280133,SRX5075174,SMARCA4,485
chr1,182279689,182279939,SRX5716463,SMARCA4,250
chr1,182279691,182280122,SRX5075176,SMARCA4,431
chr1,182279702,182280087,SRX5075170,SMARCA4,385
chr1,182279716,182280253,SRX20140895,INTS13,537
chr1,182279747,182279938,SRX5716451,SOX2,191
chr1,182289976,182290454,SRX5075176,SMARCA4,478
chr1,182290021,182290585,SRX5075170,SMARCA4,564
chr1,182290094,182290487,SRX5716470,SMARCA4,393
chr1,182290232,182290604,SRX5054309,FOSL2,372
chr1,182290256,182290577,SRX5054308,FOSL2,321
chr1,182301769,182301979,SRX4174629,CTCF,210
chr1,182357227,182357483,SRX5075174,SMARCA4,256
chr1,182359655,182359981,SRX5716463,SMARCA4,326
chr1,182359729,182359994,SRX5075174,SMARCA4,265
chr1,182359733,182359957,SRX5716464,SMARCA4,224
chr1,182359780,182360028,SRX5075168,SMARCA4,248
chr1,182391289,182392328,SRX20140895,INTS13,1039
chr1,182391373,182392039,SRX20140894,INTS13,666
chr1,182391382,182392073,SRX20140881,CPSF3L,691
chr1,182391395,182392294,SRX20140868,INTS10,899
chr1,182391408,182392097,SRX20140897,INTS13,689
chr1,182391423,182392122,SRX20140879,CPSF3L,699
chr1,182391428,182392279,SRX20140867,INTS10,851
chr1,182391445,182392146,SRX20140896,INTS13,701
chr1,182391460,182391980,SRX20140880,CPSF3L,520
chr1,182391494,182391961,SRX20140882,CPSF3L,467
chr1,182391504,182392300,SRX20140869,INTS10,796
chr1,182391738,182392195,SRX5075168,SMARCA4,457
chr1,182391740,182392129,SRX5075170,SMARCA4,389
chr1,182391750,182392081,SRX5716463,SMARCA4,331
chr1,182391777,182392263,SRX5075174,SMARCA4,486
chr1,182391850,182392268,SRX5075176,SMARCA4,418
chr1,182391904,182392123,SRX5075169,SMARCA4,219
chr1,182392046,182392268,SRX5716470,SMARCA4,222
chr1,182396677,182397129,SRX16500059,CTCF,452
chr1,182396684,182397031,SRX4174629,CTCF,347
chr1,182396687,182397153,SRX16500061,CTCF,466
chr1,182396708,182397128,SRX16500060,CTCF,420
chr1,182396712,182397115,SRX16500062,CTCF,403
chr1,182396732,182397010,SRX5075170,SMARCA4,278
chr1,182396739,182397050,SRX5075176,SMARCA4,311
chr1,182396771,182397045,SRX5075168,SMARCA4,274
chr1,182396773,182397005,SRX5075174,SMARCA4,232
chr1,182396782,182397070,SRX5716470,SMARCA4,288
chr1,182397282,182397482,SRX5075176,SMARCA4,200
chr1,182445989,182446594,SRX16500060,CTCF,605
chr1,182446020,182446498,SRX16500061,CTCF,478
chr1,182446023,182446538,SRX16500059,CTCF,515
chr1,182446093,182446371,SRX5075168,SMARCA4,278
chr1,182446118,182446432,SRX16500062,CTCF,314
chr1,182484563,182484784,SRX16500060,CTCF,221
chr1,182569636,182569901,SRX5054309,FOSL2,265
chr1,182575618,182575830,SRX5054309,FOSL2,212
chr1,182588880,182589348,SRX5075170,SMARCA4,468
chr1,182588885,182589138,SRX5075175,SMARCA4,253
chr1,182589104,182589283,SRX5075176,SMARCA4,179
chr1,182594628,182594904,SRX5075170,SMARCA4,276
chr1,182594633,182594905,SRX5075176,SMARCA4,272
chr1,182595579,182596096,SRX16500059,CTCF,517
chr1,182595604,182596057,SRX16500060,CTCF,453
chr1,182595627,182595994,SRX16500062,CTCF,367
chr1,182595636,182596038,SRX16500061,CTCF,402
chr1,182595660,182596033,SRX5075168,SMARCA4,373
chr1,182595690,182595990,SRX5075169,SMARCA4,300
chr1,182595697,182596077,SRX5075174,SMARCA4,380
chr1,182595699,182595998,SRX5075175,SMARCA4,299
chr1,182595720,182595999,SRX5075176,SMARCA4,279
chr1,182595723,182596011,SRX5716464,SMARCA4,288
chr1,182595723,182596014,SRX5716463,SMARCA4,291
chr1,182595724,182596019,SRX5075170,SMARCA4,295
chr1,182595741,182596039,SRX5716470,SMARCA4,298
chr1,182595750,182595983,SRX4174629,CTCF,233
chr1,182595771,182595987,SRX5716469,SMARCA4,216
chr1,182601282,182601736,SRX16500060,CTCF,454
chr1,182601289,182601775,SRX16500061,CTCF,486
chr1,182601294,182601722,SRX16500059,CTCF,428
chr1,182601319,182601730,SRX16500062,CTCF,411
chr1,182601429,182601656,SRX5075168,SMARCA4,227
chr1,182601430,182601666,SRX5075174,SMARCA4,236
chr1,182601440,182601707,SRX4174629,CTCF,267
chr1,182601453,182601672,SRX5075170,SMARCA4,219
chr1,182614718,182615160,SRX5075168,SMARCA4,442
chr1,182614736,182614936,SRX5054309,FOSL2,200
chr1,182614751,182614966,SRX5075169,SMARCA4,215
chr1,182614787,182615012,SRX5075176,SMARCA4,225
chr1,182614811,182615074,SRX5716464,SMARCA4,263
chr1,182614824,182615134,SRX5075170,SMARCA4,310
chr1,182614831,182615204,SRX5075174,SMARCA4,373
chr1,182614849,182615078,SRX5716463,SMARCA4,229
chr1,182614873,182615282,SRX5075175,SMARCA4,409
chr1,182614877,182615091,SRX20140867,INTS10,214
chr1,182614922,182615337,SRX20140868,INTS10,415
chr1,182614926,182615463,SRX20140895,INTS13,537
chr1,182615092,182615358,SRX20140869,INTS10,266
chr1,182615160,182615340,SRX5075169,SMARCA4,180
chr1,182616179,182616525,SRX5075169,SMARCA4,346
chr1,182616190,182616390,SRX5020211,SMARCA2,200
chr1,182616192,182616545,SRX5075170,SMARCA4,353
chr1,182616206,182616514,SRX5075176,SMARCA4,308
chr1,182616208,182616490,SRX5075175,SMARCA4,282
chr1,182616221,182616553,SRX5716470,SMARCA4,332
chr1,182617785,182618159,SRX5075176,SMARCA4,374
chr1,182617834,182618188,SRX5075170,SMARCA4,354
chr1,182617891,182618135,SRX5075175,SMARCA4,244
chr1,182623017,182623442,SRX5716467,SMARCA2,425
chr1,182623023,182623435,SRX5075176,SMARCA4,412
chr1,182623051,182623437,SRX5716468,SMARCA2,386
chr1,182623068,182623419,SRX5075175,SMARCA4,351
chr1,182623084,182623476,SRX5075170,SMARCA4,392
chr1,182623090,182623471,SRX5075169,SMARCA4,381
chr1,182623092,182623411,SRX5716470,SMARCA4,319
chr1,182623098,182623407,SRX5020211,SMARCA2,309
chr1,182623107,182623287,SRX5054308,FOSL2,180
chr1,182623110,182623438,SRX5716469,SMARCA4,328
chr1,182623157,182623417,SRX5020214,SMARCA2,260
chr1,182626192,182626392,SRX5075176,SMARCA4,200
chr1,182626208,182626440,SRX5075170,SMARCA4,232
chr1,182626217,182626404,SRX5054309,FOSL2,187
chr1,182629598,182629799,SRX5075168,SMARCA4,201
chr1,182633642,182633953,SRX20140867,INTS10,311
chr1,182651359,182651618,SRX5075170,SMARCA4,259
chr1,182651378,182651600,SRX5075176,SMARCA4,222
chr1,182662504,182662969,SRX5075174,SMARCA4,465
chr1,182662565,182662970,SRX5075168,SMARCA4,405
chr1,182662649,182662868,SRX5716463,SMARCA4,219
chr1,182680943,182681149,SRX5075175,SMARCA4,206
chr1,182680969,182681158,SRX5075170,SMARCA4,189
chr1,182680980,182681229,SRX5075169,SMARCA4,249
chr1,182680985,182681168,SRX5075176,SMARCA4,183
chr1,182699655,182699992,SRX5075170,SMARCA4,337
chr1,182699703,182700025,SRX5075176,SMARCA4,322
chr1,182699709,182699917,SRX5075175,SMARCA4,208
chr1,182699716,182699973,SRX5716469,SMARCA4,257
chr1,182699736,182699953,SRX5075169,SMARCA4,217
chr1,182699753,182700039,SRX5716470,SMARCA4,286
chr1,182699828,182700137,SRX5075174,SMARCA4,309
chr1,182699962,182700347,SRX20140895,INTS13,385
chr1,182714601,182714776,SRX5075176,SMARCA4,175
chr1,182720443,182720737,SRX5075168,SMARCA4,294
chr1,182720495,182720734,SRX16500061,CTCF,239
chr1,182720531,182720758,SRX16500060,CTCF,227
chr1,182720564,182720774,SRX16500062,CTCF,210
chr1,182739551,182740050,SRX5075168,SMARCA4,499
chr1,182739587,182739979,SRX5075174,SMARCA4,392
chr1,182739602,182739832,SRX20140867,INTS10,230
chr1,182739628,182739965,SRX5716463,SMARCA4,337
chr1,182739729,182740002,SRX5716464,SMARCA4,273
chr1,182752237,182752578,SRX5075168,SMARCA4,341
chr1,182752250,182752738,SRX5075176,SMARCA4,488
chr1,182752437,182752760,SRX5054308,FOSL2,323
chr1,182752482,182752683,SRX5054309,FOSL2,201
chr1,182752500,182752795,SRX5075175,SMARCA4,295
chr1,182752527,182752830,SRX5075170,SMARCA4,303
chr1,182752577,182753023,SRX5075174,SMARCA4,446
chr1,182752742,182752977,SRX5075168,SMARCA4,235
chr1,182768990,182769304,SRX5054308,FOSL2,314
chr1,182769002,182769379,SRX5054309,FOSL2,377
chr1,182782394,182782652,SRX16500060,CTCF,258
chr1,182784538,182784957,SRX16500062,CTCF,419
chr1,182784543,182784968,SRX16500059,CTCF,425
chr1,182784559,182784962,SRX16500060,CTCF,403
chr1,182784561,182784955,SRX16500061,CTCF,394
chr1,182786680,182787039,SRX16500059,CTCF,359
chr1,182786715,182786981,SRX16500061,CTCF,266
chr1,182786718,182786956,SRX16500062,CTCF,238
chr1,182786725,182786946,SRX16500060,CTCF,221
chr1,182786728,182786940,SRX5075168,SMARCA4,212
chr1,182786736,182786924,SRX5075176,SMARCA4,188
chr1,182786750,182786966,SRX5075174,SMARCA4,216
chr1,182786786,182786957,SRX5075170,SMARCA4,171
chr1,182789301,182789512,SRX5716470,SMARCA4,211
chr1,182789318,182789932,SRX5075174,SMARCA4,614
chr1,182789342,182789537,SRX5075175,SMARCA4,195
chr1,182789385,182789615,SRX5716469,SMARCA4,230
chr1,182789406,182790023,SRX20140895,INTS13,617
chr1,182789460,182789960,SRX5075176,SMARCA4,500
chr1,182789498,182789792,SRX20140868,INTS10,294
chr1,182789514,182789934,SRX5075168,SMARCA4,420
chr1,182789541,182789953,SRX5075169,SMARCA4,412
chr1,182789558,182789960,SRX5075170,SMARCA4,402
chr1,182789696,182790038,SRX20140881,CPSF3L,342
chr1,182834200,182834768,SRX5075168,SMARCA4,568
chr1,182834296,182834768,SRX5075174,SMARCA4,472
chr1,182834338,182834644,SRX5716451,SOX2,306
chr1,182838968,182839307,SRX5075170,SMARCA4,339
chr1,182839021,182839479,SRX5075174,SMARCA4,458
chr1,182839057,182839368,SRX5075168,SMARCA4,311
chr1,182839076,182839295,SRX5716463,SMARCA4,219
chr1,182839089,182839421,SRX5075176,SMARCA4,332
chr1,182839181,182839830,SRX20140867,INTS10,649
chr1,182839195,182840213,SRX20140895,INTS13,1018
chr1,182839217,182839704,SRX20140868,INTS10,487
chr1,182839278,182839610,SRX20140897,INTS13,332
chr1,182839295,182839628,SRX20140869,INTS10,333
chr1,182839299,182839637,SRX20140896,INTS13,338
chr1,182839541,182839848,SRX16500060,CTCF,307
chr1,182839585,182839885,SRX5075176,SMARCA4,300
chr1,182839601,182839983,SRX5075174,SMARCA4,382
chr1,182839602,182839915,SRX5075168,SMARCA4,313
chr1,182839614,182839863,SRX5075170,SMARCA4,249
chr1,182839671,182839868,SRX5075169,SMARCA4,197
chr1,182942299,182942519,SRX5075174,SMARCA4,220
chr1,182942308,182942543,SRX5075168,SMARCA4,235
chr1,182942357,182942573,SRX5075170,SMARCA4,216
chr1,182956085,182956655,SRX5075169,SMARCA4,570
chr1,182956132,182956650,SRX5075175,SMARCA4,518
chr1,182956184,182956583,SRX5716469,SMARCA4,399
chr1,182956198,182956528,SRX5716470,SMARCA4,330
chr1,182956208,182956645,SRX5075176,SMARCA4,437
chr1,182956240,182956636,SRX5075170,SMARCA4,396
chr1,182956259,182956588,SRX5054308,FOSL2,329
chr1,182956269,182956615,SRX5054309,FOSL2,346
chr1,182956283,182956527,SRX5020214,SMARCA2,244
chr1,182956283,182956545,SRX5716467,SMARCA2,262
chr1,182962317,182962877,SRX16500060,CTCF,560
chr1,182962390,182962909,SRX16500059,CTCF,519
chr1,182962420,182962894,SRX16500061,CTCF,474
chr1,182962448,182962896,SRX16500062,CTCF,448
chr1,182962503,182962948,SRX5075174,SMARCA4,445
chr1,182962504,182962809,SRX5716464,SMARCA4,305
chr1,182962506,182962928,SRX5075170,SMARCA4,422
chr1,182962508,182962909,SRX5075175,SMARCA4,401
chr1,182962518,182962959,SRX5075176,SMARCA4,441
chr1,182962521,182962938,SRX5075168,SMARCA4,417
chr1,182962543,182962978,SRX5075169,SMARCA4,435
chr1,182962550,182962879,SRX5716469,SMARCA4,329
chr1,182962553,182962839,SRX5716463,SMARCA4,286
chr1,182962569,182962871,SRX4174629,CTCF,302
chr1,182962577,182962966,SRX5716470,SMARCA4,389
chr1,182962602,182962930,SRX5054309,FOSL2,328
chr1,182962609,182962906,SRX5716467,SMARCA2,297
chr1,182962615,182962915,SRX5054308,FOSL2,300
chr1,182962644,182962857,SRX5716468,SMARCA2,213
chr1,182962645,182962911,SRX5020214,SMARCA2,266
chr1,182990425,182990734,SRX5075169,SMARCA4,309
chr1,182990439,182990678,SRX5054309,FOSL2,239
chr1,182990446,182990765,SRX5075175,SMARCA4,319
chr1,182990494,182990819,SRX5075170,SMARCA4,325
chr1,182990543,182990764,SRX5075176,SMARCA4,221
chr1,183022282,183022719,SRX5075176,SMARCA4,437
chr1,183022304,183022701,SRX5075170,SMARCA4,397
chr1,183022312,183022705,SRX5054309,FOSL2,393
chr1,183022329,183022654,SRX5054308,FOSL2,325
chr1,183022337,183022613,SRX5716467,SMARCA2,276
chr1,183022339,183022705,SRX5075169,SMARCA4,366
chr1,183022345,183022539,SRX5075168,SMARCA4,194
chr1,183022386,183022806,SRX5075175,SMARCA4,420
chr1,183022423,183022710,SRX5716470,SMARCA4,287
chr1,183022437,183022731,SRX5716469,SMARCA4,294
chr1,183022648,183023127,SRX20140895,INTS13,479
chr1,183022726,183023021,SRX20140868,INTS10,295
chr1,183022744,183023065,SRX20140879,CPSF3L,321
chr1,183022835,183023049,SRX20140867,INTS10,214
chr1,183023175,183023555,SRX5075176,SMARCA4,380
chr1,183023184,183023524,SRX5075170,SMARCA4,340
chr1,183023184,183023576,SRX5075174,SMARCA4,392
chr1,183023185,183023572,SRX5075168,SMARCA4,387
chr1,183023216,183023462,SRX5075175,SMARCA4,246
chr1,183023219,183023902,SRX20140895,INTS13,683
chr1,183023220,183023461,SRX5075169,SMARCA4,241
chr1,183023281,183023694,SRX20140868,INTS10,413
chr1,183023324,183024289,SRX16500060,CTCF,965
chr1,183023346,183023633,SRX16500061,CTCF,287
chr1,183023387,183024237,SRX16500059,CTCF,850
chr1,183023484,183023769,SRX20140867,INTS10,285
chr1,183023830,183024228,SRX16500062,CTCF,398
chr1,183023836,183024229,SRX16500061,CTCF,393
chr1,183029683,183029997,SRX5054309,FOSL2,314
chr1,183032490,183032813,SRX5054309,FOSL2,323
chr1,183032505,183032820,SRX5054308,FOSL2,315
chr1,183032537,183032795,SRX5075176,SMARCA4,258
chr1,183032544,183032746,SRX5075175,SMARCA4,202
chr1,183032549,183032766,SRX5075169,SMARCA4,217
chr1,183032551,183032760,SRX5075170,SMARCA4,209
chr1,183032582,183032780,SRX5075174,SMARCA4,198
chr1,183032609,183032794,SRX5075168,SMARCA4,185
chr1,183039788,183040478,SRX5075176,SMARCA4,690
chr1,183039923,183040578,SRX5075168,SMARCA4,655
chr1,183039944,183040469,SRX5075170,SMARCA4,525
chr1,183039969,183040466,SRX5075174,SMARCA4,497
chr1,183039976,183040386,SRX5054308,FOSL2,410
chr1,183039984,183040420,SRX5054309,FOSL2,436
chr1,183040000,183040447,SRX5716469,SMARCA4,447
chr1,183040001,183040432,SRX5075175,SMARCA4,431
chr1,183040014,183040467,SRX5075169,SMARCA4,453
chr1,183040015,183040320,SRX5716467,SMARCA2,305
chr1,183040028,183040401,SRX5716470,SMARCA4,373
chr1,183040068,183040389,SRX5716463,SMARCA4,321
chr1,183040076,183040374,SRX5020214,SMARCA2,298
chr1,183040122,183040424,SRX5020211,SMARCA2,302
chr1,183040167,183040393,SRX5075182,SMARCA2,226
chr1,183040205,183040416,SRX5716451,SOX2,211
chr1,183060378,183060823,SRX5075170,SMARCA4,445
chr1,183060410,183060832,SRX5054308,FOSL2,422
chr1,183060413,183060812,SRX5075169,SMARCA4,399
chr1,183060415,183060766,SRX5054309,FOSL2,351
chr1,183060431,183060765,SRX5716467,SMARCA2,334
chr1,183060436,183060832,SRX5716469,SMARCA4,396
chr1,183060440,183060795,SRX5075176,SMARCA4,355
chr1,183060454,183060764,SRX5020211,SMARCA2,310
chr1,183060455,183060864,SRX5716460,Epitope tags,409
chr1,183060463,183060786,SRX5716470,SMARCA4,323
chr1,183060463,183060813,SRX5075175,SMARCA4,350
chr1,183060540,183060756,SRX5716468,SMARCA2,216
chr1,183070713,183071764,SRX5075176,SMARCA4,1051
chr1,183070754,183071739,SRX5075170,SMARCA4,985
chr1,183070764,183071152,SRX5054308,FOSL2,388
chr1,183070801,183071716,SRX5075175,SMARCA4,915
chr1,183070807,183071544,SRX5075174,SMARCA4,737
chr1,183070827,183071710,SRX5075169,SMARCA4,883
chr1,183070840,183071661,SRX5716467,SMARCA2,821
chr1,183070851,183071062,SRX5716468,SMARCA2,211
chr1,183070851,183071438,SRX5075168,SMARCA4,587
chr1,183070852,183071670,SRX5716470,SMARCA4,818
chr1,183070890,183071631,SRX5716469,SMARCA4,741
chr1,183070904,183071617,SRX5054309,FOSL2,713
chr1,183071006,183071663,SRX5020211,SMARCA2,657
chr1,183071092,183071576,SRX5020214,SMARCA2,484
chr1,183071177,183071638,SRX5716468,SMARCA2,461
chr1,183071183,183071587,SRX5075181,SMARCA2,404
chr1,183071217,183071640,SRX5054308,FOSL2,423
chr1,183071265,183071570,SRX5075182,SMARCA2,305
chr1,183071338,183071775,SRX5716460,Epitope tags,437
chr1,183080411,183080791,SRX5075176,SMARCA4,380
chr1,183080419,183080711,SRX5075169,SMARCA4,292
chr1,183080445,183080737,SRX5075170,SMARCA4,292
chr1,183080459,183080733,SRX5075175,SMARCA4,274
chr1,183080475,183080715,SRX5054308,FOSL2,240
chr1,183080488,183080720,SRX5716469,SMARCA4,232
chr1,183080492,183080715,SRX5054309,FOSL2,223
chr1,183090483,183090660,SRX5075170,SMARCA4,177
chr1,183097495,183097888,SRX5075170,SMARCA4,393
chr1,183097681,183097864,SRX5054309,FOSL2,183
chr1,183097686,183098020,SRX5075169,SMARCA4,334
chr1,183105409,183105705,SRX5075175,SMARCA4,296
chr1,183105457,183105753,SRX5075169,SMARCA4,296
chr1,183110609,183110848,SRX5075174,SMARCA4,239
chr1,183126546,183126829,SRX5716470,SMARCA4,283
chr1,183126564,183126772,SRX5075169,SMARCA4,208
chr1,183126612,183126844,SRX5075175,SMARCA4,232
chr1,183126624,183126865,SRX5075170,SMARCA4,241
chr1,183131230,183131425,SRX5075170,SMARCA4,195
chr1,183139511,183139968,SRX5075169,SMARCA4,457
chr1,183139520,183140000,SRX5075170,SMARCA4,480
chr1,183139522,183139971,SRX5075176,SMARCA4,449
chr1,183139525,183139924,SRX5075175,SMARCA4,399
chr1,183139569,183139883,SRX5716469,SMARCA4,314
chr1,183139576,183139930,SRX5054308,FOSL2,354
chr1,183139584,183139978,SRX5054309,FOSL2,394
chr1,183139643,183139934,SRX5716470,SMARCA4,291
chr1,183139676,183139919,SRX5020211,SMARCA2,243
chr1,183148551,183148763,SRX5075170,SMARCA4,212
chr1,183163407,183163713,SRX5075169,SMARCA4,306
chr1,183163445,183163628,SRX5054309,FOSL2,183
chr1,183163461,183163667,SRX5075170,SMARCA4,206
chr1,183164338,183164732,SRX5075168,SMARCA4,394
chr1,183164353,183164756,SRX5075174,SMARCA4,403
chr1,183164421,183164678,SRX5716464,SMARCA4,257
chr1,183180249,183180602,SRX5075170,SMARCA4,353
chr1,183180263,183181292,SRX5075176,SMARCA4,1029
chr1,183180326,183181144,SRX5716470,SMARCA4,818
chr1,183180345,183180606,SRX5716469,SMARCA4,261
chr1,183180363,183181128,SRX5716467,SMARCA2,765
chr1,183180505,183181033,SRX5716468,SMARCA2,528
chr1,183180616,183181273,SRX5075169,SMARCA4,657
chr1,183180621,183181172,SRX5075175,SMARCA4,551
chr1,183180674,183181145,SRX5716469,SMARCA4,471
chr1,183180684,183181114,SRX5020211,SMARCA2,430
chr1,183180690,183181146,SRX5075170,SMARCA4,456
chr1,183180698,183181110,SRX5054309,FOSL2,412
chr1,183180702,183181109,SRX5075181,SMARCA2,407
chr1,183180744,183181087,SRX5054308,FOSL2,343
chr1,183180781,183181038,SRX5020214,SMARCA2,257
chr1,183180850,183181029,SRX5075182,SMARCA2,179
chr1,183186063,183186455,SRX5075170,SMARCA4,392
chr1,183186111,183186449,SRX5075169,SMARCA4,338
chr1,183186116,183186444,SRX5716469,SMARCA4,328
chr1,183186144,183186414,SRX5075174,SMARCA4,270
chr1,183186155,183186359,SRX5716463,SMARCA4,204
chr1,183186161,183186508,SRX5075168,SMARCA4,347
chr1,183186173,183186456,SRX5075175,SMARCA4,283
chr1,183186191,183186526,SRX5075176,SMARCA4,335
chr1,183186214,183186454,SRX5716470,SMARCA4,240
chr1,183191781,183192172,SRX5054309,FOSL2,391
chr1,183191790,183192169,SRX5075175,SMARCA4,379
chr1,183191795,183192192,SRX5075169,SMARCA4,397
chr1,183191812,183192217,SRX5075170,SMARCA4,405
chr1,183191823,183192160,SRX5075176,SMARCA4,337
chr1,183191845,183192155,SRX5054308,FOSL2,310
chr1,183191882,183192186,SRX5716467,SMARCA2,304
chr1,183191891,183192176,SRX5020211,SMARCA2,285
chr1,183198537,183198850,SRX5075169,SMARCA4,313
chr1,183198561,183198768,SRX5075170,SMARCA4,207
chr1,183209481,183209814,SRX5075175,SMARCA4,333
chr1,183209504,183209848,SRX5054309,FOSL2,344
chr1,183209515,183209802,SRX5054308,FOSL2,287
chr1,183209520,183209847,SRX5075176,SMARCA4,327
chr1,183209528,183209801,SRX5075169,SMARCA4,273
chr1,183209560,183209837,SRX5075170,SMARCA4,277
chr1,183227873,183228345,SRX16500061,CTCF,472
chr1,183227909,183228407,SRX16500059,CTCF,498
chr1,183227933,183228357,SRX16500060,CTCF,424
chr1,183227934,183228400,SRX16500062,CTCF,466
chr1,183228002,183228235,SRX5075174,SMARCA4,233
chr1,183234472,183235295,SRX5075176,SMARCA4,823
chr1,183234481,183235350,SRX5075170,SMARCA4,869
chr1,183234482,183235259,SRX5075169,SMARCA4,777
chr1,183234494,183235229,SRX5716467,SMARCA2,735
chr1,183234515,183235193,SRX5716469,SMARCA4,678
chr1,183234521,183235148,SRX5054309,FOSL2,627
chr1,183234524,183234808,SRX5716459,Epitope tags,284
chr1,183234539,183235233,SRX5020211,SMARCA2,694
chr1,183234543,183235182,SRX5054308,FOSL2,639
chr1,183234554,183235193,SRX5716470,SMARCA4,639
chr1,183234555,183235394,SRX5075175,SMARCA4,839
chr1,183234561,183234738,SRX5075174,SMARCA4,177
chr1,183234570,183235141,SRX5716468,SMARCA2,571
chr1,183234598,183234978,SRX5020214,SMARCA2,380
chr1,183234681,183235119,SRX5075181,SMARCA2,438
chr1,183234707,183235234,SRX5075168,SMARCA4,527
chr1,183234867,183235133,SRX20140869,INTS10,266
chr1,183234914,183235396,SRX16500059,CTCF,482
chr1,183234924,183235384,SRX16500061,CTCF,460
chr1,183234933,183235395,SRX16500062,CTCF,462
chr1,183234935,183235129,SRX5075174,SMARCA4,194
chr1,183234948,183235410,SRX16500060,CTCF,462
chr1,183244493,183244868,SRX5075170,SMARCA4,375
chr1,183244506,183244880,SRX5716467,SMARCA2,374
chr1,183244508,183244938,SRX5075176,SMARCA4,430
chr1,183244540,183244889,SRX5716470,SMARCA4,349
chr1,183244543,183244884,SRX5075169,SMARCA4,341
chr1,183244544,183244816,SRX5716469,SMARCA4,272
chr1,183244558,183244864,SRX5716468,SMARCA2,306
chr1,183244584,183244894,SRX5075175,SMARCA4,310
chr1,183244593,183244798,SRX5075181,SMARCA2,205
chr1,183244606,183244806,SRX5020211,SMARCA2,200
chr1,183270508,183271046,SRX5075176,SMARCA4,538
chr1,183270527,183271109,SRX5075169,SMARCA4,582
chr1,183270597,183271070,SRX5716469,SMARCA4,473
chr1,183270659,183271200,SRX5075170,SMARCA4,541
chr1,183270731,183271057,SRX5075175,SMARCA4,326
chr1,183270737,183271137,SRX5716470,SMARCA4,400
chr1,183272358,183272711,SRX5054309,FOSL2,353
chr1,183272391,183272612,SRX5716469,SMARCA4,221
chr1,183272406,183272692,SRX5075169,SMARCA4,286
chr1,183272429,183272699,SRX5075175,SMARCA4,270
chr1,183272489,183272684,SRX5054308,FOSL2,195
chr1,183272520,183272702,SRX5075176,SMARCA4,182
chr1,183278177,183278384,SRX5075170,SMARCA4,207
chr1,183278189,183278467,SRX5054308,FOSL2,278
chr1,183278210,183278436,SRX5054309,FOSL2,226
chr1,183278212,183278405,SRX5075176,SMARCA4,193
chr1,183281321,183281883,SRX16500060,CTCF,562
chr1,183281324,183281865,SRX16500061,CTCF,541
chr1,183281385,183281896,SRX16500059,CTCF,511
chr1,183281434,183281855,SRX16500062,CTCF,421
chr1,183281444,183281845,SRX4174629,CTCF,401
chr1,183281516,183281829,SRX5075174,SMARCA4,313
chr1,183281523,183281748,SRX5075176,SMARCA4,225
chr1,183281540,183281764,SRX5075170,SMARCA4,224
chr1,183281572,183281850,SRX5075168,SMARCA4,278
chr1,183286984,183287521,SRX5075176,SMARCA4,537
chr1,183287111,183287631,SRX5075170,SMARCA4,520
chr1,183287123,183287362,SRX20140867,INTS10,239
chr1,183287197,183287377,SRX5075169,SMARCA4,180
chr1,183291841,183292131,SRX5716469,SMARCA4,290
chr1,183291842,183292180,SRX5716470,SMARCA4,338
chr1,183291873,183292073,SRX5075176,SMARCA4,200
chr1,183291878,183292110,SRX5075175,SMARCA4,232
chr1,183291895,183292119,SRX5716468,SMARCA2,224
chr1,183291896,183292112,SRX5075170,SMARCA4,216
chr1,183291923,183292170,SRX5075169,SMARCA4,247
chr1,183304658,183305157,SRX5075174,SMARCA4,499
chr1,183304673,183305109,SRX5716463,SMARCA4,436
chr1,183304705,183305135,SRX5075168,SMARCA4,430
chr1,183304744,183305113,SRX5075176,SMARCA4,369
chr1,183304783,183305085,SRX5075170,SMARCA4,302
chr1,183304785,183305071,SRX5716464,SMARCA4,286
chr1,183304814,183305042,SRX5716470,SMARCA4,228
chr1,183306533,183306942,SRX16500060,CTCF,409
chr1,183306579,183306948,SRX16500059,CTCF,369
chr1,183306592,183306907,SRX16500062,CTCF,315
chr1,183306618,183306847,SRX16500061,CTCF,229
chr1,183312120,183312337,SRX5054309,FOSL2,217
chr1,183312171,183312351,SRX5054308,FOSL2,180
chr1,183316065,183316381,SRX5075168,SMARCA4,316
chr1,183316069,183316314,SRX5075174,SMARCA4,245
chr1,183316096,183316530,SRX20140867,INTS10,434
chr1,183316109,183316432,SRX5716463,SMARCA4,323
chr1,183318445,183318784,SRX5075176,SMARCA4,339
chr1,183318457,183318782,SRX5075170,SMARCA4,325
chr1,183318467,183318677,SRX5075175,SMARCA4,210
chr1,183318559,183318825,SRX5075169,SMARCA4,266
chr1,183331105,183331340,SRX5075174,SMARCA4,235
chr1,183331477,183331720,SRX5075174,SMARCA4,243
chr1,183349017,183349783,SRX5075176,SMARCA4,766
chr1,183349038,183349403,SRX5716467,SMARCA2,365
chr1,183349047,183349726,SRX5075170,SMARCA4,679
chr1,183349054,183349581,SRX5716468,SMARCA2,527
chr1,183349062,183349642,SRX5075175,SMARCA4,580
chr1,183349070,183349483,SRX5075169,SMARCA4,413
chr1,183349074,183349372,SRX5054309,FOSL2,298
chr1,183349087,183349626,SRX5716470,SMARCA4,539
chr1,183349112,183349293,SRX5054308,FOSL2,181
chr1,183349130,183349555,SRX5716469,SMARCA4,425
chr1,183349147,183349643,SRX5075168,SMARCA4,496
chr1,183349148,183349714,SRX5075174,SMARCA4,566
chr1,183349226,183349463,SRX5075181,SMARCA2,237
chr1,183349256,183349564,SRX20140867,INTS10,308
chr1,183349321,183349529,SRX5716463,SMARCA4,208
chr1,183349339,183349636,SRX20140895,INTS13,297
chr1,183360513,183360857,SRX5075170,SMARCA4,344
chr1,183360531,183360778,SRX5075176,SMARCA4,247
chr1,183380040,183380292,SRX5075169,SMARCA4,252
chr1,183388639,183389132,SRX5075168,SMARCA4,493
chr1,183388704,183388969,SRX5716454,SOX3,265
chr1,183388722,183389132,SRX5075174,SMARCA4,410
chr1,183388802,183389088,SRX5716463,SMARCA4,286
chr1,183388804,183389023,SRX5716451,SOX2,219
chr1,183403398,183404052,SRX5075174,SMARCA4,654
chr1,183403404,183404043,SRX5075168,SMARCA4,639
chr1,183403414,183403897,SRX5716463,SMARCA4,483
chr1,183403445,183403762,SRX5716464,SMARCA4,317
chr1,183403462,183403940,SRX20140895,INTS13,478
chr1,183403514,183403904,SRX5716451,SOX2,390
chr1,183403575,183403884,SRX5716454,SOX3,309
chr1,183403617,183403865,SRX16500062,CTCF,248
chr1,183416752,183417120,SRX5716470,SMARCA4,368
chr1,183416764,183417120,SRX5075174,SMARCA4,356
chr1,183416770,183417124,SRX5075175,SMARCA4,354
chr1,183416771,183417150,SRX5075168,SMARCA4,379
chr1,183416778,183417130,SRX5716463,SMARCA4,352
chr1,183416779,183417110,SRX5075176,SMARCA4,331
chr1,183416791,183417166,SRX5075169,SMARCA4,375
chr1,183416795,183417152,SRX5716469,SMARCA4,357
chr1,183416806,183417125,SRX5075170,SMARCA4,319
chr1,183416810,183417110,SRX5020214,SMARCA2,300
chr1,183416815,183417110,SRX5716464,SMARCA4,295
chr1,183416816,183417042,SRX5075181,SMARCA2,226
chr1,183418085,183418370,SRX5075174,SMARCA4,285
chr1,183443024,183443293,SRX5075170,SMARCA4,269
chr1,183443074,183443315,SRX5075174,SMARCA4,241
chr1,183443086,183443322,SRX5075168,SMARCA4,236
chr1,183444259,183444646,SRX5075170,SMARCA4,387
chr1,183444313,183444679,SRX5075176,SMARCA4,366
chr1,183444332,183444643,SRX5054309,FOSL2,311
chr1,183444338,183444600,SRX5075169,SMARCA4,262
chr1,183444348,183444537,SRX5075174,SMARCA4,189
chr1,183444364,183444663,SRX5075175,SMARCA4,299
chr1,183444369,183444642,SRX5054308,FOSL2,273
chr1,183470098,183470359,SRX16500060,CTCF,261
chr1,183470123,183470410,SRX5075176,SMARCA4,287
chr1,183470151,183470400,SRX16500059,CTCF,249
chr1,183470158,183470396,SRX16500061,CTCF,238
chr1,183470163,183470391,SRX5075170,SMARCA4,228
chr1,183470178,183470375,SRX5075174,SMARCA4,197
chr1,183470198,183470381,SRX5075169,SMARCA4,183
chr1,183471047,183471730,SRX20140895,INTS13,683
chr1,183471086,183471306,SRX5075174,SMARCA4,220
chr1,183471172,183471556,SRX20140867,INTS10,384
chr1,183471310,183471622,SRX20140868,INTS10,312
chr1,183471599,183471937,SRX5716463,SMARCA4,338
chr1,183471673,183472027,SRX5075168,SMARCA4,354
chr1,183471774,183471947,SRX5075174,SMARCA4,173
chr1,183471790,183471996,SRX5716451,SOX2,206
chr1,183471866,183472781,SRX20140895,INTS13,915
chr1,183472004,183472300,SRX20140869,INTS10,296
chr1,183472349,183472629,SRX20140897,INTS13,280
chr1,183472354,183472673,SRX20140867,INTS10,319
chr1,183514985,183515437,SRX5075175,SMARCA4,452
chr1,183515037,183515350,SRX5075176,SMARCA4,313
chr1,183515057,183515406,SRX5075169,SMARCA4,349
chr1,183515068,183515363,SRX5054309,FOSL2,295
chr1,183515091,183515334,SRX5075170,SMARCA4,243
chr1,183515118,183515357,SRX5716469,SMARCA4,239
chr1,183529165,183529430,SRX5075176,SMARCA4,265
chr1,183543559,183543846,SRX5716469,SMARCA4,287
chr1,183543559,183543969,SRX16500060,CTCF,410
chr1,183543578,183543992,SRX16500061,CTCF,414
chr1,183543583,183543899,SRX4174629,CTCF,316
chr1,183543583,183544163,SRX16500059,CTCF,580
chr1,183543600,183543889,SRX5716470,SMARCA4,289
chr1,183543603,183543931,SRX5075176,SMARCA4,328
chr1,183543611,183543940,SRX5075170,SMARCA4,329
chr1,183543627,183543973,SRX16500062,CTCF,346
chr1,183543638,183543892,SRX5716464,SMARCA4,254
chr1,183543638,183543932,SRX5075175,SMARCA4,294
chr1,183543640,183543960,SRX5075168,SMARCA4,320
chr1,183543647,183543977,SRX5075174,SMARCA4,330
chr1,183543653,183543927,SRX5075169,SMARCA4,274
chr1,183543664,183543901,SRX5716463,SMARCA4,237
chr1,183580280,183580583,SRX5716470,SMARCA4,303
chr1,183580313,183580623,SRX5075176,SMARCA4,310
chr1,183580335,183580662,SRX5075170,SMARCA4,327
chr1,183580473,183580653,SRX5075169,SMARCA4,180
chr1,183591800,183592061,SRX5054309,FOSL2,261
chr1,183591808,183592054,SRX5075170,SMARCA4,246
chr1,183591834,183592009,SRX5075176,SMARCA4,175
chr1,183597766,183598148,SRX5075176,SMARCA4,382
chr1,183598203,183598731,SRX5075176,SMARCA4,528
chr1,183598276,183598735,SRX5075170,SMARCA4,459
chr1,183598392,183598640,SRX5716470,SMARCA4,248
chr1,183598485,183598672,SRX5075175,SMARCA4,187
chr1,183604058,183604525,SRX5716469,SMARCA4,467
chr1,183604066,183604473,SRX5075169,SMARCA4,407
chr1,183604075,183604391,SRX20140869,INTS10,316
chr1,183604089,183604518,SRX5075176,SMARCA4,429
chr1,183604151,183604476,SRX5075170,SMARCA4,325
chr1,183604159,183604424,SRX5716467,SMARCA2,265
chr1,183604165,183604470,SRX5075175,SMARCA4,305
chr1,183604165,183604507,SRX5054308,FOSL2,342
chr1,183604168,183604400,SRX5716470,SMARCA4,232
chr1,183604196,183604518,SRX5054309,FOSL2,322
chr1,183604215,183604448,SRX5020214,SMARCA2,233
chr1,183604217,183604429,SRX5020211,SMARCA2,212
chr1,183608351,183608617,SRX5054309,FOSL2,266
chr1,183608372,183608587,SRX5075169,SMARCA4,215
chr1,183608394,183608630,SRX5075170,SMARCA4,236
chr1,183608399,183608613,SRX5075176,SMARCA4,214
chr1,183609383,183609805,SRX5075170,SMARCA4,422
chr1,183609391,183609620,SRX5075169,SMARCA4,229
chr1,183609422,183609652,SRX5075175,SMARCA4,230
chr1,183609428,183609726,SRX5075176,SMARCA4,298
chr1,183623093,183623616,SRX16500059,CTCF,523
chr1,183623161,183623474,SRX5075176,SMARCA4,313
chr1,183623161,183623605,SRX16500060,CTCF,444
chr1,183623174,183623582,SRX16500061,CTCF,408
chr1,183623198,183623615,SRX16500062,CTCF,417
chr1,183623243,183623457,SRX5075170,SMARCA4,214
chr1,183623273,183623452,SRX5075168,SMARCA4,179
chr1,183623298,183623554,SRX4174629,CTCF,256
chr1,183633577,183634210,SRX16500060,CTCF,633
chr1,183633599,183634209,SRX16500059,CTCF,610
chr1,183633642,183634108,SRX16500062,CTCF,466
chr1,183633649,183634204,SRX16500061,CTCF,555
chr1,183633677,183634011,SRX5075170,SMARCA4,334
chr1,183633702,183634099,SRX4174629,CTCF,397
chr1,183633724,183633936,SRX5075169,SMARCA4,212
chr1,183633742,183633952,SRX5075176,SMARCA4,210
chr1,183633759,183633975,SRX5075174,SMARCA4,216
chr1,183635479,183636353,SRX20140895,INTS13,874
chr1,183635666,183635911,SRX5075176,SMARCA4,245
chr1,183635738,183636174,SRX5075170,SMARCA4,436
chr1,183635753,183636374,SRX5075168,SMARCA4,621
chr1,183635773,183636141,SRX5075174,SMARCA4,368
chr1,183635862,183636131,SRX20140897,INTS13,269
chr1,183655396,183655946,SRX16500060,CTCF,550
chr1,183655398,183655918,SRX16500061,CTCF,520
chr1,183655419,183655916,SRX16500059,CTCF,497
chr1,183655421,183655906,SRX16500062,CTCF,485
chr1,183655476,183655860,SRX4174629,CTCF,384
chr1,183655511,183655869,SRX5075168,SMARCA4,358
chr1,183655525,183655873,SRX5075174,SMARCA4,348
chr1,183655554,183655776,SRX5075175,SMARCA4,222
chr1,183655583,183655866,SRX5075176,SMARCA4,283
chr1,183655588,183655805,SRX5716463,SMARCA4,217
chr1,183655589,183655840,SRX5075169,SMARCA4,251
chr1,183655619,183655843,SRX5075170,SMARCA4,224
chr1,183674292,183674848,SRX5075176,SMARCA4,556
chr1,183674340,183674754,SRX5075170,SMARCA4,414
chr1,183674507,183674694,SRX5075169,SMARCA4,187
chr1,183676211,183676853,SRX5075168,SMARCA4,642
chr1,183676217,183676863,SRX5075174,SMARCA4,646
chr1,183676261,183676508,SRX5716454,SOX3,247
chr1,183676266,183676505,SRX5716451,SOX2,239
chr1,183676320,183676681,SRX20140868,INTS10,361
chr1,183676386,183676773,SRX5716463,SMARCA4,387
chr1,183676462,183676729,SRX20140895,INTS13,267
chr1,183685053,183685595,SRX16500060,CTCF,542
chr1,183685069,183685527,SRX16500061,CTCF,458
chr1,183685089,183685467,SRX16500062,CTCF,378
chr1,183685093,183685555,SRX16500059,CTCF,462
chr1,183685185,183685433,SRX5075174,SMARCA4,248
chr1,183711968,183712209,SRX5716470,SMARCA4,241
chr1,183711990,183712545,SRX5075170,SMARCA4,555
chr1,183712040,183712376,SRX5075175,SMARCA4,336
chr1,183712053,183712429,SRX5075168,SMARCA4,376
chr1,183712065,183712443,SRX5075176,SMARCA4,378
chr1,183712104,183712301,SRX5075169,SMARCA4,197
chr1,183720096,183720313,SRX5075169,SMARCA4,217
chr1,183720118,183720305,SRX5075175,SMARCA4,187
chr1,183721085,183721393,SRX5054309,FOSL2,308
chr1,183730914,183731205,SRX5020211,SMARCA2,291
chr1,183730974,183731170,SRX5075176,SMARCA4,196
chr1,183731021,183731269,SRX5075170,SMARCA4,248
chr1,183756944,183757506,SRX5075169,SMARCA4,562
chr1,183757043,183757492,SRX5075170,SMARCA4,449
chr1,183757063,183757552,SRX5075175,SMARCA4,489
chr1,183757091,183757498,SRX5075176,SMARCA4,407
chr1,183757093,183757453,SRX5054308,FOSL2,360
chr1,183757118,183757469,SRX5054309,FOSL2,351
chr1,183757129,183757484,SRX5716467,SMARCA2,355
chr1,183757139,183757487,SRX5020211,SMARCA2,348
chr1,183757142,183757466,SRX5075174,SMARCA4,324
chr1,183757143,183757476,SRX5716470,SMARCA4,333
chr1,183757166,183757465,SRX5716469,SMARCA4,299
chr1,183757177,183757423,SRX5075168,SMARCA4,246
chr1,183757233,183757473,SRX5075181,SMARCA2,240
chr1,183776696,183776985,SRX5716470,SMARCA4,289
chr1,183776711,183776986,SRX5075175,SMARCA4,275
chr1,183776814,183777022,SRX5020211,SMARCA2,208
chr1,183776817,183777017,SRX5075169,SMARCA4,200
chr1,183778063,183778384,SRX5075176,SMARCA4,321
chr1,183778162,183778383,SRX5075170,SMARCA4,221
chr1,183783371,183783637,SRX5075169,SMARCA4,266
chr1,183783435,183783674,SRX5075176,SMARCA4,239
chr1,183783443,183783673,SRX5075170,SMARCA4,230
chr1,183784253,183784649,SRX5075170,SMARCA4,396
chr1,183784288,183784695,SRX5075176,SMARCA4,407
chr1,183784302,183784648,SRX5075175,SMARCA4,346
chr1,183784305,183784566,SRX5716470,SMARCA4,261
chr1,183784309,183784620,SRX5075169,SMARCA4,311
chr1,183784312,183784566,SRX5020211,SMARCA2,254
chr1,183784317,183784550,SRX5054309,FOSL2,233
chr1,183784370,183784583,SRX5716468,SMARCA2,213
chr1,183784380,183784618,SRX5054308,FOSL2,238
chr1,183784385,183784601,SRX5716469,SMARCA4,216
chr1,183804897,183805320,SRX5075170,SMARCA4,423
chr1,183804915,183805338,SRX5075168,SMARCA4,423
chr1,183804924,183805341,SRX5075174,SMARCA4,417
chr1,183804934,183805200,SRX20140869,INTS10,266
chr1,183804937,183805574,SRX20140895,INTS13,637
chr1,183804952,183805325,SRX20140867,INTS10,373
chr1,183804962,183805224,SRX5716468,SMARCA2,262
chr1,183804965,183805506,SRX5075176,SMARCA4,541
chr1,183804997,183805409,SRX20140897,INTS13,412
chr1,183805015,183805391,SRX5075169,SMARCA4,376
chr1,183805031,183805240,SRX5075175,SMARCA4,209
chr1,183805061,183805344,SRX20140868,INTS10,283
chr1,183805086,183805390,SRX5716470,SMARCA4,304
chr1,183805123,183805431,SRX20140881,CPSF3L,308
chr1,183807883,183808174,SRX5054309,FOSL2,291
chr1,183807911,183808103,SRX5054308,FOSL2,192
chr1,183812587,183813295,SRX5075168,SMARCA4,708
chr1,183812612,183813359,SRX5075174,SMARCA4,747
chr1,183812816,183813039,SRX5054309,FOSL2,223
chr1,183822078,183822522,SRX5075176,SMARCA4,444
chr1,183822154,183822596,SRX5075169,SMARCA4,442
chr1,183822275,183822613,SRX5075170,SMARCA4,338
chr1,183822288,183822526,SRX5716470,SMARCA4,238
chr1,183831361,183831603,SRX5075169,SMARCA4,242
chr1,183836677,183836947,SRX5054308,FOSL2,270
chr1,183837088,183837311,SRX5075175,SMARCA4,223
chr1,183837243,183837478,SRX20140879,CPSF3L,235
chr1,183840206,183840455,SRX5054309,FOSL2,249
chr1,183842344,183842869,SRX5075170,SMARCA4,525
chr1,183842407,183842829,SRX5716470,SMARCA4,422
chr1,183842414,183842875,SRX5075176,SMARCA4,461
chr1,183842418,183842916,SRX5075175,SMARCA4,498
chr1,183842422,183842755,SRX5020211,SMARCA2,333
chr1,183842440,183842840,SRX5075169,SMARCA4,400
chr1,183842487,183842777,SRX5716469,SMARCA4,290
chr1,183842497,183842798,SRX5075174,SMARCA4,301
chr1,183842498,183842786,SRX5020214,SMARCA2,288
chr1,183842508,183842829,SRX5716467,SMARCA2,321
chr1,183842522,183842749,SRX5716468,SMARCA2,227
chr1,183842544,183842724,SRX5054308,FOSL2,180
chr1,183842556,183842788,SRX5054309,FOSL2,232
chr1,183842630,183842820,SRX5075168,SMARCA4,190
chr1,183843260,183843655,SRX5075176,SMARCA4,395
chr1,183843280,183843618,SRX5075175,SMARCA4,338
chr1,183843293,183843660,SRX5716470,SMARCA4,367
chr1,183843305,183843662,SRX5075170,SMARCA4,357
chr1,183843331,183843668,SRX5716469,SMARCA4,337
chr1,183843350,183843635,SRX5075169,SMARCA4,285
chr1,183843353,183843614,SRX5716467,SMARCA2,261
chr1,183843357,183843639,SRX5020211,SMARCA2,282
chr1,183843387,183843593,SRX5075174,SMARCA4,206
chr1,183843425,183843635,SRX5075168,SMARCA4,210
chr1,183843449,183843666,SRX5716464,SMARCA4,217
chr1,183850859,183851228,SRX5075170,SMARCA4,369
chr1,183850868,183851103,SRX5054309,FOSL2,235
chr1,183850891,183851158,SRX5054308,FOSL2,267
chr1,183850897,183851141,SRX5075169,SMARCA4,244
chr1,183851002,183851245,SRX5075176,SMARCA4,243
chr1,183859692,183860264,SRX5075170,SMARCA4,572
chr1,183859831,183860336,SRX5075176,SMARCA4,505
chr1,183859875,183860255,SRX5075175,SMARCA4,380
chr1,183859914,183860321,SRX5075169,SMARCA4,407
chr1,183859943,183860275,SRX5054309,FOSL2,332
chr1,183859992,183860266,SRX5020211,SMARCA2,274
chr1,183859995,183860277,SRX5054308,FOSL2,282
chr1,183871143,183871474,SRX5075176,SMARCA4,331
chr1,183871189,183871477,SRX5075170,SMARCA4,288
chr1,183871259,183871454,SRX5075168,SMARCA4,195
chr1,183871318,183871503,SRX5075174,SMARCA4,185
chr1,183881555,183882144,SRX5075175,SMARCA4,589
chr1,183881569,183882140,SRX5075170,SMARCA4,571
chr1,183881571,183882089,SRX5075169,SMARCA4,518
chr1,183881577,183882174,SRX5075176,SMARCA4,597
chr1,183881590,183882043,SRX5075168,SMARCA4,453
chr1,183881635,183882013,SRX5054309,FOSL2,378
chr1,183881644,183882023,SRX5075174,SMARCA4,379
chr1,183881645,183882070,SRX5716469,SMARCA4,425
chr1,183881656,183882016,SRX5054308,FOSL2,360
chr1,183881657,183881978,SRX5020211,SMARCA2,321
chr1,183881667,183882078,SRX5716470,SMARCA4,411
chr1,183881670,183882060,SRX5716468,SMARCA2,390
chr1,183881680,183882056,SRX5020214,SMARCA2,376
chr1,183881691,183881964,SRX5075181,SMARCA2,273
chr1,183881693,183882117,SRX5716467,SMARCA2,424
chr1,183881710,183881908,SRX5054307,FOSL2,198
chr1,183881718,183881933,SRX5716464,SMARCA4,215
chr1,183881756,183881992,SRX5716463,SMARCA4,236
chr1,183888145,183888461,SRX5075170,SMARCA4,316
chr1,183888147,183888562,SRX5075169,SMARCA4,415
chr1,183888210,183888482,SRX5075175,SMARCA4,272
chr1,183888240,183888586,SRX5054308,FOSL2,346
chr1,183888262,183888504,SRX5075176,SMARCA4,242
chr1,183888298,183888532,SRX5716470,SMARCA4,234
chr1,183907003,183907401,SRX5075174,SMARCA4,398
chr1,183907114,183907395,SRX5075168,SMARCA4,281
chr1,183915861,183916398,SRX16500060,CTCF,537
chr1,183915907,183916416,SRX16500059,CTCF,509
chr1,183915923,183916413,SRX16500062,CTCF,490
chr1,183915926,183916392,SRX16500061,CTCF,466
chr1,183915937,183916358,SRX4174629,CTCF,421
chr1,183915947,183916402,SRX5075170,SMARCA4,455
chr1,183915952,183916410,SRX5075174,SMARCA4,458
chr1,183915975,183916338,SRX5716470,SMARCA4,363
chr1,183915975,183916361,SRX5075176,SMARCA4,386
chr1,183915980,183916411,SRX5075169,SMARCA4,431
chr1,183916016,183916348,SRX5075168,SMARCA4,332
chr1,183916024,183916401,SRX5075175,SMARCA4,377
chr1,183916053,183916275,SRX5716463,SMARCA4,222
chr1,183916073,183916389,SRX5054308,FOSL2,316
chr1,183916077,183916366,SRX5716469,SMARCA4,289
chr1,183916095,183916424,SRX5054309,FOSL2,329
chr1,183932494,183932763,SRX5054308,FOSL2,269
chr1,183932534,183932766,SRX5075169,SMARCA4,232
chr1,183937661,183937924,SRX5075176,SMARCA4,263
chr1,183942764,183943363,SRX20140895,INTS13,599
chr1,183942845,183943569,SRX5075176,SMARCA4,724
chr1,183942850,183943489,SRX5075170,SMARCA4,639
chr1,183942857,183943374,SRX5716469,SMARCA4,517
chr1,183942864,183943260,SRX5020214,SMARCA2,396
chr1,183942889,183943421,SRX5075175,SMARCA4,532
chr1,183942894,183943442,SRX5075169,SMARCA4,548
chr1,183942894,183943527,SRX5716470,SMARCA4,633
chr1,183942901,183943318,SRX5054308,FOSL2,417
chr1,183942918,183943466,SRX5716468,SMARCA2,548
chr1,183942934,183943346,SRX5054309,FOSL2,412
chr1,183942934,183943370,SRX5716467,SMARCA2,436
chr1,183942935,183943581,SRX5075174,SMARCA4,646
chr1,183942946,183943587,SRX5075168,SMARCA4,641
chr1,183942954,183943184,SRX5075181,SMARCA2,230
chr1,183942954,183943380,SRX5020211,SMARCA2,426
chr1,183942969,183943162,SRX5075182,SMARCA2,193
chr1,183943171,183943516,SRX5716464,SMARCA4,345
chr1,183943187,183943554,SRX5716463,SMARCA4,367
chr1,183945385,183945886,SRX5075168,SMARCA4,501
chr1,183945410,183945694,SRX5716463,SMARCA4,284
chr1,183945436,183945827,SRX5075174,SMARCA4,391
chr1,183945517,183945786,SRX20140868,INTS10,269
chr1,183945546,183945751,SRX5716454,SOX3,205
chr1,183956668,183957054,SRX5075169,SMARCA4,386
chr1,183956688,183957033,SRX5054308,FOSL2,345
chr1,183956699,183957064,SRX5054309,FOSL2,365
chr1,183956700,183956980,SRX5075176,SMARCA4,280
chr1,183956771,183957016,SRX5075175,SMARCA4,245
chr1,183956779,183957016,SRX5075170,SMARCA4,237
chr1,183970915,183971274,SRX5075170,SMARCA4,359
chr1,183970945,183971184,SRX5054308,FOSL2,239
chr1,183970955,183971291,SRX5075176,SMARCA4,336
chr1,183970957,183971255,SRX5075175,SMARCA4,298
chr1,183970958,183971258,SRX5075169,SMARCA4,300
chr1,183983351,183983673,SRX5075168,SMARCA4,322
chr1,183983403,183983650,SRX5075174,SMARCA4,247
chr1,183989116,183989429,SRX5075169,SMARCA4,313
chr1,183989156,183989387,SRX5075170,SMARCA4,231
chr1,183989269,183989504,SRX5075175,SMARCA4,235
chr1,184002089,184002638,SRX5075176,SMARCA4,549
chr1,184002106,184002514,SRX5716470,SMARCA4,408
chr1,184002117,184002612,SRX5075170,SMARCA4,495
chr1,184002124,184002626,SRX5075174,SMARCA4,502
chr1,184002131,184002582,SRX5075175,SMARCA4,451
chr1,184002155,184002617,SRX5075169,SMARCA4,462
chr1,184002160,184002556,SRX5075168,SMARCA4,396
chr1,184002206,184002550,SRX5054309,FOSL2,344
chr1,184002211,184002515,SRX5054308,FOSL2,304
chr1,184002233,184002594,SRX5716469,SMARCA4,361
chr1,184002299,184002544,SRX5716467,SMARCA2,245
chr1,184002323,184002523,SRX5020211,SMARCA2,200
chr1,184025036,184025292,SRX20140895,INTS13,256
chr1,184025253,184025623,SRX5075169,SMARCA4,370
chr1,184025354,184025595,SRX5075175,SMARCA4,241
chr1,184025366,184025611,SRX5075176,SMARCA4,245
chr1,184025393,184025573,SRX5054308,FOSL2,180
chr1,184025394,184025571,SRX5075170,SMARCA4,177
chr1,184036926,184037118,SRX5075175,SMARCA4,192
chr1,184036958,184037228,SRX5075169,SMARCA4,270
chr1,184036963,184037681,SRX20140895,INTS13,718
chr1,184037036,184037308,SRX5075170,SMARCA4,272
chr1,184037072,184037453,SRX20140868,INTS10,381
chr1,184037284,184037501,SRX5075174,SMARCA4,217
chr1,184037559,184037750,SRX5075169,SMARCA4,191
chr1,184051363,184051839,SRX5075176,SMARCA4,476
chr1,184051398,184051610,SRX5716469,SMARCA4,212
chr1,184051431,184051814,SRX5075175,SMARCA4,383
chr1,184051451,184051783,SRX5075169,SMARCA4,332
chr1,184051466,184051916,SRX5075170,SMARCA4,450
chr1,184051481,184052235,SRX20140895,INTS13,754
chr1,184051520,184051886,SRX5075174,SMARCA4,366
chr1,184051564,184052032,SRX20140868,INTS10,468
chr1,184051565,184051942,SRX20140897,INTS13,377
chr1,184051580,184051894,SRX20140867,INTS10,314
chr1,184051623,184051894,SRX5075168,SMARCA4,271
chr1,184056952,184057556,SRX5075168,SMARCA4,604
chr1,184056982,184057498,SRX5075169,SMARCA4,516
chr1,184056996,184057511,SRX5075174,SMARCA4,515
chr1,184057077,184057332,SRX5716470,SMARCA4,255
chr1,184057202,184057590,SRX5054309,FOSL2,388
chr1,184057217,184057489,SRX5716469,SMARCA4,272
chr1,184057291,184057555,SRX5054308,FOSL2,264
chr1,184061671,184061978,SRX5075170,SMARCA4,307
chr1,184061677,184061940,SRX5075176,SMARCA4,263
chr1,184061687,184062026,SRX5716469,SMARCA4,339
chr1,184061698,184061978,SRX5075168,SMARCA4,280
chr1,184061716,184061907,SRX5075175,SMARCA4,191
chr1,184061734,184061993,SRX5075174,SMARCA4,259
chr1,184062728,184063387,SRX5075174,SMARCA4,659
chr1,184062787,184063414,SRX5075168,SMARCA4,627
chr1,184062839,184063250,SRX5716451,SOX2,411
chr1,184062899,184063380,SRX5716463,SMARCA4,481
chr1,184062936,184063294,SRX20140895,INTS13,358
chr1,184062948,184063204,SRX5075176,SMARCA4,256
chr1,184062971,184063209,SRX5716454,SOX3,238
chr1,184062977,184063201,SRX5716464,SMARCA4,224
chr1,184068379,184068774,SRX5075168,SMARCA4,395
chr1,184068405,184068803,SRX5075174,SMARCA4,398
chr1,184072469,184072686,SRX5054309,FOSL2,217
chr1,184075323,184075850,SRX16500060,CTCF,527
chr1,184075370,184075874,SRX16500059,CTCF,504
chr1,184075416,184075848,SRX16500061,CTCF,432
chr1,184075420,184075829,SRX16500062,CTCF,409
chr1,184075424,184075787,SRX5075174,SMARCA4,363
chr1,184075453,184075744,SRX5075168,SMARCA4,291
chr1,184075499,184075752,SRX5716463,SMARCA4,253
chr1,184078796,184079041,SRX5075170,SMARCA4,245
chr1,184078803,184079061,SRX5716467,SMARCA2,258
chr1,184078807,184079074,SRX5075176,SMARCA4,267
chr1,184078837,184079027,SRX5075169,SMARCA4,190
chr1,184078872,184079122,SRX5075175,SMARCA4,250
chr1,184101169,184101369,SRX5020211,SMARCA2,200
chr1,184101213,184101382,SRX5075170,SMARCA4,169
chr1,184101231,184101453,SRX5075176,SMARCA4,222
chr1,184116320,184116610,SRX5075168,SMARCA4,290
chr1,184116368,184116612,SRX5075174,SMARCA4,244
chr1,184117991,184118308,SRX5020211,SMARCA2,317
chr1,184118006,184118399,SRX5075170,SMARCA4,393
chr1,184118018,184118391,SRX5716469,SMARCA4,373
chr1,184118029,184118409,SRX5054308,FOSL2,380
chr1,184118033,184118398,SRX5075176,SMARCA4,365
chr1,184118041,184118419,SRX5075169,SMARCA4,378
chr1,184118050,184118358,SRX5054309,FOSL2,308
chr1,184118052,184118406,SRX5075175,SMARCA4,354
chr1,184118117,184118398,SRX5716467,SMARCA2,281
chr1,184121765,184121994,SRX5054308,FOSL2,229
chr1,184121773,184121997,SRX5054309,FOSL2,224
chr1,184121794,184121978,SRX5075169,SMARCA4,184
chr1,184121816,184121995,SRX5075176,SMARCA4,179
chr1,184152423,184152849,SRX5716469,SMARCA4,426
chr1,184152454,184152913,SRX5075169,SMARCA4,459
chr1,184152493,184152929,SRX5075176,SMARCA4,436
chr1,184152506,184152940,SRX5075170,SMARCA4,434
chr1,184152527,184152830,SRX5020211,SMARCA2,303
chr1,184152530,184152876,SRX5716467,SMARCA2,346
chr1,184152541,184152996,SRX5075175,SMARCA4,455
chr1,184152546,184152857,SRX5054309,FOSL2,311
chr1,184152558,184152889,SRX5054308,FOSL2,331
chr1,184152581,184152819,SRX5716470,SMARCA4,238
chr1,184152616,184152870,SRX5075174,SMARCA4,254
chr1,184163623,184164002,SRX5716469,SMARCA4,379
chr1,184163640,184164036,SRX5075176,SMARCA4,396
chr1,184163660,184164002,SRX5075175,SMARCA4,342
chr1,184163671,184164055,SRX5075170,SMARCA4,384
chr1,184163674,184164020,SRX5054308,FOSL2,346
chr1,184163688,184163942,SRX5716467,SMARCA2,254
chr1,184163688,184164009,SRX5054309,FOSL2,321
chr1,184163695,184164049,SRX5075169,SMARCA4,354
chr1,184163709,184164037,SRX5716470,SMARCA4,328
chr1,184163714,184163957,SRX5020211,SMARCA2,243
chr1,184163719,184163965,SRX5716468,SMARCA2,246
chr1,184199099,184199357,SRX5054309,FOSL2,258
chr1,184212855,184213316,SRX5075176,SMARCA4,461
chr1,184212881,184213278,SRX5075175,SMARCA4,397
chr1,184212887,184213234,SRX5054309,FOSL2,347
chr1,184212894,184213380,SRX5075169,SMARCA4,486
chr1,184212914,184213299,SRX5075170,SMARCA4,385
chr1,184212926,184213275,SRX5716469,SMARCA4,349
chr1,184212939,184213215,SRX5054308,FOSL2,276
chr1,184212940,184213270,SRX5716467,SMARCA2,330
chr1,184212974,184213309,SRX5716470,SMARCA4,335
chr1,184212998,184213307,SRX5716468,SMARCA2,309
chr1,184219439,184219685,SRX5075175,SMARCA4,246
chr1,184222490,184222977,SRX16500061,CTCF,487
chr1,184222508,184223005,SRX16500059,CTCF,497
chr1,184222516,184223000,SRX16500060,CTCF,484
chr1,184222528,184222949,SRX16500062,CTCF,421
chr1,184260387,184260670,SRX5075169,SMARCA4,283
chr1,184260399,184260747,SRX5054308,FOSL2,348
chr1,184260404,184260775,SRX5054309,FOSL2,371
chr1,184260411,184260677,SRX5075170,SMARCA4,266
chr1,184272280,184272807,SRX5075169,SMARCA4,527
chr1,184272285,184272799,SRX5075170,SMARCA4,514
chr1,184272369,184272855,SRX5075175,SMARCA4,486
chr1,184272405,184272837,SRX5075176,SMARCA4,432
chr1,184272415,184272778,SRX5054308,FOSL2,363
chr1,184272485,184272823,SRX5054309,FOSL2,338
chr1,184272513,184272718,SRX5020214,SMARCA2,205
chr1,184272549,184272816,SRX5716470,SMARCA4,267
chr1,184278202,184278427,SRX5054308,FOSL2,225
chr1,184296540,184297030,SRX5075176,SMARCA4,490
chr1,184296592,184297008,SRX5075170,SMARCA4,416
chr1,184296609,184296889,SRX5716470,SMARCA4,280
chr1,184296634,184296976,SRX5075175,SMARCA4,342
chr1,184296693,184297012,SRX5075169,SMARCA4,319
chr1,184299176,184299660,SRX5075176,SMARCA4,484
chr1,184299293,184299639,SRX5075175,SMARCA4,346
chr1,184299300,184299548,SRX5716469,SMARCA4,248
chr1,184299322,184299615,SRX5075170,SMARCA4,293
chr1,184299390,184299643,SRX5054309,FOSL2,253
chr1,184299392,184299678,SRX5075169,SMARCA4,286
chr1,184299414,184299594,SRX5054308,FOSL2,180
chr1,184330199,184330726,SRX20140895,INTS13,527
chr1,184330299,184330660,SRX5075174,SMARCA4,361
chr1,184330402,184330678,SRX5075168,SMARCA4,276
chr1,184367091,184367293,SRX5054308,FOSL2,202
chr1,184367102,184367346,SRX5075176,SMARCA4,244
chr1,184385886,184386253,SRX5075168,SMARCA4,367
chr1,184385899,184386218,SRX5075174,SMARCA4,319
chr1,184385938,184386140,SRX5716451,SOX2,202
chr1,184385941,184386205,SRX5716463,SMARCA4,264
chr1,184385992,184386216,SRX5716454,SOX3,224
chr1,184386110,184386734,SRX20140895,INTS13,624
chr1,184386262,184386618,SRX20140868,INTS10,356
chr1,184386756,184387191,SRX5075170,SMARCA4,435
chr1,184386836,184387139,SRX5075169,SMARCA4,303
chr1,184386856,184387176,SRX5075174,SMARCA4,320
chr1,184386861,184387082,SRX5716470,SMARCA4,221
chr1,184386866,184387151,SRX5075176,SMARCA4,285
chr1,184386868,184387208,SRX5075168,SMARCA4,340
chr1,184386907,184387090,SRX5054309,FOSL2,183
chr1,184386940,184387316,SRX20140895,INTS13,376
chr1,184386952,184387226,SRX5075175,SMARCA4,274
chr1,184388506,184388704,SRX5054309,FOSL2,198
chr1,184408153,184408360,SRX5075175,SMARCA4,207
chr1,184491551,184491824,SRX5716467,SMARCA2,273
chr1,184491566,184491898,SRX5075170,SMARCA4,332
chr1,184491572,184491918,SRX5075175,SMARCA4,346
chr1,184491572,184491986,SRX5716470,SMARCA4,414
chr1,184491573,184492114,SRX5075169,SMARCA4,541
chr1,184491575,184491992,SRX5054308,FOSL2,417
chr1,184491604,184491942,SRX5054309,FOSL2,338
chr1,184491626,184491885,SRX5716459,Epitope tags,259
chr1,184491628,184491908,SRX5075176,SMARCA4,280
chr1,184491637,184492038,SRX5716469,SMARCA4,401
chr1,184491713,184491921,SRX5020211,SMARCA2,208
chr1,184497935,184498298,SRX5075174,SMARCA4,363
chr1,184497974,184498230,SRX5075168,SMARCA4,256
chr1,184498022,184498284,SRX20140895,INTS13,262
chr1,184498023,184498229,SRX5716464,SMARCA4,206
chr1,184498062,184498352,SRX16500061,CTCF,290
chr1,184498165,184498386,SRX16500060,CTCF,221
chr1,184507619,184507834,SRX5075169,SMARCA4,215
chr1,184520407,184520620,SRX5075174,SMARCA4,213
chr1,184520464,184520635,SRX5075170,SMARCA4,171
chr1,184551201,184551401,SRX5020211,SMARCA2,200
chr1,184551247,184551433,SRX5054308,FOSL2,186
chr1,184563359,184563679,SRX5075169,SMARCA4,320
chr1,184563361,184563690,SRX16500059,CTCF,329
chr1,184563366,184563607,SRX5075170,SMARCA4,241
chr1,184563370,184563610,SRX16500062,CTCF,240
chr1,184563386,184563684,SRX5075175,SMARCA4,298
chr1,184563387,184563560,SRX5075174,SMARCA4,173
chr1,184563398,184563634,SRX16500061,CTCF,236
chr1,184563398,184563701,SRX16500060,CTCF,303
chr1,184563405,184563635,SRX5075176,SMARCA4,230
chr1,184563415,184563656,SRX5716470,SMARCA4,241
chr1,184574664,184574887,SRX5075168,SMARCA4,223
chr1,184597242,184597463,SRX16500060,CTCF,221
chr1,184611298,184611476,SRX5075170,SMARCA4,178
chr1,184611349,184611555,SRX5075176,SMARCA4,206
chr1,184611352,184611628,SRX5020211,SMARCA2,276
chr1,184621283,184621474,SRX5075170,SMARCA4,191
chr1,184622232,184622581,SRX5075170,SMARCA4,349
chr1,184622282,184622601,SRX5716470,SMARCA4,319
chr1,184622293,184622599,SRX5075176,SMARCA4,306
chr1,184622305,184622601,SRX5075169,SMARCA4,296
chr1,184622310,184622600,SRX5075175,SMARCA4,290
chr1,184622353,184622588,SRX5716469,SMARCA4,235
chr1,184622360,184622560,SRX5020211,SMARCA2,200
chr1,184655220,184655418,SRX5075168,SMARCA4,198
chr1,184655238,184655434,SRX5075174,SMARCA4,196
chr1,184663899,184664437,SRX16500062,CTCF,538
chr1,184663903,184664468,SRX16500060,CTCF,565
chr1,184663927,184664412,SRX16500059,CTCF,485
chr1,184663944,184664209,SRX5075169,SMARCA4,265
chr1,184663960,184664433,SRX16500061,CTCF,473
chr1,184663966,184664247,SRX5075168,SMARCA4,281
chr1,184663967,184664242,SRX5716470,SMARCA4,275
chr1,184663975,184664180,SRX5716464,SMARCA4,205
chr1,184663994,184664271,SRX5075176,SMARCA4,277
chr1,184664002,184664302,SRX5075174,SMARCA4,300
chr1,184664006,184664249,SRX5075170,SMARCA4,243
chr1,184664008,184664225,SRX4174629,CTCF,217
chr1,184664048,184664235,SRX5075175,SMARCA4,187
chr1,184669388,184669851,SRX5075168,SMARCA4,463
chr1,184669394,184669832,SRX5075174,SMARCA4,438
chr1,184691661,184692107,SRX16500060,CTCF,446
chr1,184691661,184692142,SRX16500059,CTCF,481
chr1,184691675,184692076,SRX16500062,CTCF,401
chr1,184691687,184692110,SRX16500061,CTCF,423
chr1,184691697,184692032,SRX5075168,SMARCA4,335
chr1,184691736,184691972,SRX5075176,SMARCA4,236
chr1,184691741,184691999,SRX5075175,SMARCA4,258
chr1,184691753,184692054,SRX5075174,SMARCA4,301
chr1,184691769,184692021,SRX5075170,SMARCA4,252
chr1,184691778,184691986,SRX5716463,SMARCA4,208
chr1,184691806,184692003,SRX5075169,SMARCA4,197
chr1,184692907,184693331,SRX5716469,SMARCA4,424
chr1,184692939,184693484,SRX5075169,SMARCA4,545
chr1,184692954,184693362,SRX5716470,SMARCA4,408
chr1,184692968,184693390,SRX5075170,SMARCA4,422
chr1,184692972,184693354,SRX5020211,SMARCA2,382
chr1,184692978,184693357,SRX5054308,FOSL2,379
chr1,184692997,184693307,SRX5075176,SMARCA4,310
chr1,184693034,184693364,SRX5075181,SMARCA2,330
chr1,184693087,184693348,SRX5020214,SMARCA2,261
chr1,184693093,184693311,SRX5054309,FOSL2,218
chr1,184693108,184693337,SRX5716467,SMARCA2,229
chr1,184754080,184754255,SRX5075174,SMARCA4,175
chr1,184754428,184754641,SRX5075169,SMARCA4,213
chr1,184754465,184755006,SRX20140895,INTS13,541
chr1,184754543,184754852,SRX5075176,SMARCA4,309
chr1,184754550,184754845,SRX5075168,SMARCA4,295
chr1,184754587,184754941,SRX20140867,INTS10,354
chr1,184754605,184754921,SRX20140868,INTS10,316
chr1,184754655,184755021,SRX20140881,CPSF3L,366
chr1,184754700,184755400,SRX5075174,SMARCA4,700
chr1,184754888,184755118,SRX5054307,FOSL2,230
chr1,184754910,184755419,SRX5716463,SMARCA4,509
chr1,184755001,184755419,SRX5075168,SMARCA4,418
chr1,184755063,184755323,SRX5075170,SMARCA4,260
chr1,184755160,184755359,SRX5075176,SMARCA4,199
chr1,184755167,184755439,SRX20140895,INTS13,272
chr1,184792476,184792990,SRX5716469,SMARCA4,514
chr1,184792513,184793079,SRX5075169,SMARCA4,566
chr1,184792521,184793058,SRX5075170,SMARCA4,537
chr1,184792559,184793110,SRX5075175,SMARCA4,551
chr1,184792559,184793125,SRX5075176,SMARCA4,566
chr1,184792576,184792962,SRX5716468,SMARCA2,386
chr1,184792579,184792946,SRX5716470,SMARCA4,367
chr1,184792590,184792957,SRX5716467,SMARCA2,367
chr1,184792610,184793064,SRX5054309,FOSL2,454
chr1,184792628,184793027,SRX5020214,SMARCA2,399
chr1,184792631,184792988,SRX5054308,FOSL2,357
chr1,184792669,184792934,SRX5075181,SMARCA2,265
chr1,184792722,184793142,SRX5716460,Epitope tags,420
chr1,184792724,184792962,SRX5020211,SMARCA2,238
chr1,184801491,184801902,SRX5075170,SMARCA4,411
chr1,184801572,184801856,SRX5075176,SMARCA4,284
chr1,184801598,184801785,SRX5075175,SMARCA4,187
chr1,184803077,184803318,SRX5054308,FOSL2,241
chr1,184803102,184803343,SRX5054309,FOSL2,241
chr1,184803116,184803351,SRX5075170,SMARCA4,235
chr1,184803201,184803446,SRX5075176,SMARCA4,245
chr1,184805468,184806026,SRX16500059,CTCF,558
chr1,184805490,184805951,SRX16500061,CTCF,461
chr1,184805520,184805952,SRX16500062,CTCF,432
chr1,184805520,184806004,SRX16500060,CTCF,484
chr1,184805587,184805958,SRX4174629,CTCF,371
chr1,184805616,184805935,SRX5075168,SMARCA4,319
chr1,184805620,184805916,SRX5075174,SMARCA4,296
chr1,184805639,184805871,SRX5075170,SMARCA4,232
chr1,184805672,184805910,SRX5716463,SMARCA4,238
chr1,184821080,184821305,SRX5054308,FOSL2,225
chr1,184821081,184821348,SRX5075170,SMARCA4,267
chr1,184821101,184821409,SRX5075176,SMARCA4,308
chr1,184821113,184821293,SRX5075169,SMARCA4,180
chr1,184828013,184828469,SRX5075170,SMARCA4,456
chr1,184828014,184828496,SRX5075169,SMARCA4,482
chr1,184828051,184828461,SRX5075175,SMARCA4,410
chr1,184828065,184828475,SRX5716470,SMARCA4,410
chr1,184828069,184828465,SRX5054308,FOSL2,396
chr1,184828070,184828456,SRX5716469,SMARCA4,386
chr1,184828073,184828546,SRX5716460,Epitope tags,473
chr1,184828074,184828401,SRX5716467,SMARCA2,327
chr1,184828079,184828458,SRX5054309,FOSL2,379
chr1,184828091,184828461,SRX5075176,SMARCA4,370
chr1,184828134,184828394,SRX5020214,SMARCA2,260
chr1,184828147,184828450,SRX5075181,SMARCA2,303
chr1,184828170,184828459,SRX5716459,Epitope tags,289
chr1,184828181,184828481,SRX5020211,SMARCA2,300
chr1,184836110,184836383,SRX5075170,SMARCA4,273
chr1,184836131,184836376,SRX5075176,SMARCA4,245
chr1,184838412,184839063,SRX5075176,SMARCA4,651
chr1,184838416,184839071,SRX5075170,SMARCA4,655
chr1,184838419,184839046,SRX5075169,SMARCA4,627
chr1,184838452,184838943,SRX5716468,SMARCA2,491
chr1,184838452,184839059,SRX5054308,FOSL2,607
chr1,184838458,184839046,SRX5716470,SMARCA4,588
chr1,184838458,184839068,SRX5716467,SMARCA2,610
chr1,184838469,184838965,SRX5075175,SMARCA4,496
chr1,184838496,184838903,SRX5716469,SMARCA4,407
chr1,184838496,184838966,SRX5020211,SMARCA2,470
chr1,184838524,184838887,SRX5075181,SMARCA2,363
chr1,184838559,184839017,SRX5054309,FOSL2,458
chr1,184854513,184854797,SRX5075169,SMARCA4,284
chr1,184854514,184854736,SRX5075170,SMARCA4,222
chr1,184866979,184867628,SRX5075175,SMARCA4,649
chr1,184867008,184867620,SRX5075176,SMARCA4,612
chr1,184867021,184867556,SRX5075170,SMARCA4,535
chr1,184867054,184867551,SRX5075169,SMARCA4,497
chr1,184867057,184867512,SRX5716467,SMARCA2,455
chr1,184867107,184867515,SRX5020211,SMARCA2,408
chr1,184867136,184867540,SRX5716469,SMARCA4,404
chr1,184867157,184867556,SRX5716468,SMARCA2,399
chr1,184867161,184867539,SRX5054308,FOSL2,378
chr1,184867175,184867583,SRX5716470,SMARCA4,408
chr1,184867185,184867635,SRX5054309,FOSL2,450
chr1,184867235,184867696,SRX5716459,Epitope tags,461
chr1,184886641,184886907,SRX5054308,FOSL2,266
chr1,184886688,184886900,SRX5054309,FOSL2,212
chr1,184888443,184888926,SRX5075169,SMARCA4,483
chr1,184888465,184888889,SRX5075175,SMARCA4,424
chr1,184888480,184888901,SRX5075170,SMARCA4,421
chr1,184888482,184888904,SRX5054309,FOSL2,422
chr1,184888494,184888925,SRX5075176,SMARCA4,431
chr1,184888510,184888894,SRX5716467,SMARCA2,384
chr1,184888513,184888943,SRX5054308,FOSL2,430
chr1,184888514,184888878,SRX5716469,SMARCA4,364
chr1,184888539,184888877,SRX5716470,SMARCA4,338
chr1,184888553,184888839,SRX5716468,SMARCA2,286
chr1,184888561,184888830,SRX5075181,SMARCA2,269
chr1,184888606,184888873,SRX5020211,SMARCA2,267
chr1,184888609,184888821,SRX5075182,SMARCA2,212
chr1,184888635,184888864,SRX5020214,SMARCA2,229
chr1,184888711,184888896,SRX5054307,FOSL2,185
chr1,184889979,184890152,SRX5075170,SMARCA4,173
chr1,184889989,184890171,SRX5075176,SMARCA4,182
chr1,184896129,184896352,SRX5020211,SMARCA2,223
chr1,184896165,184896361,SRX5075175,SMARCA4,196
chr1,184919680,184919919,SRX5054308,FOSL2,239
chr1,184919707,184919876,SRX5075170,SMARCA4,169
chr1,184936044,184936468,SRX5075170,SMARCA4,424
chr1,184936093,184936333,SRX5054308,FOSL2,240
chr1,184936105,184936340,SRX5075169,SMARCA4,235
chr1,184936108,184936442,SRX5075176,SMARCA4,334
chr1,184936119,184936362,SRX5716470,SMARCA4,243
chr1,184936190,184936390,SRX5020211,SMARCA2,200
chr1,184936295,184936489,SRX5075181,SMARCA2,194
chr1,184946032,184946395,SRX5075176,SMARCA4,363
chr1,184946114,184946338,SRX5075169,SMARCA4,224
chr1,184946121,184946399,SRX5075170,SMARCA4,278
chr1,184970729,184971147,SRX5075170,SMARCA4,418
chr1,184970814,184971115,SRX5075176,SMARCA4,301
chr1,184970848,184971174,SRX5075175,SMARCA4,326
chr1,184970866,184971164,SRX5054308,FOSL2,298
chr1,184970879,184971198,SRX5054309,FOSL2,319
chr1,184970909,184971116,SRX5075169,SMARCA4,207
chr1,184973630,184974519,SRX20140895,INTS13,889
chr1,184973718,184974025,SRX5716469,SMARCA4,307
chr1,184973751,184974281,SRX5075168,SMARCA4,530
chr1,184973813,184974112,SRX20140868,INTS10,299
chr1,184973930,184974242,SRX20140867,INTS10,312
chr1,184973934,184974277,SRX5075174,SMARCA4,343
chr1,184982171,184982394,SRX5075168,SMARCA4,223
chr1,184982187,184982360,SRX5075174,SMARCA4,173
chr1,184982217,184982413,SRX5075169,SMARCA4,196
chr1,185008827,185009039,SRX5716469,SMARCA4,212
chr1,185008834,185009071,SRX5716470,SMARCA4,237
chr1,185017296,185017552,SRX5075170,SMARCA4,256
chr1,185017317,185017615,SRX5054308,FOSL2,298
chr1,185017331,185017619,SRX5075169,SMARCA4,288
chr1,185017335,185017630,SRX5075176,SMARCA4,295
chr1,185017351,185017593,SRX5054309,FOSL2,242
chr1,185017352,185017567,SRX5716467,SMARCA2,215
chr1,185017377,185017622,SRX5716469,SMARCA4,245
chr1,185017392,185017660,SRX5075175,SMARCA4,268
chr1,185045179,185045627,SRX5075176,SMARCA4,448
chr1,185045179,185045697,SRX5075168,SMARCA4,518
chr1,185045203,185045588,SRX5075174,SMARCA4,385
chr1,185045212,185046069,SRX20140895,INTS13,857
chr1,185045233,185045684,SRX5075170,SMARCA4,451
chr1,185045270,185045514,SRX5054309,FOSL2,244
chr1,185045318,185045702,SRX20140897,INTS13,384
chr1,185045349,185045748,SRX20140867,INTS10,399
chr1,185045395,185045934,SRX20140868,INTS10,539
chr1,185045502,185045741,SRX5716470,SMARCA4,239
chr1,185045986,185046171,SRX5075169,SMARCA4,185
chr1,185156086,185156277,SRX5075174,SMARCA4,191
chr1,185156432,185157070,SRX20140895,INTS13,638
chr1,185156637,185156901,SRX20140868,INTS10,264
chr1,185156712,185156887,SRX5075176,SMARCA4,175
chr1,185156731,185156994,SRX20140867,INTS10,263
chr1,185156742,185157093,SRX5075168,SMARCA4,351
chr1,185156797,185157063,SRX20140897,INTS13,266
chr1,185156823,185157129,SRX5716464,SMARCA4,306
chr1,185156851,185157446,SRX5075174,SMARCA4,595
chr1,185156946,185157160,SRX5716463,SMARCA4,214
chr1,185156994,185157236,SRX5716451,SOX2,242
chr1,185157187,185157419,SRX5075175,SMARCA4,232
chr1,185157329,185157526,SRX5075176,SMARCA4,197
chr1,185170149,185170837,SRX16500060,CTCF,688
chr1,185170161,185170887,SRX16500059,CTCF,726
chr1,185170166,185170831,SRX16500062,CTCF,665
chr1,185170181,185170714,SRX4174629,CTCF,533
chr1,185170192,185170854,SRX16500061,CTCF,662
chr1,185170229,185170686,SRX5075176,SMARCA4,457
chr1,185170273,185170642,SRX5716464,SMARCA4,369
chr1,185170279,185170697,SRX5716463,SMARCA4,418
chr1,185170287,185170747,SRX5075168,SMARCA4,460
chr1,185170320,185170722,SRX5075170,SMARCA4,402
chr1,185170328,185170737,SRX5075174,SMARCA4,409
chr1,185170397,185170724,SRX5075169,SMARCA4,327
chr1,185170406,185170678,SRX5716470,SMARCA4,272
chr1,185170417,185170658,SRX5075175,SMARCA4,241
chr1,185170456,185170689,SRX5716469,SMARCA4,233
chr1,185244404,185244668,SRX5075175,SMARCA4,264
chr1,185244415,185244667,SRX5054309,FOSL2,252
chr1,185244444,185244685,SRX5075169,SMARCA4,241
chr1,185244470,185244651,SRX5075170,SMARCA4,181
chr1,185267340,185267533,SRX5075170,SMARCA4,193
chr1,185267370,185267566,SRX5075176,SMARCA4,196
chr1,185271821,185272133,SRX20140881,CPSF3L,312
chr1,185279672,185279952,SRX5054309,FOSL2,280
chr1,185279724,185279949,SRX5054308,FOSL2,225
chr1,185316167,185317491,SRX20140895,INTS13,1324
chr1,185316314,185316676,SRX20140867,INTS10,362
chr1,185316325,185317330,SRX20140868,INTS10,1005
chr1,185316378,185316634,SRX20140897,INTS13,256
chr1,185316930,185317364,SRX20140879,CPSF3L,434
chr1,185316969,185317237,SRX20140881,CPSF3L,268
chr1,185317027,185317368,SRX20140867,INTS10,341
chr1,185317043,185317365,SRX20140897,INTS13,322
chr1,185317242,185317588,SRX5075168,SMARCA4,346
chr1,185317288,185317645,SRX5075174,SMARCA4,357
chr1,185317302,185317579,SRX5075170,SMARCA4,277
chr1,185317339,185317676,SRX16500059,CTCF,337
chr1,185317357,185317636,SRX5075176,SMARCA4,279
chr1,185317377,185317697,SRX16500060,CTCF,320
chr1,185317428,185317684,SRX16500062,CTCF,256
chr1,185317444,185317663,SRX16500061,CTCF,219
chr1,185351997,185352420,SRX5716467,SMARCA2,423
chr1,185352028,185352456,SRX5075176,SMARCA4,428
chr1,185352066,185352395,SRX5075169,SMARCA4,329
chr1,185352075,185352451,SRX5716469,SMARCA4,376
chr1,185352108,185352452,SRX5075170,SMARCA4,344
chr1,185352129,185352490,SRX5716470,SMARCA4,361
chr1,185352142,185352415,SRX5075175,SMARCA4,273
chr1,185352170,185352410,SRX5716468,SMARCA2,240
chr1,185352183,185352396,SRX5054308,FOSL2,213
chr1,185360709,185360968,SRX5054308,FOSL2,259
chr1,185360731,185361006,SRX5054309,FOSL2,275
chr1,185374115,185374348,SRX5075169,SMARCA4,233
chr1,185400104,185400341,SRX5054308,FOSL2,237
chr1,185400105,185400404,SRX5054309,FOSL2,299
chr1,185400113,185400304,SRX5075169,SMARCA4,191
chr1,185400163,185400351,SRX5075175,SMARCA4,188
chr1,185401032,185401388,SRX5075169,SMARCA4,356
chr1,185401035,185401400,SRX5075176,SMARCA4,365
chr1,185401044,185401357,SRX5075174,SMARCA4,313
chr1,185401057,185401333,SRX5020214,SMARCA2,276
chr1,185401068,185401410,SRX5716470,SMARCA4,342
chr1,185401088,185401378,SRX5716469,SMARCA4,290
chr1,185401098,185401411,SRX5075175,SMARCA4,313
chr1,185401111,185401328,SRX5054309,FOSL2,217
chr1,185401113,185401447,SRX5075170,SMARCA4,334
chr1,185401152,185401408,SRX5075168,SMARCA4,256
chr1,185401153,185401383,SRX5716464,SMARCA4,230
chr1,185401176,185401435,SRX5716463,SMARCA4,259
chr1,185408732,185408978,SRX5075169,SMARCA4,246
chr1,185426779,185427155,SRX5075176,SMARCA4,376
chr1,185426799,185427126,SRX5075170,SMARCA4,327
chr1,185426840,185427087,SRX5075175,SMARCA4,247
chr1,185426866,185427122,SRX5716469,SMARCA4,256
chr1,185426883,185427192,SRX5075169,SMARCA4,309
chr1,185426915,185427188,SRX5716470,SMARCA4,273
chr1,185426918,185427219,SRX5716467,SMARCA2,301
chr1,185439782,185439985,SRX5054309,FOSL2,203
chr1,185439788,185439964,SRX5075176,SMARCA4,176
chr1,185441671,185441891,SRX5054309,FOSL2,220
chr1,185453685,185454142,SRX5054309,FOSL2,457
chr1,185453824,185454156,SRX5054308,FOSL2,332
chr1,185453826,185454009,SRX5075176,SMARCA4,183
chr1,185453829,185454022,SRX5075170,SMARCA4,193
chr1,185453834,185454370,SRX5075175,SMARCA4,536
chr1,185453843,185454331,SRX5020211,SMARCA2,488
chr1,185453882,185454381,SRX5075169,SMARCA4,499
chr1,185454011,185454406,SRX5716469,SMARCA4,395
chr1,185454029,185454325,SRX5716467,SMARCA2,296
chr1,185454054,185454437,SRX5716470,SMARCA4,383
chr1,185454064,185454373,SRX5075176,SMARCA4,309
chr1,185479636,185480395,SRX5075168,SMARCA4,759
chr1,185479647,185480277,SRX5075174,SMARCA4,630
chr1,185479701,185480178,SRX20140881,CPSF3L,477
chr1,185479832,185480278,SRX20140895,INTS13,446
chr1,185479897,185480111,SRX5716451,SOX2,214
chr1,185479907,185480250,SRX5716463,SMARCA4,343
chr1,185479933,185480194,SRX20140868,INTS10,261
chr1,185483999,185484425,SRX5075170,SMARCA4,426
chr1,185484074,185484375,SRX5075176,SMARCA4,301
chr1,185484080,185484382,SRX5716469,SMARCA4,302
chr1,185484102,185484422,SRX5054309,FOSL2,320
chr1,185484119,185484579,SRX5075169,SMARCA4,460
chr1,185484130,185484492,SRX5075175,SMARCA4,362
chr1,185499908,185500323,SRX5075170,SMARCA4,415
chr1,185499935,185500278,SRX5075176,SMARCA4,343
chr1,185499944,185500490,SRX5054309,FOSL2,546
chr1,185499945,185500331,SRX5075175,SMARCA4,386
chr1,185499980,185500590,SRX5075169,SMARCA4,610
chr1,185499982,185500288,SRX5716467,SMARCA2,306
chr1,185499983,185500294,SRX5716469,SMARCA4,311
chr1,185499992,185500274,SRX5054308,FOSL2,282
chr1,185541842,185542114,SRX5054309,FOSL2,272
chr1,185541854,185542380,SRX5716470,SMARCA4,526
chr1,185541861,185542129,SRX5075169,SMARCA4,268
chr1,185541872,185542095,SRX5075175,SMARCA4,223
chr1,185541898,185542238,SRX5020214,SMARCA2,340
chr1,185541928,185542134,SRX5020211,SMARCA2,206
chr1,185541984,185542249,SRX5716469,SMARCA4,265
chr1,185542085,185542321,SRX5075174,SMARCA4,236
chr1,185565311,185565566,SRX5075169,SMARCA4,255
chr1,185565330,185565597,SRX5054309,FOSL2,267
chr1,185565332,185565564,SRX5054308,FOSL2,232
chr1,185565342,185565574,SRX5075170,SMARCA4,232
chr1,185565348,185565601,SRX5075175,SMARCA4,253
chr1,185565364,185565584,SRX5075181,SMARCA2,220
chr1,185565391,185565571,SRX5075176,SMARCA4,180
chr1,185567071,185567304,SRX5054308,FOSL2,233
chr1,185567110,185567316,SRX5054309,FOSL2,206
chr1,185595984,185596503,SRX16500060,CTCF,519
chr1,185596027,185596484,SRX16500062,CTCF,457
chr1,185596031,185596484,SRX16500059,CTCF,453
chr1,185596042,185596477,SRX16500061,CTCF,435
chr1,185596105,185596351,SRX4174629,CTCF,246
chr1,185596149,185596334,SRX5075174,SMARCA4,185
chr1,185596151,185596362,SRX5075168,SMARCA4,211
chr1,185645249,185645587,SRX5075174,SMARCA4,338
chr1,185645316,185645556,SRX5075168,SMARCA4,240
chr1,185646170,185646747,SRX5075175,SMARCA4,577
chr1,185646198,185646856,SRX5075168,SMARCA4,658
chr1,185646239,185646732,SRX5075170,SMARCA4,493
chr1,185646241,185646753,SRX5075169,SMARCA4,512
chr1,185646241,185646754,SRX5075176,SMARCA4,513
chr1,185646242,185646608,SRX5020214,SMARCA2,366
chr1,185646244,185646777,SRX5716463,SMARCA4,533
chr1,185646254,185646711,SRX5716469,SMARCA4,457
chr1,185646259,185646565,SRX5716468,SMARCA2,306
chr1,185646282,185646693,SRX5716470,SMARCA4,411
chr1,185646293,185646810,SRX5075174,SMARCA4,517
chr1,185646300,185646624,SRX5716467,SMARCA2,324
chr1,185646305,185646715,SRX5054309,FOSL2,410
chr1,185646326,185646708,SRX5054308,FOSL2,382
chr1,185646341,185646692,SRX5716464,SMARCA4,351
chr1,185646344,185646624,SRX5020211,SMARCA2,280
chr1,185646353,185646676,SRX5716459,Epitope tags,323
chr1,185646387,185646662,SRX5054307,FOSL2,275
chr1,185646405,185646615,SRX5075181,SMARCA2,210
chr1,185646430,185646610,SRX5075182,SMARCA2,180
chr1,185646447,185646667,SRX5716451,SOX2,220
chr1,185670249,185670750,SRX16500059,CTCF,501
chr1,185670297,185670592,SRX4174629,CTCF,295
chr1,185670320,185670711,SRX16500060,CTCF,391
chr1,185670337,185670722,SRX16500061,CTCF,385
chr1,185670387,185670678,SRX16500062,CTCF,291
chr1,185670464,185670656,SRX5075168,SMARCA4,192
chr1,185680995,185681424,SRX16500060,CTCF,429
chr1,185681019,185681373,SRX16500059,CTCF,354
chr1,185681076,185681478,SRX16500061,CTCF,402
chr1,185681081,185681348,SRX5075174,SMARCA4,267
chr1,185681083,185681382,SRX16500062,CTCF,299
chr1,185681123,185681354,SRX4174629,CTCF,231
chr1,185718913,185719400,SRX5075175,SMARCA4,487
chr1,185718941,185719297,SRX5054309,FOSL2,356
chr1,185718972,185719398,SRX5075169,SMARCA4,426
chr1,185718976,185719233,SRX5716469,SMARCA4,257
chr1,185718983,185719309,SRX5054308,FOSL2,326
chr1,185718988,185719383,SRX5075176,SMARCA4,395
chr1,185719035,185719392,SRX5075170,SMARCA4,357
chr1,185719051,185719306,SRX5716470,SMARCA4,255
chr1,185720597,185721078,SRX16500061,CTCF,481
chr1,185720625,185721089,SRX16500059,CTCF,464
chr1,185720670,185721075,SRX16500060,CTCF,405
chr1,185720674,185721027,SRX16500062,CTCF,353
chr1,185727741,185727988,SRX5075170,SMARCA4,247
chr1,185733793,185734066,SRX16500060,CTCF,273
chr1,185734081,185734661,SRX5075174,SMARCA4,580
chr1,185734138,185734725,SRX20140895,INTS13,587
chr1,185734162,185734605,SRX5075170,SMARCA4,443
chr1,185734169,185734563,SRX20140868,INTS10,394
chr1,185734206,185734597,SRX5716470,SMARCA4,391
chr1,185734283,185734629,SRX5075168,SMARCA4,346
chr1,185734311,185734619,SRX5075176,SMARCA4,308
chr1,185734364,185734597,SRX5075175,SMARCA4,233
chr1,185734431,185734655,SRX5075169,SMARCA4,224
chr1,185735771,185735960,SRX5075175,SMARCA4,189
chr1,185767657,185767915,SRX5075169,SMARCA4,258
chr1,185774500,185774765,SRX5075174,SMARCA4,265
chr1,185776538,185776836,SRX5054308,FOSL2,298
chr1,185776600,185776842,SRX5054309,FOSL2,242
chr1,185776640,185776883,SRX5075169,SMARCA4,243
chr1,185786691,185786914,SRX5054309,FOSL2,223
chr1,185788563,185788732,SRX5075170,SMARCA4,169
chr1,185790097,185790485,SRX5075169,SMARCA4,388
chr1,185790114,185790467,SRX5716469,SMARCA4,353
chr1,185790116,185790387,SRX5716467,SMARCA2,271
chr1,185790123,185790518,SRX5075176,SMARCA4,395
chr1,185790158,185790468,SRX5075170,SMARCA4,310
chr1,185790169,185790409,SRX5716468,SMARCA2,240
chr1,185790170,185790451,SRX5020211,SMARCA2,281
chr1,185790188,185790565,SRX5716470,SMARCA4,377
chr1,185790234,185790423,SRX5075175,SMARCA4,189
chr1,185795103,185795636,SRX5075175,SMARCA4,533
chr1,185795148,185795537,SRX5716470,SMARCA4,389
chr1,185795172,185795727,SRX5075169,SMARCA4,555
chr1,185795183,185795437,SRX5054309,FOSL2,254
chr1,185795197,185795524,SRX5716467,SMARCA2,327
chr1,185795215,185795471,SRX5054308,FOSL2,256
chr1,185795228,185795560,SRX5716469,SMARCA4,332
chr1,185795233,185795497,SRX5075176,SMARCA4,264
chr1,185795289,185795534,SRX5075170,SMARCA4,245
chr1,185808653,185808963,SRX5054309,FOSL2,310
chr1,185808716,185809058,SRX5075169,SMARCA4,342
chr1,185808774,185808972,SRX5075175,SMARCA4,198
chr1,185813287,185813772,SRX16500059,CTCF,485
chr1,185813381,185813743,SRX16500060,CTCF,362
chr1,185813388,185813808,SRX16500061,CTCF,420
chr1,185813424,185813708,SRX5075174,SMARCA4,284
chr1,185813430,185813733,SRX16500062,CTCF,303
chr1,185813453,185813724,SRX5075168,SMARCA4,271
chr1,185813456,185813631,SRX5075176,SMARCA4,175
chr1,185825576,185825858,SRX5075169,SMARCA4,282
chr1,185825591,185825894,SRX5716470,SMARCA4,303
chr1,185825614,185825862,SRX5020211,SMARCA2,248
chr1,185825626,185825835,SRX5075176,SMARCA4,209
chr1,185825647,185825868,SRX5075170,SMARCA4,221
chr1,185825680,185825860,SRX5054308,FOSL2,180
chr1,185843647,185843822,SRX5075176,SMARCA4,175
chr1,185844115,185844351,SRX5075175,SMARCA4,236
chr1,185844120,185844289,SRX5075170,SMARCA4,169
chr1,185853666,185854072,SRX5716469,SMARCA4,406
chr1,185853718,185854054,SRX5054308,FOSL2,336
chr1,185853726,185854053,SRX5075175,SMARCA4,327
chr1,185853735,185854088,SRX5716470,SMARCA4,353
chr1,185853736,185854028,SRX5054309,FOSL2,292
chr1,185853745,185854076,SRX5075176,SMARCA4,331
chr1,185853751,185854103,SRX5075170,SMARCA4,352
chr1,185853763,185854058,SRX5075169,SMARCA4,295
chr1,185853788,185854053,SRX5716467,SMARCA2,265
chr1,185864925,185865167,SRX5075175,SMARCA4,242
chr1,185864928,185865111,SRX5054309,FOSL2,183
chr1,185894734,185895111,SRX5075175,SMARCA4,377
chr1,185894737,185895038,SRX5075170,SMARCA4,301
chr1,185894794,185895317,SRX5075176,SMARCA4,523
chr1,185894805,185895128,SRX5054309,FOSL2,323
chr1,185894809,185895168,SRX5075169,SMARCA4,359
chr1,185894828,185895098,SRX5716467,SMARCA2,270
chr1,185894874,185895109,SRX5054308,FOSL2,235
chr1,185895494,185895677,SRX5075169,SMARCA4,183
chr1,185896992,185897191,SRX5054308,FOSL2,199
chr1,185917691,185917994,SRX5075170,SMARCA4,303
chr1,185917693,185917954,SRX5075175,SMARCA4,261
chr1,185917696,185917979,SRX5075176,SMARCA4,283
chr1,185917699,185917946,SRX5716470,SMARCA4,247
chr1,185917768,185917986,SRX5075169,SMARCA4,218
chr1,185926571,185926851,SRX5075176,SMARCA4,280
chr1,185926668,185927049,SRX5075170,SMARCA4,381
chr1,185926777,185927032,SRX5716470,SMARCA4,255
chr1,185934537,185934818,SRX5075175,SMARCA4,281
chr1,185934885,185935065,SRX5075169,SMARCA4,180
chr1,185938433,185938695,SRX5054309,FOSL2,262
chr1,185938443,185938821,SRX5075176,SMARCA4,378
chr1,185938468,185938840,SRX5075170,SMARCA4,372
chr1,185938511,185938823,SRX5075181,SMARCA2,312
chr1,185938579,185938804,SRX5075169,SMARCA4,225
chr1,185939087,185939486,SRX5075174,SMARCA4,399
chr1,185939128,185939490,SRX5716470,SMARCA4,362
chr1,185939150,185939452,SRX5075169,SMARCA4,302
chr1,185939185,185939471,SRX5075168,SMARCA4,286
chr1,185939191,185939446,SRX5054309,FOSL2,255
chr1,185939191,185939458,SRX5020214,SMARCA2,267
chr1,185939214,185939448,SRX5716469,SMARCA4,234
chr1,185939235,185939426,SRX5075176,SMARCA4,191
chr1,185939245,185939499,SRX5075170,SMARCA4,254
chr1,185960364,185961199,SRX5075176,SMARCA4,835
chr1,185960431,185961154,SRX5075170,SMARCA4,723
chr1,185960455,185960657,SRX5075169,SMARCA4,202
chr1,185960538,185961160,SRX5075175,SMARCA4,622
chr1,185960542,185961056,SRX5716470,SMARCA4,514
chr1,185960593,185960873,SRX5716467,SMARCA2,280
chr1,185960768,185961020,SRX5075169,SMARCA4,252
chr1,185960809,185961128,SRX5716469,SMARCA4,319
chr1,185960827,185961149,SRX5054308,FOSL2,322
chr1,185960899,185961106,SRX5054309,FOSL2,207
chr1,185965973,185966228,SRX5075170,SMARCA4,255
chr1,185966005,185966194,SRX5075169,SMARCA4,189
chr1,185966017,185966264,SRX5075176,SMARCA4,247
chr1,185969096,185969301,SRX5075170,SMARCA4,205
chr1,185971648,185972029,SRX5075169,SMARCA4,381
chr1,185971666,185971963,SRX5075175,SMARCA4,297
chr1,185971679,185971900,SRX5075168,SMARCA4,221
chr1,185971694,185972007,SRX5054309,FOSL2,313
chr1,185971695,185971895,SRX5020211,SMARCA2,200
chr1,185971708,185972033,SRX5054308,FOSL2,325
chr1,185971715,185971970,SRX5020214,SMARCA2,255
chr1,185971731,185971946,SRX5716470,SMARCA4,215
chr1,185971768,185971999,SRX5075176,SMARCA4,231
chr1,185971773,185972010,SRX5075170,SMARCA4,237
chr1,185973657,185974109,SRX5075169,SMARCA4,452
chr1,185973709,185974073,SRX5075170,SMARCA4,364
chr1,185973712,185974084,SRX5716468,SMARCA2,372
chr1,185973716,185974091,SRX5075176,SMARCA4,375
chr1,185973734,185974034,SRX5716470,SMARCA4,300
chr1,185973738,185974068,SRX5716469,SMARCA4,330
chr1,185973758,185974042,SRX5054309,FOSL2,284
chr1,185973759,185974077,SRX5054308,FOSL2,318
chr1,185973761,185974035,SRX5075175,SMARCA4,274
chr1,185973772,185974001,SRX5716467,SMARCA2,229
chr1,185973806,185974009,SRX5020211,SMARCA2,203
chr1,185990576,185990799,SRX5075175,SMARCA4,223
chr1,185990585,185990837,SRX5075176,SMARCA4,252
chr1,185990646,185990858,SRX5716469,SMARCA4,212
chr1,185990654,185990823,SRX5075170,SMARCA4,169
chr1,185996258,185996540,SRX5054309,FOSL2,282
chr1,185996259,185996510,SRX5075170,SMARCA4,251
chr1,185996269,185996605,SRX5075175,SMARCA4,336
chr1,185996296,185996598,SRX5075169,SMARCA4,302
chr1,185996300,185996505,SRX5054308,FOSL2,205
chr1,186008923,186009114,SRX5054308,FOSL2,191
chr1,186008939,186009276,SRX5075175,SMARCA4,337
chr1,186008943,186009408,SRX5075170,SMARCA4,465
chr1,186008997,186009369,SRX5075169,SMARCA4,372
chr1,186008999,186009414,SRX5075176,SMARCA4,415
chr1,186034037,186034224,SRX5075175,SMARCA4,187
chr1,186082280,186082537,SRX5075169,SMARCA4,257
chr1,186082293,186082576,SRX5075170,SMARCA4,283
chr1,186082303,186082484,SRX5075176,SMARCA4,181
chr1,186082317,186082603,SRX5075174,SMARCA4,286
chr1,186082340,186082611,SRX5716464,SMARCA4,271
chr1,186082417,186082658,SRX5075168,SMARCA4,241
chr1,186102410,186102840,SRX5054308,FOSL2,430
chr1,186102448,186103109,SRX5075176,SMARCA4,661
chr1,186102489,186103123,SRX5075169,SMARCA4,634
chr1,186102499,186103113,SRX5054309,FOSL2,614
chr1,186102510,186103131,SRX5075175,SMARCA4,621
chr1,186102514,186103032,SRX5716469,SMARCA4,518
chr1,186102533,186102910,SRX5716470,SMARCA4,377
chr1,186102540,186103153,SRX5716467,SMARCA2,613
chr1,186102546,186102858,SRX5075170,SMARCA4,312
chr1,186102549,186102753,SRX5020211,SMARCA2,204
chr1,186102555,186102802,SRX5716468,SMARCA2,247
chr1,186102604,186102809,SRX5020214,SMARCA2,205
chr1,186102905,186103127,SRX5054308,FOSL2,222
chr1,186102915,186103144,SRX5075170,SMARCA4,229
chr1,186113448,186113768,SRX5075170,SMARCA4,320
chr1,186113506,186113723,SRX5075176,SMARCA4,217
chr1,186139757,186140019,SRX5075169,SMARCA4,262
chr1,186139775,186140012,SRX5075170,SMARCA4,237
chr1,186139801,186140036,SRX5075175,SMARCA4,235
chr1,186139874,186140061,SRX5075176,SMARCA4,187
chr1,186143761,186143959,SRX5054308,FOSL2,198
chr1,186152570,186152919,SRX5075175,SMARCA4,349
chr1,186152574,186152877,SRX5716467,SMARCA2,303
chr1,186152578,186152916,SRX5075176,SMARCA4,338
chr1,186152585,186152911,SRX5716470,SMARCA4,326
chr1,186152597,186152936,SRX5054309,FOSL2,339
chr1,186152608,186152937,SRX5054308,FOSL2,329
chr1,186152610,186152956,SRX5075169,SMARCA4,346
chr1,186152618,186152887,SRX5020211,SMARCA2,269
chr1,186152637,186152897,SRX5075170,SMARCA4,260
chr1,186152659,186152920,SRX5716469,SMARCA4,261
chr1,186155594,186155976,SRX16500061,CTCF,382
chr1,186155624,186155920,SRX16500062,CTCF,296
chr1,186155628,186156000,SRX5075169,SMARCA4,372
chr1,186155640,186155828,SRX5054309,FOSL2,188
chr1,186155652,186155976,SRX16500060,CTCF,324
chr1,186155657,186155992,SRX5075176,SMARCA4,335
chr1,186155666,186155984,SRX5075168,SMARCA4,318
chr1,186155672,186155939,SRX5075175,SMARCA4,267
chr1,186155683,186155980,SRX5075174,SMARCA4,297
chr1,186155717,186155976,SRX5075170,SMARCA4,259
chr1,186155742,186155959,SRX5716469,SMARCA4,217
chr1,186188115,186188591,SRX5075176,SMARCA4,476
chr1,186188118,186188722,SRX5075170,SMARCA4,604
chr1,186188176,186188665,SRX5075169,SMARCA4,489
chr1,186188206,186188561,SRX5075168,SMARCA4,355
chr1,186188214,186188538,SRX5075174,SMARCA4,324
chr1,186188229,186188607,SRX5075175,SMARCA4,378
chr1,186188250,186188646,SRX5054309,FOSL2,396
chr1,186188266,186188626,SRX5716469,SMARCA4,360
chr1,186188286,186188603,SRX5054308,FOSL2,317
chr1,186188289,186188468,SRX5075182,SMARCA2,179
chr1,186188315,186188567,SRX5716467,SMARCA2,252
chr1,186212455,186212904,SRX5075168,SMARCA4,449
chr1,186212473,186212937,SRX5716470,SMARCA4,464
chr1,186212477,186212893,SRX5716463,SMARCA4,416
chr1,186212497,186212951,SRX5075174,SMARCA4,454
chr1,186212555,186212761,SRX5020214,SMARCA2,206
chr1,186212564,186212895,SRX5075175,SMARCA4,331
chr1,186212583,186212874,SRX5716469,SMARCA4,291
chr1,186212584,186212844,SRX5020211,SMARCA2,260
chr1,186212584,186213075,SRX16500059,CTCF,491
chr1,186212587,186213053,SRX16500061,CTCF,466
chr1,186212591,186212882,SRX5075170,SMARCA4,291
chr1,186212601,186213000,SRX16500062,CTCF,399
chr1,186212601,186213017,SRX16500060,CTCF,416
chr1,186212605,186212913,SRX5075176,SMARCA4,308
chr1,186212606,186212846,SRX5716467,SMARCA2,240
chr1,186212608,186213014,SRX4174629,CTCF,406
chr1,186212613,186212793,SRX5054308,FOSL2,180
chr1,186212640,186212907,SRX5075181,SMARCA2,267
chr1,186212666,186212849,SRX5054309,FOSL2,183
chr1,186212667,186212896,SRX5075169,SMARCA4,229
chr1,186236913,186237253,SRX5054308,FOSL2,340
chr1,186236920,186237319,SRX5054309,FOSL2,399
chr1,186236973,186237261,SRX5075175,SMARCA4,288
chr1,186236984,186237317,SRX5075169,SMARCA4,333
chr1,186237042,186237276,SRX5716469,SMARCA4,234
chr1,186237043,186237255,SRX5075176,SMARCA4,212
chr1,186239245,186239489,SRX5075169,SMARCA4,244
chr1,186239280,186239489,SRX5075175,SMARCA4,209
chr1,186239301,186239531,SRX5716470,SMARCA4,230
chr1,186272535,186272768,SRX5054308,FOSL2,233
chr1,186272566,186272761,SRX5075176,SMARCA4,195
chr1,186272577,186272786,SRX5054309,FOSL2,209
chr1,186279606,186279918,SRX5075170,SMARCA4,312
chr1,186279701,186279884,SRX5075169,SMARCA4,183
chr1,186286634,186287312,SRX5075176,SMARCA4,678
chr1,186286636,186287227,SRX5075170,SMARCA4,591
chr1,186286690,186287207,SRX5075169,SMARCA4,517
chr1,186286710,186287070,SRX5075175,SMARCA4,360
chr1,186286740,186287151,SRX5716467,SMARCA2,411
chr1,186286756,186287015,SRX5716470,SMARCA4,259
chr1,186286784,186287245,SRX5054308,FOSL2,461
chr1,186286811,186287196,SRX5054309,FOSL2,385
chr1,186295940,186296313,SRX5075170,SMARCA4,373
chr1,186296017,186296213,SRX5075176,SMARCA4,196
chr1,186304970,186305300,SRX16500061,CTCF,330
chr1,186304995,186305370,SRX16500059,CTCF,375
chr1,186305005,186305310,SRX16500060,CTCF,305
chr1,186305025,186305340,SRX16500062,CTCF,315
chr1,186305034,186305256,SRX5075168,SMARCA4,222
chr1,186305038,186305326,SRX5075174,SMARCA4,288
chr1,186305095,186305284,SRX5075176,SMARCA4,189
chr1,186325275,186325573,SRX16500060,CTCF,298
chr1,186330639,186331094,SRX16500060,CTCF,455
chr1,186330687,186331124,SRX16500059,CTCF,437
chr1,186330795,186331130,SRX16500061,CTCF,335
chr1,186330828,186331083,SRX16500062,CTCF,255
chr1,186374919,186375979,SRX20140895,INTS13,1060
chr1,186375004,186375766,SRX5075176,SMARCA4,762
chr1,186375012,186375978,SRX5075174,SMARCA4,966
chr1,186375135,186375920,SRX5075170,SMARCA4,785
chr1,186375155,186375819,SRX20140868,INTS10,664
chr1,186375157,186375928,SRX16500060,CTCF,771
chr1,186375202,186375916,SRX5716463,SMARCA4,714
chr1,186375217,186375837,SRX16500059,CTCF,620
chr1,186375253,186376040,SRX5075168,SMARCA4,787
chr1,186375300,186375863,SRX4174629,CTCF,563
chr1,186375303,186375719,SRX5716464,SMARCA4,416
chr1,186375319,186375900,SRX16500062,CTCF,581
chr1,186375328,186375845,SRX16500061,CTCF,517
chr1,186375340,186375698,SRX5054309,FOSL2,358
chr1,186375361,186375905,SRX20140897,INTS13,544
chr1,186375404,186375750,SRX5716470,SMARCA4,346
chr1,186375420,186375831,SRX5075169,SMARCA4,411
chr1,186375448,186375663,SRX5716467,SMARCA2,215
chr1,186375452,186375822,SRX20140881,CPSF3L,370
chr1,186375456,186376087,SRX5716469,SMARCA4,631
chr1,186375477,186375872,SRX20140869,INTS10,395
chr1,186375481,186375752,SRX20140894,INTS13,271
chr1,186375534,186375975,SRX20140867,INTS10,441
chr1,186401601,186401784,SRX5054309,FOSL2,183
chr1,186402688,186402729,SRX1424891,POU3F2,41
chr1,186402689,186402735,SRX1424893,POU3F2,46
chr1,186402690,186402730,SRX1424892,POU3F2,40
chr1,186402690,186402730,SRX1424894,POU3F2,40
chr1,186404250,186404882,SRX16500059,CTCF,632
chr1,186404335,186404861,SRX16500061,CTCF,526
chr1,186404421,186404985,SRX16500062,CTCF,564
chr1,186404433,186404919,SRX16500060,CTCF,486
chr1,186404478,186404837,SRX5075168,SMARCA4,359
chr1,186404491,186404775,SRX5075174,SMARCA4,284
chr1,186404506,186404820,SRX5075176,SMARCA4,314
chr1,186404525,186404833,SRX5075170,SMARCA4,308
chr1,186404548,186404730,SRX5075169,SMARCA4,182
chr1,186404592,186404803,SRX5716463,SMARCA4,211
chr1,186420981,186421201,SRX5075170,SMARCA4,220
chr1,186421052,186421227,SRX5075176,SMARCA4,175
chr1,186442939,186443122,SRX5054309,FOSL2,183
chr1,186466007,186466210,SRX5075170,SMARCA4,203
chr1,186482626,186483063,SRX16500060,CTCF,437
chr1,186482632,186483113,SRX16500059,CTCF,481
chr1,186482658,186482952,SRX4174629,CTCF,294
chr1,186482662,186483049,SRX16500062,CTCF,387
chr1,186482694,186483022,SRX20140895,INTS13,328
chr1,186482696,186483086,SRX16500061,CTCF,390
chr1,186482745,186483011,SRX5716470,SMARCA4,266
chr1,186482751,186483021,SRX5075168,SMARCA4,270
chr1,186482751,186483027,SRX5075174,SMARCA4,276
chr1,186482755,186482959,SRX5075169,SMARCA4,204
chr1,186482758,186483026,SRX5716463,SMARCA4,268
chr1,186482773,186483039,SRX5075175,SMARCA4,266
chr1,186482779,186483006,SRX5075170,SMARCA4,227
chr1,186482796,186482971,SRX5075176,SMARCA4,175
chr1,186487162,186487551,SRX5075175,SMARCA4,389
chr1,186487258,186487586,SRX5075169,SMARCA4,328
chr1,186487276,186487580,SRX5054309,FOSL2,304
chr1,186487349,186487518,SRX5075170,SMARCA4,169
chr1,186487354,186487586,SRX5054308,FOSL2,232
chr1,186487383,186487568,SRX5075176,SMARCA4,185
chr1,186498710,186499441,SRX5054309,FOSL2,731
chr1,186498844,186499424,SRX5075169,SMARCA4,580
chr1,186498888,186499432,SRX5075170,SMARCA4,544
chr1,186499002,186499451,SRX5075176,SMARCA4,449
chr1,186499062,186499423,SRX5075175,SMARCA4,361
chr1,186499071,186499347,SRX5716469,SMARCA4,276
chr1,186499100,186499352,SRX5054308,FOSL2,252
chr1,186499100,186499370,SRX5716470,SMARCA4,270
chr1,186534477,186534673,SRX5075176,SMARCA4,196
chr1,186535637,186536106,SRX5075170,SMARCA4,469
chr1,186535668,186536021,SRX5716470,SMARCA4,353
chr1,186535676,186536136,SRX5075176,SMARCA4,460
chr1,186535678,186536106,SRX5075169,SMARCA4,428
chr1,186535691,186536026,SRX5716469,SMARCA4,335
chr1,186535695,186536115,SRX5075175,SMARCA4,420
chr1,186535732,186536089,SRX5716467,SMARCA2,357
chr1,186535734,186535968,SRX5020214,SMARCA2,234
chr1,186535740,186536010,SRX5716468,SMARCA2,270
chr1,186535752,186536101,SRX5054309,FOSL2,349
chr1,186535758,186536063,SRX5054308,FOSL2,305
chr1,186535773,186536034,SRX5075181,SMARCA2,261
chr1,186535778,186536004,SRX5020211,SMARCA2,226
chr1,186605733,186606079,SRX16500059,CTCF,346
chr1,186605795,186606099,SRX16500062,CTCF,304
chr1,186605798,186606166,SRX16500060,CTCF,368
chr1,186605811,186606099,SRX16500061,CTCF,288
chr1,186605862,186606077,SRX4174629,CTCF,215
chr1,186620976,186621185,SRX5075170,SMARCA4,209
chr1,186620992,186621228,SRX5054309,FOSL2,236
chr1,186620992,186621299,SRX5054308,FOSL2,307
chr1,186621089,186621264,SRX5075176,SMARCA4,175
chr1,186664334,186664389,SRX1424894,POU3F2,55
chr1,186664335,186664385,SRX1424892,POU3F2,50
chr1,186664336,186664389,SRX1424891,POU3F2,53
chr1,186664337,186664388,SRX1424893,POU3F2,51
chr1,186680143,186680431,SRX5075169,SMARCA4,288
chr1,186680145,186680641,SRX5075170,SMARCA4,496
chr1,186680164,186680484,SRX5075176,SMARCA4,320
chr1,186680174,186680479,SRX16500060,CTCF,305
chr1,186680181,186680569,SRX5716470,SMARCA4,388
chr1,186680189,186680497,SRX5075174,SMARCA4,308
chr1,186680224,186680506,SRX5075168,SMARCA4,282
chr1,186680231,186680669,SRX5075175,SMARCA4,438
chr1,186680244,186680473,SRX16500061,CTCF,229
chr1,186680247,186680790,SRX5716469,SMARCA4,543
chr1,186680255,186680501,SRX5716463,SMARCA4,246
chr1,186680625,186680836,SRX5716470,SMARCA4,211
chr1,186722691,186723087,SRX16500059,CTCF,396
chr1,186722723,186723107,SRX16500061,CTCF,384
chr1,186722760,186723036,SRX16500062,CTCF,276
chr1,186722775,186723050,SRX16500060,CTCF,275
chr1,186722786,186722991,SRX5075168,SMARCA4,205
chr1,186722864,186723090,SRX5075174,SMARCA4,226
chr1,186763265,186763490,SRX5054308,FOSL2,225
chr1,186812613,186812921,SRX5020211,SMARCA2,308
chr1,186812642,186812942,SRX5054309,FOSL2,300
chr1,186812648,186812899,SRX5075169,SMARCA4,251
chr1,186812692,186813034,SRX5075175,SMARCA4,342
chr1,186812736,186812991,SRX5054308,FOSL2,255
chr1,186819132,186819465,SRX5054308,FOSL2,333
chr1,186819179,186819460,SRX5075175,SMARCA4,281
chr1,186819183,186819380,SRX5075170,SMARCA4,197
chr1,186819193,186819402,SRX5075169,SMARCA4,209
chr1,186819217,186819467,SRX5054309,FOSL2,250
chr1,186828938,186829286,SRX5075174,SMARCA4,348
chr1,186864395,186864575,SRX5075169,SMARCA4,180
chr1,186872401,186872608,SRX5075168,SMARCA4,207
chr1,186880959,186881531,SRX5075168,SMARCA4,572
chr1,186880998,186881480,SRX5716463,SMARCA4,482
chr1,186881060,186881560,SRX5075174,SMARCA4,500
chr1,186896480,186896778,SRX5075176,SMARCA4,298
chr1,186896540,186896725,SRX5075170,SMARCA4,185
chr1,186905659,186905923,SRX5054309,FOSL2,264
chr1,186905775,186905988,SRX5054308,FOSL2,213
chr1,186905814,186906038,SRX5020211,SMARCA2,224
chr1,186957398,186957576,SRX5075176,SMARCA4,178
chr1,186967676,186968141,SRX5075170,SMARCA4,465
chr1,186967702,186968248,SRX5075176,SMARCA4,546
chr1,186967734,186968116,SRX5075168,SMARCA4,382
chr1,186967739,186968037,SRX5054309,FOSL2,298
chr1,186967749,186968013,SRX5054308,FOSL2,264
chr1,186967749,186968145,SRX5075174,SMARCA4,396
chr1,186967781,186968157,SRX5075169,SMARCA4,376
chr1,186968103,186968309,SRX5054309,FOSL2,206
chr1,186974664,186975220,SRX5075176,SMARCA4,556
chr1,186974670,186975187,SRX5075170,SMARCA4,517
chr1,186974688,186975189,SRX5075169,SMARCA4,501
chr1,186974691,186975251,SRX5075175,SMARCA4,560
chr1,186974693,186975201,SRX5054309,FOSL2,508
chr1,186974727,186975150,SRX5054308,FOSL2,423
chr1,186974733,186975179,SRX5716470,SMARCA4,446
chr1,186974736,186975051,SRX5716468,SMARCA2,315
chr1,186974776,186975214,SRX5716469,SMARCA4,438
chr1,186974778,186975069,SRX5020211,SMARCA2,291
chr1,186974797,186975068,SRX5716467,SMARCA2,271
chr1,186985677,186986173,SRX4174629,CTCF,496
chr1,186985822,186986317,SRX16500060,CTCF,495
chr1,186985831,186986349,SRX16500059,CTCF,518
chr1,186985860,186986272,SRX16500061,CTCF,412
chr1,186985887,186986268,SRX16500062,CTCF,381
chr1,186985919,186986120,SRX5075176,SMARCA4,201
chr1,186985954,186986251,SRX5075174,SMARCA4,297
chr1,186985990,186986195,SRX5075170,SMARCA4,205
chr1,187001579,187001888,SRX5054308,FOSL2,309
chr1,187001592,187001876,SRX5054309,FOSL2,284
chr1,187001597,187001900,SRX5075175,SMARCA4,303
chr1,187001599,187001821,SRX5075169,SMARCA4,222
chr1,187001601,187001828,SRX5020211,SMARCA2,227
chr1,187001603,187001854,SRX5075176,SMARCA4,251
chr1,187051559,187052110,SRX16500059,CTCF,551
chr1,187051587,187052044,SRX16500060,CTCF,457
chr1,187051598,187051970,SRX16500062,CTCF,372
chr1,187051641,187052053,SRX16500061,CTCF,412
chr1,187051654,187051868,SRX4174629,CTCF,214
chr1,187051735,187051910,SRX5075176,SMARCA4,175
chr1,187051788,187051993,SRX5075168,SMARCA4,205
chr1,187122806,187123003,SRX5075168,SMARCA4,197
chr1,187203318,187203660,SRX5054309,FOSL2,342
chr1,187203351,187203662,SRX5075169,SMARCA4,311
chr1,187203360,187203582,SRX5054308,FOSL2,222
chr1,187203364,187203694,SRX5075175,SMARCA4,330
chr1,187203367,187203577,SRX5075176,SMARCA4,210
chr1,187203383,187203552,SRX5075170,SMARCA4,169
chr1,187244624,187244833,SRX5075170,SMARCA4,209
chr1,187264940,187265355,SRX16500060,CTCF,415
chr1,187265001,187265421,SRX16500059,CTCF,420
chr1,187265034,187265464,SRX16500062,CTCF,430
chr1,187265048,187265384,SRX16500061,CTCF,336
chr1,187265052,187265350,SRX5075174,SMARCA4,298
chr1,187265107,187265308,SRX5075168,SMARCA4,201
chr1,187390198,187390483,SRX5075174,SMARCA4,285
chr1,187390205,187390466,SRX5075168,SMARCA4,261
chr1,187409467,187409759,SRX5716469,SMARCA4,292
chr1,187409486,187409693,SRX5054309,FOSL2,207
chr1,187409495,187409692,SRX5054308,FOSL2,197
chr1,187413798,187414109,SRX16500059,CTCF,311
chr1,187413801,187414091,SRX16500060,CTCF,290
chr1,187413864,187414103,SRX16500062,CTCF,239
chr1,187413887,187414106,SRX16500061,CTCF,219
chr1,187433708,187433891,SRX5054309,FOSL2,183
chr1,187452606,187452928,SRX5075174,SMARCA4,322
chr1,187471497,187472001,SRX5075175,SMARCA4,504
chr1,187471590,187471963,SRX5075169,SMARCA4,373
chr1,187471592,187471997,SRX5716470,SMARCA4,405
chr1,187471612,187472011,SRX5075176,SMARCA4,399
chr1,187471619,187471974,SRX5054309,FOSL2,355
chr1,187471640,187471977,SRX5075170,SMARCA4,337
chr1,187471657,187471962,SRX5054308,FOSL2,305
chr1,187471665,187471875,SRX5020214,SMARCA2,210
chr1,187471676,187471948,SRX5716469,SMARCA4,272
chr1,187471690,187471922,SRX5716467,SMARCA2,232
chr1,187471740,187471975,SRX5075174,SMARCA4,235
chr1,187476678,187476994,SRX16500062,CTCF,316
chr1,187476703,187477055,SRX16500059,CTCF,352
chr1,187476746,187477059,SRX16500060,CTCF,313
chr1,187477233,187477468,SRX5075170,SMARCA4,235
chr1,187477247,187477434,SRX5075176,SMARCA4,187
chr1,187477272,187477453,SRX5075169,SMARCA4,181
chr1,187491047,187491768,SRX5075169,SMARCA4,721
chr1,187491053,187491709,SRX5075175,SMARCA4,656
chr1,187491136,187491643,SRX5075170,SMARCA4,507
chr1,187491171,187491709,SRX5054308,FOSL2,538
chr1,187491202,187491707,SRX5075176,SMARCA4,505
chr1,187491206,187491764,SRX5054309,FOSL2,558
chr1,187491243,187491638,SRX5716470,SMARCA4,395
chr1,187491288,187491614,SRX5716469,SMARCA4,326
chr1,187491385,187491630,SRX5716467,SMARCA2,245
chr1,187566284,187566588,SRX5075170,SMARCA4,304
chr1,187566352,187566626,SRX5075176,SMARCA4,274
chr1,187605786,187606007,SRX5075168,SMARCA4,221
chr1,187605865,187606099,SRX5075174,SMARCA4,234
chr1,187621998,187622336,SRX5716469,SMARCA4,338
chr1,187622002,187622333,SRX5075176,SMARCA4,331
chr1,187622054,187622388,SRX5075169,SMARCA4,334
chr1,187622059,187622304,SRX5075175,SMARCA4,245
chr1,187622072,187622294,SRX5716470,SMARCA4,222
chr1,187622076,187622333,SRX5075170,SMARCA4,257
chr1,187622089,187622349,SRX5054308,FOSL2,260
chr1,187622125,187622390,SRX5054309,FOSL2,265
chr1,187654642,187654898,SRX5054309,FOSL2,256
chr1,187655227,187655449,SRX5075169,SMARCA4,222
chr1,187655253,187655473,SRX5054309,FOSL2,220
chr1,187685366,187685676,SRX5075169,SMARCA4,310
chr1,187685398,187685697,SRX5716469,SMARCA4,299
chr1,187685422,187685629,SRX5075176,SMARCA4,207
chr1,187685429,187685727,SRX5054309,FOSL2,298
chr1,187685460,187685743,SRX5054308,FOSL2,283
chr1,187689131,187689520,SRX5075170,SMARCA4,389
chr1,187689140,187689445,SRX5716470,SMARCA4,305
chr1,187689156,187689527,SRX5075176,SMARCA4,371
chr1,187689183,187689499,SRX5075169,SMARCA4,316
chr1,187691371,187691774,SRX5020214,SMARCA2,403
chr1,187691385,187691864,SRX5054309,FOSL2,479
chr1,187691417,187691832,SRX5054308,FOSL2,415
chr1,187691420,187691792,SRX5075170,SMARCA4,372
chr1,187691428,187691831,SRX5075169,SMARCA4,403
chr1,187691439,187691865,SRX5075175,SMARCA4,426
chr1,187691446,187691822,SRX5075176,SMARCA4,376
chr1,187691470,187691746,SRX5075182,SMARCA2,276
chr1,187691493,187691721,SRX5716469,SMARCA4,228
chr1,187691510,187691747,SRX5716467,SMARCA2,237
chr1,187700402,187700943,SRX5075170,SMARCA4,541
chr1,187700442,187700923,SRX5075176,SMARCA4,481
chr1,187700520,187700830,SRX5054309,FOSL2,310
chr1,187787786,187788038,SRX5075168,SMARCA4,252
chr1,187788815,187789039,SRX5075174,SMARCA4,224
chr1,187819153,187819464,SRX5716470,SMARCA4,311
chr1,187819179,187819410,SRX5020214,SMARCA2,231
chr1,187819192,187819412,SRX5054309,FOSL2,220
chr1,187819212,187819425,SRX5075170,SMARCA4,213
chr1,187819217,187819493,SRX5075176,SMARCA4,276
chr1,187819257,187819505,SRX5020211,SMARCA2,248
chr1,187842763,187843075,SRX5075170,SMARCA4,312
chr1,187842833,187843116,SRX5075176,SMARCA4,283
chr1,187871516,187871685,SRX5075170,SMARCA4,169
chr1,187879442,187879784,SRX5075174,SMARCA4,342
chr1,187928272,187928701,SRX16500059,CTCF,429
chr1,187928292,187928665,SRX16500060,CTCF,373
chr1,187928301,187928656,SRX16500061,CTCF,355
chr1,187928308,187928662,SRX16500062,CTCF,354
chr1,187928323,187928605,SRX5075168,SMARCA4,282
chr1,187928355,187928638,SRX5075174,SMARCA4,283
chr1,187961897,187962188,SRX5075174,SMARCA4,291
chr1,187961983,187962191,SRX5075168,SMARCA4,208
chr1,188027506,188028023,SRX5716469,SMARCA4,517
chr1,188027530,188028028,SRX5075176,SMARCA4,498
chr1,188027559,188028032,SRX5075170,SMARCA4,473
chr1,188027574,188028052,SRX5075169,SMARCA4,478
chr1,188027584,188027994,SRX5075174,SMARCA4,410
chr1,188027595,188027997,SRX5054309,FOSL2,402
chr1,188027629,188027998,SRX5716470,SMARCA4,369
chr1,188027634,188027940,SRX5716467,SMARCA2,306
chr1,188027634,188028027,SRX5075175,SMARCA4,393
chr1,188027643,188028033,SRX5075168,SMARCA4,390
chr1,188027654,188027965,SRX5054308,FOSL2,311
chr1,188027721,188027987,SRX5020211,SMARCA2,266
chr1,188090469,188090789,SRX5075169,SMARCA4,320
chr1,188090475,188090714,SRX5075170,SMARCA4,239
chr1,188090482,188090826,SRX5075175,SMARCA4,344
chr1,188090485,188090766,SRX5020214,SMARCA2,281
chr1,188090508,188090763,SRX5054308,FOSL2,255
chr1,188090510,188090825,SRX5054309,FOSL2,315
chr1,188090523,188090755,SRX5075176,SMARCA4,232
chr1,188282046,188282262,SRX5054309,FOSL2,216
chr1,188425687,188425924,SRX5716469,SMARCA4,237
chr1,188425733,188426023,SRX5054309,FOSL2,290
chr1,188425745,188425949,SRX5054308,FOSL2,204
chr1,188425762,188425965,SRX5075169,SMARCA4,203
chr1,188425785,188425990,SRX5020214,SMARCA2,205
chr1,188427552,188428123,SRX5075174,SMARCA4,571
chr1,188427669,188427980,SRX5075168,SMARCA4,311
chr1,188427699,188427914,SRX5716463,SMARCA4,215
chr1,188427710,188427915,SRX5716464,SMARCA4,205
chr1,188479256,188479466,SRX5054309,FOSL2,210
chr1,188584152,188584540,SRX5075176,SMARCA4,388
chr1,188584289,188584489,SRX5075170,SMARCA4,200
chr1,188594578,188594823,SRX16500061,CTCF,245
chr1,188594608,188594861,SRX16500059,CTCF,253
chr1,188594633,188594854,SRX16500060,CTCF,221
chr1,188652592,188653024,SRX5020211,SMARCA2,432
chr1,188652625,188653088,SRX5716470,SMARCA4,463
chr1,188652641,188653106,SRX5075175,SMARCA4,465
chr1,188652646,188653120,SRX5075170,SMARCA4,474
chr1,188652650,188653109,SRX5075169,SMARCA4,459
chr1,188652659,188653085,SRX5054309,FOSL2,426
chr1,188652663,188653065,SRX5716469,SMARCA4,402
chr1,188652663,188653103,SRX5020214,SMARCA2,440
chr1,188652670,188652962,SRX5075182,SMARCA2,292
chr1,188652675,188653049,SRX5054308,FOSL2,374
chr1,188652690,188653072,SRX5075174,SMARCA4,382
chr1,188652703,188653125,SRX5075176,SMARCA4,422
chr1,188652714,188653028,SRX5075181,SMARCA2,314
chr1,188652719,188653058,SRX5075168,SMARCA4,339
chr1,188652738,188652987,SRX5716468,SMARCA2,249
chr1,188652770,188653040,SRX5716467,SMARCA2,270
chr1,188669835,188670043,SRX5075170,SMARCA4,208
chr1,188689615,188689792,SRX5075176,SMARCA4,177
chr1,188689640,188689852,SRX5716469,SMARCA4,212
chr1,188715571,188715820,SRX16500060,CTCF,249
chr1,188715620,188715851,SRX16500062,CTCF,231
chr1,188715637,188715904,SRX16500059,CTCF,267
chr1,188782182,188782651,SRX16500060,CTCF,469
chr1,188782185,188782509,SRX4174629,CTCF,324
chr1,188782220,188782660,SRX16500061,CTCF,440
chr1,188782229,188782624,SRX16500059,CTCF,395
chr1,188782262,188782579,SRX16500062,CTCF,317
chr1,188782292,188782593,SRX5075174,SMARCA4,301
chr1,188782296,188782536,SRX5075168,SMARCA4,240
chr1,188822162,188822462,SRX5075176,SMARCA4,300
chr1,188822168,188822386,SRX5075170,SMARCA4,218
chr1,188822197,188822498,SRX5075169,SMARCA4,301
chr1,188822233,188822420,SRX5075175,SMARCA4,187
chr1,188827465,188827713,SRX5075168,SMARCA4,248
chr1,188827473,188827746,SRX5075174,SMARCA4,273
chr1,188872471,188872679,SRX5054309,FOSL2,208
chr1,188872492,188872672,SRX5054308,FOSL2,180
chr1,188938168,188938436,SRX16500059,CTCF,268
chr1,188938176,188938537,SRX16500061,CTCF,361
chr1,188938214,188938524,SRX16500062,CTCF,310
chr1,189185034,189185528,SRX5075169,SMARCA4,494
chr1,189185068,189185529,SRX5075170,SMARCA4,461
chr1,189185100,189185516,SRX5075176,SMARCA4,416
chr1,189185108,189185619,SRX5075175,SMARCA4,511
chr1,189185121,189185417,SRX5075168,SMARCA4,296
chr1,189185125,189185419,SRX5054308,FOSL2,294
chr1,189185131,189185413,SRX5716469,SMARCA4,282
chr1,189185140,189185441,SRX5054309,FOSL2,301
chr1,189185150,189185470,SRX5716470,SMARCA4,320
chr1,189185175,189185432,SRX5716467,SMARCA2,257
chr1,189185180,189185440,SRX5075174,SMARCA4,260
chr1,189185233,189185441,SRX5020214,SMARCA2,208
chr1,189185233,189185574,SRX5020211,SMARCA2,341
chr1,189205867,189206118,SRX5054309,FOSL2,251
chr1,189211744,189212024,SRX5075169,SMARCA4,280
chr1,189211825,189212014,SRX5054309,FOSL2,189
chr1,189275876,189276045,SRX5075170,SMARCA4,169
chr1,189323076,189323416,SRX5075175,SMARCA4,340
chr1,189323113,189323369,SRX5075176,SMARCA4,256
chr1,189323126,189323404,SRX5075169,SMARCA4,278
chr1,189323161,189323451,SRX5054309,FOSL2,290
chr1,189323192,189323488,SRX5054308,FOSL2,296
chr1,189429496,189429736,SRX16500059,CTCF,240
chr1,189429573,189429877,SRX16500060,CTCF,304
chr1,189429580,189429899,SRX16500061,CTCF,319
chr1,189429605,189429835,SRX16500062,CTCF,230
chr1,189607102,189607492,SRX5075175,SMARCA4,390
chr1,189607168,189607523,SRX5054309,FOSL2,355
chr1,189607174,189607520,SRX5075169,SMARCA4,346
chr1,189607195,189607446,SRX5054308,FOSL2,251
chr1,189607348,189607581,SRX5075176,SMARCA4,233
chr1,189619664,189620031,SRX5075170,SMARCA4,367
chr1,189619685,189620059,SRX5075175,SMARCA4,374
chr1,189619701,189620072,SRX5075169,SMARCA4,371
chr1,189619703,189620021,SRX5054308,FOSL2,318
chr1,189619707,189620046,SRX5716469,SMARCA4,339
chr1,189619712,189620032,SRX5054309,FOSL2,320
chr1,189619718,189620086,SRX5075176,SMARCA4,368
chr1,189654937,189655140,SRX5054309,FOSL2,203
chr1,189669899,189670194,SRX5054309,FOSL2,295
chr1,189708710,189708923,SRX16500062,CTCF,213
chr1,189708733,189708962,SRX16500060,CTCF,229
chr1,189775243,189775610,SRX5054308,FOSL2,367
chr1,189775367,189775593,SRX5716470,SMARCA4,226
chr1,189775376,189775606,SRX5075175,SMARCA4,230
chr1,189775376,189775646,SRX5054309,FOSL2,270
chr1,189775395,189775615,SRX5716469,SMARCA4,220
chr1,189775450,189775634,SRX5075169,SMARCA4,184
chr1,189786714,189787631,SRX5075168,SMARCA4,917
chr1,189786732,189787165,SRX5075174,SMARCA4,433
chr1,189786802,189787052,SRX5716464,SMARCA4,250
chr1,189786813,189787516,SRX5716463,SMARCA4,703
chr1,189787212,189787623,SRX20140895,INTS13,411
chr1,189787236,189787628,SRX5075174,SMARCA4,392
chr1,189821906,189822113,SRX5075176,SMARCA4,207
chr1,189821908,189822120,SRX5716469,SMARCA4,212
chr1,189821937,189822200,SRX5075174,SMARCA4,263
chr1,189851807,189852052,SRX5075168,SMARCA4,245
chr1,189851814,189852084,SRX5075174,SMARCA4,270
chr1,189851869,189852143,SRX5716464,SMARCA4,274
chr1,189851887,189852096,SRX5716463,SMARCA4,209
chr1,189859387,189859753,SRX16500060,CTCF,366
chr1,189859445,189859722,SRX16500059,CTCF,277
chr1,189859459,189859706,SRX16500061,CTCF,247
chr1,189859481,189859734,SRX16500062,CTCF,253
chr1,189962158,189962548,SRX5075169,SMARCA4,390
chr1,189962189,189962546,SRX5054309,FOSL2,357
chr1,189962221,189962503,SRX5075175,SMARCA4,282
chr1,189962255,189962482,SRX5075176,SMARCA4,227
chr1,189962268,189962505,SRX5716469,SMARCA4,237
chr1,189962275,189962524,SRX5054308,FOSL2,249
chr1,190000392,190000604,SRX5716469,SMARCA4,212
chr1,190000432,190000630,SRX5054309,FOSL2,198
chr1,190001214,190001470,SRX5054308,FOSL2,256
chr1,190001230,190001531,SRX5054309,FOSL2,301
chr1,190001231,190001561,SRX5075176,SMARCA4,330
chr1,190001280,190001565,SRX5075170,SMARCA4,285
chr1,190001291,190001521,SRX5075168,SMARCA4,230
chr1,190001300,190001520,SRX5075175,SMARCA4,220
chr1,190022801,190022992,SRX5054308,FOSL2,191
chr1,190067510,190067753,SRX5075168,SMARCA4,243
chr1,190067558,190067817,SRX5075174,SMARCA4,259
chr1,190084588,190084839,SRX16500061,CTCF,251
chr1,190205793,190206002,SRX5075175,SMARCA4,209
chr1,190320932,190321339,SRX16500059,CTCF,407
chr1,190320939,190321322,SRX16500061,CTCF,383
chr1,190320965,190321343,SRX16500060,CTCF,378
chr1,190320994,190321315,SRX16500062,CTCF,321
chr1,190373746,190374047,SRX16500062,CTCF,301
chr1,190373750,190374048,SRX16500060,CTCF,298
chr1,190373754,190373995,SRX5075174,SMARCA4,241
chr1,190373775,190374017,SRX16500061,CTCF,242
chr1,190373818,190374045,SRX4174629,CTCF,227
chr1,190436636,190436942,SRX16500060,CTCF,306
chr1,190436653,190436939,SRX16500059,CTCF,286
chr1,190478716,190478908,SRX5075174,SMARCA4,192
chr1,190539223,190539495,SRX5075168,SMARCA4,272
chr1,190539233,190539526,SRX5075174,SMARCA4,293
chr1,190539234,190539443,SRX5716451,SOX2,209
chr1,190540321,190540739,SRX5075174,SMARCA4,418
chr1,190540476,190540750,SRX5075168,SMARCA4,274
chr1,190540478,190540732,SRX5716463,SMARCA4,254
chr1,190551569,190551962,SRX5075174,SMARCA4,393
chr1,190551814,190552086,SRX5075168,SMARCA4,272
chr1,190578065,190578325,SRX5075176,SMARCA4,260
chr1,190578066,190578291,SRX5075170,SMARCA4,225
chr1,190633520,190633813,SRX16500060,CTCF,293
chr1,190633565,190633801,SRX16500059,CTCF,236
chr1,190679137,190679355,SRX5054309,FOSL2,218
chr1,190679597,190679777,SRX5054308,FOSL2,180
chr1,190747547,190747867,SRX5075169,SMARCA4,320
chr1,190747596,190747869,SRX5716469,SMARCA4,273
chr1,190747659,190747863,SRX5054308,FOSL2,204
chr1,190747671,190748089,SRX5075170,SMARCA4,418
chr1,190747673,190747969,SRX5716470,SMARCA4,296
chr1,190747705,190747883,SRX5075176,SMARCA4,178
chr1,190754733,190754945,SRX5716469,SMARCA4,212
chr1,190754875,190755089,SRX5075170,SMARCA4,214
chr1,190754901,190755076,SRX5075176,SMARCA4,175
chr1,190904119,190904516,SRX5075169,SMARCA4,397
chr1,190904172,190904379,SRX5054308,FOSL2,207
chr1,190904179,190904374,SRX5075175,SMARCA4,195
chr1,190906373,190906635,SRX5075176,SMARCA4,262
chr1,190906384,190906601,SRX5075170,SMARCA4,217
chr1,190908777,190908996,SRX5054309,FOSL2,219
chr1,190935957,190936370,SRX5075174,SMARCA4,413
chr1,190935978,190936369,SRX5075168,SMARCA4,391
chr1,190949919,190950114,SRX5075174,SMARCA4,195
chr1,190950028,190950405,SRX5075168,SMARCA4,377
chr1,190963097,190963587,SRX5716469,SMARCA4,490
chr1,190963161,190963707,SRX5020211,SMARCA2,546
chr1,190963225,190963812,SRX5075170,SMARCA4,587
chr1,190963255,190963801,SRX5075176,SMARCA4,546
chr1,190963257,190963638,SRX5716470,SMARCA4,381
chr1,190963287,190963581,SRX5054308,FOSL2,294
chr1,190963302,190963693,SRX5075169,SMARCA4,391
chr1,190963324,190963617,SRX5716467,SMARCA2,293
chr1,191022846,191023254,SRX5716469,SMARCA4,408
chr1,191022862,191023288,SRX5054309,FOSL2,426
chr1,191022870,191023263,SRX5054308,FOSL2,393
chr1,191022876,191023240,SRX5075176,SMARCA4,364
chr1,191022891,191023302,SRX5075169,SMARCA4,411
chr1,191022915,191023226,SRX5075175,SMARCA4,311
chr1,191022921,191023284,SRX5075170,SMARCA4,363
chr1,191022929,191023193,SRX5020214,SMARCA2,264
chr1,191022942,191023165,SRX5716467,SMARCA2,223
chr1,191022942,191023227,SRX5716470,SMARCA4,285
chr1,191134886,191135100,SRX5075176,SMARCA4,214
chr1,191135001,191135218,SRX5716467,SMARCA2,217
chr1,191174185,191174559,SRX5075174,SMARCA4,374
chr1,191174271,191174574,SRX5075168,SMARCA4,303
chr1,191206912,191207180,SRX5075176,SMARCA4,268
chr1,191206964,191207178,SRX5075170,SMARCA4,214
chr1,191240980,191241210,SRX5075169,SMARCA4,230
chr1,191240992,191241235,SRX5075176,SMARCA4,243
chr1,191241000,191241287,SRX5075170,SMARCA4,287
chr1,191255635,191256107,SRX5075174,SMARCA4,472
chr1,191255665,191256084,SRX5075168,SMARCA4,419
chr1,191255716,191255963,SRX5716451,SOX2,247
chr1,191255754,191256004,SRX5716463,SMARCA4,250
chr1,191343908,191344136,SRX5054309,FOSL2,228
chr1,191498410,191498625,SRX5054309,FOSL2,215
chr1,191498416,191498637,SRX5054308,FOSL2,221
chr1,191517891,191518131,SRX16500061,CTCF,240
chr1,191614152,191614202,SRX1424893,POU3F2,50
chr1,191614154,191614203,SRX1424894,POU3F2,49
chr1,191614155,191614201,SRX1424891,POU3F2,46
chr1,191614156,191614200,SRX1424892,POU3F2,44
chr1,191615536,191615765,SRX5054309,FOSL2,229
chr1,191615642,191615822,SRX5054308,FOSL2,180
chr1,191641455,191641711,SRX5054308,FOSL2,256
chr1,191641488,191641725,SRX5054309,FOSL2,237
chr1,191641504,191641686,SRX5075170,SMARCA4,182
chr1,191641919,191642104,SRX5075176,SMARCA4,185
chr1,191650845,191651129,SRX5716470,SMARCA4,284
chr1,191650893,191651106,SRX5075169,SMARCA4,213
chr1,191662138,191662380,SRX5075176,SMARCA4,242
chr1,191669752,191669941,SRX5075169,SMARCA4,189
chr1,191707507,191707712,SRX5054309,FOSL2,205
chr1,191757140,191757464,SRX5020211,SMARCA2,324
chr1,191757164,191757428,SRX5075181,SMARCA2,264
chr1,191757196,191757416,SRX5075176,SMARCA4,220
chr1,191757223,191757457,SRX5716470,SMARCA4,234
chr1,191757229,191757479,SRX5716469,SMARCA4,250
chr1,191905887,191906171,SRX5075176,SMARCA4,284
chr1,191963272,191963638,SRX5075168,SMARCA4,366
chr1,191963309,191963623,SRX5054309,FOSL2,314
chr1,191963334,191963521,SRX5075175,SMARCA4,187
chr1,191963334,191963631,SRX5054308,FOSL2,297
chr1,191963358,191963545,SRX5075176,SMARCA4,187
chr1,191963358,191963627,SRX5075174,SMARCA4,269
chr1,192045160,192045329,SRX5075170,SMARCA4,169
chr1,192053571,192053936,SRX5075176,SMARCA4,365
chr1,192053586,192053925,SRX5716467,SMARCA2,339
chr1,192053737,192053924,SRX5075175,SMARCA4,187
chr1,192104738,192105275,SRX5075169,SMARCA4,537
chr1,192104748,192105218,SRX5054309,FOSL2,470
chr1,192104753,192105166,SRX5716467,SMARCA2,413
chr1,192104760,192105225,SRX5075176,SMARCA4,465
chr1,192104797,192105177,SRX5075170,SMARCA4,380
chr1,192104805,192105445,SRX5716470,SMARCA4,640
chr1,192104808,192105208,SRX5716469,SMARCA4,400
chr1,192104829,192105069,SRX5075181,SMARCA2,240
chr1,192104847,192105275,SRX5075175,SMARCA4,428
chr1,192104868,192105083,SRX5020214,SMARCA2,215
chr1,192104878,192105156,SRX5020211,SMARCA2,278
chr1,192104884,192105270,SRX5716468,SMARCA2,386
chr1,192104905,192105163,SRX5054308,FOSL2,258
chr1,192133715,192133938,SRX5054309,FOSL2,223
chr1,192148190,192148425,SRX5054308,FOSL2,235
chr1,192148204,192148434,SRX5075182,SMARCA2,230
chr1,192148217,192148534,SRX5054309,FOSL2,317
chr1,192148234,192148448,SRX5020214,SMARCA2,214
chr1,192148262,192148491,SRX5075169,SMARCA4,229
chr1,192153322,192153590,SRX5054309,FOSL2,268
chr1,192153327,192153568,SRX5054308,FOSL2,241
chr1,192168060,192168266,SRX5075170,SMARCA4,206
chr1,192224380,192224709,SRX5075176,SMARCA4,329
chr1,192224441,192224779,SRX5716469,SMARCA4,338
chr1,192224457,192224893,SRX5075175,SMARCA4,436
chr1,192224503,192224947,SRX5054309,FOSL2,444
chr1,192224511,192224935,SRX5054308,FOSL2,424
chr1,192224528,192224723,SRX5075169,SMARCA4,195
chr1,192224542,192224858,SRX5020214,SMARCA2,316
chr1,192224645,192224856,SRX5716470,SMARCA4,211
chr1,192225724,192226049,SRX5075169,SMARCA4,325
chr1,192225737,192226081,SRX5054309,FOSL2,344
chr1,192225754,192226044,SRX5075176,SMARCA4,290
chr1,192225757,192226058,SRX5075170,SMARCA4,301
chr1,192225777,192225998,SRX5075182,SMARCA2,221
chr1,192225782,192226001,SRX5054308,FOSL2,219
chr1,192225803,192226085,SRX5020214,SMARCA2,282
chr1,192225822,192226022,SRX5020211,SMARCA2,200
chr1,192263583,192263801,SRX5075175,SMARCA4,218
chr1,192311338,192311557,SRX16500061,CTCF,219
chr1,192311342,192311627,SRX16500059,CTCF,285
chr1,192311344,192311633,SRX16500060,CTCF,289
chr1,192311347,192311657,SRX16500062,CTCF,310
chr1,192401828,192402223,SRX5716469,SMARCA4,395
chr1,192401835,192402237,SRX5716470,SMARCA4,402
chr1,192401844,192402250,SRX5054309,FOSL2,406
chr1,192401875,192402229,SRX5075170,SMARCA4,354
chr1,192401876,192402213,SRX5075176,SMARCA4,337
chr1,192401877,192402182,SRX5075169,SMARCA4,305
chr1,192401897,192402184,SRX5716467,SMARCA2,287
chr1,192401905,192402141,SRX5075175,SMARCA4,236
chr1,192401933,192402143,SRX5020211,SMARCA2,210
chr1,192401944,192402198,SRX5054308,FOSL2,254
chr1,192407308,192407521,SRX5075176,SMARCA4,213
chr1,192407323,192407497,SRX5075170,SMARCA4,174
chr1,192408945,192409171,SRX5716463,SMARCA4,226
chr1,192418615,192418891,SRX5716470,SMARCA4,276
chr1,192418631,192418873,SRX5075170,SMARCA4,242
chr1,192435691,192436113,SRX5716463,SMARCA4,422
chr1,192435738,192436156,SRX5075174,SMARCA4,418
chr1,192435746,192436122,SRX5075168,SMARCA4,376
chr1,192435752,192436091,SRX5716464,SMARCA4,339
chr1,192439350,192439732,SRX5075175,SMARCA4,382
chr1,192439364,192439744,SRX5075169,SMARCA4,380
chr1,192439390,192439686,SRX5716469,SMARCA4,296
chr1,192439418,192439730,SRX5075170,SMARCA4,312
chr1,192439443,192439762,SRX5054309,FOSL2,319
chr1,192439446,192439766,SRX5075176,SMARCA4,320
chr1,192439476,192439710,SRX5054308,FOSL2,234
chr1,192443654,192443912,SRX5054309,FOSL2,258
chr1,192443683,192443933,SRX5054308,FOSL2,250
chr1,192445736,192446278,SRX16500060,CTCF,542
chr1,192445790,192446280,SRX16500059,CTCF,490
chr1,192445798,192446276,SRX16500061,CTCF,478
chr1,192445840,192446247,SRX16500062,CTCF,407
chr1,192445893,192446106,SRX5716463,SMARCA4,213
chr1,192445912,192446157,SRX5075174,SMARCA4,245
chr1,192445943,192446112,SRX5075170,SMARCA4,169
chr1,192448299,192448551,SRX5075169,SMARCA4,252
chr1,192448300,192448529,SRX5075175,SMARCA4,229
chr1,192453369,192453711,SRX5075169,SMARCA4,342
chr1,192453410,192453594,SRX5075170,SMARCA4,184
chr1,192453421,192453625,SRX5075175,SMARCA4,204
chr1,192453438,192453646,SRX5054309,FOSL2,208
chr1,192474045,192474500,SRX16500060,CTCF,455
chr1,192474052,192474489,SRX16500062,CTCF,437
chr1,192474059,192474529,SRX16500059,CTCF,470
chr1,192474085,192474511,SRX16500061,CTCF,426
chr1,192474193,192474416,SRX5075176,SMARCA4,223
chr1,192474239,192474418,SRX5075168,SMARCA4,179
chr1,192474245,192474419,SRX5075174,SMARCA4,174
chr1,192477613,192477992,SRX16500062,CTCF,379
chr1,192477620,192477979,SRX16500060,CTCF,359
chr1,192477627,192477982,SRX16500059,CTCF,355
chr1,192477636,192478030,SRX16500061,CTCF,394
chr1,192477704,192477883,SRX5075170,SMARCA4,179
chr1,192485740,192486405,SRX5075175,SMARCA4,665
chr1,192485754,192486308,SRX5075170,SMARCA4,554
chr1,192485756,192486414,SRX5075169,SMARCA4,658
chr1,192485784,192486075,SRX5075176,SMARCA4,291
chr1,192485808,192486100,SRX5054309,FOSL2,292
chr1,192485838,192486336,SRX5716469,SMARCA4,498
chr1,192485845,192486136,SRX5716470,SMARCA4,291
chr1,192485862,192486062,SRX5020211,SMARCA2,200
chr1,192485862,192486067,SRX5054308,FOSL2,205
chr1,192485862,192486286,SRX5716468,SMARCA2,424
chr1,192486165,192486448,SRX5054309,FOSL2,283
chr1,192487957,192488347,SRX16500060,CTCF,390
chr1,192488072,192488486,SRX16500061,CTCF,414
chr1,192488088,192488364,SRX16500062,CTCF,276
chr1,192488088,192488434,SRX16500059,CTCF,346
chr1,192489067,192489517,SRX5075176,SMARCA4,450
chr1,192489075,192489355,SRX5716470,SMARCA4,280
chr1,192489087,192489490,SRX5075170,SMARCA4,403
chr1,192489136,192489447,SRX5716469,SMARCA4,311
chr1,192489163,192489395,SRX5716467,SMARCA2,232
chr1,192489181,192489453,SRX5075169,SMARCA4,272
chr1,192489722,192490135,SRX5716467,SMARCA2,413
chr1,192489727,192490187,SRX5075176,SMARCA4,460
chr1,192489750,192490179,SRX5716469,SMARCA4,429
chr1,192489752,192490148,SRX5075174,SMARCA4,396
chr1,192489752,192490196,SRX5075168,SMARCA4,444
chr1,192489757,192490168,SRX5075169,SMARCA4,411
chr1,192489757,192490185,SRX5075170,SMARCA4,428
chr1,192489782,192490099,SRX5020211,SMARCA2,317
chr1,192489785,192490162,SRX5075175,SMARCA4,377
chr1,192489787,192490152,SRX5716470,SMARCA4,365
chr1,192489790,192490179,SRX5054308,FOSL2,389
chr1,192489814,192490033,SRX5716468,SMARCA2,219
chr1,192489835,192490127,SRX5054309,FOSL2,292
chr1,192489840,192490066,SRX5020214,SMARCA2,226
chr1,192491868,192492446,SRX5075176,SMARCA4,578
chr1,192492227,192492434,SRX5054308,FOSL2,207
chr1,192492234,192492455,SRX5075169,SMARCA4,221
chr1,192492246,192492447,SRX5075170,SMARCA4,201
chr1,192506645,192506990,SRX16500059,CTCF,345
chr1,192506663,192507024,SRX16500060,CTCF,361
chr1,192506674,192506954,SRX16500062,CTCF,280
chr1,192506742,192506966,SRX16500061,CTCF,224
chr1,192506753,192506933,SRX5075169,SMARCA4,180
chr1,192506786,192506965,SRX5075168,SMARCA4,179
chr1,192506789,192507047,SRX5075170,SMARCA4,258
chr1,192512561,192512841,SRX5075170,SMARCA4,280
chr1,192512669,192512895,SRX5075169,SMARCA4,226
chr1,192516742,192517037,SRX5075176,SMARCA4,295
chr1,192516791,192516996,SRX5716464,SMARCA4,205
chr1,192516821,192517001,SRX5075169,SMARCA4,180
chr1,192516823,192517139,SRX5054309,FOSL2,316
chr1,192516838,192517048,SRX5075175,SMARCA4,210
chr1,192516840,192517049,SRX5020211,SMARCA2,209
chr1,192524209,192524483,SRX5075169,SMARCA4,274
chr1,192531019,192531422,SRX5054309,FOSL2,403
chr1,192531028,192531467,SRX5075168,SMARCA4,439
chr1,192531028,192531472,SRX5075174,SMARCA4,444
chr1,192531030,192531376,SRX5075170,SMARCA4,346
chr1,192531040,192531398,SRX5075176,SMARCA4,358
chr1,192531068,192531387,SRX5075169,SMARCA4,319
chr1,192531077,192531389,SRX5716469,SMARCA4,312
chr1,192531079,192531416,SRX5054308,FOSL2,337
chr1,192531083,192531380,SRX5054307,FOSL2,297
chr1,192531094,192531389,SRX5075175,SMARCA4,295
chr1,192531120,192531350,SRX5075182,SMARCA2,230
chr1,192531168,192531379,SRX5716470,SMARCA4,211
chr1,192539545,192540178,SRX5075174,SMARCA4,633
chr1,192539549,192540113,SRX5075169,SMARCA4,564
chr1,192539568,192540128,SRX5075175,SMARCA4,560
chr1,192539569,192540179,SRX5075168,SMARCA4,610
chr1,192539596,192540159,SRX5075170,SMARCA4,563
chr1,192539625,192540088,SRX5716470,SMARCA4,463
chr1,192539626,192540137,SRX5716463,SMARCA4,511
chr1,192539647,192540204,SRX5075176,SMARCA4,557
chr1,192539648,192540116,SRX5716469,SMARCA4,468
chr1,192539685,192540103,SRX5020214,SMARCA2,418
chr1,192539686,192540133,SRX5716467,SMARCA2,447
chr1,192539722,192540102,SRX5716464,SMARCA4,380
chr1,192539725,192540144,SRX5075181,SMARCA2,419
chr1,192539734,192540131,SRX5716468,SMARCA2,397
chr1,192539768,192540099,SRX5054308,FOSL2,331
chr1,192539771,192540102,SRX5054309,FOSL2,331
chr1,192539801,192540122,SRX5020211,SMARCA2,321
chr1,192539803,192540025,SRX5075182,SMARCA2,222
chr1,192539833,192540026,SRX5716451,SOX2,193
chr1,192544861,192545121,SRX5716460,Epitope tags,260
chr1,192544868,192545401,SRX5075168,SMARCA4,533
chr1,192544877,192545469,SRX5075170,SMARCA4,592
chr1,192544882,192545374,SRX5075174,SMARCA4,492
chr1,192544887,192545386,SRX5054309,FOSL2,499
chr1,192544902,192545370,SRX5075176,SMARCA4,468
chr1,192544915,192545327,SRX5075169,SMARCA4,412
chr1,192544918,192545250,SRX5020214,SMARCA2,332
chr1,192544925,192545330,SRX5020211,SMARCA2,405
chr1,192544936,192545282,SRX5075175,SMARCA4,346
chr1,192544940,192545316,SRX5054308,FOSL2,376
chr1,192544943,192545331,SRX5716470,SMARCA4,388
chr1,192544970,192545323,SRX5716467,SMARCA2,353
chr1,192544982,192545319,SRX5716469,SMARCA4,337
chr1,192546179,192546455,SRX16500061,CTCF,276
chr1,192546300,192546510,SRX16500062,CTCF,210
chr1,192550744,192551343,SRX5054309,FOSL2,599
chr1,192550834,192551380,SRX5075175,SMARCA4,546
chr1,192550856,192551336,SRX5075169,SMARCA4,480
chr1,192550873,192551301,SRX5075176,SMARCA4,428
chr1,192550893,192551224,SRX5716468,SMARCA2,331
chr1,192550913,192551343,SRX5075170,SMARCA4,430
chr1,192550942,192551297,SRX5054308,FOSL2,355
chr1,192550957,192551201,SRX5716469,SMARCA4,244
chr1,192550982,192551266,SRX5716467,SMARCA2,284
chr1,192550993,192551376,SRX5716470,SMARCA4,383
chr1,192551008,192551229,SRX5020214,SMARCA2,221
chr1,192551033,192551235,SRX5020211,SMARCA2,202
chr1,192559357,192559911,SRX5075169,SMARCA4,554
chr1,192559387,192559881,SRX5075176,SMARCA4,494
chr1,192559408,192559961,SRX5075175,SMARCA4,553
chr1,192559410,192559841,SRX5054309,FOSL2,431
chr1,192559413,192559757,SRX5716470,SMARCA4,344
chr1,192559438,192559869,SRX5716469,SMARCA4,431
chr1,192559446,192559785,SRX5054308,FOSL2,339
chr1,192559446,192559940,SRX5075170,SMARCA4,494
chr1,192559460,192559729,SRX5716459,Epitope tags,269
chr1,192559465,192559841,SRX5020214,SMARCA2,376
chr1,192559468,192559845,SRX5020211,SMARCA2,377
chr1,192559485,192559864,SRX5716467,SMARCA2,379
chr1,192573616,192573820,SRX5075174,SMARCA4,204
chr1,192580422,192580752,SRX16500059,CTCF,330
chr1,192580432,192580682,SRX5075170,SMARCA4,250
chr1,192580484,192580664,SRX5075169,SMARCA4,180
chr1,192580499,192580800,SRX16500060,CTCF,301
chr1,192584884,192585244,SRX5075174,SMARCA4,360
chr1,192593064,192593330,SRX5075170,SMARCA4,266
chr1,192609988,192610596,SRX16500059,CTCF,608
chr1,192610028,192610542,SRX16500062,CTCF,514
chr1,192610031,192610571,SRX16500060,CTCF,540
chr1,192610043,192610494,SRX16500061,CTCF,451
chr1,192633371,192633620,SRX5075174,SMARCA4,249
chr1,192640061,192640300,SRX5054309,FOSL2,239
chr1,192654494,192654849,SRX5075176,SMARCA4,355
chr1,192654538,192654849,SRX5075170,SMARCA4,311
chr1,192654540,192654802,SRX5716469,SMARCA4,262
chr1,192654565,192654750,SRX5054308,FOSL2,185
chr1,192654611,192654794,SRX5054309,FOSL2,183
chr1,192654652,192654877,SRX5075169,SMARCA4,225
chr1,192700792,192701236,SRX5075169,SMARCA4,444
chr1,192700831,192701271,SRX5716470,SMARCA4,440
chr1,192700844,192701170,SRX5716467,SMARCA2,326
chr1,192700854,192701203,SRX5716469,SMARCA4,349
chr1,192700859,192701278,SRX5020211,SMARCA2,419
chr1,192700886,192701184,SRX5075175,SMARCA4,298
chr1,192700894,192701277,SRX5075170,SMARCA4,383
chr1,192700914,192701130,SRX5075176,SMARCA4,216
chr1,192700942,192701150,SRX5075181,SMARCA2,208
chr1,192700985,192701341,SRX5054308,FOSL2,356
chr1,192701033,192701252,SRX5054309,FOSL2,219
chr1,192709444,192709979,SRX5075174,SMARCA4,535
chr1,192709490,192709966,SRX5075168,SMARCA4,476
chr1,192709532,192709969,SRX5716463,SMARCA4,437
chr1,192709692,192709918,SRX5716454,SOX3,226
chr1,192709715,192709905,SRX5716451,SOX2,190
chr1,192724715,192725095,SRX5075170,SMARCA4,380
chr1,192724744,192725126,SRX5075176,SMARCA4,382
chr1,192747301,192747691,SRX5075169,SMARCA4,390
chr1,192747306,192747652,SRX5075176,SMARCA4,346
chr1,192747322,192747644,SRX5075170,SMARCA4,322
chr1,192747364,192747615,SRX5716469,SMARCA4,251
chr1,192747380,192747635,SRX5054308,FOSL2,255
chr1,192747383,192747610,SRX5054309,FOSL2,227
chr1,192747438,192747654,SRX5075175,SMARCA4,216
chr1,192766332,192766583,SRX5075174,SMARCA4,251
chr1,192772659,192772878,SRX5075174,SMARCA4,219
chr1,192772709,192772974,SRX5075168,SMARCA4,265
chr1,192788164,192788641,SRX5075174,SMARCA4,477
chr1,192788177,192788477,SRX5075169,SMARCA4,300
chr1,192788190,192788527,SRX5075168,SMARCA4,337
chr1,192788190,192788633,SRX5075176,SMARCA4,443
chr1,192788216,192788590,SRX5075170,SMARCA4,374
chr1,192788240,192788467,SRX5054309,FOSL2,227
chr1,192788247,192788511,SRX5716469,SMARCA4,264
chr1,192788257,192788570,SRX5075175,SMARCA4,313
chr1,192788258,192788499,SRX5054308,FOSL2,241
chr1,192788273,192788627,SRX5716470,SMARCA4,354
chr1,192805717,192806192,SRX16500059,CTCF,475
chr1,192805731,192806143,SRX16500060,CTCF,412
chr1,192805736,192806127,SRX16500061,CTCF,391
chr1,192805796,192806178,SRX16500062,CTCF,382
chr1,192805930,192806203,SRX5075170,SMARCA4,273
chr1,192805939,192806208,SRX5054309,FOSL2,269
chr1,192805944,192806207,SRX5020211,SMARCA2,263
chr1,192805956,192806199,SRX5716470,SMARCA4,243
chr1,192805962,192806227,SRX5054308,FOSL2,265
chr1,192805975,192806185,SRX5075176,SMARCA4,210
chr1,192805986,192806166,SRX5075169,SMARCA4,180
chr1,192807935,192808188,SRX5054309,FOSL2,253
chr1,192807939,192808169,SRX5054308,FOSL2,230
chr1,192808469,192809343,SRX20140895,INTS13,874
chr1,192808524,192808818,SRX5075169,SMARCA4,294
chr1,192808543,192809213,SRX20140868,INTS10,670
chr1,192808547,192808738,SRX5075175,SMARCA4,191
chr1,192808565,192809064,SRX5075170,SMARCA4,499
chr1,192808583,192809142,SRX5075174,SMARCA4,559
chr1,192808601,192809054,SRX5075176,SMARCA4,453
chr1,192808612,192809143,SRX5075168,SMARCA4,531
chr1,192808669,192809006,SRX5716463,SMARCA4,337
chr1,192808677,192809367,SRX20140897,INTS13,690
chr1,192808680,192809312,SRX20140867,INTS10,632
chr1,192808711,192809306,SRX20140879,CPSF3L,595
chr1,192808736,192809026,SRX5716464,SMARCA4,290
chr1,192808790,192809023,SRX5716469,SMARCA4,233
chr1,192808792,192809322,SRX20140896,INTS13,530
chr1,192808810,192809288,SRX20140881,CPSF3L,478
chr1,192808892,192809321,SRX20140869,INTS10,429
chr1,192809034,192809299,SRX20140894,INTS13,265
chr1,192826752,192826966,SRX5075174,SMARCA4,214
chr1,192826799,192826978,SRX5075168,SMARCA4,179
chr1,192830636,192830891,SRX5075174,SMARCA4,255
chr1,192830662,192830841,SRX5075168,SMARCA4,179
chr1,192887487,192887821,SRX5075174,SMARCA4,334
chr1,192887493,192887680,SRX5054309,FOSL2,187
chr1,192887501,192887793,SRX5075168,SMARCA4,292
chr1,192904465,192905014,SRX5716470,SMARCA4,549
chr1,192904496,192904741,SRX5075168,SMARCA4,245
chr1,192904520,192904936,SRX5075169,SMARCA4,416
chr1,192904562,192904898,SRX5075170,SMARCA4,336
chr1,192904568,192904911,SRX5075176,SMARCA4,343
chr1,192904597,192904945,SRX5054309,FOSL2,348
chr1,192904653,192905010,SRX5716469,SMARCA4,357
chr1,192904662,192904940,SRX5054308,FOSL2,278
chr1,192951629,192952353,SRX5716470,SMARCA4,724
chr1,192951790,192952429,SRX5075169,SMARCA4,639
chr1,192951810,192952461,SRX5075176,SMARCA4,651
chr1,192951896,192952447,SRX5075170,SMARCA4,551
chr1,192951935,192952459,SRX5075175,SMARCA4,524
chr1,192951949,192952426,SRX5054308,FOSL2,477
chr1,192952004,192952397,SRX5716469,SMARCA4,393
chr1,192952030,192952453,SRX5020211,SMARCA2,423
chr1,192952039,192952408,SRX5054309,FOSL2,369
chr1,192952088,192952333,SRX5716468,SMARCA2,245
chr1,192952104,192952380,SRX5716467,SMARCA2,276
chr1,192952117,192952374,SRX5020214,SMARCA2,257
chr1,192952168,192952351,SRX5075182,SMARCA2,183
chr1,192958861,192959163,SRX5054309,FOSL2,302
chr1,192958870,192959170,SRX5075176,SMARCA4,300
chr1,192958877,192959215,SRX5054308,FOSL2,338
chr1,192958881,192959138,SRX5716467,SMARCA2,257
chr1,192958895,192959172,SRX5075170,SMARCA4,277
chr1,192958900,192959177,SRX5020211,SMARCA2,277
chr1,192958907,192959151,SRX5075175,SMARCA4,244
chr1,192958907,192959202,SRX5075169,SMARCA4,295
chr1,192958914,192959150,SRX5716469,SMARCA4,236
chr1,192974844,192975044,SRX5054309,FOSL2,200
chr1,192993503,192993691,SRX5054309,FOSL2,188
chr1,192993519,192993741,SRX5054308,FOSL2,222
chr1,193013017,193013383,SRX5075169,SMARCA4,366
chr1,193013023,193013322,SRX5716470,SMARCA4,299
chr1,193013169,193013349,SRX5054308,FOSL2,180
chr1,193014392,193014795,SRX5054309,FOSL2,403
chr1,193014429,193014756,SRX5054308,FOSL2,327
chr1,193014444,193014737,SRX5075169,SMARCA4,293
chr1,193014461,193014648,SRX5075175,SMARCA4,187
chr1,193014471,193014645,SRX5075170,SMARCA4,174
chr1,193014473,193014753,SRX5075176,SMARCA4,280
chr1,193019367,193019841,SRX16500060,CTCF,474
chr1,193019420,193019967,SRX16500059,CTCF,547
chr1,193019440,193019848,SRX16500062,CTCF,408
chr1,193019458,193019902,SRX16500061,CTCF,444
chr1,193019484,193019663,SRX5075168,SMARCA4,179
chr1,193019501,193019753,SRX5075174,SMARCA4,252
chr1,193019517,193019700,SRX5075176,SMARCA4,183
chr1,193059149,193060250,SRX20140895,INTS13,1101
chr1,193059239,193060142,SRX20140867,INTS10,903
chr1,193059276,193059712,SRX5075176,SMARCA4,436
chr1,193059281,193059786,SRX5075174,SMARCA4,505
chr1,193059288,193059602,SRX20140896,INTS13,314
chr1,193059334,193059573,SRX5075169,SMARCA4,239
chr1,193059336,193059685,SRX5054309,FOSL2,349
chr1,193059341,193059656,SRX5075168,SMARCA4,315
chr1,193059341,193060063,SRX20140869,INTS10,722
chr1,193059355,193059679,SRX5054308,FOSL2,324
chr1,193059371,193059593,SRX5716464,SMARCA4,222
chr1,193059374,193059592,SRX5075175,SMARCA4,218
chr1,193059380,193060146,SRX20140868,INTS10,766
chr1,193059381,193059615,SRX5054307,FOSL2,234
chr1,193059385,193059636,SRX5716470,SMARCA4,251
chr1,193059396,193059702,SRX5075170,SMARCA4,306
chr1,193059411,193059645,SRX5716451,SOX2,234
chr1,193059420,193060218,SRX20140897,INTS13,798
chr1,193059450,193060103,SRX20140881,CPSF3L,653
chr1,193059988,193060217,SRX5716469,SMARCA4,229
chr1,193060056,193060275,SRX5075174,SMARCA4,219
chr1,193069999,193070299,SRX16500059,CTCF,300
chr1,193070023,193070308,SRX16500061,CTCF,285
chr1,193070075,193070377,SRX16500060,CTCF,302
chr1,193071060,193071335,SRX5075169,SMARCA4,275
chr1,193071091,193071297,SRX5075170,SMARCA4,206
chr1,193104488,193105009,SRX5075170,SMARCA4,521
chr1,193104529,193104715,SRX5075169,SMARCA4,186
chr1,193104563,193105022,SRX5075174,SMARCA4,459
chr1,193104603,193104898,SRX5716470,SMARCA4,295
chr1,193104607,193105706,SRX5075176,SMARCA4,1099
chr1,193104976,193105523,SRX5054309,FOSL2,547
chr1,193105003,193105743,SRX20140895,INTS13,740
chr1,193105009,193105291,SRX5054308,FOSL2,282
chr1,193105091,193105689,SRX5075174,SMARCA4,598
chr1,193105127,193105565,SRX20140897,INTS13,438
chr1,193105134,193105392,SRX5075175,SMARCA4,258
chr1,193105147,193105720,SRX5075168,SMARCA4,573
chr1,193105190,193105632,SRX5075170,SMARCA4,442
chr1,193105192,193105579,SRX20140867,INTS10,387
chr1,193105468,193105675,SRX5075169,SMARCA4,207
chr1,193105469,193105765,SRX5716464,SMARCA4,296
chr1,193111630,193111919,SRX5075175,SMARCA4,289
chr1,193111631,193111913,SRX5075169,SMARCA4,282
chr1,193111667,193111879,SRX5075170,SMARCA4,212
chr1,193111684,193111950,SRX5716470,SMARCA4,266
chr1,193115590,193116042,SRX5075169,SMARCA4,452
chr1,193115599,193116062,SRX5075176,SMARCA4,463
chr1,193115604,193115995,SRX5075170,SMARCA4,391
chr1,193115608,193116045,SRX5716469,SMARCA4,437
chr1,193115612,193116047,SRX5054309,FOSL2,435
chr1,193115619,193115932,SRX5020214,SMARCA2,313
chr1,193115622,193116164,SRX5716460,Epitope tags,542
chr1,193115623,193116039,SRX5075175,SMARCA4,416
chr1,193115634,193116022,SRX5716467,SMARCA2,388
chr1,193115654,193116025,SRX5054308,FOSL2,371
chr1,193115661,193115934,SRX5075182,SMARCA2,273
chr1,193115674,193116003,SRX5716470,SMARCA4,329
chr1,193115705,193116023,SRX5075174,SMARCA4,318
chr1,193115706,193115915,SRX5075168,SMARCA4,209
chr1,193115708,193115977,SRX5020211,SMARCA2,269
chr1,193121567,193122180,SRX5716470,SMARCA4,613
chr1,193121606,193122228,SRX5075170,SMARCA4,622
chr1,193121616,193122159,SRX5716469,SMARCA4,543
chr1,193121618,193122428,SRX5075168,SMARCA4,810
chr1,193121633,193122449,SRX5075176,SMARCA4,816
chr1,193121633,193122464,SRX20140895,INTS13,831
chr1,193121663,193122114,SRX5075169,SMARCA4,451
chr1,193121669,193122150,SRX5075175,SMARCA4,481
chr1,193121677,193122236,SRX16500060,CTCF,559
chr1,193121680,193122299,SRX16500061,CTCF,619
chr1,193121683,193122205,SRX5716463,SMARCA4,522
chr1,193121689,193122263,SRX16500059,CTCF,574
chr1,193121694,193122140,SRX16500062,CTCF,446
chr1,193121701,193121902,SRX5054308,FOSL2,201
chr1,193121704,193122533,SRX5075174,SMARCA4,829
chr1,193121723,193122270,SRX20140897,INTS13,547
chr1,193121729,193122040,SRX5054309,FOSL2,311
chr1,193121763,193122369,SRX20140868,INTS10,606
chr1,193121780,193122334,SRX20140867,INTS10,554
chr1,193121784,193122098,SRX5716464,SMARCA4,314
chr1,193121839,193122257,SRX20140869,INTS10,418
chr1,193121881,193122165,SRX20140896,INTS13,284
chr1,193121946,193122150,SRX5716451,SOX2,204
chr1,193121957,193122336,SRX20140879,CPSF3L,379
chr1,193127958,193128003,SRX1424892,POU3F2,45
chr1,193127959,193128003,SRX1424894,POU3F2,44
chr1,193127960,193128004,SRX1424893,POU3F2,44
chr1,193127961,193128003,SRX1424891,POU3F2,42
chr1,193143294,193143726,SRX16500060,CTCF,432
chr1,193143318,193143655,SRX16500059,CTCF,337
chr1,193143334,193143665,SRX16500062,CTCF,331
chr1,193182926,193183449,SRX16500062,CTCF,523
chr1,193182963,193183479,SRX16500060,CTCF,516
chr1,193182980,193183438,SRX16500059,CTCF,458
chr1,193182987,193183520,SRX16500061,CTCF,533
chr1,193183144,193183395,SRX5075170,SMARCA4,251
chr1,193183150,193183360,SRX5075168,SMARCA4,210
chr1,193183154,193183367,SRX5075174,SMARCA4,213
chr1,193186351,193186853,SRX20140895,INTS13,502
chr1,193186393,193186703,SRX5075176,SMARCA4,310
chr1,193186439,193186661,SRX5075174,SMARCA4,222
chr1,193186443,193186630,SRX5075168,SMARCA4,187
chr1,193190488,193190657,SRX5075170,SMARCA4,169
chr1,193211473,193211751,SRX5075169,SMARCA4,278
chr1,193216904,193217138,SRX5075168,SMARCA4,234
chr1,193216939,193217173,SRX5075174,SMARCA4,234
chr1,193221674,193221923,SRX5075174,SMARCA4,249
chr1,193221684,193221929,SRX5075170,SMARCA4,245
chr1,193254891,193255126,SRX16500059,CTCF,235
chr1,193271084,193271315,SRX5075169,SMARCA4,231
chr1,193271100,193271292,SRX5054308,FOSL2,192
chr1,193321321,193321715,SRX5716470,SMARCA4,394
chr1,193321394,193321640,SRX5075175,SMARCA4,246
chr1,193321423,193321647,SRX5075169,SMARCA4,224
chr1,193322276,193322594,SRX5054309,FOSL2,318
chr1,193322283,193322576,SRX5075169,SMARCA4,293
chr1,193322299,193322532,SRX5075176,SMARCA4,233
chr1,193322300,193322585,SRX5054308,FOSL2,285
chr1,193322303,193322587,SRX5075174,SMARCA4,284
chr1,193322314,193322597,SRX5075175,SMARCA4,283
chr1,193322335,193322535,SRX5020211,SMARCA2,200
chr1,193322350,193322561,SRX5020214,SMARCA2,211
chr1,193322353,193322553,SRX5075170,SMARCA4,200
chr1,193335730,193336167,SRX5075169,SMARCA4,437
chr1,193335759,193336097,SRX5075176,SMARCA4,338
chr1,193335767,193336368,SRX5075174,SMARCA4,601
chr1,193335813,193336104,SRX5716470,SMARCA4,291
chr1,193335820,193336093,SRX5716469,SMARCA4,273
chr1,193335830,193336089,SRX5716468,SMARCA2,259
chr1,193335831,193336224,SRX5075175,SMARCA4,393
chr1,193335840,193336035,SRX5054309,FOSL2,195
chr1,193335852,193336349,SRX5075168,SMARCA4,497
chr1,193335872,193336132,SRX5075170,SMARCA4,260
chr1,193335890,193336129,SRX5716463,SMARCA4,239
chr1,193335892,193336166,SRX5020211,SMARCA2,274
chr1,193335935,193336173,SRX5716467,SMARCA2,238
chr1,193348435,193348843,SRX20140869,INTS10,408
chr1,193348462,193348728,SRX5075170,SMARCA4,266
chr1,193348475,193348706,SRX5075169,SMARCA4,231
chr1,193348480,193348794,SRX5075176,SMARCA4,314
chr1,193355148,193355450,SRX5054309,FOSL2,302
chr1,193355225,193355452,SRX5054308,FOSL2,227
chr1,193406727,193407212,SRX16500062,CTCF,485
chr1,193406760,193406972,SRX5716469,SMARCA4,212
chr1,193406771,193407345,SRX16500060,CTCF,574
chr1,193406802,193407233,SRX16500061,CTCF,431
chr1,193406850,193407276,SRX16500059,CTCF,426
chr1,193406858,193407095,SRX5716470,SMARCA4,237
chr1,193406958,193407144,SRX5075174,SMARCA4,186
chr1,193408804,193409121,SRX5075170,SMARCA4,317
chr1,193408829,193409131,SRX5054309,FOSL2,302
chr1,193408836,193409030,SRX5075181,SMARCA2,194
chr1,193408879,193409152,SRX5075176,SMARCA4,273
chr1,193408922,193409145,SRX5716469,SMARCA4,223
chr1,193418241,193418806,SRX5075170,SMARCA4,565
chr1,193418295,193418726,SRX5716469,SMARCA4,431
chr1,193418437,193418709,SRX5716470,SMARCA4,272
chr1,193418460,193418861,SRX5075176,SMARCA4,401
chr1,193418494,193418789,SRX5075175,SMARCA4,295
chr1,193418541,193418767,SRX5075169,SMARCA4,226
chr1,193434345,193434571,SRX5054308,FOSL2,226
chr1,193434364,193434621,SRX5054309,FOSL2,257
chr1,193434396,193434581,SRX5075169,SMARCA4,185
chr1,193449021,193449247,SRX5075168,SMARCA4,226
chr1,193462840,193463243,SRX5075168,SMARCA4,403
chr1,193462972,193463338,SRX5075174,SMARCA4,366
chr1,193486796,193487053,SRX5075176,SMARCA4,257
chr1,193486818,193487015,SRX5075170,SMARCA4,197
chr1,193487508,193487691,SRX5054309,FOSL2,183
chr1,193498248,193498448,SRX5075176,SMARCA4,200
chr1,193498311,193498514,SRX5075170,SMARCA4,203
chr1,193513958,193514178,SRX5075175,SMARCA4,220
chr1,193514034,193514246,SRX5075169,SMARCA4,212
chr1,193533842,193534070,SRX5075170,SMARCA4,228
chr1,193543343,193543641,SRX5075170,SMARCA4,298
chr1,193543391,193543667,SRX5075176,SMARCA4,276
chr1,193545205,193545539,SRX5075170,SMARCA4,334
chr1,193545246,193545533,SRX5075176,SMARCA4,287
chr1,193545267,193545479,SRX5716470,SMARCA4,212
chr1,193558355,193559001,SRX5075176,SMARCA4,646
chr1,193558366,193558848,SRX5075175,SMARCA4,482
chr1,193558371,193558930,SRX5075170,SMARCA4,559
chr1,193558385,193558876,SRX5075169,SMARCA4,491
chr1,193558386,193558750,SRX5716467,SMARCA2,364
chr1,193558395,193558798,SRX5054309,FOSL2,403
chr1,193558399,193558732,SRX5054308,FOSL2,333
chr1,193558408,193558847,SRX5716469,SMARCA4,439
chr1,193558416,193558794,SRX5020211,SMARCA2,378
chr1,193558430,193558834,SRX5716470,SMARCA4,404
chr1,193558444,193558693,SRX5716459,Epitope tags,249
chr1,193558469,193558862,SRX5716460,Epitope tags,393
chr1,193558478,193558750,SRX5020214,SMARCA2,272
chr1,193569659,193570044,SRX5075176,SMARCA4,385
chr1,193569668,193570107,SRX5075170,SMARCA4,439
chr1,193569679,193570125,SRX5716469,SMARCA4,446
chr1,193569701,193570171,SRX5075169,SMARCA4,470
chr1,193569703,193570141,SRX5054309,FOSL2,438
chr1,193569708,193570121,SRX5054308,FOSL2,413
chr1,193569739,193570115,SRX5075175,SMARCA4,376
chr1,193569740,193570084,SRX5716467,SMARCA2,344
chr1,193569750,193570067,SRX5716470,SMARCA4,317
chr1,193569777,193570009,SRX5020211,SMARCA2,232
chr1,193569791,193570104,SRX5020214,SMARCA2,313
chr1,193588471,193588684,SRX5075169,SMARCA4,213
chr1,193589601,193589944,SRX5075176,SMARCA4,343
chr1,193589631,193589896,SRX5075170,SMARCA4,265
chr1,193629858,193630131,SRX5075170,SMARCA4,273
chr1,193629859,193630164,SRX5075174,SMARCA4,305
chr1,193629884,193630152,SRX5075176,SMARCA4,268
chr1,193630022,193630249,SRX5075168,SMARCA4,227
chr1,193661486,193661734,SRX5075170,SMARCA4,248
chr1,193662127,193662349,SRX5054308,FOSL2,222
chr1,193700863,193701337,SRX5075169,SMARCA4,474
chr1,193700928,193701346,SRX5054309,FOSL2,418
chr1,193700930,193701366,SRX5075175,SMARCA4,436
chr1,193700951,193701349,SRX5075176,SMARCA4,398
chr1,193700964,193701320,SRX5075170,SMARCA4,356
chr1,193700965,193701342,SRX5075174,SMARCA4,377
chr1,193700971,193701375,SRX5054308,FOSL2,404
chr1,193700978,193701343,SRX5716469,SMARCA4,365
chr1,193700981,193701294,SRX5075168,SMARCA4,313
chr1,193701000,193701287,SRX5716470,SMARCA4,287
chr1,193701041,193701338,SRX5020214,SMARCA2,297
chr1,193701087,193701266,SRX5054307,FOSL2,179
chr1,193701865,193702167,SRX5075168,SMARCA4,302
chr1,193701874,193702189,SRX5075174,SMARCA4,315
chr1,193707575,193708025,SRX5075169,SMARCA4,450
chr1,193707638,193707890,SRX5716469,SMARCA4,252
chr1,193707720,193708024,SRX5075176,SMARCA4,304
chr1,193707765,193707964,SRX5075175,SMARCA4,199
chr1,193725549,193725718,SRX5075170,SMARCA4,169
chr1,193763296,193763523,SRX5716469,SMARCA4,227
chr1,193763302,193763574,SRX5054308,FOSL2,272
chr1,193763313,193763607,SRX5075175,SMARCA4,294
chr1,193763345,193763644,SRX5075176,SMARCA4,299
chr1,193763373,193763618,SRX5054309,FOSL2,245
chr1,193763388,193763624,SRX5075170,SMARCA4,236
chr1,193763446,193763628,SRX5075169,SMARCA4,182
chr1,193799862,193800217,SRX5716469,SMARCA4,355
chr1,193799958,193800171,SRX5054309,FOSL2,213
chr1,193799987,193800308,SRX5075169,SMARCA4,321
chr1,193800007,193800381,SRX5054308,FOSL2,374
chr1,193919958,193920453,SRX5054309,FOSL2,495
chr1,193960895,193961146,SRX5075174,SMARCA4,251
chr1,193960944,193961123,SRX5075168,SMARCA4,179
chr1,193971510,193972051,SRX5075176,SMARCA4,541
chr1,193971550,193972018,SRX5716469,SMARCA4,468
chr1,193971553,193972020,SRX5075170,SMARCA4,467
chr1,193971574,193971813,SRX5716467,SMARCA2,239
chr1,193971586,193972011,SRX5054309,FOSL2,425
chr1,193971608,193972013,SRX5075168,SMARCA4,405
chr1,193971609,193972036,SRX5075169,SMARCA4,427
chr1,193971619,193971949,SRX5075175,SMARCA4,330
chr1,193971620,193971997,SRX5075174,SMARCA4,377
chr1,193971666,193971974,SRX5054308,FOSL2,308
chr1,193971675,193971939,SRX5716470,SMARCA4,264
chr1,193971728,193971907,SRX5054307,FOSL2,179
chr1,194004144,194004636,SRX5075174,SMARCA4,492
chr1,194004152,194004597,SRX5075168,SMARCA4,445
chr1,194004185,194004484,SRX5716463,SMARCA4,299
chr1,194004204,194004459,SRX5075176,SMARCA4,255
chr1,194024636,194025061,SRX5075176,SMARCA4,425
chr1,194024657,194024998,SRX5716469,SMARCA4,341
chr1,194024660,194025060,SRX5075170,SMARCA4,400
chr1,194024700,194024993,SRX5075181,SMARCA2,293
chr1,194024707,194025066,SRX5075169,SMARCA4,359
chr1,194024709,194025039,SRX5054309,FOSL2,330
chr1,194024714,194025092,SRX5716470,SMARCA4,378
chr1,194024718,194025040,SRX5716467,SMARCA2,322
chr1,194024729,194025053,SRX5020211,SMARCA2,324
chr1,194024729,194025070,SRX5020214,SMARCA2,341
chr1,194024741,194025089,SRX5075175,SMARCA4,348
chr1,194024766,194025028,SRX5054308,FOSL2,262
chr1,194045450,194045738,SRX5054309,FOSL2,288
chr1,194045452,194045721,SRX5054308,FOSL2,269
chr1,194045487,194045703,SRX5075169,SMARCA4,216
chr1,194045553,194045779,SRX5075170,SMARCA4,226
chr1,194052775,194053102,SRX5075176,SMARCA4,327
chr1,194052878,194053169,SRX5716470,SMARCA4,291
chr1,194053009,194053201,SRX5075170,SMARCA4,192
chr1,194073944,194074149,SRX5716464,SMARCA4,205
chr1,194167887,194168136,SRX5054309,FOSL2,249
chr1,194167963,194168159,SRX5075175,SMARCA4,196
chr1,194174605,194174821,SRX5075168,SMARCA4,216
chr1,194174629,194174813,SRX5075174,SMARCA4,184
chr1,194227198,194227571,SRX5075170,SMARCA4,373
chr1,194227218,194227573,SRX5075176,SMARCA4,355
chr1,194227245,194227424,SRX5075168,SMARCA4,179
chr1,194227295,194227564,SRX5075169,SMARCA4,269
chr1,194227307,194227539,SRX5054308,FOSL2,232
chr1,194252284,194252473,SRX5075169,SMARCA4,189
chr1,194295668,194296082,SRX16500059,CTCF,414
chr1,194295702,194296060,SRX16500061,CTCF,358
chr1,194295706,194296006,SRX16500060,CTCF,300
chr1,194295715,194296027,SRX16500062,CTCF,312
chr1,194338559,194338860,SRX5075170,SMARCA4,301
chr1,194338564,194338802,SRX5716469,SMARCA4,238
chr1,194338565,194338769,SRX5075176,SMARCA4,204
chr1,194338597,194338900,SRX5075169,SMARCA4,303
chr1,194338607,194338913,SRX5075175,SMARCA4,306
chr1,194338661,194338940,SRX5716470,SMARCA4,279
chr1,194347259,194347587,SRX5054309,FOSL2,328
chr1,194347304,194347558,SRX5054308,FOSL2,254
chr1,194394528,194395027,SRX5075174,SMARCA4,499
chr1,194394601,194394985,SRX5075168,SMARCA4,384
chr1,194394686,194394905,SRX5716463,SMARCA4,219
chr1,194395297,194395728,SRX5075168,SMARCA4,431
chr1,194395336,194395631,SRX5075174,SMARCA4,295
chr1,194407293,194407498,SRX5054309,FOSL2,205
chr1,194407347,194407527,SRX5054308,FOSL2,180
chr1,194407370,194407608,SRX5075169,SMARCA4,238
chr1,194442863,194443106,SRX5075168,SMARCA4,243
chr1,194442879,194443510,SRX5075174,SMARCA4,631
chr1,194443264,194443563,SRX5075168,SMARCA4,299
chr1,194447662,194447914,SRX5716469,SMARCA4,252
chr1,194447668,194447948,SRX5054309,FOSL2,280
chr1,194447669,194448053,SRX5075175,SMARCA4,384
chr1,194447673,194448043,SRX5054308,FOSL2,370
chr1,194447674,194448117,SRX5075169,SMARCA4,443
chr1,194447701,194448016,SRX5075176,SMARCA4,315
chr1,194447713,194448032,SRX5020211,SMARCA2,319
chr1,194447722,194447970,SRX5716470,SMARCA4,248
chr1,194447767,194447936,SRX5075170,SMARCA4,169
chr1,194466774,194466967,SRX5075176,SMARCA4,193
chr1,194466783,194466990,SRX5075170,SMARCA4,207
chr1,194474832,194475049,SRX5075174,SMARCA4,217
chr1,194476917,194477134,SRX5054308,FOSL2,217
chr1,194477011,194477265,SRX5075169,SMARCA4,254
chr1,194515920,194516341,SRX5075168,SMARCA4,421
chr1,194515952,194516363,SRX5075174,SMARCA4,411
chr1,194516020,194516272,SRX5716463,SMARCA4,252
chr1,194568755,194568924,SRX5075170,SMARCA4,169
chr1,194658145,194658474,SRX5054309,FOSL2,329
chr1,194658154,194658408,SRX5075169,SMARCA4,254
chr1,194658169,194658408,SRX5716470,SMARCA4,239
chr1,194658171,194658359,SRX5075176,SMARCA4,188
chr1,194658182,194658461,SRX5054308,FOSL2,279
chr1,194718000,194718183,SRX5054309,FOSL2,183
chr1,194735035,194735231,SRX5075168,SMARCA4,196
chr1,194755654,194755834,SRX5054308,FOSL2,180
chr1,194755655,194755872,SRX5075176,SMARCA4,217
chr1,194966412,194966651,SRX5075174,SMARCA4,239
chr1,195019317,195019870,SRX5054309,FOSL2,553
chr1,195019343,195019698,SRX5054308,FOSL2,355
chr1,195019381,195019713,SRX5716470,SMARCA4,332
chr1,195019402,195019723,SRX5075175,SMARCA4,321
chr1,195019411,195019746,SRX5075169,SMARCA4,335
chr1,195019425,195019595,SRX5075170,SMARCA4,170
chr1,195019437,195019753,SRX5716469,SMARCA4,316
chr1,195019446,195019733,SRX5020211,SMARCA2,287
chr1,195034621,195034856,SRX5075168,SMARCA4,235
chr1,195053581,195053791,SRX5075170,SMARCA4,210
chr1,195082222,195082500,SRX5054308,FOSL2,278
chr1,195082236,195082485,SRX5075176,SMARCA4,249
chr1,195082246,195082480,SRX5054309,FOSL2,234
chr1,195082249,195082461,SRX5716469,SMARCA4,212
chr1,195082293,195082531,SRX5075170,SMARCA4,238
chr1,195082295,195082506,SRX5075169,SMARCA4,211
chr1,195113550,195113746,SRX5075170,SMARCA4,196
chr1,195125082,195125385,SRX5075174,SMARCA4,303
chr1,195125125,195125328,SRX5075168,SMARCA4,203
chr1,195236961,195237318,SRX5716469,SMARCA4,357
chr1,195236970,195237316,SRX5716470,SMARCA4,346
chr1,195236996,195237388,SRX5075176,SMARCA4,392
chr1,195237003,195237278,SRX5054309,FOSL2,275
chr1,195237010,195237308,SRX5716467,SMARCA2,298
chr1,195237032,195237349,SRX5075170,SMARCA4,317
chr1,195237049,195237302,SRX5716468,SMARCA2,253
chr1,195237051,195237320,SRX5075175,SMARCA4,269
chr1,195237056,195237349,SRX5075169,SMARCA4,293
chr1,195237077,195237306,SRX5020211,SMARCA2,229
chr1,195239821,195240020,SRX5075168,SMARCA4,199
chr1,195239826,195240044,SRX5075176,SMARCA4,218
chr1,195335552,195335923,SRX5054309,FOSL2,371
chr1,195335573,195335780,SRX5075169,SMARCA4,207
chr1,195336788,195337238,SRX5075174,SMARCA4,450
chr1,195336878,195337304,SRX5075168,SMARCA4,426
chr1,195434813,195435195,SRX5075174,SMARCA4,382
chr1,195434816,195435256,SRX5075168,SMARCA4,440
chr1,195434926,195435132,SRX5716463,SMARCA4,206
chr1,195472326,195472618,SRX5075174,SMARCA4,292
chr1,195472348,195472603,SRX5075168,SMARCA4,255
chr1,195531005,195531335,SRX5075169,SMARCA4,330
chr1,195531035,195531249,SRX5020211,SMARCA2,214
chr1,195531045,195531308,SRX5716470,SMARCA4,263
chr1,195531046,195531221,SRX5075176,SMARCA4,175
chr1,195531058,195531281,SRX5075175,SMARCA4,223
chr1,195531059,195531296,SRX5716469,SMARCA4,237
chr1,195531082,195531297,SRX5716467,SMARCA2,215
chr1,195580994,195581396,SRX16500061,CTCF,402
chr1,195580999,195581324,SRX16500060,CTCF,325
chr1,195581037,195581295,SRX16500059,CTCF,258
chr1,195581053,195581273,SRX16500062,CTCF,220
chr1,195591858,195592616,SRX5075170,SMARCA4,758
chr1,195591900,195592627,SRX5075169,SMARCA4,727
chr1,195591910,195592311,SRX5075176,SMARCA4,401
chr1,195591920,195592267,SRX5075175,SMARCA4,347
chr1,195591948,195592180,SRX5054308,FOSL2,232
chr1,195591953,195592271,SRX5075168,SMARCA4,318
chr1,195591968,195592179,SRX5716470,SMARCA4,211
chr1,195591979,195592226,SRX5075174,SMARCA4,247
chr1,195592020,195592240,SRX5054309,FOSL2,220
chr1,195592032,195592292,SRX5716469,SMARCA4,260
chr1,195592071,195592485,SRX5020211,SMARCA2,414
chr1,195592319,195592613,SRX5075175,SMARCA4,294
chr1,195592381,195592647,SRX5054308,FOSL2,266
chr1,195592386,195592618,SRX5054309,FOSL2,232
chr1,195592399,195592625,SRX5075176,SMARCA4,226
chr1,195604239,195604734,SRX5075176,SMARCA4,495
chr1,195604285,195604715,SRX5075175,SMARCA4,430
chr1,195604297,195604718,SRX5075169,SMARCA4,421
chr1,195604326,195604554,SRX5075170,SMARCA4,228
chr1,195604360,195604647,SRX5054309,FOSL2,287
chr1,195617163,195617359,SRX5075174,SMARCA4,196
chr1,195663900,195664126,SRX5054309,FOSL2,226
chr1,195663939,195664156,SRX5054308,FOSL2,217
chr1,195663949,195664250,SRX5075169,SMARCA4,301
chr1,195664052,195664239,SRX5075175,SMARCA4,187
chr1,195717670,195718040,SRX16500059,CTCF,370
chr1,195717680,195717985,SRX16500062,CTCF,305
chr1,195717693,195718019,SRX16500060,CTCF,326
chr1,195717727,195718023,SRX16500061,CTCF,296
chr1,195717742,195717911,SRX5075170,SMARCA4,169
chr1,195733851,195734288,SRX16500060,CTCF,437
chr1,195733883,195734241,SRX16500059,CTCF,358
chr1,195733904,195734181,SRX16500062,CTCF,277
chr1,195733904,195734239,SRX16500061,CTCF,335
chr1,195739101,195739284,SRX5054309,FOSL2,183
chr1,195739152,195739367,SRX5054308,FOSL2,215
chr1,195766753,195766979,SRX5075176,SMARCA4,226
chr1,195766755,195767013,SRX5054308,FOSL2,258
chr1,195766768,195766975,SRX5075169,SMARCA4,207
chr1,195766771,195766981,SRX5075170,SMARCA4,210
chr1,195766776,195766996,SRX5075175,SMARCA4,220
chr1,195766776,195767030,SRX5054309,FOSL2,254
chr1,195828269,195828807,SRX5075174,SMARCA4,538
chr1,195828341,195828769,SRX5716463,SMARCA4,428
chr1,195828360,195828718,SRX5075168,SMARCA4,358
chr1,195828381,195828677,SRX5716464,SMARCA4,296
chr1,195828470,195828703,SRX5716451,SOX2,233
chr1,195886131,195886661,SRX5075168,SMARCA4,530
chr1,195886185,195886691,SRX5075174,SMARCA4,506
chr1,195886371,195886613,SRX5716463,SMARCA4,242
chr1,195899824,195900022,SRX5054308,FOSL2,198
chr1,195933918,195934143,SRX5075176,SMARCA4,225
chr1,195934816,195935213,SRX5716469,SMARCA4,397
chr1,195934818,195935561,SRX5075170,SMARCA4,743
chr1,195934819,195935113,SRX5020211,SMARCA2,294
chr1,195934851,195935154,SRX5075176,SMARCA4,303
chr1,195934859,195935366,SRX5075169,SMARCA4,507
chr1,195934878,195935109,SRX5075175,SMARCA4,231
chr1,195935117,195935365,SRX5716467,SMARCA2,248
chr1,195935121,195935504,SRX5716470,SMARCA4,383
chr1,195935216,195935552,SRX5075176,SMARCA4,336
chr1,195935223,195935472,SRX5020211,SMARCA2,249
chr1,195939908,195940208,SRX16500059,CTCF,300
chr1,195939911,195940201,SRX16500060,CTCF,290
chr1,196034039,196034315,SRX5716469,SMARCA4,276
chr1,196034040,196034445,SRX5075170,SMARCA4,405
chr1,196034065,196034437,SRX5075176,SMARCA4,372
chr1,196034066,196034441,SRX5716470,SMARCA4,375
chr1,196034085,196034359,SRX5716467,SMARCA2,274
chr1,196034103,196034408,SRX5075168,SMARCA4,305
chr1,196034118,196034398,SRX5075169,SMARCA4,280
chr1,196034144,196034370,SRX5075175,SMARCA4,226
chr1,196052718,196052901,SRX5054309,FOSL2,183
chr1,196064039,196064232,SRX5075169,SMARCA4,193
chr1,196064043,196064254,SRX5716470,SMARCA4,211
chr1,196097984,196098410,SRX5075174,SMARCA4,426
chr1,196098158,196098422,SRX5075168,SMARCA4,264
chr1,196105947,196106280,SRX5716460,Epitope tags,333
chr1,196105957,196106211,SRX5075168,SMARCA4,254
chr1,196105980,196106359,SRX5075174,SMARCA4,379
chr1,196142135,196142607,SRX5075168,SMARCA4,472
chr1,196142189,196142665,SRX5075174,SMARCA4,476
chr1,196142247,196142554,SRX20140881,CPSF3L,307
chr1,196148322,196148878,SRX16500060,CTCF,556
chr1,196148326,196148817,SRX16500059,CTCF,491
chr1,196148340,196148814,SRX16500062,CTCF,474
chr1,196148359,196148851,SRX16500061,CTCF,492
chr1,196181093,196181702,SRX5075176,SMARCA4,609
chr1,196181134,196181586,SRX5075169,SMARCA4,452
chr1,196181144,196181752,SRX5075170,SMARCA4,608
chr1,196181149,196181535,SRX5075174,SMARCA4,386
chr1,196181153,196181527,SRX5054308,FOSL2,374
chr1,196181156,196181727,SRX5075175,SMARCA4,571
chr1,196181174,196181592,SRX5054309,FOSL2,418
chr1,196181179,196181573,SRX5075168,SMARCA4,394
chr1,196181187,196181580,SRX5716470,SMARCA4,393
chr1,196181222,196181512,SRX5020214,SMARCA2,290
chr1,196181234,196181536,SRX5716469,SMARCA4,302
chr1,196181234,196181548,SRX5716467,SMARCA2,314
chr1,196181292,196181512,SRX5020211,SMARCA2,220
chr1,196193932,196194176,SRX5054308,FOSL2,244
chr1,196193977,196194249,SRX5054309,FOSL2,272
chr1,196259335,196259515,SRX5075174,SMARCA4,180
chr1,196259349,196259560,SRX5075168,SMARCA4,211
chr1,196267131,196267304,SRX5075174,SMARCA4,173
chr1,196295810,196296078,SRX5054309,FOSL2,268
chr1,196295882,196296109,SRX5054308,FOSL2,227
chr1,196295883,196296127,SRX5075169,SMARCA4,244
chr1,196302966,196303302,SRX5075168,SMARCA4,336
chr1,196302969,196303280,SRX5075174,SMARCA4,311
chr1,196303010,196303258,SRX5716463,SMARCA4,248
chr1,196303036,196303261,SRX5716464,SMARCA4,225
chr1,196309444,196309671,SRX16500062,CTCF,227
chr1,196309474,196309695,SRX16500060,CTCF,221
chr1,196317866,196318345,SRX16500060,CTCF,479
chr1,196317882,196318305,SRX16500059,CTCF,423
chr1,196317917,196318411,SRX16500062,CTCF,494
chr1,196317965,196318303,SRX16500061,CTCF,338
chr1,196318039,196318220,SRX5075174,SMARCA4,181
chr1,196318075,196318285,SRX4174629,CTCF,210
chr1,196344529,196344804,SRX5075168,SMARCA4,275
chr1,196344550,196344768,SRX5075174,SMARCA4,218
chr1,196355188,196355519,SRX16500059,CTCF,331
chr1,196355260,196355572,SRX16500060,CTCF,312
chr1,196355291,196355596,SRX16500061,CTCF,305
chr1,196355302,196355586,SRX16500062,CTCF,284
chr1,196372801,196373332,SRX16500061,CTCF,531
chr1,196372832,196373368,SRX16500059,CTCF,536
chr1,196372861,196373346,SRX16500060,CTCF,485
chr1,196372919,196373344,SRX16500062,CTCF,425
chr1,196373080,196373253,SRX5075174,SMARCA4,173
chr1,196387856,196388039,SRX5054309,FOSL2,183
chr1,196393781,196394024,SRX5075176,SMARCA4,243
chr1,196400793,196401165,SRX5716469,SMARCA4,372
chr1,196400819,196401151,SRX5716470,SMARCA4,332
chr1,196400842,196401232,SRX5075170,SMARCA4,390
chr1,196400853,196401153,SRX5075176,SMARCA4,300
chr1,196400855,196401179,SRX5075175,SMARCA4,324
chr1,196400861,196401109,SRX5716467,SMARCA2,248
chr1,196400867,196401231,SRX5075169,SMARCA4,364
chr1,196400899,196401154,SRX5075174,SMARCA4,255
chr1,196400920,196401148,SRX5716468,SMARCA2,228
chr1,196400952,196401138,SRX5054308,FOSL2,186
chr1,196400963,196401153,SRX5075168,SMARCA4,190
chr1,196407675,196408155,SRX5075170,SMARCA4,480
chr1,196407712,196408046,SRX5716469,SMARCA4,334
chr1,196407749,196408108,SRX5075176,SMARCA4,359
chr1,196407771,196408152,SRX5716470,SMARCA4,381
chr1,196407778,196408174,SRX5075169,SMARCA4,396
chr1,196407848,196408140,SRX5075175,SMARCA4,292
chr1,196407851,196408117,SRX5716467,SMARCA2,266
chr1,196409704,196409888,SRX5054309,FOSL2,184
chr1,196464564,196464813,SRX5716467,SMARCA2,249
chr1,196464570,196464976,SRX5075176,SMARCA4,406
chr1,196464583,196464960,SRX5716469,SMARCA4,377
chr1,196464585,196464947,SRX5075170,SMARCA4,362
chr1,196464598,196465112,SRX5716470,SMARCA4,514
chr1,196464614,196464891,SRX5075169,SMARCA4,277
chr1,196464649,196464924,SRX5075175,SMARCA4,275
chr1,196481703,196481947,SRX5075169,SMARCA4,244
chr1,196481764,196481961,SRX5054309,FOSL2,197
chr1,196544696,196544913,SRX5075169,SMARCA4,217
chr1,196550784,196551224,SRX5075169,SMARCA4,440
chr1,196550834,196551140,SRX5075175,SMARCA4,306
chr1,196550899,196551270,SRX5716467,SMARCA2,371
chr1,196550941,196551243,SRX5075170,SMARCA4,302
chr1,196558439,196558733,SRX5075170,SMARCA4,294
chr1,196558440,196558735,SRX5075169,SMARCA4,295
chr1,196558459,196558736,SRX5075175,SMARCA4,277
chr1,196558476,196558814,SRX5075176,SMARCA4,338
chr1,196558490,196558732,SRX5075168,SMARCA4,242
chr1,196558490,196558803,SRX5054308,FOSL2,313
chr1,196558498,196558802,SRX5054309,FOSL2,304
chr1,196558521,196558778,SRX5075174,SMARCA4,257
chr1,196608091,196608334,SRX5075168,SMARCA4,243
chr1,196608166,196608370,SRX5716463,SMARCA4,204
chr1,196608179,196609105,SRX5075174,SMARCA4,926
chr1,196608384,196609014,SRX5075176,SMARCA4,630
chr1,196608442,196609204,SRX20140895,INTS13,762
chr1,196608451,196608954,SRX5075169,SMARCA4,503
chr1,196608472,196609177,SRX5075168,SMARCA4,705
chr1,196608491,196608752,SRX5716469,SMARCA4,261
chr1,196608497,196608895,SRX20140881,CPSF3L,398
chr1,196608524,196608981,SRX20140868,INTS10,457
chr1,196608525,196608964,SRX5075175,SMARCA4,439
chr1,196608526,196609010,SRX20140867,INTS10,484
chr1,196608540,196608870,SRX20140879,CPSF3L,330
chr1,196608556,196608956,SRX5716470,SMARCA4,400
chr1,196608563,196609032,SRX5075170,SMARCA4,469
chr1,196651587,196652162,SRX5075176,SMARCA4,575
chr1,196651614,196652143,SRX5075175,SMARCA4,529
chr1,196651632,196652108,SRX5716470,SMARCA4,476
chr1,196651676,196652145,SRX5075169,SMARCA4,469
chr1,196651718,196651984,SRX5020211,SMARCA2,266
chr1,196651720,196652064,SRX5054309,FOSL2,344
chr1,196651785,196652002,SRX5716467,SMARCA2,217
chr1,196651798,196652152,SRX5075170,SMARCA4,354
chr1,196651807,196652110,SRX5716469,SMARCA4,303
chr1,196660851,196661335,SRX16500060,CTCF,484
chr1,196660867,196661396,SRX16500061,CTCF,529
chr1,196660868,196661368,SRX16500062,CTCF,500
chr1,196660875,196661398,SRX16500059,CTCF,523
chr1,196660978,196661220,SRX5075168,SMARCA4,242
chr1,196678527,196678759,SRX5716467,SMARCA2,232
chr1,196678527,196678837,SRX5716469,SMARCA4,310
chr1,196678530,196678792,SRX5075169,SMARCA4,262
chr1,196678530,196678806,SRX5020211,SMARCA2,276
chr1,196678545,196678781,SRX5075170,SMARCA4,236
chr1,196678558,196678798,SRX5075175,SMARCA4,240
chr1,196678564,196678897,SRX5716470,SMARCA4,333
chr1,196678618,196678856,SRX5075176,SMARCA4,238
chr1,196680126,196680425,SRX5054309,FOSL2,299
chr1,196680162,196680363,SRX5054308,FOSL2,201
chr1,196723319,196723744,SRX16500059,CTCF,425
chr1,196723342,196723680,SRX16500060,CTCF,338
chr1,196723352,196723704,SRX16500062,CTCF,352
chr1,196723375,196723701,SRX16500061,CTCF,326
chr1,196723397,196723674,SRX4174629,CTCF,277
chr1,196743170,196743663,SRX16500059,CTCF,493
chr1,196743172,196743710,SRX16500060,CTCF,538
chr1,196743207,196743602,SRX16500061,CTCF,395
chr1,196743238,196743670,SRX16500062,CTCF,432
chr1,196743349,196743588,SRX5075174,SMARCA4,239
chr1,196743350,196743549,SRX5075176,SMARCA4,199
chr1,196743387,196743566,SRX5075168,SMARCA4,179
chr1,196743391,196743560,SRX5075170,SMARCA4,169
chr1,196827786,196828198,SRX16500061,CTCF,412
chr1,196827800,196828354,SRX16500060,CTCF,554
chr1,196827805,196828188,SRX16500059,CTCF,383
chr1,196827834,196828159,SRX16500062,CTCF,325
chr1,196827923,196828205,SRX5075169,SMARCA4,282
chr1,196827952,196828216,SRX5075174,SMARCA4,264
chr1,196827954,196828166,SRX5075176,SMARCA4,212
chr1,196827973,196828185,SRX5075168,SMARCA4,212
chr1,196902435,196902678,SRX16500061,CTCF,243
chr1,196910189,196910441,SRX16500060,CTCF,252
chr1,196910345,196910561,SRX16500062,CTCF,216
chr1,196991924,196992195,SRX5075168,SMARCA4,271
chr1,196991946,196992187,SRX5075174,SMARCA4,241
chr1,196997408,196997809,SRX5075169,SMARCA4,401
chr1,196997457,196997776,SRX5075176,SMARCA4,319
chr1,196997467,196997795,SRX5054309,FOSL2,328
chr1,196997473,196997811,SRX5054308,FOSL2,338
chr1,196997478,196997803,SRX5075170,SMARCA4,325
chr1,196997487,196997732,SRX5716470,SMARCA4,245
chr1,196997491,196997778,SRX5075175,SMARCA4,287
chr1,196997502,196997739,SRX5020214,SMARCA2,237
chr1,196997520,196997789,SRX5716469,SMARCA4,269
chr1,196997538,196997792,SRX5020211,SMARCA2,254
chr1,197035007,197035284,SRX5075169,SMARCA4,277
chr1,197146320,197146868,SRX20140895,INTS13,548
chr1,197146368,197146649,SRX20140867,INTS10,281
chr1,197146421,197146620,SRX5075168,SMARCA4,199
chr1,197146780,197147038,SRX5075174,SMARCA4,258
chr1,197180226,197180668,SRX16500059,CTCF,442
chr1,197180238,197180702,SRX16500060,CTCF,464
chr1,197180257,197180577,SRX5075175,SMARCA4,320
chr1,197180261,197180550,SRX5075169,SMARCA4,289
chr1,197180265,197180625,SRX16500061,CTCF,360
chr1,197180266,197180453,SRX5054309,FOSL2,187
chr1,197180291,197180608,SRX5075176,SMARCA4,317
chr1,197180308,197180553,SRX5716469,SMARCA4,245
chr1,197180321,197180637,SRX16500062,CTCF,316
chr1,197180374,197180633,SRX5075170,SMARCA4,259
chr1,197180381,197180586,SRX5075174,SMARCA4,205
chr1,197180383,197180650,SRX5075168,SMARCA4,267
chr1,197195197,197195377,SRX5054308,FOSL2,180
chr1,197195202,197195385,SRX5054309,FOSL2,183
chr1,197201018,197201878,SRX20140895,INTS13,860
chr1,197201118,197201727,SRX5075168,SMARCA4,609
chr1,197201193,197201713,SRX5716463,SMARCA4,520
chr1,197201197,197201796,SRX5075174,SMARCA4,599
chr1,197201211,197201742,SRX5075176,SMARCA4,531
chr1,197201214,197201425,SRX5716470,SMARCA4,211
chr1,197201279,197201730,SRX5075170,SMARCA4,451
chr1,197201337,197201611,SRX5716464,SMARCA4,274
chr1,197201368,197201573,SRX5716454,SOX3,205
chr1,197201407,197201740,SRX5075175,SMARCA4,333
chr1,197201428,197201732,SRX20140867,INTS10,304
chr1,197201470,197201709,SRX5075169,SMARCA4,239
chr1,197201498,197201711,SRX5716470,SMARCA4,213
chr1,197224248,197224523,SRX5075169,SMARCA4,275
chr1,197224268,197224540,SRX5075176,SMARCA4,272
chr1,197224272,197224542,SRX5075170,SMARCA4,270
chr1,197224308,197224532,SRX5716470,SMARCA4,224
chr1,197229695,197229868,SRX5075174,SMARCA4,173
chr1,197249382,197249682,SRX5075170,SMARCA4,300
chr1,197268032,197268356,SRX5075174,SMARCA4,324
chr1,197268113,197268372,SRX5075168,SMARCA4,259
chr1,197269058,197269425,SRX5075174,SMARCA4,367
chr1,197269076,197269399,SRX20140895,INTS13,323
chr1,197269136,197269394,SRX5075168,SMARCA4,258
chr1,197302785,197303029,SRX5075170,SMARCA4,244
chr1,197302795,197303113,SRX5054308,FOSL2,318
chr1,197302802,197303041,SRX5075169,SMARCA4,239
chr1,197302859,197303043,SRX5075176,SMARCA4,184
chr1,197302876,197303094,SRX5054309,FOSL2,218
chr1,197304721,197305073,SRX5075168,SMARCA4,352
chr1,197304722,197305057,SRX5075174,SMARCA4,335
chr1,197304723,197305057,SRX5716463,SMARCA4,334
chr1,197304748,197305013,SRX5716451,SOX2,265
chr1,197314764,197315071,SRX5075168,SMARCA4,307
chr1,197314765,197315115,SRX5075174,SMARCA4,350
chr1,197314815,197315163,SRX5075176,SMARCA4,348
chr1,197314828,197315134,SRX5075170,SMARCA4,306
chr1,197314859,197315085,SRX5716469,SMARCA4,226
chr1,197320937,197321642,SRX5075170,SMARCA4,705
chr1,197320952,197321551,SRX5075176,SMARCA4,599
chr1,197320994,197321343,SRX5716467,SMARCA2,349
chr1,197321002,197321693,SRX5075169,SMARCA4,691
chr1,197321026,197321591,SRX5716470,SMARCA4,565
chr1,197321074,197321693,SRX5716469,SMARCA4,619
chr1,197321212,197321679,SRX5075175,SMARCA4,467
chr1,197321289,197321500,SRX5716468,SMARCA2,211
chr1,197321318,197321508,SRX5054308,FOSL2,190
chr1,197321325,197321658,SRX5054309,FOSL2,333
chr1,197321835,197322138,SRX5054309,FOSL2,303
chr1,197321897,197322138,SRX5075169,SMARCA4,241
chr1,197321898,197322081,SRX5054308,FOSL2,183
chr1,197321965,197322153,SRX5075175,SMARCA4,188
chr1,197327653,197327868,SRX4174629,CTCF,215
chr1,197327717,197328225,SRX16500059,CTCF,508
chr1,197327730,197328243,SRX16500061,CTCF,513
chr1,197327746,197328190,SRX16500062,CTCF,444
chr1,197327766,197328280,SRX16500060,CTCF,514
chr1,197327808,197327988,SRX5075169,SMARCA4,180
chr1,197327845,197328109,SRX5075170,SMARCA4,264
chr1,197327893,197328137,SRX5075174,SMARCA4,244
chr1,197327899,197328098,SRX5075168,SMARCA4,199
chr1,197327929,197328104,SRX5075176,SMARCA4,175
chr1,197342157,197342561,SRX5075174,SMARCA4,404
chr1,197342190,197342530,SRX5075168,SMARCA4,340
chr1,197342231,197342530,SRX5716464,SMARCA4,299
chr1,197342247,197342454,SRX5716463,SMARCA4,207
chr1,197354816,197354857,SRX1424894,POU3F2,41
chr1,197356883,197357258,SRX4174629,CTCF,375
chr1,197356889,197357374,SRX16500062,CTCF,485
chr1,197356898,197357378,SRX16500060,CTCF,480
chr1,197356917,197357211,SRX5075174,SMARCA4,294
chr1,197356921,197357431,SRX16500059,CTCF,510
chr1,197356934,197357368,SRX16500061,CTCF,434
chr1,197356970,197357258,SRX5075168,SMARCA4,288
chr1,197400040,197400425,SRX16500059,CTCF,385
chr1,197400047,197400416,SRX16500060,CTCF,369
chr1,197400048,197400424,SRX16500062,CTCF,376
chr1,197400126,197400395,SRX16500061,CTCF,269
chr1,197400139,197400365,SRX5075174,SMARCA4,226
chr1,197400199,197400381,SRX5075168,SMARCA4,182
chr1,197423044,197423359,SRX5075176,SMARCA4,315
chr1,197423113,197423303,SRX5075170,SMARCA4,190
chr1,197435264,197435577,SRX5075168,SMARCA4,313
chr1,197435274,197435496,SRX5716464,SMARCA4,222
chr1,197435278,197435557,SRX5075174,SMARCA4,279
chr1,197438522,197438778,SRX5054308,FOSL2,256
chr1,197438558,197438745,SRX5054309,FOSL2,187
chr1,197451331,197451549,SRX5054308,FOSL2,218
chr1,197451352,197451545,SRX5054309,FOSL2,193
chr1,197464050,197464577,SRX5075170,SMARCA4,527
chr1,197464138,197464490,SRX5716470,SMARCA4,352
chr1,197464171,197464527,SRX5075176,SMARCA4,356
chr1,197464205,197464476,SRX5716469,SMARCA4,271
chr1,197464216,197464553,SRX5075175,SMARCA4,337
chr1,197464240,197464537,SRX5054308,FOSL2,297
chr1,197464263,197464469,SRX5075169,SMARCA4,206
chr1,197464267,197464517,SRX5054309,FOSL2,250
chr1,197464350,197464544,SRX5075181,SMARCA2,194
chr1,197471523,197471725,SRX5075170,SMARCA4,202
chr1,197481191,197481440,SRX5075176,SMARCA4,249
chr1,197487052,197487241,SRX5075176,SMARCA4,189
chr1,197487086,197487255,SRX5075170,SMARCA4,169
chr1,197519830,197520065,SRX16500059,CTCF,235
chr1,197521106,197521590,SRX16500060,CTCF,484
chr1,197521114,197521584,SRX16500059,CTCF,470
chr1,197521146,197521530,SRX16500061,CTCF,384
chr1,197521163,197521510,SRX16500062,CTCF,347
chr1,197521235,197521443,SRX5075170,SMARCA4,208
chr1,197521245,197521466,SRX5075174,SMARCA4,221
chr1,197521246,197521483,SRX5075168,SMARCA4,237
chr1,197521262,197521441,SRX5075176,SMARCA4,179
chr1,197526608,197527228,SRX16500060,CTCF,620
chr1,197526706,197527252,SRX16500061,CTCF,546
chr1,197526725,197527241,SRX16500059,CTCF,516
chr1,197526753,197527262,SRX16500062,CTCF,509
chr1,197557380,197557555,SRX5075176,SMARCA4,175
chr1,197557434,197557659,SRX5075169,SMARCA4,225
chr1,197615119,197615542,SRX16500061,CTCF,423
chr1,197615138,197615594,SRX16500059,CTCF,456
chr1,197615160,197615567,SRX16500060,CTCF,407
chr1,197615164,197615572,SRX16500062,CTCF,408
chr1,197615217,197615475,SRX4174629,CTCF,258
chr1,197618052,197618355,SRX5075176,SMARCA4,303
chr1,197619147,197619366,SRX16500061,CTCF,219
chr1,197675959,197676256,SRX5075174,SMARCA4,297
chr1,197683878,197684089,SRX5716470,SMARCA4,211
chr1,197696534,197696770,SRX5054308,FOSL2,236
chr1,197707862,197708234,SRX9989505,GFP,372
chr1,197733331,197733790,SRX5075168,SMARCA4,459
chr1,197733346,197733821,SRX5075174,SMARCA4,475
chr1,197733354,197733785,SRX20140895,INTS13,431
chr1,197733391,197733727,SRX5716463,SMARCA4,336
chr1,197733434,197733734,SRX20140868,INTS10,300
chr1,197733435,197733648,SRX5716451,SOX2,213
chr1,197774758,197775541,SRX20140895,INTS13,783
chr1,197774759,197774959,SRX5075176,SMARCA4,200
chr1,197774766,197775157,SRX5075170,SMARCA4,391
chr1,197774774,197775337,SRX5075168,SMARCA4,563
chr1,197774807,197775211,SRX20140868,INTS10,404
chr1,197774818,197775113,SRX5075169,SMARCA4,295
chr1,197774860,197775107,SRX5716470,SMARCA4,247
chr1,197774954,197775593,SRX5075174,SMARCA4,639
chr1,197775120,197775344,SRX5075176,SMARCA4,224
chr1,197775370,197775633,SRX16500061,CTCF,263
chr1,197776496,197776745,SRX5054309,FOSL2,249
chr1,197776509,197776689,SRX5054308,FOSL2,180
chr1,197783498,197783792,SRX5075176,SMARCA4,294
chr1,197783548,197783930,SRX5075170,SMARCA4,382
chr1,197783553,197783898,SRX5716467,SMARCA2,345
chr1,197783563,197784037,SRX5054308,FOSL2,474
chr1,197783569,197784001,SRX5075169,SMARCA4,432
chr1,197783699,197783988,SRX5716470,SMARCA4,289
chr1,197799307,197799516,SRX5054308,FOSL2,209
chr1,197799313,197799534,SRX5075175,SMARCA4,221
chr1,197838863,197839177,SRX5054309,FOSL2,314
chr1,197838932,197839128,SRX5054308,FOSL2,196
chr1,197838958,197839127,SRX5075170,SMARCA4,169
chr1,197868937,197869197,SRX16500059,CTCF,260
chr1,197868985,197869262,SRX16500060,CTCF,277
chr1,197869003,197869248,SRX16500062,CTCF,245
chr1,197869012,197869234,SRX16500061,CTCF,222
chr1,197902361,197902849,SRX5075176,SMARCA4,488
chr1,197902365,197903209,SRX5075170,SMARCA4,844
chr1,197902367,197903039,SRX20140895,INTS13,672
chr1,197902389,197903124,SRX5716470,SMARCA4,735
chr1,197902391,197902645,SRX5075169,SMARCA4,254
chr1,197902397,197903141,SRX5075175,SMARCA4,744
chr1,197902399,197903181,SRX5075174,SMARCA4,782
chr1,197902420,197903066,SRX20140868,INTS10,646
chr1,197902493,197902879,SRX20140867,INTS10,386
chr1,197902504,197902903,SRX20140897,INTS13,399
chr1,197902533,197903213,SRX5075168,SMARCA4,680
chr1,197902579,197902877,SRX20140879,CPSF3L,298
chr1,197902602,197902908,SRX20140869,INTS10,306
chr1,197902752,197903108,SRX5716463,SMARCA4,356
chr1,197902927,197903191,SRX5075169,SMARCA4,264
chr1,197903004,197903191,SRX5075176,SMARCA4,187
chr1,197915680,197916064,SRX16500061,CTCF,384
chr1,197915732,197916159,SRX16500059,CTCF,427
chr1,197915758,197916111,SRX16500062,CTCF,353
chr1,197915770,197916167,SRX16500060,CTCF,397
chr1,197915870,197916049,SRX5075174,SMARCA4,179
chr1,197924397,197924887,SRX16500060,CTCF,490
chr1,197924404,197924946,SRX16500059,CTCF,542
chr1,197924423,197924881,SRX16500061,CTCF,458
chr1,197924489,197924878,SRX16500062,CTCF,389
chr1,197924587,197924783,SRX5075176,SMARCA4,196
chr1,197924596,197924858,SRX4174629,CTCF,262
chr1,197955458,197955712,SRX5716468,SMARCA2,254
chr1,197955494,197955724,SRX5716470,SMARCA4,230
chr1,197955526,197955778,SRX5716469,SMARCA4,252
chr1,197955537,197955752,SRX5716467,SMARCA2,215
chr1,197955551,197955789,SRX5075176,SMARCA4,238
chr1,197955592,197955796,SRX5075169,SMARCA4,204
chr1,197955620,197955908,SRX5075175,SMARCA4,288
chr1,197955647,197955816,SRX5075170,SMARCA4,169
chr1,197973191,197973397,SRX5075170,SMARCA4,206
chr1,197973241,197973471,SRX5075176,SMARCA4,230
chr1,197984342,197984631,SRX5054309,FOSL2,289
chr1,197984342,197984682,SRX5716470,SMARCA4,340
chr1,197984352,197984664,SRX5075169,SMARCA4,312
chr1,197984354,197984592,SRX5054308,FOSL2,238
chr1,197984354,197984645,SRX5075176,SMARCA4,291
chr1,197984370,197984597,SRX5075170,SMARCA4,227
chr1,197984378,197984574,SRX5075175,SMARCA4,196
chr1,197984393,197984669,SRX5716467,SMARCA2,276
chr1,198018486,198018778,SRX5075175,SMARCA4,292
chr1,198018601,198018904,SRX5054309,FOSL2,303
chr1,198018624,198018863,SRX5075169,SMARCA4,239
chr1,198018631,198018921,SRX5075176,SMARCA4,290
chr1,198018663,198018866,SRX5075170,SMARCA4,203
chr1,198024784,198025073,SRX5075169,SMARCA4,289
chr1,198024809,198025133,SRX5075176,SMARCA4,324
chr1,198024830,198025104,SRX5075170,SMARCA4,274
chr1,198024850,198025033,SRX5054309,FOSL2,183
chr1,198024857,198025079,SRX5054308,FOSL2,222
chr1,198024865,198025145,SRX5075175,SMARCA4,280
chr1,198030756,198031134,SRX5075170,SMARCA4,378
chr1,198030831,198031048,SRX5716467,SMARCA2,217
chr1,198030837,198031093,SRX5075176,SMARCA4,256
chr1,198030842,198031028,SRX5075169,SMARCA4,186
chr1,198088332,198088712,SRX16500060,CTCF,380
chr1,198088333,198088689,SRX16500062,CTCF,356
chr1,198088419,198088707,SRX16500059,CTCF,288
chr1,198088842,198089189,SRX5075169,SMARCA4,347
chr1,198096298,198096684,SRX5075176,SMARCA4,386
chr1,198096358,198096698,SRX5075170,SMARCA4,340
chr1,198096453,198096732,SRX5075169,SMARCA4,279
chr1,198096555,198096795,SRX5054309,FOSL2,240
chr1,198102202,198102579,SRX5075175,SMARCA4,377
chr1,198102247,198102753,SRX5075169,SMARCA4,506
chr1,198102267,198102593,SRX5075176,SMARCA4,326
chr1,198102295,198102754,SRX5075170,SMARCA4,459
chr1,198102322,198102654,SRX5054309,FOSL2,332
chr1,198102325,198102671,SRX5020211,SMARCA2,346
chr1,198102337,198102582,SRX5054308,FOSL2,245
chr1,198102339,198102555,SRX5716469,SMARCA4,216
chr1,198102392,198102691,SRX5716470,SMARCA4,299
chr1,198113284,198113578,SRX5716470,SMARCA4,294
chr1,198113315,198113599,SRX5075170,SMARCA4,284
chr1,198113315,198113615,SRX5716467,SMARCA2,300
chr1,198113317,198113677,SRX5075169,SMARCA4,360
chr1,198113326,198113585,SRX5075176,SMARCA4,259
chr1,198113333,198113536,SRX5020211,SMARCA2,203
chr1,198113346,198113535,SRX5075175,SMARCA4,189
chr1,198113352,198113587,SRX5716468,SMARCA2,235
chr1,198118069,198118380,SRX5716470,SMARCA4,311
chr1,198118110,198118448,SRX5075175,SMARCA4,338
chr1,198118123,198118446,SRX5075169,SMARCA4,323
chr1,198118128,198118445,SRX5075170,SMARCA4,317
chr1,198118135,198118456,SRX5075176,SMARCA4,321
chr1,198118148,198118414,SRX5716467,SMARCA2,266
chr1,198118149,198118488,SRX5716469,SMARCA4,339
chr1,198121089,198121432,SRX5054309,FOSL2,343
chr1,198121090,198121361,SRX5075175,SMARCA4,271
chr1,198121112,198121354,SRX5054308,FOSL2,242
chr1,198121136,198121353,SRX5075169,SMARCA4,217
chr1,198123226,198123466,SRX5075169,SMARCA4,240
chr1,198123233,198123459,SRX5075176,SMARCA4,226
chr1,198123306,198123494,SRX5054309,FOSL2,188
chr1,198126036,198126264,SRX5075176,SMARCA4,228
chr1,198126082,198126294,SRX5716469,SMARCA4,212
chr1,198126115,198126381,SRX5075169,SMARCA4,266
chr1,198155235,198155485,SRX5075169,SMARCA4,250
chr1,198155267,198155611,SRX5054309,FOSL2,344
chr1,198155270,198155503,SRX5075176,SMARCA4,233
chr1,198155282,198155499,SRX5075175,SMARCA4,217
chr1,198155315,198155509,SRX5075170,SMARCA4,194
chr1,198155332,198155545,SRX5054308,FOSL2,213
chr1,198156031,198156518,SRX16500062,CTCF,487
chr1,198156034,198156525,SRX16500059,CTCF,491
chr1,198156048,198156572,SRX16500060,CTCF,524
chr1,198156102,198156525,SRX16500061,CTCF,423
chr1,198156164,198156352,SRX5075174,SMARCA4,188
chr1,198156712,198157334,SRX20140895,INTS13,622
chr1,198159040,198159462,SRX20140895,INTS13,422
chr1,198159143,198159370,SRX5075174,SMARCA4,227
chr1,198159185,198159457,SRX20140868,INTS10,272
chr1,198220364,198220830,SRX5075175,SMARCA4,466
chr1,198220402,198220658,SRX5716470,SMARCA4,256
chr1,198220422,198220799,SRX5075176,SMARCA4,377
chr1,198220449,198220833,SRX5054309,FOSL2,384
chr1,198220456,198220861,SRX5075170,SMARCA4,405
chr1,198220460,198220802,SRX5054308,FOSL2,342
chr1,198220473,198220836,SRX5075169,SMARCA4,363
chr1,198220531,198220827,SRX5020214,SMARCA2,296
chr1,198220538,198220738,SRX5020211,SMARCA2,200
chr1,198232473,198232660,SRX5075175,SMARCA4,187
chr1,198234457,198234831,SRX5075176,SMARCA4,374
chr1,198234462,198234964,SRX5075170,SMARCA4,502
chr1,198234481,198234769,SRX5054308,FOSL2,288
chr1,198234486,198234901,SRX5075169,SMARCA4,415
chr1,198234511,198234801,SRX5054309,FOSL2,290
chr1,198234541,198234800,SRX5716469,SMARCA4,259
chr1,198234541,198234823,SRX5075175,SMARCA4,282
chr1,198234578,198234836,SRX5716470,SMARCA4,258
chr1,198258496,198258815,SRX5054309,FOSL2,319
chr1,198258557,198258804,SRX5075176,SMARCA4,247
chr1,198258563,198258904,SRX5075169,SMARCA4,341
chr1,198258585,198258786,SRX5054308,FOSL2,201
chr1,198258594,198258788,SRX5075175,SMARCA4,194
chr1,198267869,198268331,SRX5075169,SMARCA4,462
chr1,198267871,198268266,SRX5075170,SMARCA4,395
chr1,198267886,198268336,SRX5075175,SMARCA4,450
chr1,198267891,198268268,SRX5716469,SMARCA4,377
chr1,198267899,198268242,SRX5054308,FOSL2,343
chr1,198267900,198268194,SRX5716467,SMARCA2,294
chr1,198267913,198268245,SRX5075176,SMARCA4,332
chr1,198267927,198268269,SRX5054309,FOSL2,342
chr1,198267929,198268371,SRX5716470,SMARCA4,442
chr1,198267950,198268257,SRX5716468,SMARCA2,307
chr1,198267956,198268195,SRX5020211,SMARCA2,239
chr1,198267962,198268242,SRX5020214,SMARCA2,280
chr1,198267979,198268177,SRX5075182,SMARCA2,198
chr1,198273946,198274147,SRX5075170,SMARCA4,201
chr1,198288860,198289265,SRX5716469,SMARCA4,405
chr1,198288925,198289276,SRX5075175,SMARCA4,351
chr1,198288928,198289246,SRX5054308,FOSL2,318
chr1,198288936,198289266,SRX5075176,SMARCA4,330
chr1,198288938,198289274,SRX5075169,SMARCA4,336
chr1,198288942,198289271,SRX5075170,SMARCA4,329
chr1,198288965,198289276,SRX5054309,FOSL2,311
chr1,198288992,198289233,SRX5716467,SMARCA2,241
chr1,198289017,198289235,SRX5716470,SMARCA4,218
chr1,198295135,198295579,SRX5075174,SMARCA4,444
chr1,198295176,198295570,SRX5075168,SMARCA4,394
chr1,198295191,198295553,SRX5716463,SMARCA4,362
chr1,198295215,198295518,SRX5716464,SMARCA4,303
chr1,198296013,198296261,SRX5075168,SMARCA4,248
chr1,198296079,198296338,SRX5075174,SMARCA4,259
chr1,198296436,198296619,SRX5054308,FOSL2,183
chr1,198298676,198298971,SRX5075168,SMARCA4,295
chr1,198298736,198299001,SRX5075174,SMARCA4,265
chr1,198316745,198316975,SRX5075168,SMARCA4,230
chr1,198333902,198334097,SRX5054309,FOSL2,195
chr1,198359065,198359369,SRX16500061,CTCF,304
chr1,198359110,198359390,SRX16500062,CTCF,280
chr1,198359170,198359406,SRX16500060,CTCF,236
chr1,198387606,198387867,SRX5075174,SMARCA4,261
chr1,198387624,198387903,SRX5716464,SMARCA4,279
chr1,198387690,198388067,SRX5075168,SMARCA4,377
chr1,198387744,198387948,SRX5054309,FOSL2,204
chr1,198423773,198423998,SRX20140867,INTS10,225
chr1,198435100,198435469,SRX5075176,SMARCA4,369
chr1,198435247,198435584,SRX5075170,SMARCA4,337
chr1,198436330,198436538,SRX5075170,SMARCA4,208
chr1,198436356,198436576,SRX5716470,SMARCA4,220
chr1,198443330,198443712,SRX5075175,SMARCA4,382
chr1,198443339,198443766,SRX5075170,SMARCA4,427
chr1,198443342,198443802,SRX5075176,SMARCA4,460
chr1,198443376,198443636,SRX5716460,Epitope tags,260
chr1,198443387,198443679,SRX5075174,SMARCA4,292
chr1,198443387,198443725,SRX5054309,FOSL2,338
chr1,198443392,198443742,SRX5075169,SMARCA4,350
chr1,198443442,198443731,SRX5075168,SMARCA4,289
chr1,198443450,198443734,SRX5054308,FOSL2,284
chr1,198443501,198443795,SRX5716469,SMARCA4,294
chr1,198462421,198462649,SRX5075169,SMARCA4,228
chr1,198465501,198465976,SRX16500059,CTCF,475
chr1,198465536,198465977,SRX16500062,CTCF,441
chr1,198465538,198465961,SRX16500060,CTCF,423
chr1,198465548,198465998,SRX16500061,CTCF,450
chr1,198465589,198465800,SRX5075174,SMARCA4,211
chr1,198465627,198465796,SRX5075170,SMARCA4,169
chr1,198492920,198493222,SRX5054309,FOSL2,302
chr1,198492940,198493236,SRX5075175,SMARCA4,296
chr1,198492942,198493189,SRX5075169,SMARCA4,247
chr1,198492967,198493206,SRX5075176,SMARCA4,239
chr1,198496416,198496804,SRX5075175,SMARCA4,388
chr1,198496477,198496764,SRX5054308,FOSL2,287
chr1,198496568,198496763,SRX5054309,FOSL2,195
chr1,198496582,198496751,SRX5075170,SMARCA4,169
chr1,198497553,198497821,SRX5075176,SMARCA4,268
chr1,198497603,198497772,SRX5075170,SMARCA4,169
chr1,198497620,198497847,SRX5054308,FOSL2,227
chr1,198497663,198497846,SRX5054309,FOSL2,183
chr1,198528448,198528644,SRX5075169,SMARCA4,196
chr1,198528468,198528684,SRX5054309,FOSL2,216
chr1,198528485,198528715,SRX5054308,FOSL2,230
chr1,198529423,198529774,SRX5075176,SMARCA4,351
chr1,198529460,198529784,SRX5075170,SMARCA4,324
chr1,198529486,198529769,SRX5075175,SMARCA4,283
chr1,198529496,198529701,SRX5075169,SMARCA4,205
chr1,198529523,198529767,SRX5716469,SMARCA4,244
chr1,198561336,198561625,SRX5716470,SMARCA4,289
chr1,198561372,198561664,SRX5075170,SMARCA4,292
chr1,198561419,198561680,SRX5075169,SMARCA4,261
chr1,198561438,198561666,SRX5075176,SMARCA4,228
chr1,198563645,198563827,SRX5054308,FOSL2,182
chr1,198577541,198577832,SRX5075169,SMARCA4,291
chr1,198577544,198577823,SRX5075175,SMARCA4,279
chr1,198577582,198577794,SRX5054309,FOSL2,212
chr1,198577677,198577906,SRX5054308,FOSL2,229
chr1,198606050,198606311,SRX20140881,CPSF3L,261
chr1,198606075,198606361,SRX5075170,SMARCA4,286
chr1,198606093,198606478,SRX5075174,SMARCA4,385
chr1,198606115,198606327,SRX5716463,SMARCA4,212
chr1,198606182,198606479,SRX5075176,SMARCA4,297
chr1,198606262,198606620,SRX5075168,SMARCA4,358
chr1,198623907,198624217,SRX5054309,FOSL2,310
chr1,198623937,198624179,SRX5054308,FOSL2,242
chr1,198641602,198641917,SRX5075170,SMARCA4,315
chr1,198641622,198641989,SRX5075169,SMARCA4,367
chr1,198641682,198641964,SRX5075175,SMARCA4,282
chr1,198641684,198641877,SRX5075176,SMARCA4,193
chr1,198641687,198641904,SRX5054308,FOSL2,217
chr1,198641699,198641977,SRX5054309,FOSL2,278
chr1,198657510,198658107,SRX5075176,SMARCA4,597
chr1,198657531,198658004,SRX5716467,SMARCA2,473
chr1,198657534,198658050,SRX5075170,SMARCA4,516
chr1,198657551,198657994,SRX5075175,SMARCA4,443
chr1,198657554,198658041,SRX5075169,SMARCA4,487
chr1,198657574,198657996,SRX5716470,SMARCA4,422
chr1,198657608,198658074,SRX5716469,SMARCA4,466
chr1,198657635,198657942,SRX5054308,FOSL2,307
chr1,198657649,198658002,SRX5054309,FOSL2,353
chr1,198657723,198657966,SRX5716468,SMARCA2,243
chr1,198657725,198657919,SRX5075181,SMARCA2,194
chr1,198669002,198669463,SRX5075169,SMARCA4,461
chr1,198669033,198669392,SRX5716470,SMARCA4,359
chr1,198669041,198669450,SRX5075176,SMARCA4,409
chr1,198669045,198669425,SRX5054309,FOSL2,380
chr1,198669055,198669430,SRX5075170,SMARCA4,375
chr1,198669056,198669450,SRX5716469,SMARCA4,394
chr1,198669090,198669362,SRX5075174,SMARCA4,272
chr1,198669102,198669392,SRX5054308,FOSL2,290
chr1,198669102,198669443,SRX5075175,SMARCA4,341
chr1,198669111,198669366,SRX5716467,SMARCA2,255
chr1,198681794,198682098,SRX5716470,SMARCA4,304
chr1,198681803,198682453,SRX5075168,SMARCA4,650
chr1,198681810,198682432,SRX5075174,SMARCA4,622
chr1,198681823,198682268,SRX5075169,SMARCA4,445
chr1,198681837,198682332,SRX5075176,SMARCA4,495
chr1,198681847,198682240,SRX5075175,SMARCA4,393
chr1,198681854,198682282,SRX5075170,SMARCA4,428
chr1,198681872,198682226,SRX5716467,SMARCA2,354
chr1,198681882,198682088,SRX5716463,SMARCA4,206
chr1,198681898,198682219,SRX5716469,SMARCA4,321
chr1,198681937,198682283,SRX20140895,INTS13,346
chr1,198681942,198682122,SRX5054308,FOSL2,180
chr1,198686132,198686535,SRX16500061,CTCF,403
chr1,198686139,198686574,SRX16500059,CTCF,435
chr1,198686150,198686518,SRX16500060,CTCF,368
chr1,198686175,198686539,SRX16500062,CTCF,364
chr1,198699360,198699890,SRX16500059,CTCF,530
chr1,198699375,198699830,SRX16500061,CTCF,455
chr1,198699386,198699853,SRX16500062,CTCF,467
chr1,198699397,198699987,SRX16500060,CTCF,590
chr1,198699480,198699691,SRX5075168,SMARCA4,211
chr1,198699489,198699771,SRX4174629,CTCF,282
chr1,198699504,198699684,SRX5075169,SMARCA4,180
chr1,198699505,198699794,SRX5075174,SMARCA4,289
chr1,198699506,198699718,SRX5075170,SMARCA4,212
chr1,198701360,198701580,SRX5075168,SMARCA4,220
chr1,198726545,198726735,SRX5075169,SMARCA4,190
chr1,198741696,198741995,SRX5075176,SMARCA4,299
chr1,198741736,198742086,SRX5075169,SMARCA4,350
chr1,198741737,198742037,SRX5075175,SMARCA4,300
chr1,198741797,198742032,SRX5054308,FOSL2,235
chr1,198741806,198742034,SRX5075170,SMARCA4,228
chr1,198741858,198742048,SRX5054309,FOSL2,190
chr1,198756431,198756862,SRX16500059,CTCF,431
chr1,198756507,198756825,SRX16500060,CTCF,318
chr1,198756520,198756809,SRX16500061,CTCF,289
chr1,198756552,198756865,SRX16500062,CTCF,313
chr1,198763254,198763700,SRX5075170,SMARCA4,446
chr1,198763266,198763721,SRX5075176,SMARCA4,455
chr1,198763283,198763662,SRX5075169,SMARCA4,379
chr1,198763283,198763716,SRX5075175,SMARCA4,433
chr1,198763287,198763551,SRX5716469,SMARCA4,264
chr1,198763379,198763653,SRX5716470,SMARCA4,274
chr1,198771495,198771983,SRX16500060,CTCF,488
chr1,198771541,198771981,SRX16500061,CTCF,440
chr1,198771551,198771957,SRX16500059,CTCF,406
chr1,198771560,198772005,SRX16500062,CTCF,445
chr1,198776585,198776984,SRX5054309,FOSL2,399
chr1,198776612,198776822,SRX5020214,SMARCA2,210
chr1,198776614,198776910,SRX5054308,FOSL2,296
chr1,198776642,198776901,SRX5075175,SMARCA4,259
chr1,198776687,198776933,SRX5075169,SMARCA4,246
chr1,198788285,198789079,SRX5075168,SMARCA4,794
chr1,198788353,198789085,SRX5075174,SMARCA4,732
chr1,198788424,198788643,SRX5716470,SMARCA4,219
chr1,198788523,198789039,SRX5716463,SMARCA4,516
chr1,198788536,198789078,SRX5716464,SMARCA4,542
chr1,198788601,198788940,SRX5716454,SOX3,339
chr1,198788609,198788891,SRX20140895,INTS13,282
chr1,198788637,198788845,SRX5716451,SOX2,208
chr1,198788697,198789227,SRX16500060,CTCF,530
chr1,198788718,198789223,SRX16500059,CTCF,505
chr1,198788766,198789219,SRX16500061,CTCF,453
chr1,198788787,198789036,SRX4174629,CTCF,249
chr1,198788790,198789330,SRX16500062,CTCF,540
chr1,198794536,198794974,SRX5054309,FOSL2,438
chr1,198794566,198795098,SRX5716469,SMARCA4,532
chr1,198794567,198794914,SRX5054308,FOSL2,347
chr1,198794583,198795062,SRX5075181,SMARCA2,479
chr1,198794589,198795002,SRX5075169,SMARCA4,413
chr1,198794592,198795067,SRX5075176,SMARCA4,475
chr1,198794594,198795091,SRX5075175,SMARCA4,497
chr1,198794596,198795029,SRX5716470,SMARCA4,433
chr1,198794620,198795065,SRX5075170,SMARCA4,445
chr1,198794695,198794965,SRX5716467,SMARCA2,270
chr1,198794735,198795055,SRX5716468,SMARCA2,320
chr1,198794798,198795176,SRX5020211,SMARCA2,378
chr1,198813814,198814075,SRX20140881,CPSF3L,261
chr1,198848826,198849037,SRX5716470,SMARCA4,211
chr1,198849149,198849402,SRX5075170,SMARCA4,253
chr1,198849236,198849425,SRX5075176,SMARCA4,189
chr1,198876318,198876954,SRX5075174,SMARCA4,636
chr1,198876359,198876908,SRX5075168,SMARCA4,549
chr1,198876396,198876930,SRX5716463,SMARCA4,534
chr1,198876623,198876934,SRX5716464,SMARCA4,311
chr1,198881176,198881599,SRX5075176,SMARCA4,423
chr1,198881194,198881602,SRX5075169,SMARCA4,408
chr1,198881196,198881643,SRX5716469,SMARCA4,447
chr1,198881206,198881601,SRX5075170,SMARCA4,395
chr1,198881218,198881589,SRX5054309,FOSL2,371
chr1,198881236,198881485,SRX5020211,SMARCA2,249
chr1,198881236,198881601,SRX5075175,SMARCA4,365
chr1,198881238,198881604,SRX5054308,FOSL2,366
chr1,198881239,198881560,SRX5716467,SMARCA2,321
chr1,198881251,198881545,SRX5020214,SMARCA2,294
chr1,198881284,198881558,SRX5075174,SMARCA4,274
chr1,198881305,198881540,SRX5075168,SMARCA4,235
chr1,198881305,198881541,SRX5716470,SMARCA4,236
chr1,198881352,198881531,SRX5075182,SMARCA2,179
chr1,198892055,198892397,SRX5075170,SMARCA4,342
chr1,198892071,198892300,SRX5020211,SMARCA2,229
chr1,198892088,198892441,SRX5075176,SMARCA4,353
chr1,198892104,198892309,SRX5054308,FOSL2,205
chr1,198892114,198892421,SRX5075169,SMARCA4,307
chr1,198892124,198892336,SRX5075175,SMARCA4,212
chr1,198892139,198892394,SRX5075174,SMARCA4,255
chr1,198901254,198901498,SRX5075176,SMARCA4,244
chr1,198903190,198903672,SRX5075174,SMARCA4,482
chr1,198903198,198903657,SRX5075168,SMARCA4,459
chr1,198903257,198903629,SRX5716464,SMARCA4,372
chr1,198903264,198903545,SRX20140895,INTS13,281
chr1,198903270,198903597,SRX5716463,SMARCA4,327
chr1,198909961,198910199,SRX5075174,SMARCA4,238
chr1,198909997,198910191,SRX5075168,SMARCA4,194
chr1,198910024,198910295,SRX5075175,SMARCA4,271
chr1,198910039,198910250,SRX5075170,SMARCA4,211
chr1,198910046,198910322,SRX5075176,SMARCA4,276
chr1,198910055,198910319,SRX5054309,FOSL2,264
chr1,198910078,198910315,SRX5075169,SMARCA4,237
chr1,198910093,198910372,SRX5054308,FOSL2,279
chr1,198932312,198932699,SRX20140895,INTS13,387
chr1,198932358,198932618,SRX5075174,SMARCA4,260
chr1,198935498,198935762,SRX5075168,SMARCA4,264
chr1,198935519,198935927,SRX5075176,SMARCA4,408
chr1,198935547,198935852,SRX5075169,SMARCA4,305
chr1,198935572,198935883,SRX5075175,SMARCA4,311
chr1,198935581,198935794,SRX5054309,FOSL2,213
chr1,198935592,198935796,SRX5075174,SMARCA4,204
chr1,198935605,198935882,SRX5075170,SMARCA4,277
chr1,198937225,198937696,SRX20140895,INTS13,471
chr1,198937256,198937595,SRX20140897,INTS13,339
chr1,198937373,198937660,SRX5075168,SMARCA4,287
chr1,198937397,198937731,SRX5075174,SMARCA4,334
chr1,198937421,198937701,SRX5075170,SMARCA4,280
chr1,198995378,198995666,SRX5075176,SMARCA4,288
chr1,198995422,198995660,SRX5075170,SMARCA4,238
chr1,199002508,199003055,SRX5075170,SMARCA4,547
chr1,199002522,199003014,SRX5716469,SMARCA4,492
chr1,199002570,199003110,SRX5075169,SMARCA4,540
chr1,199002588,199003010,SRX5075176,SMARCA4,422
chr1,199002607,199003050,SRX5716470,SMARCA4,443
chr1,199002608,199003001,SRX5716467,SMARCA2,393
chr1,199002648,199003028,SRX5075175,SMARCA4,380
chr1,199002682,199003100,SRX5716468,SMARCA2,418
chr1,199002764,199003012,SRX5020211,SMARCA2,248
chr1,199011141,199011324,SRX5054309,FOSL2,183
chr1,199044288,199044457,SRX5075170,SMARCA4,169
chr1,199113280,199113604,SRX16500060,CTCF,324
chr1,199113292,199113587,SRX16500059,CTCF,295
chr1,199113295,199113525,SRX5075174,SMARCA4,230
chr1,199113325,199113572,SRX16500061,CTCF,247
chr1,199113347,199113596,SRX16500062,CTCF,249
chr1,199151780,199151963,SRX5075174,SMARCA4,183
chr1,199173323,199173507,SRX5075170,SMARCA4,184
chr1,199226135,199226526,SRX5075175,SMARCA4,391
chr1,199226146,199226559,SRX5075170,SMARCA4,413
chr1,199226150,199226630,SRX5075176,SMARCA4,480
chr1,199226202,199226556,SRX5054309,FOSL2,354
chr1,199226220,199226505,SRX5716469,SMARCA4,285
chr1,199226232,199226597,SRX5075169,SMARCA4,365
chr1,199226331,199226556,SRX5054308,FOSL2,225
chr1,199243429,199243813,SRX16500060,CTCF,384
chr1,199243429,199243841,SRX16500059,CTCF,412
chr1,199243467,199243800,SRX16500062,CTCF,333
chr1,199243472,199243795,SRX16500061,CTCF,323
chr1,199243535,199243745,SRX4174629,CTCF,210
chr1,199272050,199272362,SRX5075169,SMARCA4,312
chr1,199272102,199272296,SRX5075170,SMARCA4,194
chr1,199272528,199273111,SRX5075169,SMARCA4,583
chr1,199272554,199273155,SRX5054309,FOSL2,601
chr1,199272573,199273155,SRX5075176,SMARCA4,582
chr1,199272588,199273081,SRX5075175,SMARCA4,493
chr1,199272599,199273111,SRX5075170,SMARCA4,512
chr1,199272609,199273113,SRX5054308,FOSL2,504
chr1,199272629,199273084,SRX5716470,SMARCA4,455
chr1,199272652,199273074,SRX5716467,SMARCA2,422
chr1,199272662,199273034,SRX5716469,SMARCA4,372
chr1,199272667,199272942,SRX5075168,SMARCA4,275
chr1,199272676,199273035,SRX5716468,SMARCA2,359
chr1,199272677,199273077,SRX5020211,SMARCA2,400
chr1,199272700,199273036,SRX5075181,SMARCA2,336
chr1,199272709,199272981,SRX5075174,SMARCA4,272
chr1,199272731,199273060,SRX5020214,SMARCA2,329
chr1,199272746,199272993,SRX5075182,SMARCA2,247
chr1,199283717,199284006,SRX5075176,SMARCA4,289
chr1,199283794,199284026,SRX5716470,SMARCA4,232
chr1,199283795,199284021,SRX5075170,SMARCA4,226
chr1,199283807,199284154,SRX5075169,SMARCA4,347
chr1,199302566,199302755,SRX5075169,SMARCA4,189
chr1,199302570,199302868,SRX5075175,SMARCA4,298
chr1,199302620,199302806,SRX5054309,FOSL2,186
chr1,199302670,199302842,SRX5075170,SMARCA4,172
chr1,199311580,199311764,SRX5075174,SMARCA4,184
chr1,199336276,199336487,SRX5716470,SMARCA4,211
chr1,199351908,199352225,SRX5075170,SMARCA4,317
chr1,199351958,199352213,SRX5716469,SMARCA4,255
chr1,199351976,199352248,SRX5075176,SMARCA4,272
chr1,199358318,199358552,SRX5075176,SMARCA4,234
chr1,199403583,199403870,SRX5716470,SMARCA4,287
chr1,199403663,199404121,SRX5716469,SMARCA4,458
chr1,199403689,199404022,SRX5075169,SMARCA4,333
chr1,199403818,199404098,SRX5054309,FOSL2,280
chr1,199403827,199404121,SRX5054308,FOSL2,294
chr1,199403830,199404115,SRX5020211,SMARCA2,285
chr1,199403834,199404069,SRX5075175,SMARCA4,235
chr1,199403913,199404105,SRX5075176,SMARCA4,192
chr1,199411460,199411892,SRX5075168,SMARCA4,432
chr1,199411477,199411816,SRX5716463,SMARCA4,339
chr1,199411501,199411874,SRX5075174,SMARCA4,373
chr1,199411506,199411786,SRX5716464,SMARCA4,280
chr1,199434231,199434851,SRX5075168,SMARCA4,620
chr1,199434318,199434820,SRX5075174,SMARCA4,502
chr1,199449211,199449455,SRX5075175,SMARCA4,244
chr1,199449267,199449469,SRX5054309,FOSL2,202
chr1,199463589,199463850,SRX16500060,CTCF,261
chr1,199490773,199491278,SRX5716470,SMARCA4,505
chr1,199490797,199491183,SRX5716469,SMARCA4,386
chr1,199490810,199491231,SRX5054309,FOSL2,421
chr1,199490811,199491200,SRX5075170,SMARCA4,389
chr1,199490818,199491193,SRX5020214,SMARCA2,375
chr1,199490833,199491181,SRX5075169,SMARCA4,348
chr1,199490841,199491219,SRX5075176,SMARCA4,378
chr1,199490846,199491199,SRX5075175,SMARCA4,353
chr1,199490848,199491193,SRX5054308,FOSL2,345
chr1,199490856,199491067,SRX5716468,SMARCA2,211
chr1,199490858,199491195,SRX5716467,SMARCA2,337
chr1,199490879,199491127,SRX5020211,SMARCA2,248
chr1,199490903,199491099,SRX5075181,SMARCA2,196
chr1,199512068,199512463,SRX5075170,SMARCA4,395
chr1,199512088,199512359,SRX5075174,SMARCA4,271
chr1,199512137,199512470,SRX5075168,SMARCA4,333
chr1,199512206,199512420,SRX5075176,SMARCA4,214
chr1,199522480,199522686,SRX5054308,FOSL2,206
chr1,199550595,199550943,SRX5075169,SMARCA4,348
chr1,199550695,199550875,SRX5075170,SMARCA4,180
chr1,199551901,199552402,SRX16500059,CTCF,501
chr1,199551920,199552424,SRX16500060,CTCF,504
chr1,199551926,199552372,SRX16500061,CTCF,446
chr1,199551949,199552400,SRX16500062,CTCF,451
chr1,199552000,199552212,SRX5716469,SMARCA4,212
chr1,199552001,199552239,SRX5716464,SMARCA4,238
chr1,199552001,199552320,SRX5075174,SMARCA4,319
chr1,199552011,199552215,SRX5716463,SMARCA4,204
chr1,199552073,199552283,SRX4174629,CTCF,210
chr1,199613113,199613529,SRX5075169,SMARCA4,416
chr1,199613133,199613500,SRX5054309,FOSL2,367
chr1,199613135,199613452,SRX5075175,SMARCA4,317
chr1,199613136,199613469,SRX5716470,SMARCA4,333
chr1,199613171,199613411,SRX5054308,FOSL2,240
chr1,199613173,199613413,SRX5075176,SMARCA4,240
chr1,199613207,199613503,SRX5716469,SMARCA4,296
chr1,199613228,199613411,SRX5075170,SMARCA4,183
chr1,199676495,199676926,SRX5075168,SMARCA4,431
chr1,199676538,199676860,SRX5075174,SMARCA4,322
chr1,199676616,199676873,SRX5716463,SMARCA4,257
chr1,199684615,199685161,SRX16500059,CTCF,546
chr1,199684619,199685072,SRX16500061,CTCF,453
chr1,199684666,199685182,SRX16500060,CTCF,516
chr1,199684670,199685103,SRX16500062,CTCF,433
chr1,199684769,199685006,SRX5075174,SMARCA4,237
chr1,199684819,199685061,SRX4174629,CTCF,242
chr1,199685432,199685728,SRX5054309,FOSL2,296
chr1,199685441,199685745,SRX5054308,FOSL2,304
chr1,199688112,199688602,SRX5075170,SMARCA4,490
chr1,199688162,199688794,SRX5075176,SMARCA4,632
chr1,199688250,199688638,SRX5716470,SMARCA4,388
chr1,199688270,199688501,SRX5075169,SMARCA4,231
chr1,199688327,199688607,SRX5716467,SMARCA2,280
chr1,199691474,199691875,SRX5075174,SMARCA4,401
chr1,199691524,199691964,SRX5075170,SMARCA4,440
chr1,199691547,199691954,SRX5075175,SMARCA4,407
chr1,199691548,199691968,SRX5075169,SMARCA4,420
chr1,199691550,199691889,SRX5075168,SMARCA4,339
chr1,199691560,199691939,SRX5716469,SMARCA4,379
chr1,199691568,199691986,SRX5075176,SMARCA4,418
chr1,199691592,199691941,SRX5716470,SMARCA4,349
chr1,199691617,199691961,SRX5716467,SMARCA2,344
chr1,199691618,199691900,SRX5020211,SMARCA2,282
chr1,199691628,199691978,SRX5054309,FOSL2,350
chr1,199691635,199691946,SRX5716468,SMARCA2,311
chr1,199691645,199691919,SRX5054308,FOSL2,274
chr1,199691656,199691906,SRX5075181,SMARCA2,250
chr1,199691668,199691937,SRX5020214,SMARCA2,269
chr1,199691684,199691863,SRX5075182,SMARCA2,179
chr1,199723210,199723445,SRX5075168,SMARCA4,235
chr1,199733192,199733424,SRX5054308,FOSL2,232
chr1,199742525,199742924,SRX5075175,SMARCA4,399
chr1,199742580,199742909,SRX5054309,FOSL2,329
chr1,199742606,199742900,SRX5075169,SMARCA4,294
chr1,199742608,199742919,SRX5075176,SMARCA4,311
chr1,199742618,199742843,SRX5054308,FOSL2,225
chr1,199742647,199742866,SRX5075170,SMARCA4,219
chr1,199743267,199743692,SRX5075168,SMARCA4,425
chr1,199743341,199743667,SRX5075174,SMARCA4,326
chr1,199758983,199759611,SRX5075176,SMARCA4,628
chr1,199759033,199759590,SRX5075170,SMARCA4,557
chr1,199759070,199759328,SRX5716469,SMARCA4,258
chr1,199759132,199759561,SRX5075175,SMARCA4,429
chr1,199759134,199759578,SRX5075169,SMARCA4,444
chr1,199759141,199759382,SRX5716470,SMARCA4,241
chr1,199759175,199759538,SRX5054309,FOSL2,363
chr1,199759179,199759402,SRX5020211,SMARCA2,223
chr1,199759202,199759434,SRX5716467,SMARCA2,232
chr1,199759204,199759632,SRX5054308,FOSL2,428
chr1,199770771,199771210,SRX5716463,SMARCA4,439
chr1,199770789,199771162,SRX5075168,SMARCA4,373
chr1,199770792,199771041,SRX5075176,SMARCA4,249
chr1,199770818,199771216,SRX5075174,SMARCA4,398
chr1,199770837,199771166,SRX5716464,SMARCA4,329
chr1,199781001,199781262,SRX5075175,SMARCA4,261
chr1,199781006,199781290,SRX5075169,SMARCA4,284
chr1,199781016,199781232,SRX5054309,FOSL2,216
chr1,199781070,199781280,SRX5054308,FOSL2,210
chr1,199784190,199784471,SRX5054309,FOSL2,281
chr1,199784277,199784446,SRX5075170,SMARCA4,169
chr1,199787309,199787615,SRX5054308,FOSL2,306
chr1,199787360,199787582,SRX5075175,SMARCA4,222
chr1,199787378,199787591,SRX5075169,SMARCA4,213
chr1,199808157,199808509,SRX5075169,SMARCA4,352
chr1,199821374,199821722,SRX5075176,SMARCA4,348
chr1,199821422,199821606,SRX5075170,SMARCA4,184
chr1,199855709,199855884,SRX5075176,SMARCA4,175
chr1,199859374,199859942,SRX5075170,SMARCA4,568
chr1,199859410,199859820,SRX5075176,SMARCA4,410
chr1,199859429,199859640,SRX5716470,SMARCA4,211
chr1,199859445,199859785,SRX5054308,FOSL2,340
chr1,199859446,199859779,SRX5075175,SMARCA4,333
chr1,199859447,199859747,SRX5716469,SMARCA4,300
chr1,199859448,199859789,SRX5054309,FOSL2,341
chr1,199859455,199859741,SRX5716467,SMARCA2,286
chr1,199859459,199859833,SRX5075169,SMARCA4,374
chr1,199867593,199867894,SRX5075174,SMARCA4,301
chr1,199867619,199867874,SRX5075176,SMARCA4,255
chr1,199867639,199867925,SRX5075170,SMARCA4,286
chr1,199867676,199867880,SRX5075175,SMARCA4,204
chr1,199941291,199941512,SRX5054308,FOSL2,221
chr1,199954794,199955073,SRX16500060,CTCF,279
chr1,199954814,199955024,SRX16500062,CTCF,210
chr1,199954832,199955085,SRX16500061,CTCF,253
chr1,199978466,199978836,SRX5075176,SMARCA4,370
chr1,199978520,199978860,SRX5075170,SMARCA4,340
chr1,200028989,200029355,SRX5075174,SMARCA4,366
chr1,200028991,200029441,SRX5075168,SMARCA4,450
chr1,200029039,200029352,SRX5075170,SMARCA4,313
chr1,200029086,200029371,SRX5075176,SMARCA4,285
chr1,200029115,200029319,SRX5716463,SMARCA4,204
chr1,200029123,200029349,SRX5075175,SMARCA4,226
chr1,200029142,200029402,SRX5075169,SMARCA4,260
chr1,200048211,200048531,SRX5075168,SMARCA4,320
chr1,200048281,200048517,SRX5075174,SMARCA4,236
chr1,200053675,200053908,SRX5054308,FOSL2,233
chr1,200053706,200053889,SRX5054309,FOSL2,183
chr1,200076186,200076556,SRX5716470,SMARCA4,370
chr1,200076190,200076581,SRX5075169,SMARCA4,391
chr1,200076191,200076566,SRX5075176,SMARCA4,375
chr1,200076198,200076528,SRX5716469,SMARCA4,330
chr1,200076233,200076565,SRX5075170,SMARCA4,332
chr1,200076243,200076561,SRX5054308,FOSL2,318
chr1,200076268,200076572,SRX5020211,SMARCA2,304
chr1,200076287,200076670,SRX5716460,Epitope tags,383
chr1,200076290,200076552,SRX5054309,FOSL2,262
chr1,200076291,200076528,SRX5075175,SMARCA4,237
chr1,200076355,200076583,SRX5716467,SMARCA2,228
chr1,200139601,200140079,SRX16500059,CTCF,478
chr1,200139631,200140028,SRX16500060,CTCF,397
chr1,200139687,200139994,SRX16500062,CTCF,307
chr1,200139689,200140100,SRX16500061,CTCF,411
chr1,200139714,200139956,SRX5075168,SMARCA4,242
chr1,200139755,200139974,SRX5075174,SMARCA4,219
chr1,200146284,200146680,SRX5075174,SMARCA4,396
chr1,200146293,200146508,SRX5716464,SMARCA4,215
chr1,200146333,200146641,SRX5075168,SMARCA4,308
chr1,200150674,200150960,SRX5054309,FOSL2,286
chr1,200150674,200151006,SRX5075175,SMARCA4,332
chr1,200150693,200150967,SRX5075170,SMARCA4,274
chr1,200150702,200150925,SRX5054308,FOSL2,223
chr1,200150712,200150997,SRX5075169,SMARCA4,285
chr1,200150745,200150991,SRX5075176,SMARCA4,246
chr1,200150777,200150990,SRX5716470,SMARCA4,213
chr1,200179244,200179720,SRX5075176,SMARCA4,476
chr1,200179388,200179723,SRX5075175,SMARCA4,335
chr1,200179483,200179781,SRX5075170,SMARCA4,298
chr1,200179490,200179749,SRX5075169,SMARCA4,259
chr1,200179556,200179789,SRX5054309,FOSL2,233
chr1,200184152,200184528,SRX5075176,SMARCA4,376
chr1,200184185,200184559,SRX5075170,SMARCA4,374
chr1,200184229,200184423,SRX5075175,SMARCA4,194
chr1,200184234,200184523,SRX5075169,SMARCA4,289
chr1,200184254,200184518,SRX5716469,SMARCA4,264
chr1,200184434,200184672,SRX5075174,SMARCA4,238
chr1,200206404,200206762,SRX5054309,FOSL2,358
chr1,200206448,200206671,SRX5075176,SMARCA4,223
chr1,200206451,200206749,SRX5075169,SMARCA4,298
chr1,200206472,200206680,SRX5075170,SMARCA4,208
chr1,200206472,200206682,SRX5075175,SMARCA4,210
chr1,200206483,200206686,SRX5054308,FOSL2,203
chr1,200226216,200226447,SRX5075176,SMARCA4,231
chr1,200226218,200226485,SRX5075170,SMARCA4,267
chr1,200226299,200226493,SRX5054308,FOSL2,194
chr1,200227944,200228481,SRX5075168,SMARCA4,537
chr1,200227971,200228486,SRX5075174,SMARCA4,515
chr1,200228051,200228495,SRX20140895,INTS13,444
chr1,200228090,200228394,SRX5716463,SMARCA4,304
chr1,200228138,200228348,SRX5716451,SOX2,210
chr1,200232027,200232310,SRX5054309,FOSL2,283
chr1,200233420,200233625,SRX5054309,FOSL2,205
chr1,200233439,200233644,SRX5075169,SMARCA4,205
chr1,200233454,200233672,SRX5054308,FOSL2,218
chr1,200233485,200233705,SRX5075175,SMARCA4,220
chr1,200233493,200233764,SRX5075174,SMARCA4,271
chr1,200242427,200242852,SRX5075170,SMARCA4,425
chr1,200242479,200242912,SRX5075168,SMARCA4,433
chr1,200242518,200242867,SRX5075176,SMARCA4,349
chr1,200242518,200242870,SRX5075174,SMARCA4,352
chr1,200242529,200242842,SRX5716470,SMARCA4,313
chr1,200242832,200243329,SRX20140895,INTS13,497
chr1,200258466,200258817,SRX16500061,CTCF,351
chr1,200258515,200258898,SRX16500060,CTCF,383
chr1,200258516,200258796,SRX16500062,CTCF,280
chr1,200274182,200274525,SRX5716463,SMARCA4,343
chr1,200279759,200280198,SRX16500059,CTCF,439
chr1,200279783,200280155,SRX16500060,CTCF,372
chr1,200279810,200280127,SRX16500062,CTCF,317
chr1,200279831,200280151,SRX16500061,CTCF,320
chr1,200279907,200280080,SRX5075174,SMARCA4,173
chr1,200302159,200302476,SRX5075175,SMARCA4,317
chr1,200302164,200302449,SRX5075168,SMARCA4,285
chr1,200302192,200302483,SRX5716470,SMARCA4,291
chr1,200302202,200302579,SRX5075169,SMARCA4,377
chr1,200302205,200302546,SRX5075176,SMARCA4,341
chr1,200302211,200302513,SRX5075170,SMARCA4,302
chr1,200302238,200302551,SRX5716469,SMARCA4,313
chr1,200302243,200302509,SRX5075174,SMARCA4,266
chr1,200307328,200307885,SRX16500059,CTCF,557
chr1,200307352,200307881,SRX16500062,CTCF,529
chr1,200307355,200307608,SRX4174629,CTCF,253
chr1,200307356,200307917,SRX16500061,CTCF,561
chr1,200307437,200307919,SRX16500060,CTCF,482
chr1,200307495,200307841,SRX5075168,SMARCA4,346
chr1,200307511,200307776,SRX5716463,SMARCA4,265
chr1,200307521,200307797,SRX5716464,SMARCA4,276
chr1,200307532,200307791,SRX5075174,SMARCA4,259
chr1,200307552,200307775,SRX5075170,SMARCA4,223
chr1,200314323,200314594,SRX5075170,SMARCA4,271
chr1,200314385,200314647,SRX5020211,SMARCA2,262
chr1,200314425,200314724,SRX5716468,SMARCA2,299
chr1,200314435,200314628,SRX5075175,SMARCA4,193
chr1,200314436,200314675,SRX5075169,SMARCA4,239
chr1,200314466,200314711,SRX5054309,FOSL2,245
chr1,200314468,200314687,SRX5716469,SMARCA4,219
chr1,200314481,200314698,SRX5075176,SMARCA4,217
chr1,200314516,200314781,SRX5716470,SMARCA4,265
chr1,200317297,200317540,SRX5054308,FOSL2,243
chr1,200317349,200317590,SRX5075169,SMARCA4,241
chr1,200317358,200317617,SRX5716469,SMARCA4,259
chr1,200320762,200321205,SRX5075176,SMARCA4,443
chr1,200320807,200321020,SRX5054308,FOSL2,213
chr1,200320814,200321324,SRX5075170,SMARCA4,510
chr1,200320836,200321149,SRX5075169,SMARCA4,313
chr1,200320851,200321078,SRX5054309,FOSL2,227
chr1,200320879,200321122,SRX5716469,SMARCA4,243
chr1,200320887,200321157,SRX5075175,SMARCA4,270
chr1,200321015,200321527,SRX5075168,SMARCA4,512
chr1,200321048,200321430,SRX5716463,SMARCA4,382
chr1,200321066,200321583,SRX5075174,SMARCA4,517
chr1,200321092,200321443,SRX20140895,INTS13,351
chr1,200321163,200321463,SRX5716464,SMARCA4,300
chr1,200321177,200321397,SRX5716451,SOX2,220
chr1,200332650,200333069,SRX5054309,FOSL2,419
chr1,200332727,200332976,SRX5020214,SMARCA2,249
chr1,200332755,200332935,SRX5075169,SMARCA4,180
chr1,200332774,200332971,SRX5075175,SMARCA4,197
chr1,200336431,200336730,SRX5716469,SMARCA4,299
chr1,200336465,200336690,SRX5054309,FOSL2,225
chr1,200336505,200336745,SRX5075169,SMARCA4,240
chr1,200342859,200343086,SRX5054308,FOSL2,227
chr1,200342870,200343342,SRX5075169,SMARCA4,472
chr1,200342884,200343239,SRX5054309,FOSL2,355
chr1,200342982,200343221,SRX5075175,SMARCA4,239
chr1,200352082,200352626,SRX5075170,SMARCA4,544
chr1,200352103,200352645,SRX5075175,SMARCA4,542
chr1,200352103,200352702,SRX5075176,SMARCA4,599
chr1,200352126,200352574,SRX5716470,SMARCA4,448
chr1,200352146,200352601,SRX5075169,SMARCA4,455
chr1,200352182,200352393,SRX5716468,SMARCA2,211
chr1,200352206,200352601,SRX5054308,FOSL2,395
chr1,200352216,200352586,SRX5716469,SMARCA4,370
chr1,200352226,200352590,SRX5054309,FOSL2,364
chr1,200352249,200352554,SRX5716467,SMARCA2,305
chr1,200352255,200352577,SRX5020214,SMARCA2,322
chr1,200352327,200352543,SRX5075182,SMARCA2,216
chr1,200352392,200352597,SRX5020211,SMARCA2,205
chr1,200364120,200364354,SRX5075169,SMARCA4,234
chr1,200364136,200364372,SRX5075176,SMARCA4,236
chr1,200364171,200364375,SRX5075170,SMARCA4,204
chr1,200364179,200364390,SRX5075174,SMARCA4,211
chr1,200368061,200368485,SRX5716470,SMARCA4,424
chr1,200368120,200368525,SRX5075176,SMARCA4,405
chr1,200368129,200368387,SRX5716469,SMARCA4,258
chr1,200368152,200368484,SRX5075170,SMARCA4,332
chr1,200368157,200368512,SRX5054309,FOSL2,355
chr1,200368161,200368460,SRX5075175,SMARCA4,299
chr1,200368186,200368480,SRX5075181,SMARCA2,294
chr1,200368193,200368465,SRX5075169,SMARCA4,272
chr1,200368195,200368465,SRX5716467,SMARCA2,270
chr1,200368197,200368445,SRX5054308,FOSL2,248
chr1,200368211,200368390,SRX5075182,SMARCA2,179
chr1,200372237,200372442,SRX5075175,SMARCA4,205
chr1,200373718,200374198,SRX5075168,SMARCA4,480
chr1,200373721,200374203,SRX5075174,SMARCA4,482
chr1,200379227,200379795,SRX5075176,SMARCA4,568
chr1,200379235,200379776,SRX5075169,SMARCA4,541
chr1,200379245,200379741,SRX5020211,SMARCA2,496
chr1,200379252,200379800,SRX5075170,SMARCA4,548
chr1,200379265,200379803,SRX5075175,SMARCA4,538
chr1,200379279,200379712,SRX5716470,SMARCA4,433
chr1,200379301,200379607,SRX5716469,SMARCA4,306
chr1,200379310,200379828,SRX5054309,FOSL2,518
chr1,200379356,200379760,SRX5020214,SMARCA2,404
chr1,200379358,200379802,SRX5054308,FOSL2,444
chr1,200379399,200379640,SRX5716467,SMARCA2,241
chr1,200409745,200409947,SRX5075175,SMARCA4,202
chr1,200409855,200410164,SRX20140895,INTS13,309
chr1,200409881,200410374,SRX5075174,SMARCA4,493
chr1,200409903,200410304,SRX5075176,SMARCA4,401
chr1,200409904,200410379,SRX5075168,SMARCA4,475
chr1,200409937,200410280,SRX5075170,SMARCA4,343
chr1,200409938,200410304,SRX5716464,SMARCA4,366
chr1,200409985,200410318,SRX5716463,SMARCA4,333
chr1,200410064,200410277,SRX5075175,SMARCA4,213
chr1,200410171,200410382,SRX5716470,SMARCA4,211
chr1,200415623,200416351,SRX5075170,SMARCA4,728
chr1,200415655,200416453,SRX5075176,SMARCA4,798
chr1,200415701,200416402,SRX5716469,SMARCA4,701
chr1,200415712,200416270,SRX5075175,SMARCA4,558
chr1,200415725,200416312,SRX5075169,SMARCA4,587
chr1,200415734,200416305,SRX5716470,SMARCA4,571
chr1,200415793,200416308,SRX5020211,SMARCA2,515
chr1,200415839,200416205,SRX5716467,SMARCA2,366
chr1,200415868,200416204,SRX5020214,SMARCA2,336
chr1,200415873,200416321,SRX5054309,FOSL2,448
chr1,200415879,200416294,SRX5054308,FOSL2,415
chr1,200415936,200416127,SRX5075182,SMARCA2,191
chr1,200415936,200416204,SRX5075181,SMARCA2,268
chr1,200415948,200416230,SRX5716468,SMARCA2,282
chr1,200429196,200429847,SRX5075169,SMARCA4,651
chr1,200429228,200429570,SRX5075175,SMARCA4,342
chr1,200429249,200429548,SRX5716470,SMARCA4,299
chr1,200429289,200429546,SRX5716468,SMARCA2,257
chr1,200429302,200429756,SRX5716469,SMARCA4,454
chr1,200429305,200429531,SRX5054309,FOSL2,226
chr1,200429318,200429510,SRX5075170,SMARCA4,192
chr1,200429388,200429841,SRX5075176,SMARCA4,453
chr1,200435385,200435824,SRX5075176,SMARCA4,439
chr1,200435440,200435777,SRX5075170,SMARCA4,337
chr1,200435441,200435745,SRX5054309,FOSL2,304
chr1,200435474,200435702,SRX5054308,FOSL2,228
chr1,200435491,200435698,SRX5075175,SMARCA4,207
chr1,200435494,200435769,SRX5075169,SMARCA4,275
chr1,200438942,200439199,SRX5075169,SMARCA4,257
chr1,200483351,200483832,SRX5716467,SMARCA2,481
chr1,200483359,200483846,SRX5716469,SMARCA4,487
chr1,200483360,200483924,SRX5075175,SMARCA4,564
chr1,200483364,200483914,SRX5075169,SMARCA4,550
chr1,200483369,200483843,SRX5075170,SMARCA4,474
chr1,200483391,200483945,SRX5075176,SMARCA4,554
chr1,200483436,200483782,SRX5716468,SMARCA2,346
chr1,200483470,200483880,SRX5716470,SMARCA4,410
chr1,200483477,200483894,SRX5054309,FOSL2,417
chr1,200483480,200483788,SRX5075181,SMARCA2,308
chr1,200483498,200483766,SRX5716459,Epitope tags,268
chr1,200483504,200483744,SRX5020211,SMARCA2,240
chr1,200483505,200483842,SRX5054308,FOSL2,337
chr1,200483526,200483744,SRX5075182,SMARCA2,218
chr1,200483540,200483814,SRX5020214,SMARCA2,274
chr1,200483583,200483821,SRX5075174,SMARCA4,238
chr1,200487861,200487914,SRX1424894,POU3F2,53
chr1,200487861,200487916,SRX1424893,POU3F2,55
chr1,200487863,200487913,SRX1424891,POU3F2,50
chr1,200487864,200487914,SRX1424892,POU3F2,50
chr1,200488606,200489154,SRX16500059,CTCF,548
chr1,200488616,200489107,SRX16500060,CTCF,491
chr1,200488626,200489121,SRX16500061,CTCF,495
chr1,200488636,200489156,SRX16500062,CTCF,520
chr1,200488644,200488982,SRX4174629,CTCF,338
chr1,200488718,200488995,SRX5075176,SMARCA4,277
chr1,200488735,200489009,SRX5075174,SMARCA4,274
chr1,200488751,200489043,SRX5075168,SMARCA4,292
chr1,200488776,200488958,SRX5075170,SMARCA4,182
chr1,200493443,200493622,SRX5075168,SMARCA4,179
chr1,200510000,200510564,SRX16500059,CTCF,564
chr1,200510055,200510558,SRX16500060,CTCF,503
chr1,200510059,200510619,SRX16500061,CTCF,560
chr1,200510098,200510561,SRX16500062,CTCF,463
chr1,200510127,200510479,SRX5075174,SMARCA4,352
chr1,200510128,200510481,SRX5075168,SMARCA4,353
chr1,200510141,200510453,SRX5075170,SMARCA4,312
chr1,200510144,200510509,SRX4174629,CTCF,365
chr1,200510152,200510455,SRX5075176,SMARCA4,303
chr1,200510156,200510445,SRX5075169,SMARCA4,289
chr1,200510172,200510456,SRX5716463,SMARCA4,284
chr1,200510174,200510417,SRX5075175,SMARCA4,243
chr1,200510193,200510454,SRX5716470,SMARCA4,261
chr1,200510211,200510435,SRX5716464,SMARCA4,224
chr1,200512300,200512496,SRX5075175,SMARCA4,196
chr1,200512327,200512573,SRX5075169,SMARCA4,246
chr1,200512344,200512567,SRX5075170,SMARCA4,223
chr1,200512352,200512545,SRX5075176,SMARCA4,193
chr1,200512361,200512544,SRX5054309,FOSL2,183
chr1,200525317,200525853,SRX5075176,SMARCA4,536
chr1,200525324,200525922,SRX5075170,SMARCA4,598
chr1,200525364,200525651,SRX5075181,SMARCA2,287
chr1,200525403,200525693,SRX5075169,SMARCA4,290
chr1,200525409,200525757,SRX5716470,SMARCA4,348
chr1,200525411,200525732,SRX5075175,SMARCA4,321
chr1,200525422,200525709,SRX5716467,SMARCA2,287
chr1,200525451,200525731,SRX5716469,SMARCA4,280
chr1,200525462,200525842,SRX5054309,FOSL2,380
chr1,200525481,200525725,SRX5716468,SMARCA2,244
chr1,200525622,200525820,SRX5054308,FOSL2,198
chr1,200527285,200527586,SRX5075175,SMARCA4,301
chr1,200527327,200527593,SRX5075176,SMARCA4,266
chr1,200527350,200527602,SRX5054308,FOSL2,252
chr1,200527355,200527595,SRX5075170,SMARCA4,240
chr1,200527358,200527637,SRX5075169,SMARCA4,279
chr1,200535731,200535952,SRX16500060,CTCF,221
chr1,200558794,200559200,SRX16500061,CTCF,406
chr1,200558832,200559278,SRX16500060,CTCF,446
chr1,200558879,200559248,SRX16500062,CTCF,369
chr1,200558890,200559281,SRX16500059,CTCF,391
chr1,200558898,200559154,SRX5075168,SMARCA4,256
chr1,200558937,200559226,SRX5075169,SMARCA4,289
chr1,200558946,200559164,SRX5075174,SMARCA4,218
chr1,200558954,200559220,SRX5075176,SMARCA4,266
chr1,200558975,200559162,SRX5075175,SMARCA4,187
chr1,200558986,200559228,SRX5075170,SMARCA4,242
chr1,200611047,200611235,SRX5075175,SMARCA4,188
chr1,200620242,200620544,SRX5075169,SMARCA4,302
chr1,200620296,200620515,SRX5054309,FOSL2,219
chr1,200620316,200620517,SRX5075175,SMARCA4,201
chr1,200620342,200621088,SRX5075174,SMARCA4,746
chr1,200620552,200621034,SRX20140895,INTS13,482
chr1,200620659,200621101,SRX5075168,SMARCA4,442
chr1,200620672,200621050,SRX5716464,SMARCA4,378
chr1,200620678,200620970,SRX5716463,SMARCA4,292
chr1,200620689,200621076,SRX5075176,SMARCA4,387
chr1,200620745,200621046,SRX5075170,SMARCA4,301
chr1,200620860,200621047,SRX5075175,SMARCA4,187
chr1,200622169,200622664,SRX16500059,CTCF,495
chr1,200622231,200622698,SRX16500061,CTCF,467
chr1,200622249,200622818,SRX16500060,CTCF,569
chr1,200622291,200622665,SRX16500062,CTCF,374
chr1,200639973,200640346,SRX5075169,SMARCA4,373
chr1,200639975,200640352,SRX5075176,SMARCA4,377
chr1,200639988,200640212,SRX5075174,SMARCA4,224
chr1,200639992,200640358,SRX5075175,SMARCA4,366
chr1,200639998,200640238,SRX5054308,FOSL2,240
chr1,200640018,200640313,SRX5054309,FOSL2,295
chr1,200640028,200640347,SRX5075170,SMARCA4,319
chr1,200653240,200653538,SRX5075168,SMARCA4,298
chr1,200653248,200653587,SRX5075174,SMARCA4,339
chr1,200653282,200653512,SRX5075170,SMARCA4,230
chr1,200653289,200653494,SRX5716464,SMARCA4,205
chr1,200665951,200666221,SRX5075176,SMARCA4,270
chr1,200669281,200670186,SRX20140895,INTS13,905
chr1,200669368,200669607,SRX5075174,SMARCA4,239
chr1,200669374,200669597,SRX5075170,SMARCA4,223
chr1,200669385,200670097,SRX20140868,INTS10,712
chr1,200669391,200669571,SRX5075169,SMARCA4,180
chr1,200669395,200669609,SRX5716470,SMARCA4,214
chr1,200669469,200670179,SRX20140867,INTS10,710
chr1,200669476,200670078,SRX20140869,INTS10,602
chr1,200669497,200670091,SRX20140897,INTS13,594
chr1,200669507,200670020,SRX20140879,CPSF3L,513
chr1,200669535,200669869,SRX20140881,CPSF3L,334
chr1,200669764,200670240,SRX5075174,SMARCA4,476
chr1,200669871,200670124,SRX5054307,FOSL2,253
chr1,200669932,200670385,SRX5075168,SMARCA4,453
chr1,200669983,200670336,SRX5075170,SMARCA4,353
chr1,200670036,200670337,SRX5075176,SMARCA4,301
chr1,200670173,200670412,SRX5075175,SMARCA4,239
chr1,200674333,200674624,SRX5716467,SMARCA2,291
chr1,200674354,200674750,SRX5075176,SMARCA4,396
chr1,200674411,200674732,SRX5075170,SMARCA4,321
chr1,200685884,200685931,SRX1424894,POU3F2,47
chr1,200685890,200685930,SRX1424891,POU3F2,40
chr1,200686770,200687119,SRX5716469,SMARCA4,349
chr1,200686788,200687074,SRX5075169,SMARCA4,286
chr1,200686793,200687206,SRX5075176,SMARCA4,413
chr1,200686795,200687039,SRX5716470,SMARCA4,244
chr1,200686795,200687183,SRX5075170,SMARCA4,388
chr1,200686879,200687086,SRX5054308,FOSL2,207
chr1,200686893,200687180,SRX5716468,SMARCA2,287
chr1,200694833,200695022,SRX5075176,SMARCA4,189
chr1,200699869,200700269,SRX5075170,SMARCA4,400
chr1,200699871,200700226,SRX5075175,SMARCA4,355
chr1,200699879,200700263,SRX5075169,SMARCA4,384
chr1,200699882,200700251,SRX5075176,SMARCA4,369
chr1,200699887,200700169,SRX5716469,SMARCA4,282
chr1,200699904,200700216,SRX5054309,FOSL2,312
chr1,200699922,200700223,SRX5054308,FOSL2,301
chr1,200738451,200738750,SRX5716470,SMARCA4,299
chr1,200738549,200738809,SRX5075174,SMARCA4,260
chr1,200738554,200738807,SRX5075175,SMARCA4,253
chr1,200738568,200738803,SRX5075176,SMARCA4,235
chr1,200738570,200738808,SRX5075168,SMARCA4,238
chr1,200738603,200738823,SRX5075170,SMARCA4,220
chr1,200738959,200739912,SRX20140895,INTS13,953
chr1,200738987,200739473,SRX20140867,INTS10,486
chr1,200739068,200739348,SRX20140869,INTS10,280
chr1,200739069,200739464,SRX20140897,INTS13,395
chr1,200739072,200739378,SRX20140879,CPSF3L,306
chr1,200739096,200739697,SRX20140868,INTS10,601
chr1,200739208,200739766,SRX5075174,SMARCA4,558
chr1,200739250,200739592,SRX5716470,SMARCA4,342
chr1,200739434,200739752,SRX5075170,SMARCA4,318
chr1,200739476,200739655,SRX5075168,SMARCA4,179
chr1,200739479,200739677,SRX5075175,SMARCA4,198
chr1,200739544,200739754,SRX5075176,SMARCA4,210
chr1,200777064,200777334,SRX5075174,SMARCA4,270
chr1,200777065,200777356,SRX5075168,SMARCA4,291
chr1,200781148,200781409,SRX5716470,SMARCA4,261
chr1,200795175,200795505,SRX5075176,SMARCA4,330
chr1,200795182,200795410,SRX5716467,SMARCA2,228
chr1,200795209,200795482,SRX5075169,SMARCA4,273
chr1,200795211,200795432,SRX5075170,SMARCA4,221
chr1,200795228,200795490,SRX5716469,SMARCA4,262
chr1,200795229,200795489,SRX5075175,SMARCA4,260
chr1,200795248,200795506,SRX5054308,FOSL2,258
chr1,200795262,200795519,SRX5054309,FOSL2,257
chr1,200795320,200795520,SRX5020211,SMARCA2,200
chr1,200802828,200803384,SRX16500059,CTCF,556
chr1,200802830,200803402,SRX16500060,CTCF,572
chr1,200802836,200803223,SRX5716464,SMARCA4,387
chr1,200802842,200803263,SRX5075168,SMARCA4,421
chr1,200802843,200803347,SRX16500062,CTCF,504
chr1,200802853,200803255,SRX5716463,SMARCA4,402
chr1,200802860,200803232,SRX5075174,SMARCA4,372
chr1,200802867,200803156,SRX5716470,SMARCA4,289
chr1,200802871,200803320,SRX4174629,CTCF,449
chr1,200802877,200803376,SRX16500061,CTCF,499
chr1,200802897,200803207,SRX5075170,SMARCA4,310
chr1,200802900,200803223,SRX5075169,SMARCA4,323
chr1,200802901,200803188,SRX5075175,SMARCA4,287
chr1,200802908,200803221,SRX5075176,SMARCA4,313
chr1,200802950,200803168,SRX5716469,SMARCA4,218
chr1,200831169,200831435,SRX20140869,INTS10,266
chr1,200837949,200838360,SRX16500060,CTCF,411
chr1,200837966,200838360,SRX16500062,CTCF,394
chr1,200837980,200838354,SRX16500061,CTCF,374
chr1,200838044,200838370,SRX16500059,CTCF,326
chr1,200846245,200846782,SRX5075168,SMARCA4,537
chr1,200846352,200846818,SRX5075174,SMARCA4,466
chr1,200846441,200846704,SRX5716451,SOX2,263
chr1,200856926,200857283,SRX5075169,SMARCA4,357
chr1,200856938,200857318,SRX5075176,SMARCA4,380
chr1,200856976,200857274,SRX5075170,SMARCA4,298
chr1,200857005,200857268,SRX5075175,SMARCA4,263
chr1,200857031,200857211,SRX5054308,FOSL2,180
chr1,200857032,200857287,SRX5716469,SMARCA4,255
chr1,200857047,200857314,SRX5716470,SMARCA4,267
chr1,200857078,200857278,SRX5020211,SMARCA2,200
chr1,200866243,200866412,SRX5075170,SMARCA4,169
chr1,200880222,200880651,SRX5075174,SMARCA4,429
chr1,200880328,200880614,SRX5075170,SMARCA4,286
chr1,200880386,200880633,SRX5075176,SMARCA4,247
chr1,200890782,200891126,SRX16500062,CTCF,344
chr1,200890813,200891153,SRX16500061,CTCF,340
chr1,200890824,200891198,SRX16500059,CTCF,374
chr1,200890842,200891460,SRX5075174,SMARCA4,618
chr1,200890851,200891252,SRX5075176,SMARCA4,401
chr1,200890856,200891165,SRX16500060,CTCF,309
chr1,200890870,200891202,SRX5075168,SMARCA4,332
chr1,200890890,200891147,SRX5075175,SMARCA4,257
chr1,200890891,200891236,SRX5716470,SMARCA4,345
chr1,200890915,200891322,SRX5716469,SMARCA4,407
chr1,200890916,200892147,SRX20140895,INTS13,1231
chr1,200890922,200891174,SRX5075170,SMARCA4,252
chr1,200890927,200891172,SRX5075169,SMARCA4,245
chr1,200890967,200892109,SRX20140868,INTS10,1142
chr1,200891002,200891299,SRX20140879,CPSF3L,297
chr1,200891028,200891480,SRX20140867,INTS10,452
chr1,200891298,200891494,SRX5075168,SMARCA4,196
chr1,200891906,200892163,SRX5075174,SMARCA4,257
chr1,200923715,200923930,SRX5075169,SMARCA4,215
chr1,200923730,200923905,SRX5075176,SMARCA4,175
chr1,200925606,200925647,SRX1424893,POU3F2,41
chr1,200965563,200965776,SRX5075176,SMARCA4,213
chr1,200968518,200968780,SRX5054309,FOSL2,262
chr1,200971891,200972402,SRX16500060,CTCF,511
chr1,200971898,200972355,SRX16500062,CTCF,457
chr1,200971913,200972405,SRX16500061,CTCF,492
chr1,200971917,200972392,SRX16500059,CTCF,475
chr1,200971952,200972377,SRX4174629,CTCF,425
chr1,200972009,200972272,SRX5075168,SMARCA4,263
chr1,200972058,200972288,SRX5075174,SMARCA4,230
chr1,200972068,200972326,SRX5075170,SMARCA4,258
chr1,200972074,200972323,SRX5075176,SMARCA4,249
chr1,200972110,200972314,SRX5716463,SMARCA4,204
chr1,200979537,200979956,SRX16500060,CTCF,419
chr1,200979544,200979994,SRX16500059,CTCF,450
chr1,200979547,200979958,SRX16500062,CTCF,411
chr1,200979551,200979975,SRX16500061,CTCF,424
chr1,200979593,200979875,SRX4174629,CTCF,282
chr1,200979680,200979900,SRX5075174,SMARCA4,220
chr1,201010287,201010682,SRX5075174,SMARCA4,395
chr1,201010317,201010694,SRX20140895,INTS13,377
chr1,201010380,201010678,SRX5075168,SMARCA4,298
chr1,201016394,201016614,SRX5075176,SMARCA4,220
chr1,201020948,201021305,SRX16500061,CTCF,357
chr1,201020970,201021376,SRX16500060,CTCF,406
chr1,201020973,201021325,SRX16500059,CTCF,352
chr1,201020989,201021353,SRX16500062,CTCF,364
chr1,201023143,201023821,SRX20140895,INTS13,678
chr1,201023603,201023852,SRX5075174,SMARCA4,249
chr1,201023615,201023847,SRX5075168,SMARCA4,232
chr1,201023684,201023883,SRX5054307,FOSL2,199
chr1,201025577,201025908,SRX5054309,FOSL2,331
chr1,201025586,201025874,SRX5075169,SMARCA4,288
chr1,201025604,201025862,SRX5054308,FOSL2,258
chr1,201025621,201025944,SRX5075170,SMARCA4,323
chr1,201025626,201025848,SRX5075175,SMARCA4,222
chr1,201025640,201026016,SRX5075176,SMARCA4,376
chr1,201042814,201043310,SRX16500059,CTCF,496
chr1,201042843,201043329,SRX16500060,CTCF,486
chr1,201042849,201043381,SRX16500061,CTCF,532
chr1,201042888,201043337,SRX16500062,CTCF,449
chr1,201042920,201043164,SRX5075174,SMARCA4,244
chr1,201042939,201043274,SRX5075168,SMARCA4,335
chr1,201042967,201043324,SRX4174629,CTCF,357
chr1,201055777,201055961,SRX5075169,SMARCA4,184
chr1,201062499,201062691,SRX5075174,SMARCA4,192
chr1,201084327,201084619,SRX5075168,SMARCA4,292
chr1,201085910,201086350,SRX16500060,CTCF,440
chr1,201085935,201086286,SRX16500061,CTCF,351
chr1,201085956,201086307,SRX16500059,CTCF,351
chr1,201085960,201086279,SRX16500062,CTCF,319
chr1,201108528,201109101,SRX5075168,SMARCA4,573
chr1,201108562,201109035,SRX5075174,SMARCA4,473
chr1,201108588,201109024,SRX5716464,SMARCA4,436
chr1,201108636,201108934,SRX20140879,CPSF3L,298
chr1,201108666,201108958,SRX5716454,SOX3,292
chr1,201108689,201109004,SRX5716463,SMARCA4,315
chr1,201108717,201108989,SRX5716451,SOX2,272
chr1,201113990,201114538,SRX16500061,CTCF,548
chr1,201114018,201114500,SRX4174629,CTCF,482
chr1,201114043,201114538,SRX16500059,CTCF,495
chr1,201114060,201114602,SRX16500060,CTCF,542
chr1,201114079,201114465,SRX5075176,SMARCA4,386
chr1,201114081,201114545,SRX16500062,CTCF,464
chr1,201114089,201114507,SRX5075170,SMARCA4,418
chr1,201114101,201114638,SRX20140895,INTS13,537
chr1,201114119,201114458,SRX5075168,SMARCA4,339
chr1,201114120,201114456,SRX5075174,SMARCA4,336
chr1,201114156,201114531,SRX5075169,SMARCA4,375
chr1,201114188,201114447,SRX5075175,SMARCA4,259
chr1,201114191,201114489,SRX5716463,SMARCA4,298
chr1,201114221,201114547,SRX5716469,SMARCA4,326
chr1,201119228,201119702,SRX16500059,CTCF,474
chr1,201119238,201119674,SRX16500061,CTCF,436
chr1,201119239,201119689,SRX16500060,CTCF,450
chr1,201119253,201119658,SRX16500062,CTCF,405
chr1,201119273,201119477,SRX5075174,SMARCA4,204
chr1,201119277,201119541,SRX5075168,SMARCA4,264
chr1,201119754,201120125,SRX5075170,SMARCA4,371
chr1,201119849,201120087,SRX5075176,SMARCA4,238
chr1,201137490,201137985,SRX5075170,SMARCA4,495
chr1,201137530,201137867,SRX5075175,SMARCA4,337
chr1,201137531,201138011,SRX5075169,SMARCA4,480
chr1,201137537,201137893,SRX5075176,SMARCA4,356
chr1,201137550,201137875,SRX5054308,FOSL2,325
chr1,201137557,201137909,SRX5054309,FOSL2,352
chr1,201137573,201137936,SRX5716469,SMARCA4,363
chr1,201137592,201137835,SRX5716470,SMARCA4,243
chr1,201149360,201149765,SRX16500060,CTCF,405
chr1,201149390,201149705,SRX16500061,CTCF,315
chr1,201149399,201149737,SRX16500059,CTCF,338
chr1,201149421,201149668,SRX16500062,CTCF,247
chr1,201149423,201149709,SRX4174629,CTCF,286
chr1,201154188,201154787,SRX20140895,INTS13,599
chr1,201154250,201154457,SRX5716464,SMARCA4,207
chr1,201154280,201154809,SRX5075168,SMARCA4,529
chr1,201154303,201154753,SRX5075174,SMARCA4,450
chr1,201154351,201154747,SRX5716463,SMARCA4,396
chr1,201154351,201154795,SRX5075170,SMARCA4,444
chr1,201154561,201154762,SRX5075176,SMARCA4,201
chr1,201170416,201171310,SRX5716470,SMARCA4,894
chr1,201170512,201171032,SRX5075174,SMARCA4,520
chr1,201170542,201171114,SRX20140867,INTS10,572
chr1,201170547,201170899,SRX20140881,CPSF3L,352
chr1,201170554,201170850,SRX5716463,SMARCA4,296
chr1,201170569,201171128,SRX5075168,SMARCA4,559
chr1,201170575,201170910,SRX5075169,SMARCA4,335
chr1,201170581,201171105,SRX5716469,SMARCA4,524
chr1,201170585,201170825,SRX5716464,SMARCA4,240
chr1,201170599,201171098,SRX5075176,SMARCA4,499
chr1,201170627,201171082,SRX5075170,SMARCA4,455
chr1,201170660,201171036,SRX5075175,SMARCA4,376
chr1,201170669,201171422,SRX20140895,INTS13,753
chr1,201170934,201171451,SRX16500059,CTCF,517
chr1,201170950,201171277,SRX20140869,INTS10,327
chr1,201171042,201171405,SRX16500061,CTCF,363
chr1,201171087,201171439,SRX16500060,CTCF,352
chr1,201171093,201171446,SRX20140868,INTS10,353
chr1,201171165,201171345,SRX5075170,SMARCA4,180
chr1,201171165,201171413,SRX16500062,CTCF,248
chr1,201171177,201171437,SRX5075174,SMARCA4,260
chr1,201184870,201185216,SRX5075176,SMARCA4,346
chr1,201184880,201185264,SRX16500060,CTCF,384
chr1,201184881,201185160,SRX5075175,SMARCA4,279
chr1,201184899,201185205,SRX5075169,SMARCA4,306
chr1,201184921,201185233,SRX16500059,CTCF,312
chr1,201184924,201185161,SRX5075170,SMARCA4,237
chr1,201184988,201185180,SRX5075168,SMARCA4,192
chr1,201191708,201192252,SRX5075169,SMARCA4,544
chr1,201191745,201192007,SRX5054309,FOSL2,262
chr1,201191757,201191987,SRX5054308,FOSL2,230
chr1,201192330,201192650,SRX5716467,SMARCA2,320
chr1,201192343,201192933,SRX5716470,SMARCA4,590
chr1,201192359,201192877,SRX5075170,SMARCA4,518
chr1,201192360,201192738,SRX5075169,SMARCA4,378
chr1,201192372,201192666,SRX5075175,SMARCA4,294
chr1,201192382,201192914,SRX5075176,SMARCA4,532
chr1,201192451,201192826,SRX5716469,SMARCA4,375
chr1,201192458,201192818,SRX5716468,SMARCA2,360
chr1,201192538,201192845,SRX5020211,SMARCA2,307
chr1,201222761,201223353,SRX16500060,CTCF,592
chr1,201222779,201223343,SRX16500061,CTCF,564
chr1,201222811,201223307,SRX16500062,CTCF,496
chr1,201222820,201223355,SRX16500059,CTCF,535
chr1,201222885,201223262,SRX4174629,CTCF,377
chr1,201222911,201223171,SRX5075168,SMARCA4,260
chr1,201222930,201223176,SRX5075174,SMARCA4,246
chr1,201239690,201239736,SRX1424891,POU3F2,46
chr1,201239692,201239740,SRX1424892,POU3F2,48
chr1,201239693,201239736,SRX1424893,POU3F2,43
chr1,201254015,201254184,SRX5075170,SMARCA4,169
chr1,201254423,201255049,SRX16500059,CTCF,626
chr1,201254426,201254975,SRX16500061,CTCF,549
chr1,201254453,201254983,SRX16500060,CTCF,530
chr1,201254488,201254961,SRX16500062,CTCF,473
chr1,201254528,201254896,SRX4174629,CTCF,368
chr1,201254648,201254834,SRX5075174,SMARCA4,186
chr1,201266759,201267065,SRX5075176,SMARCA4,306
chr1,201266773,201267048,SRX5075169,SMARCA4,275
chr1,201266799,201267068,SRX5075170,SMARCA4,269
chr1,201266814,201267050,SRX5054308,FOSL2,236
chr1,201266816,201267074,SRX5054309,FOSL2,258
chr1,201266851,201267087,SRX5075175,SMARCA4,236
chr1,201275295,201275571,SRX5075170,SMARCA4,276
chr1,201275369,201275642,SRX5075176,SMARCA4,273
chr1,201295983,201296192,SRX5075175,SMARCA4,209
chr1,201296002,201296219,SRX5075170,SMARCA4,217
chr1,201296011,201296241,SRX5075176,SMARCA4,230
chr1,201309438,201309780,SRX5075168,SMARCA4,342
chr1,201309468,201309747,SRX5075170,SMARCA4,279
chr1,201309477,201309674,SRX5075174,SMARCA4,197
chr1,201309519,201309789,SRX16500062,CTCF,270
chr1,201309549,201309816,SRX5075176,SMARCA4,267
chr1,201309617,201309852,SRX16500059,CTCF,235
chr1,201329333,201329654,SRX5075170,SMARCA4,321
chr1,201346547,201346967,SRX16500061,CTCF,420
chr1,201346569,201346906,SRX16500060,CTCF,337
chr1,201346598,201346946,SRX16500059,CTCF,348
chr1,201346630,201346948,SRX16500062,CTCF,318
chr1,201348133,201348463,SRX16500060,CTCF,330
chr1,201348143,201348489,SRX16500059,CTCF,346
chr1,201348162,201348435,SRX16500061,CTCF,273
chr1,201348189,201348486,SRX16500062,CTCF,297
chr1,201361471,201362042,SRX16500059,CTCF,571
chr1,201361575,201362044,SRX16500062,CTCF,469
chr1,201361588,201362061,SRX16500060,CTCF,473
chr1,201361595,201362019,SRX16500061,CTCF,424
chr1,201361673,201361960,SRX4174629,CTCF,287
chr1,201376410,201376767,SRX5075169,SMARCA4,357
chr1,201376443,201376747,SRX5716463,SMARCA4,304
chr1,201376443,201377197,SRX5075174,SMARCA4,754
chr1,201376464,201376843,SRX5716464,SMARCA4,379
chr1,201376482,201376677,SRX5075170,SMARCA4,195
chr1,201376485,201376887,SRX20140881,CPSF3L,402
chr1,201376507,201376817,SRX5075168,SMARCA4,310
chr1,201376541,201376822,SRX5716470,SMARCA4,281
chr1,201376605,201377115,SRX20140897,INTS13,510
chr1,201376615,201376935,SRX20140869,INTS10,320
chr1,201376770,201377333,SRX16500060,CTCF,563
chr1,201376795,201377334,SRX16500059,CTCF,539
chr1,201376821,201377224,SRX5716469,SMARCA4,403
chr1,201376839,201377248,SRX16500061,CTCF,409
chr1,201376841,201377241,SRX16500062,CTCF,400
chr1,201376881,201377161,SRX5075169,SMARCA4,280
chr1,201376890,201377205,SRX5075176,SMARCA4,315
chr1,201376896,201377194,SRX5075168,SMARCA4,298
chr1,201376897,201377152,SRX5075170,SMARCA4,255
chr1,201376903,201377161,SRX5716470,SMARCA4,258
chr1,201376909,201377189,SRX5075175,SMARCA4,280
chr1,201376984,201377195,SRX5716464,SMARCA4,211
chr1,201384010,201384599,SRX5075175,SMARCA4,589
chr1,201384037,201384478,SRX5075170,SMARCA4,441
chr1,201384051,201384491,SRX5075176,SMARCA4,440
chr1,201384058,201384417,SRX5054309,FOSL2,359
chr1,201384060,201384503,SRX5075169,SMARCA4,443
chr1,201384087,201384483,SRX5716470,SMARCA4,396
chr1,201384093,201384459,SRX5716467,SMARCA2,366
chr1,201384113,201384426,SRX5716468,SMARCA2,313
chr1,201384131,201384460,SRX5716469,SMARCA4,329
chr1,201384139,201384433,SRX5054308,FOSL2,294
chr1,201385233,201385740,SRX16500061,CTCF,507
chr1,201385262,201385734,SRX16500062,CTCF,472
chr1,201385275,201385744,SRX16500060,CTCF,469
chr1,201385287,201385728,SRX16500059,CTCF,441
chr1,201408139,201408645,SRX16500061,CTCF,506
chr1,201408145,201408618,SRX16500060,CTCF,473
chr1,201408153,201408639,SRX16500062,CTCF,486
chr1,201408165,201408677,SRX16500059,CTCF,512
chr1,201408208,201408612,SRX4174629,CTCF,404
chr1,201408237,201408421,SRX5075168,SMARCA4,184
chr1,201408255,201408457,SRX5075170,SMARCA4,202
chr1,201435468,201435932,SRX16500062,CTCF,464
chr1,201435576,201436047,SRX16500060,CTCF,471
chr1,201435610,201435939,SRX16500061,CTCF,329
chr1,201435629,201435956,SRX16500059,CTCF,327
chr1,201435702,201436064,SRX5075168,SMARCA4,362
chr1,201435708,201436051,SRX5075174,SMARCA4,343
chr1,201435718,201436106,SRX5075176,SMARCA4,388
chr1,201435761,201436065,SRX5075170,SMARCA4,304
chr1,201435778,201436031,SRX5075169,SMARCA4,253
chr1,201435780,201435990,SRX4174629,CTCF,210
chr1,201435803,201436047,SRX5716470,SMARCA4,244
chr1,201435832,201436130,SRX5075175,SMARCA4,298
chr1,201447976,201448546,SRX16500059,CTCF,570
chr1,201448020,201448503,SRX16500060,CTCF,483
chr1,201448033,201448503,SRX16500061,CTCF,470
chr1,201448072,201448506,SRX16500062,CTCF,434
chr1,201448102,201448510,SRX5716464,SMARCA4,408
chr1,201448129,201448556,SRX5075174,SMARCA4,427
chr1,201448150,201448653,SRX5075168,SMARCA4,503
chr1,201448164,201448481,SRX4174629,CTCF,317
chr1,201448211,201448559,SRX5075170,SMARCA4,348
chr1,201448249,201448633,SRX20140895,INTS13,384
chr1,201448268,201448526,SRX5716463,SMARCA4,258
chr1,201448272,201448503,SRX5075176,SMARCA4,231
chr1,201448292,201448526,SRX5716451,SOX2,234
chr1,201448297,201448542,SRX5716470,SMARCA4,245
chr1,201448310,201448656,SRX20140868,INTS10,346
chr1,201450892,201451347,SRX5075170,SMARCA4,455
chr1,201450934,201451329,SRX5075176,SMARCA4,395
chr1,201450961,201451319,SRX5075175,SMARCA4,358
chr1,201450995,201451374,SRX5075169,SMARCA4,379
chr1,201451038,201451280,SRX5716467,SMARCA2,242
chr1,201461133,201461455,SRX5054309,FOSL2,322
chr1,201461149,201461509,SRX5075175,SMARCA4,360
chr1,201461157,201461480,SRX5075174,SMARCA4,323
chr1,201461160,201461444,SRX5075170,SMARCA4,284
chr1,201461167,201461461,SRX5075169,SMARCA4,294
chr1,201461184,201461516,SRX5075168,SMARCA4,332
chr1,201461185,201461486,SRX5075176,SMARCA4,301
chr1,201461188,201461442,SRX5054308,FOSL2,254
chr1,201461221,201461408,SRX5054307,FOSL2,187
chr1,201461911,201462332,SRX5075169,SMARCA4,421
chr1,201461935,201462219,SRX5716467,SMARCA2,284
chr1,201461939,201462276,SRX5075176,SMARCA4,337
chr1,201461943,201462262,SRX5054308,FOSL2,319
chr1,201461945,201462305,SRX5075175,SMARCA4,360
chr1,201461949,201462279,SRX5075170,SMARCA4,330
chr1,201461950,201462294,SRX5716469,SMARCA4,344
chr1,201461952,201462293,SRX5054309,FOSL2,341
chr1,201462012,201462273,SRX5020211,SMARCA2,261
chr1,201468841,201469552,SRX20140895,INTS13,711
chr1,201468847,201469368,SRX20140868,INTS10,521
chr1,201469080,201469578,SRX5075174,SMARCA4,498
chr1,201469089,201469489,SRX5075168,SMARCA4,400
chr1,201469104,201469469,SRX5075175,SMARCA4,365
chr1,201469120,201469535,SRX5075169,SMARCA4,415
chr1,201469155,201469475,SRX5075176,SMARCA4,320
chr1,201469165,201469518,SRX5075170,SMARCA4,353
chr1,201469197,201469435,SRX5054309,FOSL2,238
chr1,201469199,201469553,SRX5716470,SMARCA4,354
chr1,201469204,201469473,SRX5716463,SMARCA4,269
chr1,201469232,201469412,SRX5054308,FOSL2,180
chr1,201471751,201472099,SRX5075176,SMARCA4,348
chr1,201471761,201472046,SRX5075175,SMARCA4,285
chr1,201471788,201472048,SRX5075169,SMARCA4,260
chr1,201471792,201472036,SRX5054308,FOSL2,244
chr1,201471815,201472008,SRX5054309,FOSL2,193
chr1,201471819,201472050,SRX5075170,SMARCA4,231
chr1,201481772,201482467,SRX16500062,CTCF,695
chr1,201481860,201482504,SRX16500059,CTCF,644
chr1,201481877,201482496,SRX16500060,CTCF,619
chr1,201481962,201482494,SRX16500061,CTCF,532
chr1,201482047,201482392,SRX4174629,CTCF,345
chr1,201482089,201482421,SRX5075168,SMARCA4,332
chr1,201482104,201482405,SRX5075176,SMARCA4,301
chr1,201482128,201482373,SRX5075174,SMARCA4,245
chr1,201489108,201489655,SRX5075176,SMARCA4,547
chr1,201489126,201489594,SRX5075170,SMARCA4,468
chr1,201489141,201489591,SRX5075169,SMARCA4,450
chr1,201489169,201489588,SRX5075175,SMARCA4,419
chr1,201489171,201489532,SRX5054309,FOSL2,361
chr1,201489173,201489600,SRX5716470,SMARCA4,427
chr1,201489184,201489476,SRX5054308,FOSL2,292
chr1,201489185,201489600,SRX5716469,SMARCA4,415
chr1,201489192,201489474,SRX5716468,SMARCA2,282
chr1,201489239,201489562,SRX5716467,SMARCA2,323
chr1,201489258,201489490,SRX5020214,SMARCA2,232
chr1,201503308,201503976,SRX5075170,SMARCA4,668
chr1,201503314,201503946,SRX5075176,SMARCA4,632
chr1,201503325,201503960,SRX5075169,SMARCA4,635
chr1,201503333,201503939,SRX5716469,SMARCA4,606
chr1,201503362,201503949,SRX5716470,SMARCA4,587
chr1,201503364,201503908,SRX5075174,SMARCA4,544
chr1,201503367,201503842,SRX5020211,SMARCA2,475
chr1,201503376,201503836,SRX5075175,SMARCA4,460
chr1,201503380,201503910,SRX5075168,SMARCA4,530
chr1,201503381,201503777,SRX5075181,SMARCA2,396
chr1,201503389,201503917,SRX5716467,SMARCA2,528
chr1,201503400,201503773,SRX5716468,SMARCA2,373
chr1,201503418,201503822,SRX5716463,SMARCA4,404
chr1,201503455,201503766,SRX20140869,INTS10,311
chr1,201503463,201503784,SRX5054308,FOSL2,321
chr1,201503471,201503883,SRX5054309,FOSL2,412
chr1,201503475,201503785,SRX5075182,SMARCA2,310
chr1,201503486,201503895,SRX5020214,SMARCA2,409
chr1,201503507,201503834,SRX5716464,SMARCA4,327
chr1,201503538,201503783,SRX5054307,FOSL2,245
chr1,201506897,201507220,SRX20140867,INTS10,323
chr1,201506989,201507237,SRX20140897,INTS13,248
chr1,201511781,201512272,SRX5075176,SMARCA4,491
chr1,201511845,201512234,SRX5075170,SMARCA4,389
chr1,201511872,201512087,SRX5716467,SMARCA2,215
chr1,201511944,201512166,SRX5075169,SMARCA4,222
chr1,201512006,201512277,SRX5075168,SMARCA4,271
chr1,201512720,201513434,SRX16500061,CTCF,714
chr1,201512772,201513438,SRX16500060,CTCF,666
chr1,201512797,201513457,SRX16500059,CTCF,660
chr1,201512802,201513429,SRX16500062,CTCF,627
chr1,201512850,201513631,SRX4174629,CTCF,781
chr1,201512929,201513358,SRX5075168,SMARCA4,429
chr1,201512956,201513280,SRX5075170,SMARCA4,324
chr1,201512962,201513290,SRX5075175,SMARCA4,328
chr1,201512969,201513386,SRX5075174,SMARCA4,417
chr1,201512998,201513292,SRX5075176,SMARCA4,294
chr1,201513022,201513275,SRX5716463,SMARCA4,253
chr1,201513031,201513323,SRX5716470,SMARCA4,292
chr1,201529065,201529257,SRX5054309,FOSL2,192
chr1,201530678,201531227,SRX16500062,CTCF,549
chr1,201530682,201531049,SRX5716470,SMARCA4,367
chr1,201530682,201531139,SRX5075170,SMARCA4,457
chr1,201530684,201531087,SRX5075176,SMARCA4,403
chr1,201530698,201531067,SRX5075175,SMARCA4,369
chr1,201530702,201531137,SRX5716469,SMARCA4,435
chr1,201530703,201531172,SRX16500059,CTCF,469
chr1,201530733,201531114,SRX4174629,CTCF,381
chr1,201530736,201531114,SRX16500061,CTCF,378
chr1,201530741,201531091,SRX5075169,SMARCA4,350
chr1,201530745,201531067,SRX5716467,SMARCA2,322
chr1,201530746,201531137,SRX16500060,CTCF,391
chr1,201530748,201531014,SRX5054308,FOSL2,266
chr1,201530801,201531072,SRX5716468,SMARCA2,271
chr1,201530801,201531108,SRX5075174,SMARCA4,307
chr1,201530811,201531049,SRX5075168,SMARCA4,238
chr1,201536580,201536823,SRX5075169,SMARCA4,243
chr1,201536596,201536802,SRX5054309,FOSL2,206
chr1,201538819,201539066,SRX20140894,INTS13,247
chr1,201538835,201539130,SRX5075168,SMARCA4,295
chr1,201538842,201539091,SRX5075175,SMARCA4,249
chr1,201538856,201539369,SRX20140868,INTS10,513
chr1,201538871,201539254,SRX5075174,SMARCA4,383
chr1,201538873,201539307,SRX20140867,INTS10,434
chr1,201538878,201539398,SRX20140895,INTS13,520
chr1,201551874,201552093,SRX5075169,SMARCA4,219
chr1,201551882,201552100,SRX5054309,FOSL2,218
chr1,201556883,201557084,SRX5054309,FOSL2,201
chr1,201556894,201557168,SRX5054308,FOSL2,274
chr1,201556895,201557164,SRX5075176,SMARCA4,269
chr1,201556923,201557204,SRX5075175,SMARCA4,281
chr1,201556925,201557195,SRX5075169,SMARCA4,270
chr1,201556947,201557207,SRX5075170,SMARCA4,260
chr1,201559566,201560092,SRX16500059,CTCF,526
chr1,201559584,201560075,SRX16500060,CTCF,491
chr1,201559607,201560063,SRX16500062,CTCF,456
chr1,201559611,201560130,SRX16500061,CTCF,519
chr1,201559626,201560117,SRX4174629,CTCF,491
chr1,201559664,201559952,SRX5075174,SMARCA4,288
chr1,201559739,201559918,SRX5075168,SMARCA4,179
chr1,201562263,201562795,SRX5075169,SMARCA4,532
chr1,201562266,201562612,SRX5075170,SMARCA4,346
chr1,201562268,201562595,SRX5075175,SMARCA4,327
chr1,201562280,201562742,SRX5075176,SMARCA4,462
chr1,201562290,201562655,SRX5716469,SMARCA4,365
chr1,201562357,201562554,SRX5054309,FOSL2,197
chr1,201562360,201562575,SRX5716467,SMARCA2,215
chr1,201562361,201562611,SRX5054308,FOSL2,250
chr1,201562745,201563023,SRX5054309,FOSL2,278
chr1,201562776,201563105,SRX5075170,SMARCA4,329
chr1,201562852,201563066,SRX5075169,SMARCA4,214
chr1,201562878,201563081,SRX5075175,SMARCA4,203
chr1,201584662,201584924,SRX5075176,SMARCA4,262
chr1,201585020,201585334,SRX5054308,FOSL2,314
chr1,201585103,201585382,SRX5054309,FOSL2,279
chr1,201593022,201593995,SRX5075176,SMARCA4,973
chr1,201593030,201594018,SRX5075170,SMARCA4,988
chr1,201593137,201593724,SRX5716470,SMARCA4,587
chr1,201593145,201593845,SRX5075169,SMARCA4,700
chr1,201593163,201593717,SRX5716468,SMARCA2,554
chr1,201593175,201593738,SRX5054309,FOSL2,563
chr1,201593182,201593557,SRX5020214,SMARCA2,375
chr1,201593187,201593603,SRX5075181,SMARCA2,416
chr1,201593187,201593695,SRX5716469,SMARCA4,508
chr1,201593193,201593720,SRX5054308,FOSL2,527
chr1,201593194,201593630,SRX5075182,SMARCA2,436
chr1,201593209,201593718,SRX5075175,SMARCA4,509
chr1,201593253,201593652,SRX5716467,SMARCA2,399
chr1,201593255,201593752,SRX5020211,SMARCA2,497
chr1,201594676,201594936,SRX5075168,SMARCA4,260
chr1,201594691,201594918,SRX5075175,SMARCA4,227
chr1,201594709,201594932,SRX5075174,SMARCA4,223
chr1,201602756,201603242,SRX5075169,SMARCA4,486
chr1,201602781,201603239,SRX5054309,FOSL2,458
chr1,201602816,201603177,SRX5716469,SMARCA4,361
chr1,201602828,201603215,SRX5075175,SMARCA4,387
chr1,201602832,201603173,SRX5075170,SMARCA4,341
chr1,201602833,201603192,SRX5075176,SMARCA4,359
chr1,201602878,201603196,SRX5054308,FOSL2,318
chr1,201602909,201603172,SRX5020214,SMARCA2,263
chr1,201602936,201603154,SRX5075174,SMARCA4,218
chr1,201614152,201614502,SRX5075169,SMARCA4,350
chr1,201614168,201614445,SRX5716469,SMARCA4,277
chr1,201614168,201614565,SRX5075174,SMARCA4,397
chr1,201614171,201614495,SRX5716464,SMARCA4,324
chr1,201614174,201614514,SRX5075170,SMARCA4,340
chr1,201614175,201614516,SRX5716470,SMARCA4,341
chr1,201614179,201614524,SRX5075176,SMARCA4,345
chr1,201614180,201614498,SRX5075175,SMARCA4,318
chr1,201614193,201614512,SRX5075168,SMARCA4,319
chr1,201625002,201625707,SRX5075169,SMARCA4,705
chr1,201625075,201625708,SRX5075176,SMARCA4,633
chr1,201625108,201625706,SRX5075175,SMARCA4,598
chr1,201625130,201625713,SRX5075170,SMARCA4,583
chr1,201625137,201625703,SRX5054309,FOSL2,566
chr1,201625153,201625609,SRX5716470,SMARCA4,456
chr1,201625161,201625651,SRX5054308,FOSL2,490
chr1,201625165,201625655,SRX5716467,SMARCA2,490
chr1,201625198,201625609,SRX5075181,SMARCA2,411
chr1,201625214,201625575,SRX5075182,SMARCA2,361
chr1,201625216,201625678,SRX5716469,SMARCA4,462
chr1,201625217,201625659,SRX5020214,SMARCA2,442
chr1,201625258,201625674,SRX5020211,SMARCA2,416
chr1,201630665,201630996,SRX5075176,SMARCA4,331
chr1,201630706,201630958,SRX5075170,SMARCA4,252
chr1,201636592,201636892,SRX5075169,SMARCA4,300
chr1,201637846,201638034,SRX5075170,SMARCA4,188
chr1,201650041,201650648,SRX20140895,INTS13,607
chr1,201653331,201653526,SRX5075174,SMARCA4,195
chr1,201655125,201655536,SRX5075170,SMARCA4,411
chr1,201655157,201655564,SRX5075176,SMARCA4,407
chr1,201655262,201655557,SRX5075175,SMARCA4,295
chr1,201655306,201655495,SRX5075169,SMARCA4,189
chr1,201655315,201655549,SRX5716467,SMARCA2,234
chr1,201656667,201657081,SRX5075176,SMARCA4,414
chr1,201656694,201657051,SRX5075169,SMARCA4,357
chr1,201656704,201657083,SRX5075170,SMARCA4,379
chr1,201656708,201657058,SRX5716470,SMARCA4,350
chr1,201656721,201657005,SRX5716468,SMARCA2,284
chr1,201656745,201657033,SRX5075175,SMARCA4,288
chr1,201656751,201657005,SRX5020211,SMARCA2,254
chr1,201656768,201657026,SRX5716469,SMARCA4,258
chr1,201656772,201656987,SRX5716467,SMARCA2,215
chr1,201674046,201674384,SRX5075174,SMARCA4,338
chr1,201674183,201674440,SRX5716463,SMARCA4,257
chr1,201674193,201674381,SRX5075168,SMARCA4,188
chr1,201676107,201676604,SRX5075176,SMARCA4,497
chr1,201676154,201676426,SRX5075170,SMARCA4,272
chr1,201676185,201676418,SRX5716467,SMARCA2,233
chr1,201676671,201676909,SRX5716467,SMARCA2,238
chr1,201678554,201678773,SRX5075168,SMARCA4,219
chr1,201678616,201679319,SRX5075170,SMARCA4,703
chr1,201678753,201678965,SRX5075174,SMARCA4,212
chr1,201678755,201679356,SRX5075176,SMARCA4,601
chr1,201686796,201686994,SRX5075168,SMARCA4,198
chr1,201693892,201694343,SRX5075174,SMARCA4,451
chr1,201693894,201694372,SRX5075168,SMARCA4,478
chr1,201696182,201696874,SRX5075176,SMARCA4,692
chr1,201696251,201696883,SRX5075170,SMARCA4,632
chr1,201696398,201696855,SRX5075169,SMARCA4,457
chr1,201696433,201696856,SRX5716467,SMARCA2,423
chr1,201696437,201696710,SRX5716468,SMARCA2,273
chr1,201696441,201696873,SRX5075175,SMARCA4,432
chr1,201696460,201696771,SRX5716469,SMARCA4,311
chr1,201696506,201696844,SRX5054308,FOSL2,338
chr1,201696524,201696818,SRX5054309,FOSL2,294
chr1,201696556,201696757,SRX5020211,SMARCA2,201
chr1,201703039,201703236,SRX5075174,SMARCA4,197
chr1,201704124,201704633,SRX16500059,CTCF,509
chr1,201704129,201704631,SRX16500060,CTCF,502
chr1,201704143,201704610,SRX16500061,CTCF,467
chr1,201704162,201704464,SRX5075170,SMARCA4,302
chr1,201704180,201704614,SRX16500062,CTCF,434
chr1,201704188,201704569,SRX4174629,CTCF,381
chr1,201704191,201704415,SRX5716470,SMARCA4,224
chr1,201704196,201704502,SRX5075174,SMARCA4,306
chr1,201704223,201704491,SRX5075168,SMARCA4,268
chr1,201704245,201704482,SRX5075175,SMARCA4,237
chr1,201704253,201704489,SRX5075169,SMARCA4,236
chr1,201704268,201704502,SRX5075176,SMARCA4,234
chr1,201709365,201709915,SRX16500061,CTCF,550
chr1,201709422,201709926,SRX16500060,CTCF,504
chr1,201709434,201709934,SRX16500059,CTCF,500
chr1,201709439,201709910,SRX16500062,CTCF,471
chr1,201709485,201709935,SRX4174629,CTCF,450
chr1,201709566,201709774,SRX5075168,SMARCA4,208
chr1,201713392,201713812,SRX5075176,SMARCA4,420
chr1,201713404,201713788,SRX5075170,SMARCA4,384
chr1,201713407,201713804,SRX5075169,SMARCA4,397
chr1,201713410,201713762,SRX5716467,SMARCA2,352
chr1,201713412,201713758,SRX5716470,SMARCA4,346
chr1,201713423,201713768,SRX5716469,SMARCA4,345
chr1,201713430,201713825,SRX5075175,SMARCA4,395
chr1,201713442,201713748,SRX5054309,FOSL2,306
chr1,201713460,201713731,SRX5054308,FOSL2,271
chr1,201713462,201713727,SRX5716468,SMARCA2,265
chr1,201714631,201714964,SRX5075169,SMARCA4,333
chr1,201714632,201714962,SRX5054309,FOSL2,330
chr1,201714648,201715009,SRX5075170,SMARCA4,361
chr1,201714654,201714991,SRX5075175,SMARCA4,337
chr1,201714658,201714964,SRX5054308,FOSL2,306
chr1,201714662,201715012,SRX5075176,SMARCA4,350
chr1,201714663,201714904,SRX5020214,SMARCA2,241
chr1,201714724,201714977,SRX5716469,SMARCA4,253
chr1,201719859,201720117,SRX5075176,SMARCA4,258
chr1,201719885,201720149,SRX5075170,SMARCA4,264
chr1,201719944,201720129,SRX5075169,SMARCA4,185
chr1,201724768,201724979,SRX5075170,SMARCA4,211
chr1,201737617,201738040,SRX5716470,SMARCA4,423
chr1,201737650,201737992,SRX5075169,SMARCA4,342
chr1,201737665,201737892,SRX5020214,SMARCA2,227
chr1,201737665,201738005,SRX5716469,SMARCA4,340
chr1,201737673,201738088,SRX5075176,SMARCA4,415
chr1,201737681,201738007,SRX5716467,SMARCA2,326
chr1,201737688,201737945,SRX5716468,SMARCA2,257
chr1,201737690,201737925,SRX5020211,SMARCA2,235
chr1,201737693,201737955,SRX5075170,SMARCA4,262
chr1,201737693,201738009,SRX5075175,SMARCA4,316
chr1,201737694,201737888,SRX5075181,SMARCA2,194
chr1,201737694,201737910,SRX5054309,FOSL2,216
chr1,201737765,201737952,SRX5054308,FOSL2,187
chr1,201739492,201739904,SRX20140895,INTS13,412
chr1,201739754,201739948,SRX5075168,SMARCA4,194
chr1,201745142,201745335,SRX5054308,FOSL2,193
chr1,201748380,201748750,SRX5054309,FOSL2,370
chr1,201748386,201748759,SRX5716469,SMARCA4,373
chr1,201748415,201748720,SRX5075170,SMARCA4,305
chr1,201748415,201748726,SRX5075169,SMARCA4,311
chr1,201748433,201748720,SRX5075176,SMARCA4,287
chr1,201748443,201748714,SRX5075175,SMARCA4,271
chr1,201748471,201748686,SRX5716467,SMARCA2,215
chr1,201748474,201748697,SRX5020214,SMARCA2,223
chr1,201748480,201748710,SRX5054308,FOSL2,230
chr1,201751812,201752312,SRX5075168,SMARCA4,500
chr1,201751838,201752422,SRX5075174,SMARCA4,584
chr1,201751907,201752209,SRX5716451,SOX2,302
chr1,201751921,201752585,SRX20140895,INTS13,664
chr1,201751937,201752257,SRX5716463,SMARCA4,320
chr1,201751952,201752429,SRX20140868,INTS10,477
chr1,201760481,201760836,SRX5075168,SMARCA4,355
chr1,201760559,201760941,SRX5075174,SMARCA4,382
chr1,201760560,201760765,SRX5075169,SMARCA4,205
chr1,201766131,201766468,SRX5075169,SMARCA4,337
chr1,201766176,201766503,SRX5075176,SMARCA4,327
chr1,201766181,201766517,SRX5075170,SMARCA4,336
chr1,201766185,201766444,SRX5075175,SMARCA4,259
chr1,201766201,201766491,SRX5716470,SMARCA4,290
chr1,201766202,201766430,SRX5054309,FOSL2,228
chr1,201766210,201766499,SRX5020211,SMARCA2,289
chr1,201766211,201766459,SRX5716467,SMARCA2,248
chr1,201766221,201766453,SRX5054308,FOSL2,232
chr1,201766246,201766487,SRX5075181,SMARCA2,241
chr1,201766291,201766502,SRX5716468,SMARCA2,211
chr1,201781377,201781694,SRX5075170,SMARCA4,317
chr1,201781472,201781725,SRX5075176,SMARCA4,253
chr1,201781494,201781739,SRX5075169,SMARCA4,245
chr1,201781535,201781745,SRX5075175,SMARCA4,210
chr1,201790297,201790636,SRX5075170,SMARCA4,339
chr1,201790298,201790577,SRX5075175,SMARCA4,279
chr1,201790308,201790618,SRX5075176,SMARCA4,310
chr1,201790310,201790622,SRX5075169,SMARCA4,312
chr1,201790320,201790541,SRX5054309,FOSL2,221
chr1,201790331,201790632,SRX5054308,FOSL2,301
chr1,201790338,201790563,SRX5716467,SMARCA2,225
chr1,201791454,201792183,SRX5075176,SMARCA4,729
chr1,201791514,201792242,SRX5075170,SMARCA4,728
chr1,201791825,201792218,SRX5075169,SMARCA4,393
chr1,201791845,201792143,SRX5716469,SMARCA4,298
chr1,201791879,201792119,SRX5716467,SMARCA2,240
chr1,201791881,201792158,SRX5075175,SMARCA4,277
chr1,201792916,201793498,SRX16500060,CTCF,582
chr1,201792947,201793454,SRX16500062,CTCF,507
chr1,201792963,201793489,SRX16500061,CTCF,526
chr1,201792971,201793497,SRX16500059,CTCF,526
chr1,201793012,201793315,SRX5075174,SMARCA4,303
chr1,201793022,201793431,SRX4174629,CTCF,409
chr1,201793120,201793295,SRX5075176,SMARCA4,175
chr1,201828768,201829289,SRX16500062,CTCF,521
chr1,201828773,201829350,SRX16500060,CTCF,577
chr1,201828784,201829297,SRX16500061,CTCF,513
chr1,201828798,201829276,SRX16500059,CTCF,478
chr1,201828881,201829281,SRX5075168,SMARCA4,400
chr1,201828895,201829269,SRX5075174,SMARCA4,374
chr1,201828896,201829286,SRX5075176,SMARCA4,390
chr1,201828902,201829143,SRX5716451,SOX2,241
chr1,201828910,201829144,SRX5075170,SMARCA4,234
chr1,201828945,201829210,SRX5716463,SMARCA4,265
chr1,201828958,201829566,SRX20140895,INTS13,608
chr1,201828973,201829411,SRX20140868,INTS10,438
chr1,201828974,201829454,SRX20140867,INTS10,480
chr1,201828991,201829460,SRX20140869,INTS10,469
chr1,201829001,201829472,SRX20140894,INTS13,471
chr1,201829007,201829455,SRX20140896,INTS13,448
chr1,201829011,201829278,SRX5716464,SMARCA4,267
chr1,201829014,201829515,SRX20140897,INTS13,501
chr1,201829048,201829446,SRX20140879,CPSF3L,398
chr1,201829058,201829492,SRX20140881,CPSF3L,434
chr1,201849815,201850312,SRX5054309,FOSL2,497
chr1,201849816,201850368,SRX5075169,SMARCA4,552
chr1,201849826,201850348,SRX5716469,SMARCA4,522
chr1,201849867,201850179,SRX5716459,Epitope tags,312
chr1,201849867,201850505,SRX5075175,SMARCA4,638
chr1,201849874,201850466,SRX5075176,SMARCA4,592
chr1,201849881,201850355,SRX5075174,SMARCA4,474
chr1,201849886,201850282,SRX5054308,FOSL2,396
chr1,201849915,201850253,SRX5075168,SMARCA4,338
chr1,201849930,201850400,SRX5075170,SMARCA4,470
chr1,201849970,201850369,SRX5716470,SMARCA4,399
chr1,201850034,201850331,SRX5716467,SMARCA2,297
chr1,201850041,201850402,SRX5020214,SMARCA2,361
chr1,201850082,201850339,SRX5075182,SMARCA2,257
chr1,201850112,201850328,SRX5020211,SMARCA2,216
chr1,201850112,201850445,SRX5716468,SMARCA2,333
chr1,201850131,201850409,SRX5075181,SMARCA2,278
chr1,201877796,201878259,SRX16500061,CTCF,463
chr1,201877815,201878219,SRX16500062,CTCF,404
chr1,201877836,201878273,SRX16500060,CTCF,437
chr1,201877844,201878267,SRX16500059,CTCF,423
chr1,201877898,201878122,SRX5075174,SMARCA4,224
chr1,201877978,201878175,SRX5075168,SMARCA4,197
chr1,201882786,201883021,SRX5075169,SMARCA4,235
chr1,201882817,201883022,SRX5075175,SMARCA4,205
chr1,201882850,201883059,SRX5075170,SMARCA4,209
chr1,201882854,201883055,SRX5075176,SMARCA4,201
chr1,201883746,201883926,SRX5054308,FOSL2,180
chr1,201883762,201883957,SRX5075170,SMARCA4,195
chr1,201883766,201883966,SRX5075176,SMARCA4,200
chr1,201883768,201883950,SRX5075169,SMARCA4,182
chr1,201888624,201888841,SRX5716469,SMARCA4,217
chr1,201888678,201889049,SRX5075176,SMARCA4,371
chr1,201888694,201888929,SRX5075170,SMARCA4,235
chr1,201888727,201889001,SRX5075175,SMARCA4,274
chr1,201888749,201889057,SRX5075168,SMARCA4,308
chr1,201888758,201889132,SRX5075174,SMARCA4,374
chr1,201895825,201896303,SRX16500060,CTCF,478
chr1,201895832,201896290,SRX16500061,CTCF,458
chr1,201895836,201896317,SRX16500059,CTCF,481
chr1,201895869,201896308,SRX16500062,CTCF,439
chr1,201895925,201896295,SRX4174629,CTCF,370
chr1,201895925,201896312,SRX5075174,SMARCA4,387
chr1,201895932,201896291,SRX5075168,SMARCA4,359
chr1,201895982,201896319,SRX5075176,SMARCA4,337
chr1,201895988,201896310,SRX5716469,SMARCA4,322
chr1,201895997,201896291,SRX5716464,SMARCA4,294
chr1,201895997,201896306,SRX5075170,SMARCA4,309
chr1,201896007,201896287,SRX5075175,SMARCA4,280
chr1,201896018,201896268,SRX5075169,SMARCA4,250
chr1,201896026,201896269,SRX5054308,FOSL2,243
chr1,201896032,201896310,SRX5054309,FOSL2,278
chr1,201896056,201896344,SRX5716470,SMARCA4,288
chr1,201896058,201896276,SRX5716463,SMARCA4,218
chr1,201903135,201903414,SRX5716470,SMARCA4,279
chr1,201903173,201903443,SRX5075170,SMARCA4,270
chr1,201903183,201903520,SRX5075169,SMARCA4,337
chr1,201903198,201903451,SRX5075175,SMARCA4,253
chr1,201903256,201903482,SRX5075176,SMARCA4,226
chr1,201904515,201905036,SRX5075176,SMARCA4,521
chr1,201904515,201905049,SRX5075170,SMARCA4,534
chr1,201904530,201905053,SRX5075175,SMARCA4,523
chr1,201904551,201904829,SRX5020211,SMARCA2,278
chr1,201904557,201904950,SRX5716469,SMARCA4,393
chr1,201904558,201904947,SRX5075169,SMARCA4,389
chr1,201904561,201904895,SRX5716470,SMARCA4,334
chr1,201904580,201904885,SRX5716468,SMARCA2,305
chr1,201904599,201904914,SRX5054309,FOSL2,315
chr1,201904612,201904820,SRX5054308,FOSL2,208
chr1,201904644,201904890,SRX5716467,SMARCA2,246
chr1,201904745,201904943,SRX5075168,SMARCA4,198
chr1,201911727,201912201,SRX5075176,SMARCA4,474
chr1,201911784,201912033,SRX5716470,SMARCA4,249
chr1,201911828,201912154,SRX5075170,SMARCA4,326
chr1,201916599,201917035,SRX5075169,SMARCA4,436
chr1,201916622,201917111,SRX5075176,SMARCA4,489
chr1,201916623,201917038,SRX5075170,SMARCA4,415
chr1,201916658,201916997,SRX5716469,SMARCA4,339
chr1,201916692,201917014,SRX5716467,SMARCA2,322
chr1,201916704,201916964,SRX5716468,SMARCA2,260
chr1,201916710,201917073,SRX5716470,SMARCA4,363
chr1,201916719,201916969,SRX5054309,FOSL2,250
chr1,201916724,201917062,SRX5075175,SMARCA4,338
chr1,201916769,201916949,SRX5054308,FOSL2,180
chr1,201917434,201917621,SRX5075175,SMARCA4,187
chr1,201917439,201917697,SRX5054309,FOSL2,258
chr1,201917480,201917706,SRX5054308,FOSL2,226
chr1,201917493,201917668,SRX5075176,SMARCA4,175
chr1,201917533,201917755,SRX5075170,SMARCA4,222
chr1,201925986,201926390,SRX5075176,SMARCA4,404
chr1,201925987,201926273,SRX5075170,SMARCA4,286
chr1,201926016,201926227,SRX5716470,SMARCA4,211
chr1,201926097,201926284,SRX5075175,SMARCA4,187
chr1,201937879,201938244,SRX5054309,FOSL2,365
chr1,201937890,201938158,SRX5075169,SMARCA4,268
chr1,201937899,201938103,SRX5075176,SMARCA4,204
chr1,201937909,201938225,SRX5054308,FOSL2,316
chr1,201937940,201938148,SRX5075170,SMARCA4,208
chr1,201937970,201938225,SRX5075175,SMARCA4,255
chr1,201937999,201938211,SRX5716469,SMARCA4,212
chr1,201941516,201941817,SRX20140869,INTS10,301
chr1,201941532,201941888,SRX20140895,INTS13,356
chr1,201945231,201945452,SRX16500060,CTCF,221
chr1,201945255,201945592,SRX16500059,CTCF,337
chr1,201946382,201946824,SRX5075168,SMARCA4,442
chr1,201946407,201946802,SRX5075174,SMARCA4,395
chr1,201946502,201946764,SRX5716464,SMARCA4,262
chr1,201946532,201946766,SRX5075170,SMARCA4,234
chr1,201946562,201946803,SRX5716470,SMARCA4,241
chr1,201946563,201946825,SRX5075176,SMARCA4,262
chr1,201946579,201946829,SRX5075175,SMARCA4,250
chr1,201946592,201946802,SRX5716463,SMARCA4,210
chr1,201949542,201949824,SRX5716467,SMARCA2,282
chr1,201949566,201949830,SRX5075170,SMARCA4,264
chr1,201949577,201949810,SRX5075176,SMARCA4,233
chr1,201954970,201955539,SRX20140869,INTS10,569
chr1,201955040,201955687,SRX20140895,INTS13,647
chr1,201955077,201955475,SRX5075170,SMARCA4,398
chr1,201955127,201955578,SRX20140897,INTS13,451
chr1,201955131,201955643,SRX5075176,SMARCA4,512
chr1,201955155,201955335,SRX5075169,SMARCA4,180
chr1,201955167,201955589,SRX5075168,SMARCA4,422
chr1,201955167,201955609,SRX5075174,SMARCA4,442
chr1,201955168,201955360,SRX5075175,SMARCA4,192
chr1,201955168,201955407,SRX20140879,CPSF3L,239
chr1,201955187,201955488,SRX5716463,SMARCA4,301
chr1,201955198,201955429,SRX5716470,SMARCA4,231
chr1,201955218,201955569,SRX20140867,INTS10,351
chr1,201955247,201955557,SRX5054309,FOSL2,310
chr1,201972556,201973060,SRX16500060,CTCF,504
chr1,201972591,201973031,SRX16500059,CTCF,440
chr1,201972592,201973018,SRX16500062,CTCF,426
chr1,201972631,201973004,SRX16500061,CTCF,373
chr1,201972668,201972891,SRX5075176,SMARCA4,223
chr1,201972677,201972900,SRX5075170,SMARCA4,223
chr1,201982391,201982787,SRX5075168,SMARCA4,396
chr1,201982400,201982756,SRX5075174,SMARCA4,356
chr1,201982425,201982847,SRX5075170,SMARCA4,422
chr1,201982429,201982838,SRX5075169,SMARCA4,409
chr1,201982474,201983503,SRX20140895,INTS13,1029
chr1,201982535,201982903,SRX20140867,INTS10,368
chr1,201982562,201982975,SRX20140897,INTS13,413
chr1,201982562,201983306,SRX20140868,INTS10,744
chr1,201982584,201983101,SRX5075175,SMARCA4,517
chr1,201982628,201982850,SRX5716470,SMARCA4,222
chr1,201982674,201982906,SRX5075176,SMARCA4,232
chr1,201982864,201983074,SRX16500062,CTCF,210
chr1,201983159,201983409,SRX5075176,SMARCA4,250
chr1,201983187,201983498,SRX5075170,SMARCA4,311
chr1,201983286,201983569,SRX5075169,SMARCA4,283
chr1,201983312,201983487,SRX5075174,SMARCA4,175
chr1,201999561,202000186,SRX16500062,CTCF,625
chr1,201999581,202000054,SRX16500060,CTCF,473
chr1,201999599,202000060,SRX16500059,CTCF,461
chr1,201999600,202000073,SRX16500061,CTCF,473
chr1,201999661,202000005,SRX4174629,CTCF,344
chr1,201999744,201999937,SRX5075174,SMARCA4,193
chr1,202009421,202009990,SRX16500060,CTCF,569
chr1,202009423,202010017,SRX16500059,CTCF,594
chr1,202009449,202009910,SRX4174629,CTCF,461
chr1,202009460,202009988,SRX16500061,CTCF,528
chr1,202009479,202009939,SRX16500062,CTCF,460
chr1,202009563,202009782,SRX5075168,SMARCA4,219
chr1,202009597,202009836,SRX5075176,SMARCA4,239
chr1,202009608,202009817,SRX5075170,SMARCA4,209
chr1,202009653,202009853,SRX5075174,SMARCA4,200
chr1,202009658,202009892,SRX5075175,SMARCA4,234
chr1,202019212,202019381,SRX5075170,SMARCA4,169
chr1,202022249,202022507,SRX5054309,FOSL2,258
chr1,202022283,202022507,SRX5054308,FOSL2,224
chr1,202022299,202022495,SRX5075169,SMARCA4,196
chr1,202022337,202022547,SRX5075175,SMARCA4,210
chr1,202029042,202029651,SRX5075176,SMARCA4,609
chr1,202029090,202029533,SRX5054308,FOSL2,443
chr1,202029101,202029609,SRX5075169,SMARCA4,508
chr1,202029110,202029576,SRX5075175,SMARCA4,466
chr1,202029121,202029508,SRX5054309,FOSL2,387
chr1,202029123,202029571,SRX5716469,SMARCA4,448
chr1,202029126,202029422,SRX5020214,SMARCA2,296
chr1,202029150,202029595,SRX5075170,SMARCA4,445
chr1,202029184,202029394,SRX5020211,SMARCA2,210
chr1,202029189,202029501,SRX5716467,SMARCA2,312
chr1,202029192,202029528,SRX5716470,SMARCA4,336
chr1,202034710,202035209,SRX5075175,SMARCA4,499
chr1,202034723,202035217,SRX5716470,SMARCA4,494
chr1,202034741,202035266,SRX5075169,SMARCA4,525
chr1,202034758,202035195,SRX5075170,SMARCA4,437
chr1,202034790,202035190,SRX5075176,SMARCA4,400
chr1,202034822,202035219,SRX5716469,SMARCA4,397
chr1,202034843,202035137,SRX5020211,SMARCA2,294
chr1,202034878,202035155,SRX5054308,FOSL2,277
chr1,202034880,202035148,SRX5054309,FOSL2,268
chr1,202034881,202035196,SRX5716467,SMARCA2,315
chr1,202035797,202036093,SRX5716468,SMARCA2,296
chr1,202035810,202036021,SRX5716470,SMARCA4,211
chr1,202035820,202036050,SRX5716469,SMARCA4,230
chr1,202035829,202036131,SRX5716467,SMARCA2,302
chr1,202035840,202036061,SRX5075175,SMARCA4,221
chr1,202035843,202036056,SRX5075176,SMARCA4,213
chr1,202035844,202036062,SRX5075170,SMARCA4,218
chr1,202035845,202036025,SRX5075169,SMARCA4,180
chr1,202058222,202058426,SRX5054308,FOSL2,204
chr1,202063062,202063338,SRX5075168,SMARCA4,276
chr1,202063139,202063467,SRX5075169,SMARCA4,328
chr1,202063215,202063450,SRX5075175,SMARCA4,235
chr1,202063247,202063431,SRX5075170,SMARCA4,184
chr1,202085406,202085602,SRX5075168,SMARCA4,196
chr1,202105498,202105958,SRX5075168,SMARCA4,460
chr1,202105511,202106064,SRX5075174,SMARCA4,553
chr1,202105582,202105830,SRX5075169,SMARCA4,248
chr1,202105587,202105934,SRX5716463,SMARCA4,347
chr1,202105603,202105805,SRX5054309,FOSL2,202
chr1,202105613,202105905,SRX5075175,SMARCA4,292
chr1,202112871,202113071,SRX5075170,SMARCA4,200
chr1,202118888,202119369,SRX16500060,CTCF,481
chr1,202118934,202119319,SRX16500062,CTCF,385
chr1,202118946,202119382,SRX16500059,CTCF,436
chr1,202118951,202119342,SRX4174629,CTCF,391
chr1,202118966,202119336,SRX16500061,CTCF,370
chr1,202118984,202119247,SRX5075176,SMARCA4,263
chr1,202119056,202119225,SRX5075170,SMARCA4,169
chr1,202122594,202122928,SRX16500060,CTCF,334
chr1,202122611,202122992,SRX16500061,CTCF,381
chr1,202122613,202122959,SRX16500062,CTCF,346
chr1,202122630,202122969,SRX16500059,CTCF,339
chr1,202122693,202122942,SRX5075174,SMARCA4,249
chr1,202122706,202122921,SRX5075168,SMARCA4,215
chr1,202130402,202130682,SRX5075174,SMARCA4,280
chr1,202130413,202130723,SRX5075168,SMARCA4,310
chr1,202135075,202135592,SRX16500060,CTCF,517
chr1,202135117,202135574,SRX16500059,CTCF,457
chr1,202135127,202135612,SRX16500061,CTCF,485
chr1,202135144,202135539,SRX4174629,CTCF,395
chr1,202135150,202135522,SRX16500062,CTCF,372
chr1,202135189,202135407,SRX5716470,SMARCA4,218
chr1,202135207,202135477,SRX5075168,SMARCA4,270
chr1,202135211,202135486,SRX5075174,SMARCA4,275
chr1,202135242,202135429,SRX5075176,SMARCA4,187
chr1,202135253,202135435,SRX5075169,SMARCA4,182
chr1,202135255,202135481,SRX5075170,SMARCA4,226
chr1,202135293,202135501,SRX5716463,SMARCA4,208
chr1,202143787,202144125,SRX20140895,INTS13,338
chr1,202143860,202144085,SRX5075174,SMARCA4,225
chr1,202144511,202145051,SRX20140895,INTS13,540
chr1,202144539,202144918,SRX5075170,SMARCA4,379
chr1,202144592,202144923,SRX5716470,SMARCA4,331
chr1,202144596,202144901,SRX5075168,SMARCA4,305
chr1,202144613,202144853,SRX5075176,SMARCA4,240
chr1,202144617,202144852,SRX5075169,SMARCA4,235
chr1,202144639,202144883,SRX20140867,INTS10,244
chr1,202144654,202144992,SRX5075174,SMARCA4,338
chr1,202144778,202145023,SRX5716469,SMARCA4,245
chr1,202144906,202145134,SRX5075176,SMARCA4,228
chr1,202154779,202155105,SRX16500062,CTCF,326
chr1,202154875,202155177,SRX16500060,CTCF,302
chr1,202154886,202155060,SRX5075174,SMARCA4,174
chr1,202154900,202155156,SRX16500061,CTCF,256
chr1,202154921,202155127,SRX5075168,SMARCA4,206
chr1,202154925,202155140,SRX5075176,SMARCA4,215
chr1,202154928,202155205,SRX16500059,CTCF,277
chr1,202167734,202167903,SRX5075170,SMARCA4,169
chr1,202184602,202185087,SRX16500062,CTCF,485
chr1,202184605,202185056,SRX16500060,CTCF,451
chr1,202184610,202185099,SRX16500059,CTCF,489
chr1,202184621,202185037,SRX16500061,CTCF,416
chr1,202184625,202184924,SRX5716464,SMARCA4,299
chr1,202184658,202185062,SRX5716470,SMARCA4,404
chr1,202184670,202185017,SRX5075170,SMARCA4,347
chr1,202184674,202184989,SRX5075169,SMARCA4,315
chr1,202184679,202185046,SRX5075168,SMARCA4,367
chr1,202184679,202185092,SRX5075174,SMARCA4,413
chr1,202184692,202184929,SRX5716463,SMARCA4,237
chr1,202184708,202184948,SRX4174629,CTCF,240
chr1,202184715,202185071,SRX5075175,SMARCA4,356
chr1,202184722,202184965,SRX5716469,SMARCA4,243
chr1,202184736,202184962,SRX5075176,SMARCA4,226
chr1,202188935,202189344,SRX16500059,CTCF,409
chr1,202188945,202189298,SRX16500060,CTCF,353
chr1,202188958,202189185,SRX4174629,CTCF,227
chr1,202188960,202189303,SRX16500061,CTCF,343
chr1,202188967,202189300,SRX16500062,CTCF,333
chr1,202192787,202193209,SRX16500060,CTCF,422
chr1,202192816,202193273,SRX16500059,CTCF,457
chr1,202192838,202193213,SRX16500061,CTCF,375
chr1,202192841,202193214,SRX16500062,CTCF,373
chr1,202192862,202193114,SRX5075174,SMARCA4,252
chr1,202192874,202193145,SRX5075168,SMARCA4,271
chr1,202192920,202193100,SRX5075169,SMARCA4,180
chr1,202192936,202193154,SRX5075176,SMARCA4,218
chr1,202200295,202200482,SRX5075175,SMARCA4,187
chr1,202207348,202207715,SRX5075170,SMARCA4,367
chr1,202207399,202207695,SRX5075169,SMARCA4,296
chr1,202207407,202207738,SRX5075176,SMARCA4,331
chr1,202207408,202207685,SRX5716470,SMARCA4,277
chr1,202207437,202207683,SRX5075175,SMARCA4,246
chr1,202207474,202207690,SRX5716469,SMARCA4,216
chr1,202213519,202213740,SRX16500060,CTCF,221
chr1,202214340,202214565,SRX5075174,SMARCA4,225
chr1,202214423,202214628,SRX5075170,SMARCA4,205
chr1,202222245,202222586,SRX5075168,SMARCA4,341
chr1,202222332,202222647,SRX5075176,SMARCA4,315
chr1,202222357,202222593,SRX5054309,FOSL2,236
chr1,202222359,202222669,SRX5075174,SMARCA4,310
chr1,202222387,202222627,SRX5075169,SMARCA4,240
chr1,202222404,202222606,SRX5075170,SMARCA4,202
chr1,202235765,202236253,SRX5075175,SMARCA4,488
chr1,202235766,202236155,SRX5716470,SMARCA4,389
chr1,202235776,202236221,SRX5075169,SMARCA4,445
chr1,202235811,202236147,SRX5075174,SMARCA4,336
chr1,202235833,202236235,SRX5054309,FOSL2,402
chr1,202235844,202236202,SRX5054308,FOSL2,358
chr1,202235846,202236211,SRX5075170,SMARCA4,365
chr1,202235856,202236202,SRX5716469,SMARCA4,346
chr1,202235862,202236105,SRX5716467,SMARCA2,243
chr1,202235863,202236326,SRX5716460,Epitope tags,463
chr1,202235870,202236185,SRX5075168,SMARCA4,315
chr1,202235870,202236210,SRX5075176,SMARCA4,340
chr1,202235904,202236118,SRX5020214,SMARCA2,214
chr1,202235930,202236109,SRX5054307,FOSL2,179
chr1,202236283,202236683,SRX16500061,CTCF,400
chr1,202236284,202236821,SRX16500059,CTCF,537
chr1,202236320,202236787,SRX16500060,CTCF,467
chr1,202236329,202236732,SRX16500062,CTCF,403
chr1,202236969,202237404,SRX16500059,CTCF,435
chr1,202237141,202237434,SRX16500062,CTCF,293
chr1,202237184,202237446,SRX16500061,CTCF,262
chr1,202237210,202237497,SRX16500060,CTCF,287
chr1,202281288,202281681,SRX5075169,SMARCA4,393
chr1,202281313,202281693,SRX5075176,SMARCA4,380
chr1,202281314,202281559,SRX5054309,FOSL2,245
chr1,202281323,202281672,SRX5075170,SMARCA4,349
chr1,202281345,202281654,SRX5075175,SMARCA4,309
chr1,202281350,202281625,SRX5716469,SMARCA4,275
chr1,202281351,202281695,SRX5716470,SMARCA4,344
chr1,202283214,202283723,SRX5075170,SMARCA4,509
chr1,202283215,202283691,SRX5075176,SMARCA4,476
chr1,202283255,202283630,SRX5020211,SMARCA2,375
chr1,202283280,202283664,SRX5716470,SMARCA4,384
chr1,202283289,202283629,SRX5716467,SMARCA2,340
chr1,202283292,202283650,SRX5075169,SMARCA4,358
chr1,202283306,202283659,SRX5716469,SMARCA4,353
chr1,202283320,202283669,SRX5075175,SMARCA4,349
chr1,202283348,202283663,SRX5716468,SMARCA2,315
chr1,202283354,202283572,SRX5054309,FOSL2,218
chr1,202286629,202287025,SRX5075169,SMARCA4,396
chr1,202286722,202286946,SRX5716467,SMARCA2,224
chr1,202286798,202287010,SRX5716470,SMARCA4,212
chr1,202292324,202292615,SRX5075170,SMARCA4,291
chr1,202292331,202292693,SRX5075176,SMARCA4,362
chr1,202292336,202292614,SRX5075175,SMARCA4,278
chr1,202292341,202292545,SRX5075169,SMARCA4,204
chr1,202292365,202292608,SRX5054309,FOSL2,243
chr1,202292371,202292562,SRX5054308,FOSL2,191
chr1,202295571,202295773,SRX5075169,SMARCA4,202
chr1,202295595,202295862,SRX5054309,FOSL2,267
chr1,202295632,202295896,SRX5054308,FOSL2,264
chr1,202295694,202295963,SRX5716469,SMARCA4,269
chr1,202315423,202316090,SRX16500059,CTCF,667
chr1,202315528,202316000,SRX16500061,CTCF,472
chr1,202315533,202315959,SRX4174629,CTCF,426
chr1,202315557,202316078,SRX16500062,CTCF,521
chr1,202315567,202316039,SRX16500060,CTCF,472
chr1,202315614,202315939,SRX5075168,SMARCA4,325
chr1,202315655,202315941,SRX5075174,SMARCA4,286
chr1,202315663,202315847,SRX5075169,SMARCA4,184
chr1,202315670,202315933,SRX5075170,SMARCA4,263
chr1,202315701,202315885,SRX5075176,SMARCA4,184
chr1,202341601,202342295,SRX20140895,INTS13,694
chr1,202341760,202341994,SRX20140867,INTS10,234
chr1,202341944,202342131,SRX5054307,FOSL2,187
chr1,202343661,202344222,SRX16500062,CTCF,561
chr1,202343682,202344264,SRX16500060,CTCF,582
chr1,202343705,202344232,SRX16500059,CTCF,527
chr1,202343737,202344186,SRX16500061,CTCF,449
chr1,202343808,202344048,SRX5075168,SMARCA4,240
chr1,202343859,202344045,SRX5075174,SMARCA4,186
chr1,202343876,202344050,SRX5075170,SMARCA4,174
chr1,202348364,202349078,SRX20140895,INTS13,714
chr1,202348398,202348621,SRX5716454,SOX3,223
chr1,202348438,202348668,SRX5716463,SMARCA4,230
chr1,202348438,202348681,SRX5075176,SMARCA4,243
chr1,202348441,202349013,SRX5075174,SMARCA4,572
chr1,202348445,202348650,SRX5716464,SMARCA4,205
chr1,202348451,202349009,SRX5075168,SMARCA4,558
chr1,202348456,202348914,SRX20140894,INTS13,458
chr1,202348489,202348668,SRX5054307,FOSL2,179
chr1,202348489,202348766,SRX5716451,SOX2,277
chr1,202348507,202348971,SRX20140867,INTS10,464
chr1,202348513,202348966,SRX20140897,INTS13,453
chr1,202348543,202348969,SRX20140868,INTS10,426
chr1,202348552,202348934,SRX20140896,INTS13,382
chr1,202348571,202348897,SRX20140879,CPSF3L,326
chr1,202348751,202349045,SRX5075170,SMARCA4,294
chr1,202348786,202348966,SRX5075169,SMARCA4,180
chr1,202348789,202349033,SRX5716470,SMARCA4,244
chr1,202349215,202349531,SRX5075169,SMARCA4,316
chr1,202349240,202349570,SRX5716469,SMARCA4,330
chr1,202349275,202349562,SRX5716470,SMARCA4,287
chr1,202349280,202349488,SRX5075176,SMARCA4,208
chr1,202349302,202349495,SRX5075175,SMARCA4,193
chr1,202380690,202380880,SRX5054309,FOSL2,190
chr1,202410946,202411256,SRX5716470,SMARCA4,310
chr1,202411014,202411211,SRX5054308,FOSL2,197
chr1,202411016,202411305,SRX5075175,SMARCA4,289
chr1,202411063,202411260,SRX5075169,SMARCA4,197
chr1,202417691,202417934,SRX5716470,SMARCA4,243
chr1,202417702,202418154,SRX5075170,SMARCA4,452
chr1,202417713,202418224,SRX5075176,SMARCA4,511
chr1,202417726,202418105,SRX5075169,SMARCA4,379
chr1,202417745,202417996,SRX5716469,SMARCA4,251
chr1,202417805,202418026,SRX5716467,SMARCA2,221
chr1,202430183,202430363,SRX5054308,FOSL2,180
chr1,202456545,202456812,SRX5054309,FOSL2,267
chr1,202459843,202460424,SRX5716470,SMARCA4,581
chr1,202459981,202460485,SRX5716467,SMARCA2,504
chr1,202459985,202460493,SRX5716469,SMARCA4,508
chr1,202460023,202460522,SRX5075169,SMARCA4,499
chr1,202460076,202460483,SRX5075175,SMARCA4,407
chr1,202460082,202460546,SRX5075170,SMARCA4,464
chr1,202460146,202460477,SRX5054309,FOSL2,331
chr1,202460152,202460481,SRX5054308,FOSL2,329
chr1,202460189,202460523,SRX5075176,SMARCA4,334
chr1,202460219,202460472,SRX5020211,SMARCA2,253
chr1,202460233,202460476,SRX5075182,SMARCA2,243
chr1,202460267,202460492,SRX5020214,SMARCA2,225
chr1,202464100,202464522,SRX16500062,CTCF,422
chr1,202464105,202464580,SRX16500059,CTCF,475
chr1,202464109,202464576,SRX16500060,CTCF,467
chr1,202464117,202464571,SRX16500061,CTCF,454
chr1,202464292,202464493,SRX5075168,SMARCA4,201
chr1,202464371,202464595,SRX4174629,CTCF,224
chr1,202489134,202489436,SRX5020211,SMARCA2,302
chr1,202489134,202489449,SRX5075176,SMARCA4,315
chr1,202489150,202489461,SRX5716467,SMARCA2,311
chr1,202489160,202489510,SRX5054309,FOSL2,350
chr1,202489164,202489419,SRX5716469,SMARCA4,255
chr1,202489170,202489425,SRX5716470,SMARCA4,255
chr1,202489171,202489486,SRX5075170,SMARCA4,315
chr1,202489173,202489499,SRX5075169,SMARCA4,326
chr1,202489180,202489495,SRX5054308,FOSL2,315
chr1,202489186,202489503,SRX5075175,SMARCA4,317
chr1,202489206,202489411,SRX5020214,SMARCA2,205
chr1,202501232,202501678,SRX16500060,CTCF,446
chr1,202501285,202501677,SRX16500059,CTCF,392
chr1,202501329,202501619,SRX16500062,CTCF,290
chr1,202501347,202501624,SRX16500061,CTCF,277
chr1,202505274,202505719,SRX5075176,SMARCA4,445
chr1,202505412,202505680,SRX5075169,SMARCA4,268
chr1,202505475,202505740,SRX5054308,FOSL2,265
chr1,202505476,202505763,SRX5075170,SMARCA4,287
chr1,202505498,202505728,SRX5075175,SMARCA4,230
chr1,202505538,202505749,SRX5716470,SMARCA4,211
chr1,202505544,202505779,SRX5054309,FOSL2,235
chr1,202520011,202520462,SRX5075176,SMARCA4,451
chr1,202520085,202520396,SRX5716468,SMARCA2,311
chr1,202520090,202520431,SRX5716467,SMARCA2,341
chr1,202520104,202520439,SRX5716469,SMARCA4,335
chr1,202520106,202520517,SRX5716470,SMARCA4,411
chr1,202520131,202520433,SRX5075169,SMARCA4,302
chr1,202520133,202520369,SRX5075170,SMARCA4,236
chr1,202520147,202520366,SRX5054308,FOSL2,219
chr1,202520173,202520418,SRX5075175,SMARCA4,245
chr1,202527250,202527434,SRX5075168,SMARCA4,184
chr1,202532127,202532341,SRX5054309,FOSL2,214
chr1,202539169,202539510,SRX5075169,SMARCA4,341
chr1,202539173,202539542,SRX5716470,SMARCA4,369
chr1,202539176,202539517,SRX5075175,SMARCA4,341
chr1,202539206,202539532,SRX5716469,SMARCA4,326
chr1,202539223,202539539,SRX5075170,SMARCA4,316
chr1,202539231,202539515,SRX5075176,SMARCA4,284
chr1,202539247,202539547,SRX5716467,SMARCA2,300
chr1,202539336,202539547,SRX5054309,FOSL2,211
chr1,202567779,202568054,SRX5075169,SMARCA4,275
chr1,202567780,202568095,SRX5020211,SMARCA2,315
chr1,202567828,202568059,SRX5075175,SMARCA4,231
chr1,202567853,202568126,SRX5716467,SMARCA2,273
chr1,202567865,202568106,SRX5054309,FOSL2,241
chr1,202567868,202568090,SRX5716469,SMARCA4,222
chr1,202567874,202568080,SRX5075176,SMARCA4,206
chr1,202571652,202572112,SRX16500062,CTCF,460
chr1,202571676,202572234,SRX16500060,CTCF,558
chr1,202571734,202572150,SRX16500061,CTCF,416
chr1,202571740,202572188,SRX16500059,CTCF,448
chr1,202578038,202578453,SRX5716470,SMARCA4,415
chr1,202578069,202578494,SRX5075176,SMARCA4,425
chr1,202578086,202578510,SRX5075170,SMARCA4,424
chr1,202578111,202578512,SRX5716469,SMARCA4,401
chr1,202578169,202578408,SRX5716467,SMARCA2,239
chr1,202578177,202578418,SRX5054308,FOSL2,241
chr1,202578228,202578553,SRX5075175,SMARCA4,325
chr1,202578244,202578464,SRX5075169,SMARCA4,220
chr1,202578319,202578506,SRX5075168,SMARCA4,187
chr1,202578671,202578862,SRX5075176,SMARCA4,191
chr1,202579960,202580200,SRX5054309,FOSL2,240
chr1,202579977,202580180,SRX5054308,FOSL2,203
chr1,202586438,202586810,SRX5075176,SMARCA4,372
chr1,202586452,202586813,SRX5075169,SMARCA4,361
chr1,202586474,202586829,SRX5075170,SMARCA4,355
chr1,202589101,202589616,SRX5716469,SMARCA4,515
chr1,202589106,202589606,SRX5075176,SMARCA4,500
chr1,202589132,202589665,SRX5075168,SMARCA4,533
chr1,202589136,202589599,SRX5075175,SMARCA4,463
chr1,202589137,202589604,SRX5075169,SMARCA4,467
chr1,202589159,202589596,SRX5075170,SMARCA4,437
chr1,202589162,202589565,SRX5054309,FOSL2,403
chr1,202589191,202589596,SRX5075174,SMARCA4,405
chr1,202589192,202589636,SRX5716470,SMARCA4,444
chr1,202589220,202589546,SRX5716467,SMARCA2,326
chr1,202589221,202589529,SRX5054308,FOSL2,308
chr1,202589232,202589455,SRX5020211,SMARCA2,223
chr1,202589233,202589561,SRX5716468,SMARCA2,328
chr1,202589282,202589518,SRX5020214,SMARCA2,236
chr1,202589291,202589496,SRX5716464,SMARCA4,205
chr1,202600123,202600569,SRX16500059,CTCF,446
chr1,202600135,202600598,SRX16500060,CTCF,463
chr1,202600145,202600358,SRX5075176,SMARCA4,213
chr1,202600157,202600511,SRX16500062,CTCF,354
chr1,202600170,202600593,SRX16500061,CTCF,423
chr1,202600175,202600476,SRX4174629,CTCF,301
chr1,202600204,202600445,SRX5075170,SMARCA4,241
chr1,202600210,202600417,SRX5075174,SMARCA4,207
chr1,202600212,202600394,SRX5075168,SMARCA4,182
chr1,202615466,202615973,SRX5075169,SMARCA4,507
chr1,202615628,202615850,SRX5075175,SMARCA4,222
chr1,202618435,202618679,SRX5054309,FOSL2,244
chr1,202618483,202618700,SRX5054308,FOSL2,217
chr1,202618484,202618653,SRX5075170,SMARCA4,169
chr1,202623204,202623384,SRX5054308,FOSL2,180
chr1,202625445,202625748,SRX5075174,SMARCA4,303
chr1,202625445,202625778,SRX16500059,CTCF,333
chr1,202625454,202625623,SRX5075170,SMARCA4,169
chr1,202625461,202625743,SRX16500062,CTCF,282
chr1,202625462,202625811,SRX16500060,CTCF,349
chr1,202625483,202625730,SRX5075168,SMARCA4,247
chr1,202625509,202625805,SRX16500061,CTCF,296
chr1,202637990,202638419,SRX5075174,SMARCA4,429
chr1,202637995,202638429,SRX5075168,SMARCA4,434
chr1,202638010,202638782,SRX20140868,INTS10,772
chr1,202638086,202638729,SRX20140895,INTS13,643
chr1,202638311,202638570,SRX20140879,CPSF3L,259
chr1,202648750,202649125,SRX20140895,INTS13,375
chr1,202648779,202649040,SRX20140868,INTS10,261
chr1,202648784,202649134,SRX20140867,INTS10,350
chr1,202648798,202649098,SRX20140894,INTS13,300
chr1,202648841,202649148,SRX20140879,CPSF3L,307
chr1,202656123,202656449,SRX16500060,CTCF,326
chr1,202656132,202656315,SRX5075168,SMARCA4,183
chr1,202656149,202656402,SRX16500062,CTCF,253
chr1,202657330,202657503,SRX5075174,SMARCA4,173
chr1,202657453,202657702,SRX16500060,CTCF,249
chr1,202692949,202693346,SRX16500059,CTCF,397
chr1,202692954,202693243,SRX5716467,SMARCA2,289
chr1,202692961,202693225,SRX16500061,CTCF,264
chr1,202692961,202693321,SRX5716470,SMARCA4,360
chr1,202692964,202693276,SRX16500062,CTCF,312
chr1,202692967,202693311,SRX5075176,SMARCA4,344
chr1,202692970,202693339,SRX5716469,SMARCA4,369
chr1,202692971,202693299,SRX16500060,CTCF,328
chr1,202692971,202693304,SRX5075170,SMARCA4,333
chr1,202692971,202693318,SRX5075174,SMARCA4,347
chr1,202692974,202693354,SRX5075168,SMARCA4,380
chr1,202692977,202693290,SRX5075169,SMARCA4,313
chr1,202692978,202693299,SRX5716464,SMARCA4,321
chr1,202692992,202693290,SRX5075175,SMARCA4,298
chr1,202693007,202693269,SRX5716463,SMARCA4,262
chr1,202693034,202693239,SRX5020214,SMARCA2,205
chr1,202710355,202710671,SRX5075168,SMARCA4,316
chr1,202710403,202710578,SRX5075176,SMARCA4,175
chr1,202719539,202720071,SRX16500061,CTCF,532
chr1,202719544,202720000,SRX16500060,CTCF,456
chr1,202719552,202720006,SRX16500062,CTCF,454
chr1,202719566,202720015,SRX16500059,CTCF,449
chr1,202719574,202719838,SRX5075174,SMARCA4,264
chr1,202719606,202719918,SRX5075176,SMARCA4,312
chr1,202719609,202719852,SRX5075175,SMARCA4,243
chr1,202719613,202719881,SRX5075170,SMARCA4,268
chr1,202719618,202719874,SRX5716469,SMARCA4,256
chr1,202719625,202719895,SRX5075168,SMARCA4,270
chr1,202719627,202719842,SRX5716463,SMARCA4,215
chr1,202719631,202719951,SRX4174629,CTCF,320
chr1,202719648,202719881,SRX5075169,SMARCA4,233
chr1,202719667,202719872,SRX5716464,SMARCA4,205
chr1,202803138,202803364,SRX5054308,FOSL2,226
chr1,202808156,202808656,SRX20140895,INTS13,500
chr1,202808194,202808564,SRX20140897,INTS13,370
chr1,202808212,202808549,SRX20140879,CPSF3L,337
chr1,202808238,202808583,SRX20140867,INTS10,345
chr1,202808245,202808506,SRX20140880,CPSF3L,261
chr1,202808367,202808656,SRX20140868,INTS10,289
chr1,202808422,202808662,SRX5075174,SMARCA4,240
chr1,202808427,202808635,SRX5075168,SMARCA4,208
chr1,202810610,202810986,SRX5075168,SMARCA4,376
chr1,202810675,202811088,SRX5075174,SMARCA4,413
chr1,202810721,202811240,SRX20140895,INTS13,519
chr1,202810723,202811119,SRX20140897,INTS13,396
chr1,202810750,202811096,SRX20140868,INTS10,346
chr1,202810752,202810959,SRX5716464,SMARCA4,207
chr1,202810754,202811117,SRX20140881,CPSF3L,363
chr1,202810756,202811203,SRX20140879,CPSF3L,447
chr1,202810759,202811048,SRX5075176,SMARCA4,289
chr1,202810777,202810997,SRX5075170,SMARCA4,220
chr1,202810835,202811057,SRX20140867,INTS10,222
chr1,202821449,202821814,SRX20140897,INTS13,365
chr1,202821457,202821782,SRX20140869,INTS10,325
chr1,202852101,202852718,SRX16500059,CTCF,617
chr1,202852137,202852669,SRX16500060,CTCF,532
chr1,202852231,202852740,SRX16500061,CTCF,509
chr1,202852256,202852738,SRX16500062,CTCF,482
chr1,202852317,202852518,SRX5075170,SMARCA4,201
chr1,202852334,202852548,SRX4174629,CTCF,214
chr1,202860805,202861145,SRX5075174,SMARCA4,340
chr1,202860836,202861260,SRX5075168,SMARCA4,424
chr1,202860845,202861814,SRX20140895,INTS13,969
chr1,202861109,202861610,SRX20140868,INTS10,501
chr1,202861234,202861409,SRX5075176,SMARCA4,175
chr1,202861436,202861949,SRX5075168,SMARCA4,513
chr1,202861467,202861849,SRX5075176,SMARCA4,382
chr1,202861486,202861919,SRX5075170,SMARCA4,433
chr1,202861525,202861905,SRX5075174,SMARCA4,380
chr1,202861565,202861902,SRX5716463,SMARCA4,337
chr1,202861575,202861798,SRX5075169,SMARCA4,223
chr1,202888417,202888810,SRX5075175,SMARCA4,393
chr1,202888470,202889106,SRX5075176,SMARCA4,636
chr1,202888485,202889278,SRX20140895,INTS13,793
chr1,202888558,202889340,SRX5075168,SMARCA4,782
chr1,202888594,202889444,SRX5075174,SMARCA4,850
chr1,202888698,202889140,SRX20140881,CPSF3L,442
chr1,202888721,202889116,SRX5716469,SMARCA4,395
chr1,202888788,202889168,SRX20140897,INTS13,380
chr1,202888793,202889061,SRX20140868,INTS10,268
chr1,202888832,202889281,SRX5075170,SMARCA4,449
chr1,202888877,202889075,SRX5075175,SMARCA4,198
chr1,202888881,202889281,SRX20140867,INTS10,400
chr1,202888920,202889150,SRX5716464,SMARCA4,230
chr1,202926673,202927104,SRX16500059,CTCF,431
chr1,202926679,202927078,SRX16500060,CTCF,399
chr1,202926686,202927027,SRX16500061,CTCF,341
chr1,202926774,202927028,SRX16500062,CTCF,254
chr1,202926812,202927237,SRX5716470,SMARCA4,425
chr1,202926893,202927437,SRX5075169,SMARCA4,544
chr1,202926898,202927148,SRX5716469,SMARCA4,250
chr1,202926904,202927622,SRX20140895,INTS13,718
chr1,202926905,202927458,SRX5075176,SMARCA4,553
chr1,202926938,202927525,SRX5075168,SMARCA4,587
chr1,202926942,202927526,SRX20140879,CPSF3L,584
chr1,202926952,202927518,SRX5075170,SMARCA4,566
chr1,202926970,202927502,SRX20140894,INTS13,532
chr1,202926987,202927466,SRX20140881,CPSF3L,479
chr1,202927000,202927517,SRX5075174,SMARCA4,517
chr1,202927010,202927584,SRX20140868,INTS10,574
chr1,202927045,202927572,SRX20140896,INTS13,527
chr1,202927052,202927598,SRX20140897,INTS13,546
chr1,202927059,202927571,SRX20140867,INTS10,512
chr1,202927099,202927517,SRX20140869,INTS10,418
chr1,202927176,202927459,SRX5716464,SMARCA4,283
chr1,202927239,202927479,SRX5075175,SMARCA4,240
chr1,202957812,202958637,SRX5075174,SMARCA4,825
chr1,202957898,202958292,SRX5716470,SMARCA4,394
chr1,202957916,202958402,SRX20140868,INTS10,486
chr1,202957986,202958440,SRX20140895,INTS13,454
chr1,202958020,202958612,SRX5716469,SMARCA4,592
chr1,202958023,202958258,SRX20140879,CPSF3L,235
chr1,202958053,202958554,SRX5075168,SMARCA4,501
chr1,202958065,202958361,SRX20140867,INTS10,296
chr1,202958066,202958427,SRX16500059,CTCF,361
chr1,202958070,202958416,SRX16500062,CTCF,346
chr1,202958086,202958445,SRX16500060,CTCF,359
chr1,202958098,202958570,SRX5075170,SMARCA4,472
chr1,202958149,202958564,SRX5075176,SMARCA4,415
chr1,202958200,202958589,SRX5716463,SMARCA4,389
chr1,202958343,202958577,SRX5716464,SMARCA4,234
chr1,202967036,202967274,SRX5075174,SMARCA4,238
chr1,202967418,202967743,SRX5075176,SMARCA4,325
chr1,202967423,202967597,SRX5075170,SMARCA4,174
chr1,202967739,202967986,SRX5716470,SMARCA4,247
chr1,202968923,202969345,SRX16500061,CTCF,422
chr1,202968970,202969408,SRX16500059,CTCF,438
chr1,202968994,202969394,SRX16500062,CTCF,400
chr1,202969013,202969426,SRX16500060,CTCF,413
chr1,202999110,202999709,SRX16500059,CTCF,599
chr1,202999167,202999675,SRX16500061,CTCF,508
chr1,202999216,202999675,SRX16500060,CTCF,459
chr1,202999242,202999638,SRX16500062,CTCF,396
chr1,202999271,202999550,SRX5716463,SMARCA4,279
chr1,202999290,202999621,SRX5075174,SMARCA4,331
chr1,202999296,202999542,SRX5075168,SMARCA4,246
chr1,202999297,202999532,SRX5075176,SMARCA4,235
chr1,202999307,202999555,SRX5075170,SMARCA4,248
chr1,203006818,203007715,SRX20140895,INTS13,897
chr1,203006933,203007633,SRX20140868,INTS10,700
chr1,203006949,203007625,SRX20140881,CPSF3L,676
chr1,203007042,203007222,SRX5075176,SMARCA4,180
chr1,203007055,203007687,SRX20140869,INTS10,632
chr1,203007081,203007682,SRX20140867,INTS10,601
chr1,203007143,203007729,SRX20140897,INTS13,586
chr1,203007152,203007559,SRX5075174,SMARCA4,407
chr1,203007161,203007590,SRX5075168,SMARCA4,429
chr1,203007206,203007599,SRX20140896,INTS13,393
chr1,203007224,203007507,SRX5716464,SMARCA4,283
chr1,203007230,203007570,SRX20140894,INTS13,340
chr1,203007253,203007573,SRX5716470,SMARCA4,320
chr1,203007277,203007869,SRX5075169,SMARCA4,592
chr1,203007293,203007674,SRX20140879,CPSF3L,381
chr1,203007327,203007615,SRX5075170,SMARCA4,288
chr1,203007423,203007736,SRX5075176,SMARCA4,313
chr1,203022798,203023218,SRX16500060,CTCF,420
chr1,203022838,203023294,SRX16500061,CTCF,456
chr1,203022920,203023285,SRX16500062,CTCF,365
chr1,203022948,203023197,SRX16500059,CTCF,249
chr1,203022975,203023177,SRX5075174,SMARCA4,202
chr1,203026116,203026661,SRX20140895,INTS13,545
chr1,203026154,203026554,SRX20140897,INTS13,400
chr1,203026167,203026445,SRX20140868,INTS10,278
chr1,203026229,203026671,SRX5075174,SMARCA4,442
chr1,203026237,203026693,SRX5075176,SMARCA4,456
chr1,203026255,203026680,SRX5075168,SMARCA4,425
chr1,203026256,203026635,SRX5716464,SMARCA4,379
chr1,203026263,203026669,SRX5075170,SMARCA4,406
chr1,203026267,203026519,SRX5075175,SMARCA4,252
chr1,203026306,203026548,SRX5054307,FOSL2,242
chr1,203026325,203026635,SRX5716463,SMARCA4,310
chr1,203026348,203026611,SRX5075169,SMARCA4,263
chr1,203026475,203026769,SRX5716470,SMARCA4,294
chr1,203038194,203038390,SRX5075175,SMARCA4,196
chr1,203038209,203038402,SRX5075169,SMARCA4,193
chr1,203038249,203038448,SRX5075170,SMARCA4,199
chr1,203039272,203039760,SRX16500061,CTCF,488
chr1,203039273,203039742,SRX16500059,CTCF,469
chr1,203039278,203039810,SRX16500060,CTCF,532
chr1,203039294,203039764,SRX16500062,CTCF,470
chr1,203039353,203039778,SRX4174629,CTCF,425
chr1,203039367,203039684,SRX5075174,SMARCA4,317
chr1,203039399,203039689,SRX5075168,SMARCA4,290
chr1,203039413,203039671,SRX5075170,SMARCA4,258
chr1,203039449,203039624,SRX5075176,SMARCA4,175
chr1,203047250,203047685,SRX5075176,SMARCA4,435
chr1,203047267,203047597,SRX5075169,SMARCA4,330
chr1,203047277,203047660,SRX5054309,FOSL2,383
chr1,203047279,203047638,SRX5075170,SMARCA4,359
chr1,203047299,203047587,SRX5075168,SMARCA4,288
chr1,203047299,203047614,SRX5054308,FOSL2,315
chr1,203047309,203047620,SRX5075175,SMARCA4,311
chr1,203047332,203047536,SRX5020211,SMARCA2,204
chr1,203047332,203047602,SRX5716469,SMARCA4,270
chr1,203047335,203047591,SRX5020214,SMARCA2,256
chr1,203047377,203047577,SRX5075174,SMARCA4,200
chr1,203052192,203052368,SRX5075170,SMARCA4,176
chr1,203057792,203058281,SRX5075169,SMARCA4,489
chr1,203057843,203058318,SRX5075176,SMARCA4,475
chr1,203057860,203058392,SRX5075170,SMARCA4,532
chr1,203057895,203058231,SRX5716468,SMARCA2,336
chr1,203057914,203058260,SRX5716467,SMARCA2,346
chr1,203057917,203058242,SRX5716470,SMARCA4,325
chr1,203057933,203058322,SRX5075175,SMARCA4,389
chr1,203057948,203058232,SRX5716469,SMARCA4,284
chr1,203057973,203058229,SRX5020211,SMARCA2,256
chr1,203057980,203058264,SRX5054308,FOSL2,284
chr1,203069374,203069543,SRX5075170,SMARCA4,169
chr1,203069419,203069598,SRX5075168,SMARCA4,179
chr1,203084557,203084778,SRX16500060,CTCF,221
chr1,203084639,203084892,SRX16500059,CTCF,253
chr1,203117668,203118238,SRX16500059,CTCF,570
chr1,203117732,203118188,SRX16500060,CTCF,456
chr1,203117760,203118263,SRX16500061,CTCF,503
chr1,203117775,203118237,SRX16500062,CTCF,462
chr1,203117859,203118187,SRX5075174,SMARCA4,328
chr1,203117893,203118164,SRX5716463,SMARCA4,271
chr1,203117894,203118156,SRX4174629,CTCF,262
chr1,203117905,203118145,SRX5075168,SMARCA4,240
chr1,203117933,203118130,SRX5075169,SMARCA4,197
chr1,203117945,203118114,SRX5075170,SMARCA4,169
chr1,203126317,203126710,SRX16500060,CTCF,393
chr1,203126353,203126653,SRX16500061,CTCF,300
chr1,203126360,203126700,SRX16500059,CTCF,340
chr1,203126416,203126678,SRX16500062,CTCF,262
chr1,203128150,203128571,SRX20140895,INTS13,421
chr1,203128205,203128496,SRX5075174,SMARCA4,291
chr1,203128261,203128463,SRX5075168,SMARCA4,202
chr1,203144640,203144847,SRX5075170,SMARCA4,207
chr1,203147516,203147705,SRX5075168,SMARCA4,189
chr1,203147566,203147753,SRX5075174,SMARCA4,187
chr1,203148105,203148475,SRX16500059,CTCF,370
chr1,203148140,203148436,SRX16500061,CTCF,296
chr1,203152379,203152694,SRX5075176,SMARCA4,315
chr1,203152396,203152736,SRX5075169,SMARCA4,340
chr1,203152405,203152760,SRX5075170,SMARCA4,355
chr1,203152409,203152667,SRX5075174,SMARCA4,258
chr1,203152442,203152716,SRX5054309,FOSL2,274
chr1,203152444,203152723,SRX5054308,FOSL2,279
chr1,203152455,203152705,SRX5075175,SMARCA4,250
chr1,203152483,203152834,SRX5716470,SMARCA4,351
chr1,203172198,203172579,SRX16500059,CTCF,381
chr1,203172229,203172568,SRX16500060,CTCF,339
chr1,203172253,203172547,SRX16500062,CTCF,294
chr1,203172277,203172596,SRX16500061,CTCF,319
chr1,203178110,203178483,SRX5075174,SMARCA4,373
chr1,203178129,203178468,SRX5075168,SMARCA4,339
chr1,203197640,203197985,SRX5716469,SMARCA4,345
chr1,203197643,203198057,SRX5075169,SMARCA4,414
chr1,203197672,203197986,SRX5054308,FOSL2,314
chr1,203197673,203197980,SRX5054309,FOSL2,307
chr1,203197694,203197912,SRX5716470,SMARCA4,218
chr1,203197699,203197994,SRX5075175,SMARCA4,295
chr1,203197699,203198007,SRX5075176,SMARCA4,308
chr1,203197709,203197957,SRX5075170,SMARCA4,248
chr1,203197750,203197978,SRX5716467,SMARCA2,228
chr1,203216117,203216652,SRX16500059,CTCF,535
chr1,203216127,203216619,SRX16500060,CTCF,492
chr1,203216134,203216596,SRX16500062,CTCF,462
chr1,203216147,203216583,SRX16500061,CTCF,436
chr1,203216178,203216574,SRX4174629,CTCF,396
chr1,203216180,203216517,SRX5716464,SMARCA4,337
chr1,203216189,203216512,SRX5075174,SMARCA4,323
chr1,203216205,203216447,SRX5075169,SMARCA4,242
chr1,203216218,203216566,SRX5075168,SMARCA4,348
chr1,203216250,203216423,SRX5075170,SMARCA4,173
chr1,203216255,203216466,SRX5716470,SMARCA4,211
chr1,203216257,203216487,SRX5075176,SMARCA4,230
chr1,203216258,203216477,SRX5716463,SMARCA4,219
chr1,203267219,203267662,SRX16500059,CTCF,443
chr1,203267249,203267636,SRX16500060,CTCF,387
chr1,203267260,203267642,SRX16500061,CTCF,382
chr1,203267264,203267611,SRX16500062,CTCF,347
chr1,203267279,203267657,SRX5716469,SMARCA4,378
chr1,203267286,203267623,SRX5075168,SMARCA4,337
chr1,203267287,203267661,SRX5075176,SMARCA4,374
chr1,203267292,203267732,SRX5075175,SMARCA4,440
chr1,203267294,203267726,SRX5075169,SMARCA4,432
chr1,203267296,203267726,SRX5716470,SMARCA4,430
chr1,203267298,203267682,SRX5075170,SMARCA4,384
chr1,203267300,203267667,SRX5716463,SMARCA4,367
chr1,203267304,203267688,SRX5075174,SMARCA4,384
chr1,203267310,203267543,SRX5075181,SMARCA2,233
chr1,203267321,203267571,SRX4174629,CTCF,250
chr1,203267394,203267689,SRX5716464,SMARCA4,295
chr1,203267394,203267696,SRX5716467,SMARCA2,302
chr1,203267412,203267623,SRX5716468,SMARCA2,211
chr1,203267427,203267627,SRX5020211,SMARCA2,200
chr1,203267446,203267694,SRX5716459,Epitope tags,248
chr1,203269022,203269441,SRX16500060,CTCF,419
chr1,203269040,203269426,SRX16500061,CTCF,386
chr1,203269041,203269407,SRX16500059,CTCF,366
chr1,203269061,203269434,SRX16500062,CTCF,373
chr1,203269157,203269338,SRX5075174,SMARCA4,181
chr1,203273027,203273600,SRX16500059,CTCF,573
chr1,203273032,203273584,SRX16500060,CTCF,552
chr1,203273044,203273600,SRX16500061,CTCF,556
chr1,203273047,203273538,SRX16500062,CTCF,491
chr1,203273050,203273564,SRX4174629,CTCF,514
chr1,203273140,203273377,SRX5075174,SMARCA4,237
chr1,203273198,203273525,SRX20140895,INTS13,327
chr1,203273202,203273405,SRX5075170,SMARCA4,203
chr1,203278342,203278877,SRX5075176,SMARCA4,535
chr1,203278392,203278892,SRX5075170,SMARCA4,500
chr1,203278421,203278809,SRX5075175,SMARCA4,388
chr1,203278422,203278781,SRX5716469,SMARCA4,359
chr1,203278436,203278714,SRX5716467,SMARCA2,278
chr1,203278444,203278959,SRX5716470,SMARCA4,515
chr1,203278495,203279073,SRX5075169,SMARCA4,578
chr1,203278718,203278967,SRX5075168,SMARCA4,249
chr1,203290373,203290938,SRX20140895,INTS13,565
chr1,203290398,203290834,SRX5075174,SMARCA4,436
chr1,203290444,203290726,SRX5075168,SMARCA4,282
chr1,203290485,203290913,SRX20140867,INTS10,428
chr1,203290587,203290835,SRX20140879,CPSF3L,248
chr1,203304966,203305742,SRX20140869,INTS10,776
chr1,203305116,203305480,SRX5716470,SMARCA4,364
chr1,203305120,203305924,SRX20140895,INTS13,804
chr1,203305121,203305655,SRX5075168,SMARCA4,534
chr1,203305128,203305776,SRX20140867,INTS10,648
chr1,203305140,203305641,SRX5075174,SMARCA4,501
chr1,203305141,203305541,SRX5075170,SMARCA4,400
chr1,203305149,203305586,SRX5075169,SMARCA4,437
chr1,203305155,203305584,SRX5075176,SMARCA4,429
chr1,203305173,203305779,SRX20140897,INTS13,606
chr1,203305184,203305478,SRX5716464,SMARCA4,294
chr1,203305192,203305457,SRX5054309,FOSL2,265
chr1,203305213,203305431,SRX5716469,SMARCA4,218
chr1,203305215,203305496,SRX5716463,SMARCA4,281
chr1,203305245,203305470,SRX5075175,SMARCA4,225
chr1,203305256,203305906,SRX20140868,INTS10,650
chr1,203305288,203305816,SRX20140881,CPSF3L,528
chr1,203305292,203305698,SRX20140896,INTS13,406
chr1,203305321,203305798,SRX20140879,CPSF3L,477
chr1,203305373,203305771,SRX20140894,INTS13,398
chr1,203305384,203305803,SRX20140880,CPSF3L,419
chr1,203306578,203306811,SRX5075175,SMARCA4,233
chr1,203306593,203306834,SRX5075170,SMARCA4,241
chr1,203306630,203306805,SRX5075176,SMARCA4,175
chr1,203324857,203325196,SRX20140895,INTS13,339
chr1,203325000,203325378,SRX5075168,SMARCA4,378
chr1,203325010,203325382,SRX5075174,SMARCA4,372
chr1,203325021,203325277,SRX5716451,SOX2,256
chr1,203327288,203327615,SRX5075174,SMARCA4,327
chr1,203327308,203327614,SRX5075168,SMARCA4,306
chr1,203327308,203327982,SRX20140895,INTS13,674
chr1,203327505,203327988,SRX16500060,CTCF,483
chr1,203327533,203327984,SRX16500062,CTCF,451
chr1,203327557,203327804,SRX16500059,CTCF,247
chr1,203327569,203327830,SRX20140868,INTS10,261
chr1,203327738,203328009,SRX4174629,CTCF,271
chr1,203328825,203329086,SRX5075176,SMARCA4,261
chr1,203328897,203329076,SRX5075170,SMARCA4,179
chr1,203338415,203338811,SRX16500060,CTCF,396
chr1,203338432,203338775,SRX16500062,CTCF,343
chr1,203338438,203338822,SRX16500059,CTCF,384
chr1,203338458,203338811,SRX16500061,CTCF,353
chr1,203338462,203338718,SRX5075168,SMARCA4,256
chr1,203338465,203338717,SRX5075170,SMARCA4,252
chr1,203338511,203338750,SRX5075174,SMARCA4,239
chr1,203340020,203340444,SRX16500062,CTCF,424
chr1,203340030,203340459,SRX16500061,CTCF,429
chr1,203340041,203340450,SRX16500060,CTCF,409
chr1,203340046,203340392,SRX4174629,CTCF,346
chr1,203340046,203340489,SRX16500059,CTCF,443
chr1,203340118,203340410,SRX5075168,SMARCA4,292
chr1,203340124,203340434,SRX5075176,SMARCA4,310
chr1,203340175,203340428,SRX5075174,SMARCA4,253
chr1,203340199,203340385,SRX5075170,SMARCA4,186
chr1,203342457,203342810,SRX16500060,CTCF,353
chr1,203342478,203342825,SRX16500061,CTCF,347
chr1,203342498,203342860,SRX16500059,CTCF,362
chr1,203342506,203342780,SRX16500062,CTCF,274
chr1,203342564,203342774,SRX5075168,SMARCA4,210
chr1,203354267,203354508,SRX5054309,FOSL2,241
chr1,203374553,203374869,SRX5054309,FOSL2,316
chr1,203374597,203374854,SRX5075176,SMARCA4,257
chr1,203374604,203374873,SRX5054308,FOSL2,269
chr1,203374642,203374814,SRX5075170,SMARCA4,172
chr1,203401335,203401542,SRX5075174,SMARCA4,207
chr1,203402566,203402951,SRX5075169,SMARCA4,385
chr1,203402589,203402923,SRX5075176,SMARCA4,334
chr1,203402595,203402923,SRX5075175,SMARCA4,328
chr1,203402626,203402995,SRX5075170,SMARCA4,369
chr1,203402635,203402993,SRX5054309,FOSL2,358
chr1,203402671,203402912,SRX5054308,FOSL2,241
chr1,203408607,203408831,SRX5075170,SMARCA4,224
chr1,203408628,203408806,SRX5075176,SMARCA4,178
chr1,203425509,203426054,SRX5075170,SMARCA4,545
chr1,203425541,203426043,SRX5075176,SMARCA4,502
chr1,203425627,203426015,SRX5054309,FOSL2,388
chr1,203425646,203425987,SRX5716469,SMARCA4,341
chr1,203425647,203425994,SRX5054308,FOSL2,347
chr1,203425695,203426010,SRX5075169,SMARCA4,315
chr1,203425695,203426016,SRX5020211,SMARCA2,321
chr1,203425708,203425923,SRX5075175,SMARCA4,215
chr1,203425716,203425931,SRX5716467,SMARCA2,215
chr1,203425728,203425922,SRX5075181,SMARCA2,194
chr1,203440696,203441076,SRX5075176,SMARCA4,380
chr1,203440721,203441083,SRX5075170,SMARCA4,362
chr1,203440766,203441055,SRX5716470,SMARCA4,289
chr1,203440797,203441054,SRX5075169,SMARCA4,257
chr1,203440811,203441043,SRX5075175,SMARCA4,232
chr1,203462962,203463263,SRX5054309,FOSL2,301
chr1,203463721,203463946,SRX5075176,SMARCA4,225
chr1,203463781,203464019,SRX5075169,SMARCA4,238
chr1,203463790,203464004,SRX5075170,SMARCA4,214
chr1,203466038,203466431,SRX5716470,SMARCA4,393
chr1,203466066,203466381,SRX5075170,SMARCA4,315
chr1,203466079,203466463,SRX5075176,SMARCA4,384
chr1,203466099,203466362,SRX5075169,SMARCA4,263
chr1,203466129,203466399,SRX5075175,SMARCA4,270
chr1,203475418,203475619,SRX5075170,SMARCA4,201
chr1,203480524,203481034,SRX5075175,SMARCA4,510
chr1,203480539,203480940,SRX5075170,SMARCA4,401
chr1,203480542,203481006,SRX5075176,SMARCA4,464
chr1,203480555,203481084,SRX5075169,SMARCA4,529
chr1,203480563,203480743,SRX5054308,FOSL2,180
chr1,203480628,203480854,SRX5716470,SMARCA4,226
chr1,203480911,203481122,SRX5716470,SMARCA4,211
chr1,203487363,203488238,SRX16500060,CTCF,875
chr1,203487371,203488204,SRX16500059,CTCF,833
chr1,203487380,203488287,SRX16500061,CTCF,907
chr1,203487404,203488190,SRX16500062,CTCF,786
chr1,203487516,203487980,SRX4174629,CTCF,464
chr1,203487520,203488082,SRX5075176,SMARCA4,562
chr1,203487558,203487946,SRX5716469,SMARCA4,388
chr1,203487563,203488039,SRX5075170,SMARCA4,476
chr1,203487613,203487905,SRX5716467,SMARCA2,292
chr1,203487640,203487970,SRX5075175,SMARCA4,330
chr1,203487656,203488028,SRX5075169,SMARCA4,372
chr1,203487664,203488001,SRX5075168,SMARCA4,337
chr1,203487667,203487968,SRX5716470,SMARCA4,301
chr1,203487681,203488009,SRX5075174,SMARCA4,328
chr1,203487697,203487931,SRX5716468,SMARCA2,234
chr1,203487759,203488003,SRX5716464,SMARCA4,244
chr1,203504482,203505083,SRX4174629,CTCF,601
chr1,203504528,203505083,SRX16500059,CTCF,555
chr1,203504542,203505093,SRX16500060,CTCF,551
chr1,203504589,203505072,SRX16500062,CTCF,483
chr1,203504597,203505079,SRX16500061,CTCF,482
chr1,203504733,203505007,SRX5075174,SMARCA4,274
chr1,203504769,203504993,SRX5075170,SMARCA4,224
chr1,203507921,203508141,SRX5075176,SMARCA4,220
chr1,203512787,203513123,SRX5716469,SMARCA4,336
chr1,203512801,203513180,SRX5054309,FOSL2,379
chr1,203512822,203513163,SRX5054308,FOSL2,341
chr1,203512836,203513140,SRX5075176,SMARCA4,304
chr1,203512847,203513156,SRX5075169,SMARCA4,309
chr1,203512858,203513108,SRX5075174,SMARCA4,250
chr1,203512858,203513234,SRX5075175,SMARCA4,376
chr1,203512860,203513128,SRX5075168,SMARCA4,268
chr1,203512875,203513130,SRX5075170,SMARCA4,255
chr1,203514163,203514474,SRX5075170,SMARCA4,311
chr1,203516239,203516308,SRX1424894,POU3F2,69
chr1,203516302,203516504,SRX5075174,SMARCA4,202
chr1,203522277,203522765,SRX5716467,SMARCA2,488
chr1,203522318,203522633,SRX5075169,SMARCA4,315
chr1,203522325,203522751,SRX5075176,SMARCA4,426
chr1,203522329,203522693,SRX5075170,SMARCA4,364
chr1,203522331,203522630,SRX20140895,INTS13,299
chr1,203522374,203522741,SRX5075175,SMARCA4,367
chr1,203522376,203522598,SRX5075168,SMARCA4,222
chr1,203522384,203522638,SRX5716470,SMARCA4,254
chr1,203522445,203522667,SRX5075174,SMARCA4,222
chr1,203534595,203534830,SRX5075170,SMARCA4,235
chr1,203534601,203534798,SRX5075175,SMARCA4,197
chr1,203534637,203534928,SRX5075169,SMARCA4,291
chr1,203556117,203556609,SRX20140895,INTS13,492
chr1,203556182,203556443,SRX20140868,INTS10,261
chr1,203556226,203556745,SRX5075170,SMARCA4,519
chr1,203556251,203556682,SRX5075176,SMARCA4,431
chr1,203556292,203556682,SRX5716470,SMARCA4,390
chr1,203556324,203556660,SRX5075175,SMARCA4,336
chr1,203556329,203556703,SRX5716467,SMARCA2,374
chr1,203556357,203556681,SRX5075181,SMARCA2,324
chr1,203556384,203556696,SRX5075169,SMARCA4,312
chr1,203556445,203556695,SRX5716468,SMARCA2,250
chr1,203558155,203558598,SRX5075170,SMARCA4,443
chr1,203558168,203558582,SRX5075175,SMARCA4,414
chr1,203558216,203558443,SRX5716470,SMARCA4,227
chr1,203558239,203558704,SRX5075169,SMARCA4,465
chr1,203558265,203558545,SRX5716469,SMARCA4,280
chr1,203558306,203558636,SRX5075176,SMARCA4,330
chr1,203558357,203558647,SRX5054309,FOSL2,290
chr1,203571985,203572572,SRX5075168,SMARCA4,587
chr1,203572010,203572487,SRX5716463,SMARCA4,477
chr1,203572045,203572441,SRX20140868,INTS10,396
chr1,203572049,203572433,SRX20140895,INTS13,384
chr1,203572060,203572353,SRX5716470,SMARCA4,293
chr1,203572060,203572569,SRX5075174,SMARCA4,509
chr1,203572085,203572586,SRX5075170,SMARCA4,501
chr1,203572086,203572457,SRX5716469,SMARCA4,371
chr1,203572134,203572454,SRX5075176,SMARCA4,320
chr1,203572141,203572495,SRX5716464,SMARCA4,354
chr1,203572175,203572484,SRX5716451,SOX2,309
chr1,203589229,203589529,SRX5075176,SMARCA4,300
chr1,203589332,203589536,SRX5075170,SMARCA4,204
chr1,203607237,203607630,SRX5075169,SMARCA4,393
chr1,203607240,203607624,SRX5075175,SMARCA4,384
chr1,203607256,203607663,SRX5075170,SMARCA4,407
chr1,203607261,203607613,SRX5075176,SMARCA4,352
chr1,203607273,203607562,SRX5075168,SMARCA4,289
chr1,203607282,203607601,SRX5716469,SMARCA4,319
chr1,203607299,203607620,SRX5054309,FOSL2,321
chr1,203607309,203607593,SRX5075174,SMARCA4,284
chr1,203607309,203607610,SRX5716467,SMARCA2,301
chr1,203607310,203607578,SRX5716470,SMARCA4,268
chr1,203607331,203607640,SRX5054308,FOSL2,309
chr1,203607367,203607629,SRX5716460,Epitope tags,262
chr1,203613259,203613460,SRX5075170,SMARCA4,201
chr1,203613263,203613482,SRX5075176,SMARCA4,219
chr1,203626527,203626819,SRX5075168,SMARCA4,292
chr1,203626564,203626942,SRX5075174,SMARCA4,378
chr1,203626568,203626939,SRX5075170,SMARCA4,371
chr1,203626574,203626873,SRX5075176,SMARCA4,299
chr1,203626657,203626883,SRX5054309,FOSL2,226
chr1,203626666,203626865,SRX5075169,SMARCA4,199
chr1,203626718,203626898,SRX5054308,FOSL2,180
chr1,203628308,203628628,SRX16500060,CTCF,320
chr1,203628326,203628548,SRX16500062,CTCF,222
chr1,203628368,203628629,SRX16500059,CTCF,261
chr1,203629595,203629825,SRX5075174,SMARCA4,230
chr1,203629672,203629963,SRX20140895,INTS13,291
chr1,203645166,203645383,SRX5075170,SMARCA4,217
chr1,203645181,203645366,SRX5075176,SMARCA4,185
chr1,203645208,203645411,SRX5075175,SMARCA4,203
chr1,203645241,203645443,SRX5075169,SMARCA4,202
chr1,203650243,203650749,SRX5075176,SMARCA4,506
chr1,203650315,203650562,SRX5054308,FOSL2,247
chr1,203650351,203650678,SRX5075169,SMARCA4,327
chr1,203650354,203650787,SRX5075175,SMARCA4,433
chr1,203650458,203650846,SRX5075170,SMARCA4,388
chr1,203650472,203650807,SRX5716470,SMARCA4,335
chr1,203650522,203650805,SRX5075168,SMARCA4,283
chr1,203663160,203663668,SRX5075170,SMARCA4,508
chr1,203663161,203663641,SRX5075176,SMARCA4,480
chr1,203663195,203663670,SRX5075169,SMARCA4,475
chr1,203663231,203663492,SRX5075175,SMARCA4,261
chr1,203663285,203663522,SRX5716469,SMARCA4,237
chr1,203663313,203663611,SRX5054309,FOSL2,298
chr1,203663317,203663615,SRX5054308,FOSL2,298
chr1,203669752,203670064,SRX5075176,SMARCA4,312
chr1,203669781,203670107,SRX5075170,SMARCA4,326
chr1,203669820,203670042,SRX5075175,SMARCA4,222
chr1,203669826,203670048,SRX5075168,SMARCA4,222
chr1,203669838,203670071,SRX5075174,SMARCA4,233
chr1,203669863,203670043,SRX5075169,SMARCA4,180
chr1,203669874,203670087,SRX5054308,FOSL2,213
chr1,203672441,203672629,SRX5075174,SMARCA4,188
chr1,203672442,203672611,SRX5075170,SMARCA4,169
chr1,203673989,203674511,SRX5075168,SMARCA4,522
chr1,203674132,203674526,SRX5075174,SMARCA4,394
chr1,203674169,203674529,SRX5716469,SMARCA4,360
chr1,203674192,203674543,SRX5054309,FOSL2,351
chr1,203674208,203674509,SRX5075170,SMARCA4,301
chr1,203674217,203674529,SRX5054308,FOSL2,312
chr1,203674233,203674507,SRX5075175,SMARCA4,274
chr1,203674237,203674521,SRX5075169,SMARCA4,284
chr1,203674238,203674532,SRX5075176,SMARCA4,294
chr1,203674248,203674472,SRX5716470,SMARCA4,224
chr1,203677916,203678135,SRX5075174,SMARCA4,219
chr1,203677982,203678263,SRX5075168,SMARCA4,281
chr1,203686004,203686595,SRX5075170,SMARCA4,591
chr1,203686068,203686633,SRX5075176,SMARCA4,565
chr1,203686090,203686502,SRX5075175,SMARCA4,412
chr1,203686206,203686592,SRX5075169,SMARCA4,386
chr1,203686231,203686542,SRX5716469,SMARCA4,311
chr1,203686286,203686589,SRX5716470,SMARCA4,303
chr1,203692575,203693490,SRX5075176,SMARCA4,915
chr1,203692594,203693495,SRX5075170,SMARCA4,901
chr1,203692622,203693482,SRX5716469,SMARCA4,860
chr1,203692628,203693482,SRX5075175,SMARCA4,854
chr1,203692669,203693527,SRX5075169,SMARCA4,858
chr1,203692707,203693459,SRX5716467,SMARCA2,752
chr1,203692711,203693485,SRX5054309,FOSL2,774
chr1,203692750,203693479,SRX5716470,SMARCA4,729
chr1,203692794,203693484,SRX5054308,FOSL2,690
chr1,203692856,203693418,SRX5020211,SMARCA2,562
chr1,203693050,203693313,SRX5020214,SMARCA2,263
chr1,203693069,203693398,SRX5716468,SMARCA2,329
chr1,203701976,203702487,SRX4174629,CTCF,511
chr1,203702019,203702520,SRX16500059,CTCF,501
chr1,203702041,203702511,SRX16500061,CTCF,470
chr1,203702044,203702501,SRX16500062,CTCF,457
chr1,203702047,203702527,SRX16500060,CTCF,480
chr1,203720209,203720653,SRX5075174,SMARCA4,444
chr1,203720241,203720514,SRX5075168,SMARCA4,273
chr1,203744207,203744440,SRX5075170,SMARCA4,233
chr1,203751049,203751282,SRX5716470,SMARCA4,233
chr1,203751055,203751370,SRX5075169,SMARCA4,315
chr1,203751065,203751317,SRX5075176,SMARCA4,252
chr1,203751067,203751362,SRX5716469,SMARCA4,295
chr1,203751069,203751322,SRX5075175,SMARCA4,253
chr1,203751097,203751350,SRX5716468,SMARCA2,253
chr1,203751142,203751384,SRX5020214,SMARCA2,242
chr1,203769503,203769721,SRX5075176,SMARCA4,218
chr1,203769562,203769749,SRX5075175,SMARCA4,187
chr1,203769586,203769798,SRX5716469,SMARCA4,212
chr1,203795220,203795472,SRX5716470,SMARCA4,252
chr1,203795252,203795556,SRX5075169,SMARCA4,304
chr1,203795285,203796008,SRX20140895,INTS13,723
chr1,203795297,203795943,SRX20140897,INTS13,646
chr1,203795300,203795611,SRX5075176,SMARCA4,311
chr1,203795307,203795686,SRX5075168,SMARCA4,379
chr1,203795326,203795992,SRX5075174,SMARCA4,666
chr1,203795339,203795776,SRX5716464,SMARCA4,437
chr1,203795351,203795677,SRX5075170,SMARCA4,326
chr1,203795360,203795565,SRX5716463,SMARCA4,205
chr1,203795402,203795976,SRX20140867,INTS10,574
chr1,203795445,203795913,SRX20140869,INTS10,468
chr1,203795455,203796006,SRX20140868,INTS10,551
chr1,203795458,203795758,SRX20140896,INTS13,300
chr1,203795510,203795824,SRX20140881,CPSF3L,314
chr1,203795555,203795846,SRX20140894,INTS13,291
chr1,203795585,203795891,SRX20140879,CPSF3L,306
chr1,203807314,203807558,SRX5075169,SMARCA4,244
chr1,203807316,203807485,SRX5075170,SMARCA4,169
chr1,203807323,203807506,SRX5054309,FOSL2,183
chr1,203829334,203829564,SRX5075170,SMARCA4,230
chr1,203829334,203829631,SRX5075176,SMARCA4,297
chr1,203829348,203829550,SRX5054308,FOSL2,202
chr1,203829352,203829539,SRX5075175,SMARCA4,187
chr1,203829393,203829614,SRX5075169,SMARCA4,221
chr1,203839084,203839603,SRX5716469,SMARCA4,519
chr1,203839110,203839558,SRX5716470,SMARCA4,448
chr1,203839116,203839601,SRX5075170,SMARCA4,485
chr1,203839140,203839571,SRX5075176,SMARCA4,431
chr1,203839146,203839561,SRX5716467,SMARCA2,415
chr1,203839164,203839519,SRX5716468,SMARCA2,355
chr1,203839184,203839611,SRX5075169,SMARCA4,427
chr1,203839199,203839559,SRX5075175,SMARCA4,360
chr1,203839245,203839449,SRX5054308,FOSL2,204
chr1,203839246,203839468,SRX5020214,SMARCA2,222
chr1,203839258,203839514,SRX5054309,FOSL2,256
chr1,203839265,203839500,SRX5075181,SMARCA2,235
chr1,203839282,203839575,SRX5020211,SMARCA2,293
chr1,203858122,203858399,SRX5054308,FOSL2,277
chr1,203861193,203861706,SRX16500060,CTCF,513
chr1,203861221,203861735,SRX16500059,CTCF,514
chr1,203861229,203861722,SRX5075174,SMARCA4,493
chr1,203861232,203861689,SRX16500061,CTCF,457
chr1,203861245,203861693,SRX16500062,CTCF,448
chr1,203861261,203861611,SRX5075170,SMARCA4,350
chr1,203861276,203861583,SRX5716464,SMARCA4,307
chr1,203861280,203861799,SRX5075168,SMARCA4,519
chr1,203861291,203861678,SRX5075176,SMARCA4,387
chr1,203861295,203861589,SRX5075169,SMARCA4,294
chr1,203861312,203861623,SRX4174629,CTCF,311
chr1,203861324,203861772,SRX5716463,SMARCA4,448
chr1,203861327,203861985,SRX20140895,INTS13,658
chr1,203861362,203862011,SRX20140868,INTS10,649
chr1,203861364,203861691,SRX5716454,SOX3,327
chr1,203861401,203861812,SRX5716469,SMARCA4,411
chr1,203861403,203861798,SRX20140894,INTS13,395
chr1,203861411,203861893,SRX20140867,INTS10,482
chr1,203861418,203861852,SRX20140897,INTS13,434
chr1,203861433,203861884,SRX20140881,CPSF3L,451
chr1,203861457,203861942,SRX5716470,SMARCA4,485
chr1,203861482,203861944,SRX20140869,INTS10,462
chr1,203861560,203861831,SRX20140896,INTS13,271
chr1,203861589,203861848,SRX20140879,CPSF3L,259
chr1,203870909,203871455,SRX16500059,CTCF,546
chr1,203870919,203871454,SRX16500060,CTCF,535
chr1,203870935,203871462,SRX16500061,CTCF,527
chr1,203870935,203871505,SRX4174629,CTCF,570
chr1,203870961,203871487,SRX16500062,CTCF,526
chr1,203871102,203871387,SRX5075174,SMARCA4,285
chr1,203871122,203871326,SRX5716463,SMARCA4,204
chr1,203871125,203871419,SRX5075168,SMARCA4,294
chr1,203871138,203871483,SRX5716469,SMARCA4,345
chr1,203871141,203871470,SRX5075170,SMARCA4,329
chr1,203871145,203871477,SRX5075176,SMARCA4,332
chr1,203871168,203871438,SRX5075175,SMARCA4,270
chr1,203871186,203871420,SRX5075169,SMARCA4,234
chr1,203871214,203871517,SRX5716470,SMARCA4,303
chr1,203888742,203889301,SRX5075170,SMARCA4,559
chr1,203888809,203889310,SRX5075175,SMARCA4,501
chr1,203888864,203889288,SRX5075176,SMARCA4,424
chr1,203888885,203889251,SRX5075169,SMARCA4,366
chr1,203888885,203889292,SRX5020214,SMARCA2,407
chr1,203888999,203889211,SRX5716469,SMARCA4,212
chr1,203889016,203889269,SRX5054309,FOSL2,253
chr1,203889083,203889263,SRX5054308,FOSL2,180
chr1,203906921,203907349,SRX5075175,SMARCA4,428
chr1,203906944,203907375,SRX5075169,SMARCA4,431
chr1,203906948,203907371,SRX5054309,FOSL2,423
chr1,203906950,203907370,SRX5075170,SMARCA4,420
chr1,203906955,203907338,SRX5020211,SMARCA2,383
chr1,203906961,203907318,SRX5716469,SMARCA4,357
chr1,203906961,203907411,SRX5075176,SMARCA4,450
chr1,203906967,203907273,SRX5716467,SMARCA2,306
chr1,203906967,203907354,SRX5054308,FOSL2,387
chr1,203906972,203907278,SRX5716459,Epitope tags,306
chr1,203906972,203907350,SRX5020214,SMARCA2,378
chr1,203906977,203907354,SRX5716470,SMARCA4,377
chr1,203906993,203907308,SRX5716460,Epitope tags,315
chr1,203907033,203907238,SRX5075181,SMARCA2,205
chr1,203907057,203907276,SRX5075182,SMARCA2,219
chr1,203907095,203907324,SRX5075168,SMARCA4,229
chr1,203907096,203907286,SRX5075174,SMARCA4,190
chr1,203922736,203923001,SRX5075170,SMARCA4,265
chr1,203922740,203923084,SRX5075176,SMARCA4,344
chr1,203985052,203985364,SRX5075174,SMARCA4,312
chr1,203985109,203985390,SRX5716464,SMARCA4,281
chr1,203985111,203985375,SRX5716463,SMARCA4,264
chr1,203985125,203985383,SRX5075168,SMARCA4,258
chr1,203995251,203995513,SRX5075170,SMARCA4,262
chr1,203996158,203996407,SRX5075174,SMARCA4,249
chr1,203996516,203997105,SRX20140895,INTS13,589
chr1,203996564,203997154,SRX5075174,SMARCA4,590
chr1,203996578,203997188,SRX5075168,SMARCA4,610
chr1,203996688,203997085,SRX5716451,SOX2,397
chr1,203996712,203997100,SRX5716454,SOX3,388
chr1,203996723,203997036,SRX5716463,SMARCA4,313
chr1,204026166,204026488,SRX20140895,INTS13,322
chr1,204041136,204041414,SRX5075170,SMARCA4,278
chr1,204041141,204041550,SRX5075169,SMARCA4,409
chr1,204041210,204041467,SRX5075176,SMARCA4,257
chr1,204046389,204046639,SRX5075170,SMARCA4,250
chr1,204057399,204058002,SRX5075174,SMARCA4,603
chr1,204057419,204058057,SRX5075170,SMARCA4,638
chr1,204057425,204058030,SRX5075168,SMARCA4,605
chr1,204057462,204058061,SRX5075176,SMARCA4,599
chr1,204057570,204058038,SRX5075175,SMARCA4,468
chr1,204057697,204058094,SRX5075169,SMARCA4,397
chr1,204057716,204058071,SRX5716469,SMARCA4,355
chr1,204057739,204058110,SRX5054309,FOSL2,371
chr1,204057766,204058040,SRX5054308,FOSL2,274
chr1,204065189,204065424,SRX5075176,SMARCA4,235
chr1,204065310,204065633,SRX5075174,SMARCA4,323
chr1,204065352,204065562,SRX5716463,SMARCA4,210
chr1,204065355,204065534,SRX5075168,SMARCA4,179
chr1,204065375,204065602,SRX5716451,SOX2,227
chr1,204072866,204073147,SRX5075174,SMARCA4,281
chr1,204072886,204073159,SRX5075168,SMARCA4,273
chr1,204072949,204073259,SRX5075170,SMARCA4,310
chr1,204072961,204073495,SRX20140895,INTS13,534
chr1,204073043,204073441,SRX20140868,INTS10,398
chr1,204073063,204073340,SRX20140879,CPSF3L,277
chr1,204073067,204073304,SRX20140867,INTS10,237
chr1,204074741,204074936,SRX5075169,SMARCA4,195
chr1,204078645,204078942,SRX5075174,SMARCA4,297
chr1,204090979,204091227,SRX5075168,SMARCA4,248
chr1,204094274,204094826,SRX20140895,INTS13,552
chr1,204094275,204094522,SRX20140894,INTS13,247
chr1,204094314,204094758,SRX20140879,CPSF3L,444
chr1,204094370,204094737,SRX5075168,SMARCA4,367
chr1,204094405,204094719,SRX5075174,SMARCA4,314
chr1,204108421,204109058,SRX20140895,INTS13,637
chr1,204108481,204109227,SRX5075174,SMARCA4,746
chr1,204108555,204109235,SRX5075168,SMARCA4,680
chr1,204108569,204108925,SRX20140879,CPSF3L,356
chr1,204108639,204109013,SRX20140868,INTS10,374
chr1,204108641,204109038,SRX20140867,INTS10,397
chr1,204108645,204109024,SRX5716451,SOX2,379
chr1,204108666,204109077,SRX5716463,SMARCA4,411
chr1,204108686,204108987,SRX5075170,SMARCA4,301
chr1,204108689,204109021,SRX5716454,SOX3,332
chr1,204108746,204109020,SRX5716464,SMARCA4,274
chr1,204108825,204109000,SRX5075176,SMARCA4,175
chr1,204127597,204128037,SRX16500059,CTCF,440
chr1,204127623,204128020,SRX16500060,CTCF,397
chr1,204127634,204128036,SRX16500061,CTCF,402
chr1,204127638,204127978,SRX5075168,SMARCA4,340
chr1,204127640,204127904,SRX5075170,SMARCA4,264
chr1,204127641,204128025,SRX16500062,CTCF,384
chr1,204127657,204127865,SRX5075176,SMARCA4,208
chr1,204127661,204128024,SRX4174629,CTCF,363
chr1,204127685,204127911,SRX5075174,SMARCA4,226
chr1,204128948,204129494,SRX16500059,CTCF,546
chr1,204128969,204129427,SRX16500061,CTCF,458
chr1,204128981,204129445,SRX16500060,CTCF,464
chr1,204128987,204129454,SRX16500062,CTCF,467
chr1,204128993,204129261,SRX4174629,CTCF,268
chr1,204129050,204129289,SRX5075168,SMARCA4,239
chr1,204129073,204129259,SRX5075174,SMARCA4,186
chr1,204130870,204131393,SRX5075176,SMARCA4,523
chr1,204130889,204131280,SRX5716470,SMARCA4,391
chr1,204130907,204131311,SRX5075169,SMARCA4,404
chr1,204130909,204131291,SRX5716469,SMARCA4,382
chr1,204130918,204131497,SRX5075170,SMARCA4,579
chr1,204130938,204131230,SRX5716467,SMARCA2,292
chr1,204130946,204131322,SRX5054309,FOSL2,376
chr1,204130965,204131373,SRX5075175,SMARCA4,408
chr1,204130985,204131336,SRX5054308,FOSL2,351
chr1,204130993,204131209,SRX5020211,SMARCA2,216
chr1,204151676,204152494,SRX5075174,SMARCA4,818
chr1,204151683,204152215,SRX5075175,SMARCA4,532
chr1,204151699,204152459,SRX20140895,INTS13,760
chr1,204151755,204152384,SRX5075168,SMARCA4,629
chr1,204151776,204152056,SRX5075170,SMARCA4,280
chr1,204151794,204152021,SRX5716470,SMARCA4,227
chr1,204151811,204152111,SRX5716469,SMARCA4,300
chr1,204151842,204152063,SRX5054309,FOSL2,221
chr1,204151854,204152167,SRX5075176,SMARCA4,313
chr1,204151897,204152111,SRX20140867,INTS10,214
chr1,204151906,204152141,SRX5054308,FOSL2,235
chr1,204151925,204152434,SRX5075169,SMARCA4,509
chr1,204152084,204152361,SRX20140868,INTS10,277
chr1,204162403,204162976,SRX16500060,CTCF,573
chr1,204162405,204162946,SRX16500059,CTCF,541
chr1,204162415,204162905,SRX16500062,CTCF,490
chr1,204162415,204162957,SRX16500061,CTCF,542
chr1,204162495,204162958,SRX4174629,CTCF,463
chr1,204162503,204162798,SRX5075168,SMARCA4,295
chr1,204162520,204162809,SRX5075174,SMARCA4,289
chr1,204162563,204162789,SRX5075170,SMARCA4,226
chr1,204162576,204162814,SRX5075176,SMARCA4,238
chr1,204162586,204162829,SRX5075169,SMARCA4,243
chr1,204162599,204162840,SRX5716470,SMARCA4,241
chr1,204206965,204207551,SRX16500059,CTCF,586
chr1,204207000,204207489,SRX16500061,CTCF,489
chr1,204207023,204207555,SRX16500062,CTCF,532
chr1,204207029,204207445,SRX4174629,CTCF,416
chr1,204207033,204207541,SRX16500060,CTCF,508
chr1,204207120,204207382,SRX5075168,SMARCA4,262
chr1,204207160,204207395,SRX5075174,SMARCA4,235
chr1,204214089,204214629,SRX16500060,CTCF,540
chr1,204214089,204214646,SRX16500059,CTCF,557
chr1,204214127,204214601,SRX16500061,CTCF,474
chr1,204214143,204214611,SRX16500062,CTCF,468
chr1,204214166,204214554,SRX5716470,SMARCA4,388
chr1,204214187,204214514,SRX5075174,SMARCA4,327
chr1,204214260,204214595,SRX5075168,SMARCA4,335
chr1,204214323,204214569,SRX4174629,CTCF,246
chr1,204222821,204222990,SRX5075170,SMARCA4,169
chr1,204224763,204225017,SRX5054309,FOSL2,254
chr1,204224853,204225034,SRX5075170,SMARCA4,181
chr1,204232371,204232929,SRX5075176,SMARCA4,558
chr1,204232423,204232941,SRX5075170,SMARCA4,518
chr1,204232451,204232937,SRX5075169,SMARCA4,486
chr1,204232461,204232867,SRX5716470,SMARCA4,406
chr1,204232491,204232908,SRX5716469,SMARCA4,417
chr1,204232494,204232823,SRX5716467,SMARCA2,329
chr1,204232514,204232943,SRX5054308,FOSL2,429
chr1,204232518,204232940,SRX5075175,SMARCA4,422
chr1,204232532,204232794,SRX5716468,SMARCA2,262
chr1,204232546,204232857,SRX5020211,SMARCA2,311
chr1,204232549,204232910,SRX5054309,FOSL2,361
chr1,204232582,204232790,SRX5075181,SMARCA2,208
chr1,204232598,204232830,SRX5020214,SMARCA2,232
chr1,204232654,204232834,SRX5075182,SMARCA2,180
chr1,204255157,204255672,SRX5075174,SMARCA4,515
chr1,204255182,204255600,SRX5075168,SMARCA4,418
chr1,204256073,204256289,SRX5075170,SMARCA4,216
chr1,204256103,204256286,SRX5075176,SMARCA4,183
chr1,204256124,204256304,SRX5054308,FOSL2,180
chr1,204258274,204258744,SRX16500059,CTCF,470
chr1,204258359,204258747,SRX16500062,CTCF,388
chr1,204258375,204258759,SRX16500061,CTCF,384
chr1,204258383,204258803,SRX16500060,CTCF,420
chr1,204272551,204272893,SRX5075176,SMARCA4,342
chr1,204278991,204279259,SRX5075176,SMARCA4,268
chr1,204279014,204279295,SRX5075170,SMARCA4,281
chr1,204294357,204294687,SRX5075169,SMARCA4,330
chr1,204294393,204294672,SRX5075175,SMARCA4,279
chr1,204294409,204294758,SRX5075176,SMARCA4,349
chr1,204294412,204294744,SRX5054308,FOSL2,332
chr1,204294420,204294647,SRX5716469,SMARCA4,227
chr1,204294431,204294666,SRX5075170,SMARCA4,235
chr1,204294464,204294720,SRX5054309,FOSL2,256
chr1,204296550,204296748,SRX5075169,SMARCA4,198
chr1,204304078,204304466,SRX5075168,SMARCA4,388
chr1,204304104,204304425,SRX5075174,SMARCA4,321
chr1,204323869,204324107,SRX5075170,SMARCA4,238
chr1,204335208,204335402,SRX5075176,SMARCA4,194
chr1,204336744,204336959,SRX20140867,INTS10,215
chr1,204341501,204341855,SRX5054309,FOSL2,354
chr1,204341576,204341802,SRX5054308,FOSL2,226
chr1,204348748,204349105,SRX5075174,SMARCA4,357
chr1,204348778,204349114,SRX5075168,SMARCA4,336
chr1,204348794,204349051,SRX5075170,SMARCA4,257
chr1,204348833,204349119,SRX5075176,SMARCA4,286
chr1,204348844,204349068,SRX20140867,INTS10,224
chr1,204350831,204351238,SRX5075176,SMARCA4,407
chr1,204350860,204351421,SRX5075168,SMARCA4,561
chr1,204350863,204351127,SRX5075170,SMARCA4,264
chr1,204350863,204351285,SRX20140895,INTS13,422
chr1,204350898,204351407,SRX5075174,SMARCA4,509
chr1,204350935,204351196,SRX5716463,SMARCA4,261
chr1,204350957,204351209,SRX5716464,SMARCA4,252
chr1,204350963,204351268,SRX20140867,INTS10,305
chr1,204359264,204359544,SRX5075176,SMARCA4,280
chr1,204359611,204360092,SRX5075176,SMARCA4,481
chr1,204359651,204359935,SRX5716470,SMARCA4,284
chr1,204359687,204360030,SRX5075169,SMARCA4,343
chr1,204359716,204360057,SRX5075170,SMARCA4,341
chr1,204359735,204360147,SRX20140895,INTS13,412
chr1,204359763,204360005,SRX5716467,SMARCA2,242
chr1,204359824,204360072,SRX5075175,SMARCA4,248
chr1,204363544,204364080,SRX16500059,CTCF,536
chr1,204363578,204364088,SRX16500060,CTCF,510
chr1,204363608,204363994,SRX4174629,CTCF,386
chr1,204363611,204364089,SRX16500061,CTCF,478
chr1,204363618,204364076,SRX16500062,CTCF,458
chr1,204363622,204364025,SRX5075168,SMARCA4,403
chr1,204363623,204363866,SRX5716469,SMARCA4,243
chr1,204363689,204363963,SRX5075174,SMARCA4,274
chr1,204363694,204363916,SRX5075170,SMARCA4,222
chr1,204377838,204378040,SRX5075168,SMARCA4,202
chr1,204378055,204378268,SRX5716470,SMARCA4,213
chr1,204378154,204378435,SRX5075168,SMARCA4,281
chr1,204378261,204378434,SRX5075174,SMARCA4,173
chr1,204398352,204398936,SRX16500062,CTCF,584
chr1,204398427,204398986,SRX16500061,CTCF,559
chr1,204398435,204399026,SRX16500059,CTCF,591
chr1,204398448,204398996,SRX16500060,CTCF,548
chr1,204398480,204398938,SRX4174629,CTCF,458
chr1,204398517,204398824,SRX5716470,SMARCA4,307
chr1,204398531,204398878,SRX5075168,SMARCA4,347
chr1,204398557,204398859,SRX5075174,SMARCA4,302
chr1,204398577,204398781,SRX5716463,SMARCA4,204
chr1,204398597,204398780,SRX5075176,SMARCA4,183
chr1,204411579,204411897,SRX20140869,INTS10,318
chr1,204411596,204411898,SRX20140867,INTS10,302
chr1,204411622,204411973,SRX20140895,INTS13,351
chr1,204411629,204411892,SRX20140897,INTS13,263
chr1,204411747,204411982,SRX5075176,SMARCA4,235
chr1,204411835,204412315,SRX5075168,SMARCA4,480
chr1,204411850,204412228,SRX5716464,SMARCA4,378
chr1,204411857,204412026,SRX5075170,SMARCA4,169
chr1,204411864,204412037,SRX5075174,SMARCA4,173
chr1,204411871,204412099,SRX5716454,SOX3,228
chr1,204411966,204412305,SRX5716463,SMARCA4,339
chr1,204412029,204412241,SRX5716469,SMARCA4,212
chr1,204412036,204412091,SRX1424894,POU3F2,55
chr1,204412036,204412093,SRX1424893,POU3F2,57
chr1,204412039,204412089,SRX1424891,POU3F2,50
chr1,204412039,204412090,SRX1424892,POU3F2,51
chr1,204412096,204412374,SRX5075174,SMARCA4,278
chr1,204412132,204412301,SRX5075170,SMARCA4,169
chr1,204412144,204412319,SRX5075176,SMARCA4,175
chr1,204417077,204417868,SRX5075169,SMARCA4,791
chr1,204417090,204417362,SRX5716469,SMARCA4,272
chr1,204417096,204417392,SRX5054309,FOSL2,296
chr1,204417103,204417396,SRX5075170,SMARCA4,293
chr1,204417113,204417392,SRX5054308,FOSL2,279
chr1,204417145,204417350,SRX5075175,SMARCA4,205
chr1,204417177,204417448,SRX5075176,SMARCA4,271
chr1,204417563,204417889,SRX5075175,SMARCA4,326
chr1,204417613,204417942,SRX5075170,SMARCA4,329
chr1,204417637,204417940,SRX5054309,FOSL2,303
chr1,204417652,204417897,SRX5054308,FOSL2,245
chr1,204417663,204417920,SRX5075176,SMARCA4,257
chr1,204431128,204431722,SRX16500062,CTCF,594
chr1,204431209,204431763,SRX16500059,CTCF,554
chr1,204431241,204431715,SRX16500061,CTCF,474
chr1,204431259,204431745,SRX16500060,CTCF,486
chr1,204431260,204431773,SRX4174629,CTCF,513
chr1,204431359,204431671,SRX5075168,SMARCA4,312
chr1,204431366,204431627,SRX5075174,SMARCA4,261
chr1,204431427,204431641,SRX5075170,SMARCA4,214
chr1,204431462,204431637,SRX5075176,SMARCA4,175
chr1,204438639,204438911,SRX5075176,SMARCA4,272
chr1,204438651,204438900,SRX5075170,SMARCA4,249
chr1,204438663,204438889,SRX5716469,SMARCA4,226
chr1,204438665,204438927,SRX5075169,SMARCA4,262
chr1,204438676,204438924,SRX5075175,SMARCA4,248
chr1,204445827,204446749,SRX16500059,CTCF,922
chr1,204445843,204446713,SRX16500061,CTCF,870
chr1,204445899,204446794,SRX16500062,CTCF,895
chr1,204445937,204446741,SRX16500060,CTCF,804
chr1,204446376,204446745,SRX4174629,CTCF,369
chr1,204446461,204446753,SRX5075174,SMARCA4,292
chr1,204446496,204446733,SRX5075168,SMARCA4,237
chr1,204446538,204446754,SRX5075176,SMARCA4,216
chr1,204454931,204455656,SRX5075174,SMARCA4,725
chr1,204454934,204455578,SRX5075168,SMARCA4,644
chr1,204454964,204455428,SRX5716464,SMARCA4,464
chr1,204454967,204455589,SRX20140895,INTS13,622
chr1,204455010,204455594,SRX20140868,INTS10,584
chr1,204455024,204455394,SRX20140879,CPSF3L,370
chr1,204455045,204455582,SRX5716463,SMARCA4,537
chr1,204455052,204455544,SRX5716451,SOX2,492
chr1,204455058,204455311,SRX20140867,INTS10,253
chr1,204455079,204455539,SRX5716454,SOX3,460
chr1,204456929,204457390,SRX5075176,SMARCA4,461
chr1,204456935,204457437,SRX5075170,SMARCA4,502
chr1,204456945,204457231,SRX5716469,SMARCA4,286
chr1,204457020,204457317,SRX5716470,SMARCA4,297
chr1,204457052,204457262,SRX5020211,SMARCA2,210
chr1,204457064,204457293,SRX5075175,SMARCA4,229
chr1,204457110,204457352,SRX5075169,SMARCA4,242
chr1,204493133,204493319,SRX5075176,SMARCA4,186
chr1,204494001,204495071,SRX20140895,INTS13,1070
chr1,204494344,204495031,SRX20140868,INTS10,687
chr1,204494401,204494936,SRX16500059,CTCF,535
chr1,204494405,204494722,SRX20140881,CPSF3L,317
chr1,204494424,204494950,SRX16500060,CTCF,526
chr1,204494451,204494873,SRX16500062,CTCF,422
chr1,204494474,204494925,SRX16500061,CTCF,451
chr1,204494496,204494904,SRX20140867,INTS10,408
chr1,204494571,204495068,SRX5075168,SMARCA4,497
chr1,204494593,204494998,SRX5075174,SMARCA4,405
chr1,204494601,204494863,SRX5716451,SOX2,262
chr1,204494644,204494950,SRX5716470,SMARCA4,306
chr1,204494659,204495099,SRX5075176,SMARCA4,440
chr1,204494678,204495045,SRX5075170,SMARCA4,367
chr1,204494686,204495128,SRX5075169,SMARCA4,442
chr1,204494740,204495073,SRX5075175,SMARCA4,333
chr1,204494884,204495102,SRX5716463,SMARCA4,218
chr1,204503087,204503577,SRX16500060,CTCF,490
chr1,204503088,204503648,SRX16500061,CTCF,560
chr1,204503093,204503598,SRX16500059,CTCF,505
chr1,204503100,204503563,SRX16500062,CTCF,463
chr1,204506243,204507491,SRX20140895,INTS13,1248
chr1,204506294,204507320,SRX20140869,INTS10,1026
chr1,204506309,204506688,SRX20140868,INTS10,379
chr1,204506376,204506645,SRX20140867,INTS10,269
chr1,204506418,204507224,SRX20140860,SOX2,806
chr1,204506441,204506970,SRX20140894,INTS13,529
chr1,204506504,204506752,SRX5075174,SMARCA4,248
chr1,204506532,204507295,SRX20140879,CPSF3L,763
chr1,204506719,204507346,SRX20140881,CPSF3L,627
chr1,204506848,204507117,SRX5716451,SOX2,269
chr1,204506918,204507298,SRX20140868,INTS10,380
chr1,204507000,204507258,SRX20140867,INTS10,258
chr1,204507557,204507851,SRX20140895,INTS13,294
chr1,204516022,204516718,SRX20140895,INTS13,696
chr1,204516046,204516579,SRX5075174,SMARCA4,533
chr1,204516093,204516761,SRX20140897,INTS13,668
chr1,204516105,204516492,SRX5075168,SMARCA4,387
chr1,204516126,204516641,SRX20140867,INTS10,515
chr1,204516130,204516668,SRX5075176,SMARCA4,538
chr1,204516173,204516683,SRX20140879,CPSF3L,510
chr1,204516200,204516681,SRX20140869,INTS10,481
chr1,204516203,204516682,SRX5075169,SMARCA4,479
chr1,204516213,204516678,SRX20140868,INTS10,465
chr1,204516221,204516562,SRX5075175,SMARCA4,341
chr1,204516238,204516640,SRX5075170,SMARCA4,402
chr1,204516241,204516611,SRX5716463,SMARCA4,370
chr1,204516251,204516671,SRX5716469,SMARCA4,420
chr1,204516275,204516643,SRX20140896,INTS13,368
chr1,204516305,204516614,SRX5054309,FOSL2,309
chr1,204516402,204516724,SRX20140881,CPSF3L,322
chr1,204516450,204516678,SRX5716470,SMARCA4,228
chr1,204517461,204517507,SRX1424894,POU3F2,46
chr1,204517462,204517504,SRX1424892,POU3F2,42
chr1,204517462,204517504,SRX1424893,POU3F2,42
chr1,204517463,204517505,SRX1424891,POU3F2,42
chr1,204521289,204521484,SRX5054308,FOSL2,195
chr1,204560728,204560935,SRX5075174,SMARCA4,207
chr1,204560734,204560922,SRX5054309,FOSL2,188
chr1,204565612,204565915,SRX5716463,SMARCA4,303
chr1,204565710,204565945,SRX5075174,SMARCA4,235
chr1,204565733,204566465,SRX16500060,CTCF,732
chr1,204565734,204566482,SRX16500059,CTCF,748
chr1,204565789,204566419,SRX16500061,CTCF,630
chr1,204565801,204566486,SRX4174629,CTCF,685
chr1,204565808,204566318,SRX16500062,CTCF,510
chr1,204565876,204566179,SRX5075168,SMARCA4,303
chr1,204565879,204566130,SRX5075170,SMARCA4,251
chr1,204578874,204579087,SRX5075170,SMARCA4,213
chr1,204578919,204579219,SRX5075176,SMARCA4,300
chr1,204591720,204592096,SRX5075175,SMARCA4,376
chr1,204591798,204592145,SRX5054309,FOSL2,347
chr1,204591799,204592077,SRX5075169,SMARCA4,278
chr1,204591827,204592057,SRX5075176,SMARCA4,230
chr1,204591843,204592131,SRX5020214,SMARCA2,288
chr1,204591872,204592123,SRX5054308,FOSL2,251
chr1,204591877,204592102,SRX5075170,SMARCA4,225
chr1,204591881,204592094,SRX5716469,SMARCA4,213
chr1,204599173,204599349,SRX5075170,SMARCA4,176
chr1,204600980,204601201,SRX16500060,CTCF,221
chr1,204600991,204601298,SRX16500061,CTCF,307
chr1,204601053,204601291,SRX16500059,CTCF,238
chr1,204602059,204602442,SRX5075170,SMARCA4,383
chr1,204602091,204602471,SRX5075176,SMARCA4,380
chr1,204602103,204602550,SRX5075168,SMARCA4,447
chr1,204602123,204602416,SRX5075174,SMARCA4,293
chr1,204602133,204602381,SRX5716469,SMARCA4,248
chr1,204602159,204602505,SRX5716470,SMARCA4,346
chr1,204602163,204602437,SRX5054309,FOSL2,274
chr1,204602205,204602465,SRX5075175,SMARCA4,260
chr1,204602210,204602415,SRX5020214,SMARCA2,205
chr1,204602212,204602430,SRX5075169,SMARCA4,218
chr1,204602245,204602501,SRX5716467,SMARCA2,256
chr1,204623301,204623592,SRX5054309,FOSL2,291
chr1,204623322,204623619,SRX5075170,SMARCA4,297
chr1,204623331,204623575,SRX5054308,FOSL2,244
chr1,204623335,204623630,SRX5075176,SMARCA4,295
chr1,204623339,204623600,SRX5075174,SMARCA4,261
chr1,204623357,204623537,SRX5075169,SMARCA4,180
chr1,204623374,204623603,SRX5075168,SMARCA4,229
chr1,204630564,204630771,SRX5075174,SMARCA4,207
chr1,204637331,204638181,SRX5716469,SMARCA4,850
chr1,204637361,204637799,SRX20140895,INTS13,438
chr1,204637415,204638261,SRX5075170,SMARCA4,846
chr1,204637451,204637643,SRX5075175,SMARCA4,192
chr1,204637469,204637999,SRX5075174,SMARCA4,530
chr1,204637587,204637976,SRX5075168,SMARCA4,389
chr1,204637667,204638234,SRX5075169,SMARCA4,567
chr1,204637672,204638287,SRX5716470,SMARCA4,615
chr1,204637675,204638305,SRX5075176,SMARCA4,630
chr1,204637700,204637855,SRX1424894,POU3F2,155
chr1,204637706,204637860,SRX1424893,POU3F2,154
chr1,204637712,204637845,SRX1424891,POU3F2,133
chr1,204637759,204637810,SRX1424892,POU3F2,51
chr1,204637795,204638100,SRX5716467,SMARCA2,305
chr1,204637845,204638193,SRX5716468,SMARCA2,348
chr1,204637859,204638228,SRX20140895,INTS13,369
chr1,204637930,204638149,SRX5075175,SMARCA4,219
chr1,204638178,204638351,SRX5075174,SMARCA4,173
chr1,204647568,204647885,SRX5054309,FOSL2,317
chr1,204647570,204647875,SRX5075175,SMARCA4,305
chr1,204647584,204647833,SRX5075176,SMARCA4,249
chr1,204647594,204647899,SRX5075168,SMARCA4,305
chr1,204647596,204647885,SRX5075174,SMARCA4,289
chr1,204647605,204647827,SRX5054308,FOSL2,222
chr1,204647608,204647861,SRX5075170,SMARCA4,253
chr1,204647614,204647879,SRX5075169,SMARCA4,265
chr1,204647657,204647873,SRX5716470,SMARCA4,216
chr1,204670514,204670881,SRX5075170,SMARCA4,367
chr1,204670521,204670818,SRX5054309,FOSL2,297
chr1,204670526,204670834,SRX5054308,FOSL2,308
chr1,204670534,204670875,SRX5075176,SMARCA4,341
chr1,204670553,204670861,SRX5075175,SMARCA4,308
chr1,204670570,204670792,SRX5020214,SMARCA2,222
chr1,204670581,204670863,SRX5075169,SMARCA4,282
chr1,204670583,204670856,SRX5716470,SMARCA4,273
chr1,204670601,204670816,SRX5716467,SMARCA2,215
chr1,204670610,204670876,SRX5716469,SMARCA4,266
chr1,204685169,204685634,SRX5075168,SMARCA4,465
chr1,204685189,204685364,SRX5075176,SMARCA4,175
chr1,204685249,204685624,SRX5075174,SMARCA4,375
chr1,204691546,204691772,SRX5075176,SMARCA4,226
chr1,204691555,204691735,SRX5054308,FOSL2,180
chr1,204707092,204707363,SRX5075168,SMARCA4,271
chr1,204707105,204707385,SRX5075174,SMARCA4,280
chr1,204721525,204722245,SRX5075174,SMARCA4,720
chr1,204721608,204722205,SRX5075168,SMARCA4,597
chr1,204726610,204726856,SRX5054309,FOSL2,246
chr1,204732141,204732201,SRX1424893,POU3F2,60
chr1,204746731,204747282,SRX16500059,CTCF,551
chr1,204746760,204747294,SRX16500060,CTCF,534
chr1,204746789,204747198,SRX16500062,CTCF,409
chr1,204746832,204747282,SRX16500061,CTCF,450
chr1,204746924,204747175,SRX5716464,SMARCA4,251
chr1,204746931,204747222,SRX5075174,SMARCA4,291
chr1,204746941,204747216,SRX5075168,SMARCA4,275
chr1,204763742,204764232,SRX16500061,CTCF,490
chr1,204763755,204764077,SRX5075176,SMARCA4,322
chr1,204763760,204764143,SRX5075168,SMARCA4,383
chr1,204763774,204764292,SRX16500059,CTCF,518
chr1,204763776,204764260,SRX16500062,CTCF,484
chr1,204763779,204764001,SRX5054308,FOSL2,222
chr1,204763784,204763995,SRX5075170,SMARCA4,211
chr1,204763787,204764053,SRX5075175,SMARCA4,266
chr1,204763791,204764256,SRX16500060,CTCF,465
chr1,204763808,204764039,SRX5075169,SMARCA4,231
chr1,204763811,204764155,SRX5075174,SMARCA4,344
chr1,204763868,204764082,SRX4174629,CTCF,214
chr1,204763872,204764150,SRX5716464,SMARCA4,278
chr1,204791682,204792152,SRX16500062,CTCF,470
chr1,204791688,204792220,SRX16500061,CTCF,532
chr1,204791698,204792299,SRX16500060,CTCF,601
chr1,204791748,204792200,SRX16500059,CTCF,452
chr1,204791781,204792094,SRX5075168,SMARCA4,313
chr1,204791837,204792128,SRX5075174,SMARCA4,291
chr1,204806916,204807633,SRX16500061,CTCF,717
chr1,204806921,204807652,SRX4174629,CTCF,731
chr1,204806922,204807625,SRX16500059,CTCF,703
chr1,204806925,204807618,SRX16500060,CTCF,693
chr1,204806942,204807549,SRX5075168,SMARCA4,607
chr1,204806969,204807602,SRX16500062,CTCF,633
chr1,204807051,204807533,SRX5075174,SMARCA4,482
chr1,204807066,204807441,SRX5716470,SMARCA4,375
chr1,204807077,204807380,SRX5054309,FOSL2,303
chr1,204807112,204807342,SRX5716464,SMARCA4,230
chr1,204807128,204807437,SRX5075175,SMARCA4,309
chr1,204807168,204807412,SRX5075169,SMARCA4,244
chr1,204807203,204807470,SRX5075176,SMARCA4,267
chr1,204807207,204807425,SRX5716463,SMARCA4,218
chr1,204807210,204807450,SRX5075170,SMARCA4,240
chr1,204807220,204807479,SRX20140895,INTS13,259
chr1,204807971,204808275,SRX4174629,CTCF,304
chr1,204808021,204808458,SRX16500059,CTCF,437
chr1,204808071,204808423,SRX16500061,CTCF,352
chr1,204808074,204808448,SRX16500060,CTCF,374
chr1,204808087,204808447,SRX5075174,SMARCA4,360
chr1,204808091,204808411,SRX5075168,SMARCA4,320
chr1,204808096,204808409,SRX16500062,CTCF,313
chr1,204808119,204808392,SRX5075175,SMARCA4,273
chr1,204808129,204808406,SRX5075176,SMARCA4,277
chr1,204808130,204808399,SRX5075169,SMARCA4,269
chr1,204808134,204808404,SRX5075170,SMARCA4,270
chr1,204808145,204808370,SRX5716469,SMARCA4,225
chr1,204808185,204808463,SRX5716470,SMARCA4,278
chr1,204808203,204808424,SRX5716464,SMARCA4,221
chr1,204828318,204828835,SRX5075174,SMARCA4,517
chr1,204828390,204828811,SRX5716463,SMARCA4,421
chr1,204828403,204828826,SRX5075168,SMARCA4,423
chr1,204828423,204828688,SRX16500059,CTCF,265
chr1,204828460,204828783,SRX5716464,SMARCA4,323
chr1,204828500,204828737,SRX5075169,SMARCA4,237
chr1,204828509,204828789,SRX5075176,SMARCA4,280
chr1,204828526,204828826,SRX5075170,SMARCA4,300
chr1,204828562,204828801,SRX5075175,SMARCA4,239
chr1,204834210,204834577,SRX5075168,SMARCA4,367
chr1,204834274,204834586,SRX5075174,SMARCA4,312
chr1,204837314,204837674,SRX16500060,CTCF,360
chr1,204837365,204837621,SRX16500061,CTCF,256
chr1,204837480,204837797,SRX5075176,SMARCA4,317
chr1,204837483,204837743,SRX5716463,SMARCA4,260
chr1,204837483,204837790,SRX5716470,SMARCA4,307
chr1,204837487,204837797,SRX5075174,SMARCA4,310
chr1,204837490,204837828,SRX5716469,SMARCA4,338
chr1,204837496,204837787,SRX5075170,SMARCA4,291
chr1,204837500,204837795,SRX5075168,SMARCA4,295
chr1,204837510,204837804,SRX5075169,SMARCA4,294
chr1,204837516,204837786,SRX5075175,SMARCA4,270
chr1,204837544,204837779,SRX5716464,SMARCA4,235
chr1,204858340,204858743,SRX5075174,SMARCA4,403
chr1,204858418,204858777,SRX5075168,SMARCA4,359
chr1,204870079,204870755,SRX20140895,INTS13,676
chr1,204870116,204870672,SRX20140868,INTS10,556
chr1,204870181,204870881,SRX5075168,SMARCA4,700
chr1,204870502,204870887,SRX5075174,SMARCA4,385
chr1,204870596,204870681,SRX1424891,POU3F2,85
chr1,204870615,204870656,SRX1424893,POU3F2,41
chr1,204870624,204870673,SRX1424892,POU3F2,49
chr1,204941633,204942307,SRX16500060,CTCF,674
chr1,204941684,204942261,SRX16500059,CTCF,577
chr1,204941687,204942065,SRX4174629,CTCF,378
chr1,204941691,204942284,SRX16500061,CTCF,593
chr1,204941711,204942233,SRX16500062,CTCF,522
chr1,204941724,204942069,SRX5075174,SMARCA4,345
chr1,204941745,204942051,SRX5075168,SMARCA4,306
chr1,204941765,204942030,SRX5716464,SMARCA4,265
chr1,204941769,204942078,SRX5716463,SMARCA4,309
chr1,204941788,204941991,SRX5075170,SMARCA4,203
chr1,204941849,204942024,SRX5075176,SMARCA4,175
chr1,204945587,204945821,SRX5075174,SMARCA4,234
chr1,204945616,204945848,SRX5075168,SMARCA4,232
chr1,204972125,204972373,SRX5054309,FOSL2,248
chr1,204972145,204972327,SRX5054308,FOSL2,182
chr1,204972162,204972358,SRX5075175,SMARCA4,196
chr1,204972163,204972341,SRX5075170,SMARCA4,178
chr1,204975554,204976061,SRX16500060,CTCF,507
chr1,204975600,204976033,SRX16500062,CTCF,433
chr1,204975606,204976121,SRX16500059,CTCF,515
chr1,204975617,204976140,SRX16500061,CTCF,523
chr1,204975746,204975936,SRX5075168,SMARCA4,190
chr1,204975768,204976020,SRX4174629,CTCF,252
chr1,204975788,204975969,SRX5075174,SMARCA4,181
chr1,204989236,204989749,SRX16500062,CTCF,513
chr1,204989243,204989704,SRX16500059,CTCF,461
chr1,204989255,204989803,SRX16500060,CTCF,548
chr1,204989259,204989721,SRX16500061,CTCF,462
chr1,204989287,204989724,SRX4174629,CTCF,437
chr1,204989319,204989625,SRX5075170,SMARCA4,306
chr1,204989341,204989617,SRX5075176,SMARCA4,276
chr1,204989370,204989609,SRX5075174,SMARCA4,239
chr1,204989388,204989658,SRX5075168,SMARCA4,270
chr1,205007777,205007961,SRX5054309,FOSL2,184
chr1,205013971,205014158,SRX5075170,SMARCA4,187
chr1,205061488,205062007,SRX16500059,CTCF,519
chr1,205061493,205062021,SRX16500060,CTCF,528
chr1,205061530,205062050,SRX16500062,CTCF,520
chr1,205061556,205062034,SRX16500061,CTCF,478
chr1,205061560,205061962,SRX5075168,SMARCA4,402
chr1,205061570,205061927,SRX4174629,CTCF,357
chr1,205061589,205061919,SRX5075174,SMARCA4,330
chr1,205061611,205061925,SRX5075170,SMARCA4,314
chr1,205061612,205061954,SRX5716470,SMARCA4,342
chr1,205061618,205061906,SRX5075176,SMARCA4,288
chr1,205061720,205061935,SRX5716463,SMARCA4,215
chr1,205068757,205068934,SRX5075170,SMARCA4,177
chr1,205121730,205122591,SRX20140895,INTS13,861
chr1,205121806,205122421,SRX20140879,CPSF3L,615
chr1,205121822,205122526,SRX20140881,CPSF3L,704
chr1,205121824,205122605,SRX5075170,SMARCA4,781
chr1,205121840,205122593,SRX5075174,SMARCA4,753
chr1,205121905,205122431,SRX20140867,INTS10,526
chr1,205121907,205122333,SRX20140897,INTS13,426
chr1,205121912,205122535,SRX20140868,INTS10,623
chr1,205121978,205122600,SRX20140869,INTS10,622
chr1,205121996,205122599,SRX5075168,SMARCA4,603
chr1,205122055,205122644,SRX5075176,SMARCA4,589
chr1,205122071,205122465,SRX5716451,SOX2,394
chr1,205122078,205122538,SRX5075175,SMARCA4,460
chr1,205122087,205122340,SRX5716463,SMARCA4,253
chr1,205122111,205122476,SRX20140894,INTS13,365
chr1,205122146,205122551,SRX16500060,CTCF,405
chr1,205122154,205122716,SRX4174629,CTCF,562
chr1,205122179,205122590,SRX16500061,CTCF,411
chr1,205122190,205122542,SRX16500059,CTCF,352
chr1,205122209,205122542,SRX16500062,CTCF,333
chr1,205122225,205122557,SRX5075169,SMARCA4,332
chr1,205122298,205122509,SRX5716468,SMARCA2,211
chr1,205122302,205122530,SRX5716470,SMARCA4,228
chr1,205122320,205122367,SRX1424893,POU3F2,47
chr1,205122329,205122509,SRX5054308,FOSL2,180
chr1,205141539,205142133,SRX16500059,CTCF,594
chr1,205141568,205142130,SRX16500060,CTCF,562
chr1,205141584,205142051,SRX16500061,CTCF,467
chr1,205141620,205142109,SRX16500062,CTCF,489
chr1,205141639,205141921,SRX5075174,SMARCA4,282
chr1,205141677,205142042,SRX4174629,CTCF,365
chr1,205141678,205141937,SRX5075168,SMARCA4,259
chr1,205144690,205145088,SRX5716469,SMARCA4,398
chr1,205144724,205145085,SRX5075176,SMARCA4,361
chr1,205144736,205145122,SRX5075169,SMARCA4,386
chr1,205144745,205145203,SRX5716470,SMARCA4,458
chr1,205144763,205145126,SRX5075175,SMARCA4,363
chr1,205144774,205145146,SRX5054309,FOSL2,372
chr1,205144775,205145114,SRX5716467,SMARCA2,339
chr1,205144787,205145084,SRX5075170,SMARCA4,297
chr1,205144792,205145008,SRX5075174,SMARCA4,216
chr1,205144831,205145056,SRX5020214,SMARCA2,225
chr1,205144860,205145056,SRX5054308,FOSL2,196
chr1,205144872,205145053,SRX5075168,SMARCA4,181
chr1,205144893,205145134,SRX5716468,SMARCA2,241
chr1,205172668,205173083,SRX5075175,SMARCA4,415
chr1,205172706,205173074,SRX5075169,SMARCA4,368
chr1,205172709,205173074,SRX5075176,SMARCA4,365
chr1,205172741,205172963,SRX5716470,SMARCA4,222
chr1,205172753,205173101,SRX5075170,SMARCA4,348
chr1,205172759,205173069,SRX5054309,FOSL2,310
chr1,205172766,205173065,SRX5054308,FOSL2,299
chr1,205172781,205172960,SRX5075182,SMARCA2,179
chr1,205175405,205176267,SRX5075169,SMARCA4,862
chr1,205175409,205175812,SRX5716470,SMARCA4,403
chr1,205175413,205175721,SRX5716469,SMARCA4,308
chr1,205175417,205175859,SRX5075170,SMARCA4,442
chr1,205175418,205175768,SRX5075175,SMARCA4,350
chr1,205175418,205175861,SRX5075176,SMARCA4,443
chr1,205175445,205175786,SRX5054309,FOSL2,341
chr1,205175446,205175879,SRX5075174,SMARCA4,433
chr1,205175463,205175750,SRX5075168,SMARCA4,287
chr1,205175466,205176083,SRX5716460,Epitope tags,617
chr1,205175474,205175775,SRX5054308,FOSL2,301
chr1,205175504,205175705,SRX5020211,SMARCA2,201
chr1,205175520,205175731,SRX5716468,SMARCA2,211
chr1,205175527,205175713,SRX5054307,FOSL2,186
chr1,205175544,205175776,SRX5716467,SMARCA2,232
chr1,205175744,205175993,SRX5716459,Epitope tags,249
chr1,205175827,205176277,SRX5716469,SMARCA4,450
chr1,205175903,205176253,SRX5054309,FOSL2,350
chr1,205175960,205176229,SRX5075170,SMARCA4,269
chr1,205175971,205176221,SRX5075176,SMARCA4,250
chr1,205175986,205176231,SRX5054308,FOSL2,245
chr1,205211058,205211797,SRX20140895,INTS13,739
chr1,205211157,205211732,SRX20140869,INTS10,575
chr1,205211158,205211762,SRX20140879,CPSF3L,604
chr1,205211176,205211772,SRX20140881,CPSF3L,596
chr1,205211212,205211842,SRX20140868,INTS10,630
chr1,205211357,205211768,SRX20140867,INTS10,411
chr1,205211372,205211954,SRX5075174,SMARCA4,582
chr1,205211390,205211895,SRX5716469,SMARCA4,505
chr1,205211416,205211802,SRX20140897,INTS13,386
chr1,205211460,205211961,SRX5075168,SMARCA4,501
chr1,205211476,205211738,SRX20140894,INTS13,262
chr1,205211477,205211850,SRX5075170,SMARCA4,373
chr1,205211511,205211698,SRX5075175,SMARCA4,187
chr1,205211517,205211827,SRX5075176,SMARCA4,310
chr1,205211560,205211807,SRX5075169,SMARCA4,247
chr1,205227530,205227984,SRX20140895,INTS13,454
chr1,205227594,205227954,SRX5075168,SMARCA4,360
chr1,205227629,205227970,SRX5075174,SMARCA4,341
chr1,205227736,205227936,SRX5054307,FOSL2,200
chr1,205235815,205235865,SRX1424894,POU3F2,50
chr1,205235816,205235867,SRX1424893,POU3F2,51
chr1,205235817,205235865,SRX1424891,POU3F2,48
chr1,205235823,205235865,SRX1424892,POU3F2,42
chr1,205256091,205256586,SRX16500059,CTCF,495
chr1,205256100,205256590,SRX16500060,CTCF,490
chr1,205256107,205256459,SRX5075168,SMARCA4,352
chr1,205256122,205256602,SRX16500062,CTCF,480
chr1,205256123,205256579,SRX16500061,CTCF,456
chr1,205256165,205256491,SRX5075174,SMARCA4,326
chr1,205256205,205256536,SRX5075176,SMARCA4,331
chr1,205256205,205256551,SRX4174629,CTCF,346
chr1,205256231,205256474,SRX5075169,SMARCA4,243
chr1,205256236,205256488,SRX5075170,SMARCA4,252
chr1,205261417,205261682,SRX5054309,FOSL2,265
chr1,205261472,205261690,SRX5054308,FOSL2,218
chr1,205271450,205271701,SRX5075170,SMARCA4,251
chr1,205271532,205271713,SRX5075176,SMARCA4,181
chr1,205273362,205273936,SRX16500060,CTCF,574
chr1,205273395,205273871,SRX16500061,CTCF,476
chr1,205273402,205273906,SRX16500059,CTCF,504
chr1,205273403,205273858,SRX16500062,CTCF,455
chr1,205273422,205273883,SRX4174629,CTCF,461
chr1,205273494,205273753,SRX5075174,SMARCA4,259
chr1,205273529,205273762,SRX5075170,SMARCA4,233
chr1,205273532,205273836,SRX5075168,SMARCA4,304
chr1,205284610,205285167,SRX5075174,SMARCA4,557
chr1,205284648,205285182,SRX5075168,SMARCA4,534
chr1,205284658,205285076,SRX5075169,SMARCA4,418
chr1,205284687,205285062,SRX5075176,SMARCA4,375
chr1,205284694,205285026,SRX5054309,FOSL2,332
chr1,205284701,205285088,SRX5075170,SMARCA4,387
chr1,205284713,205285032,SRX5716463,SMARCA4,319
chr1,205284721,205285034,SRX5075175,SMARCA4,313
chr1,205284723,205285032,SRX5054307,FOSL2,309
chr1,205284724,205284976,SRX5716470,SMARCA4,252
chr1,205284727,205285019,SRX5054308,FOSL2,292
chr1,205284792,205285075,SRX5716469,SMARCA4,283
chr1,205294360,205294864,SRX5075169,SMARCA4,504
chr1,205294410,205294938,SRX5075176,SMARCA4,528
chr1,205294414,205294904,SRX5075170,SMARCA4,490
chr1,205294450,205294884,SRX5054308,FOSL2,434
chr1,205294475,205295012,SRX5075174,SMARCA4,537
chr1,205294479,205294883,SRX5075175,SMARCA4,404
chr1,205294486,205294913,SRX5054309,FOSL2,427
chr1,205294499,205295020,SRX5075168,SMARCA4,521
chr1,205294534,205294842,SRX5716470,SMARCA4,308
chr1,205294592,205294902,SRX5054307,FOSL2,310
chr1,205294604,205294930,SRX5716469,SMARCA4,326
chr1,205294680,205294922,SRX5716463,SMARCA4,242
chr1,205294696,205294932,SRX5020211,SMARCA2,236
chr1,205298491,205298802,SRX5075169,SMARCA4,311
chr1,205298508,205298814,SRX5075175,SMARCA4,306
chr1,205298509,205298829,SRX5054309,FOSL2,320
chr1,205298516,205298771,SRX5716469,SMARCA4,255
chr1,205298525,205298826,SRX5075170,SMARCA4,301
chr1,205298553,205298832,SRX5075176,SMARCA4,279
chr1,205298567,205298741,SRX5075174,SMARCA4,174
chr1,205298593,205298773,SRX5054308,FOSL2,180
chr1,205300680,205300727,SRX1424893,POU3F2,47
chr1,205300683,205300725,SRX1424891,POU3F2,42
chr1,205300684,205300724,SRX1424892,POU3F2,40
chr1,205300774,205301030,SRX20140895,INTS13,256
chr1,205301163,205301761,SRX20140895,INTS13,598
chr1,205301243,205301703,SRX20140881,CPSF3L,460
chr1,205301347,205301936,SRX5075168,SMARCA4,589
chr1,205301348,205301799,SRX5716464,SMARCA4,451
chr1,205301365,205301945,SRX5075174,SMARCA4,580
chr1,205301376,205301750,SRX5716463,SMARCA4,374
chr1,205301391,205301741,SRX5716470,SMARCA4,350
chr1,205301412,205301695,SRX5716467,SMARCA2,283
chr1,205301413,205301806,SRX20140867,INTS10,393
chr1,205301415,205301718,SRX5716468,SMARCA2,303
chr1,205301425,205301753,SRX5075175,SMARCA4,328
chr1,205301427,205301728,SRX5075169,SMARCA4,301
chr1,205301438,205301774,SRX5716469,SMARCA4,336
chr1,205301449,205301699,SRX5075170,SMARCA4,250
chr1,205301465,205301745,SRX20140868,INTS10,280
chr1,205301469,205301760,SRX5716454,SOX3,291
chr1,205301489,205301752,SRX5716451,SOX2,263
chr1,205301497,205301708,SRX5075176,SMARCA4,211
chr1,205313523,205314383,SRX20140895,INTS13,860
chr1,205313587,205313766,SRX5075168,SMARCA4,179
chr1,205313649,205314344,SRX20140881,CPSF3L,695
chr1,205313717,205314363,SRX20140868,INTS10,646
chr1,205313757,205314449,SRX5075174,SMARCA4,692
chr1,205313818,205314441,SRX5075168,SMARCA4,623
chr1,205313853,205314291,SRX5075169,SMARCA4,438
chr1,205313877,205314295,SRX5716463,SMARCA4,418
chr1,205313899,205314340,SRX20140867,INTS10,441
chr1,205313900,205314292,SRX5716470,SMARCA4,392
chr1,205313922,205314350,SRX5716451,SOX2,428
chr1,205313940,205314278,SRX5075170,SMARCA4,338
chr1,205313958,205314295,SRX5075176,SMARCA4,337
chr1,205313963,205314338,SRX5716454,SOX3,375
chr1,205313980,205314348,SRX5716469,SMARCA4,368
chr1,205314002,205314335,SRX20140879,CPSF3L,333
chr1,205314045,205314263,SRX5054307,FOSL2,218
chr1,205314084,205314373,SRX5716464,SMARCA4,289
chr1,205314111,205314301,SRX5075175,SMARCA4,190
chr1,205321291,205321471,SRX5075169,SMARCA4,180
chr1,205321356,205321616,SRX5716470,SMARCA4,260
chr1,205321366,205322069,SRX20140895,INTS13,703
chr1,205321425,205321921,SRX5075176,SMARCA4,496
chr1,205321494,205321978,SRX20140897,INTS13,484
chr1,205321521,205321925,SRX20140881,CPSF3L,404
chr1,205321548,205321942,SRX20140867,INTS10,394
chr1,205321595,205321764,SRX5075170,SMARCA4,169
chr1,205321615,205322012,SRX5075168,SMARCA4,397
chr1,205321741,205322080,SRX5075174,SMARCA4,339
chr1,205321776,205321955,SRX5054307,FOSL2,179
chr1,205325357,205325852,SRX16500061,CTCF,495
chr1,205325358,205325873,SRX16500059,CTCF,515
chr1,205325393,205325774,SRX4174629,CTCF,381
chr1,205325398,205325813,SRX16500060,CTCF,415
chr1,205325411,205325842,SRX16500062,CTCF,431
chr1,205325477,205325742,SRX5075168,SMARCA4,265
chr1,205325487,205325704,SRX5075174,SMARCA4,217
chr1,205335557,205335978,SRX16500061,CTCF,421
chr1,205335560,205336027,SRX16500062,CTCF,467
chr1,205335562,205336051,SRX4174629,CTCF,489
chr1,205335570,205336020,SRX16500060,CTCF,450
chr1,205335636,205335972,SRX5075174,SMARCA4,336
chr1,205335645,205336057,SRX16500059,CTCF,412
chr1,205335646,205335850,SRX5716463,SMARCA4,204
chr1,205335647,205335956,SRX5075168,SMARCA4,309
chr1,205335657,205335988,SRX5716464,SMARCA4,331
chr1,205335680,205335909,SRX5075170,SMARCA4,229
chr1,205335690,205335897,SRX5075176,SMARCA4,207
chr1,205335735,205335960,SRX5075169,SMARCA4,225
chr1,205343399,205343634,SRX16500059,CTCF,235
chr1,205343716,205344126,SRX16500060,CTCF,410
chr1,205343728,205344023,SRX16500062,CTCF,295
chr1,205343733,205344081,SRX16500059,CTCF,348
chr1,205343786,205344070,SRX16500061,CTCF,284
chr1,205344015,205344389,SRX5075168,SMARCA4,374
chr1,205344069,205344317,SRX5075169,SMARCA4,248
chr1,205344180,205344355,SRX5075174,SMARCA4,175
chr1,205348874,205349057,SRX5054309,FOSL2,183
chr1,205348881,205349067,SRX5054308,FOSL2,186
chr1,205354164,205354718,SRX16500061,CTCF,554
chr1,205354212,205354727,SRX16500059,CTCF,515
chr1,205354216,205354699,SRX16500060,CTCF,483
chr1,205354232,205354791,SRX16500062,CTCF,559
chr1,205354334,205354701,SRX4174629,CTCF,367
chr1,205354371,205354612,SRX5075176,SMARCA4,241
chr1,205356677,205357201,SRX20140895,INTS13,524
chr1,205356783,205357041,SRX5075170,SMARCA4,258
chr1,205356826,205357232,SRX5075168,SMARCA4,406
chr1,205356831,205357167,SRX5075174,SMARCA4,336
chr1,205366269,205366445,SRX5075170,SMARCA4,176
chr1,205372353,205372556,SRX5054308,FOSL2,203
chr1,205372357,205372540,SRX5054309,FOSL2,183
chr1,205372373,205372586,SRX5075169,SMARCA4,213
chr1,205374740,205375106,SRX5075170,SMARCA4,366
chr1,205374745,205375066,SRX5075176,SMARCA4,321
chr1,205374757,205375120,SRX5075169,SMARCA4,363
chr1,205374763,205375097,SRX5054309,FOSL2,334
chr1,205374819,205375043,SRX5075175,SMARCA4,224
chr1,205376240,205376558,SRX5075168,SMARCA4,318
chr1,205376265,205376505,SRX5075174,SMARCA4,240
chr1,205376311,205376540,SRX5054307,FOSL2,229
chr1,205396883,205397437,SRX16500060,CTCF,554
chr1,205396971,205397413,SRX16500061,CTCF,442
chr1,205396994,205397361,SRX5075168,SMARCA4,367
chr1,205397011,205397431,SRX16500059,CTCF,420
chr1,205397018,205397487,SRX16500062,CTCF,469
chr1,205397041,205397422,SRX5075174,SMARCA4,381
chr1,205397061,205397376,SRX4174629,CTCF,315
chr1,205397078,205397328,SRX5716464,SMARCA4,250
chr1,205397082,205397307,SRX5075169,SMARCA4,225
chr1,205397093,205397304,SRX5716470,SMARCA4,211
chr1,205397094,205397378,SRX5075176,SMARCA4,284
chr1,205397105,205397336,SRX5075170,SMARCA4,231
chr1,205397158,205397368,SRX5716463,SMARCA4,210
chr1,205430734,205431203,SRX16500060,CTCF,469
chr1,205430764,205431111,SRX5075168,SMARCA4,347
chr1,205430773,205431210,SRX16500059,CTCF,437
chr1,205430800,205431208,SRX16500061,CTCF,408
chr1,205430807,205431174,SRX16500062,CTCF,367
chr1,205430808,205431030,SRX5075176,SMARCA4,222
chr1,205430810,205431024,SRX5716470,SMARCA4,214
chr1,205430820,205431094,SRX5075174,SMARCA4,274
chr1,205430825,205431093,SRX5716464,SMARCA4,268
chr1,205430833,205431020,SRX5075175,SMARCA4,187
chr1,205430881,205431174,SRX4174629,CTCF,293
chr1,205435866,205436228,SRX5075174,SMARCA4,362
chr1,205435946,205436192,SRX5075168,SMARCA4,246
chr1,205438725,205438946,SRX5075170,SMARCA4,221
chr1,205441148,205441321,SRX5075174,SMARCA4,173
chr1,205442045,205442276,SRX20140867,INTS10,231
chr1,205444949,205445243,SRX5075174,SMARCA4,294
chr1,205444977,205445201,SRX5075168,SMARCA4,224
chr1,205449921,205450304,SRX5075168,SMARCA4,383
chr1,205449937,205450291,SRX5075175,SMARCA4,354
chr1,205449940,205450312,SRX5075174,SMARCA4,372
chr1,205449941,205450339,SRX5075170,SMARCA4,398
chr1,205450001,205450338,SRX5075176,SMARCA4,337
chr1,205450073,205450389,SRX16500060,CTCF,316
chr1,205450076,205450273,SRX5075169,SMARCA4,197
chr1,205450098,205450430,SRX16500061,CTCF,332
chr1,205450121,205450371,SRX5054309,FOSL2,250
chr1,205450186,205450428,SRX16500062,CTCF,242
chr1,205456725,205457395,SRX20140895,INTS13,670
chr1,205456846,205457028,SRX5075168,SMARCA4,182
chr1,205457031,205457312,SRX20140868,INTS10,281
chr1,205458995,205459296,SRX5716470,SMARCA4,301
chr1,205458996,205459310,SRX5716469,SMARCA4,314
chr1,205458999,205459279,SRX5075169,SMARCA4,280
chr1,205459000,205459323,SRX5075175,SMARCA4,323
chr1,205459005,205459324,SRX5075176,SMARCA4,319
chr1,205459007,205459297,SRX5075170,SMARCA4,290
chr1,205459052,205459275,SRX5075181,SMARCA2,223
chr1,205459091,205459273,SRX5075174,SMARCA4,182
chr1,205466731,205466922,SRX5075169,SMARCA4,191
chr1,205466759,205466986,SRX5075176,SMARCA4,227
chr1,205466779,205467046,SRX5075170,SMARCA4,267
chr1,205466914,205467142,SRX5716470,SMARCA4,228
chr1,205477896,205478293,SRX5075169,SMARCA4,397
chr1,205477922,205478251,SRX5075170,SMARCA4,329
chr1,205477953,205478304,SRX5075175,SMARCA4,351
chr1,205477959,205478341,SRX5716469,SMARCA4,382
chr1,205477978,205478350,SRX5075176,SMARCA4,372
chr1,205478024,205478272,SRX5716468,SMARCA2,248
chr1,205478032,205478381,SRX5716470,SMARCA4,349
chr1,205485417,205485904,SRX16500060,CTCF,487
chr1,205485424,205485889,SRX16500061,CTCF,465
chr1,205485428,205485950,SRX16500059,CTCF,522
chr1,205485439,205485905,SRX16500062,CTCF,466
chr1,205485483,205485735,SRX5075168,SMARCA4,252
chr1,205485493,205485865,SRX4174629,CTCF,372
chr1,205485507,205485824,SRX5075174,SMARCA4,317
chr1,205485518,205485698,SRX5075169,SMARCA4,180
chr1,205485567,205485736,SRX5075170,SMARCA4,169
chr1,205488070,205488486,SRX16500060,CTCF,416
chr1,205488071,205488444,SRX16500062,CTCF,373
chr1,205488084,205488480,SRX16500059,CTCF,396
chr1,205488090,205488463,SRX4174629,CTCF,373
chr1,205488095,205488495,SRX16500061,CTCF,400
chr1,205488117,205488377,SRX5075168,SMARCA4,260
chr1,205488179,205488399,SRX5075174,SMARCA4,220
chr1,205493293,205493594,SRX5075175,SMARCA4,301
chr1,205493300,205493635,SRX5054309,FOSL2,335
chr1,205493301,205493643,SRX5075169,SMARCA4,342
chr1,205493320,205493684,SRX5075176,SMARCA4,364
chr1,205493321,205493642,SRX5075170,SMARCA4,321
chr1,205493331,205493665,SRX5716469,SMARCA4,334
chr1,205493344,205493589,SRX5054308,FOSL2,245
chr1,205493371,205493608,SRX5716467,SMARCA2,237
chr1,205493394,205493636,SRX5716470,SMARCA4,242
chr1,205504685,205504951,SRX5075174,SMARCA4,266
chr1,205524205,205524626,SRX16500061,CTCF,421
chr1,205524230,205524708,SRX16500059,CTCF,478
chr1,205524232,205524661,SRX16500060,CTCF,429
chr1,205524272,205524669,SRX16500062,CTCF,397
chr1,205524298,205524614,SRX4174629,CTCF,316
chr1,205524316,205524602,SRX5075168,SMARCA4,286
chr1,205528828,205529384,SRX16500059,CTCF,556
chr1,205528857,205529384,SRX16500061,CTCF,527
chr1,205528868,205529354,SRX16500060,CTCF,486
chr1,205528877,205529322,SRX16500062,CTCF,445
chr1,205528941,205529277,SRX5716463,SMARCA4,336
chr1,205529019,205529278,SRX5075168,SMARCA4,259
chr1,205529043,205529324,SRX5075174,SMARCA4,281
chr1,205529047,205529273,SRX5075170,SMARCA4,226
chr1,205529062,205529278,SRX4174629,CTCF,216
chr1,205529077,205529303,SRX5075176,SMARCA4,226
chr1,205543314,205543855,SRX5075176,SMARCA4,541
chr1,205543316,205543940,SRX5075174,SMARCA4,624
chr1,205543363,205543870,SRX5075170,SMARCA4,507
chr1,205543389,205543583,SRX5054309,FOSL2,194
chr1,205543418,205543903,SRX5075169,SMARCA4,485
chr1,205543436,205543776,SRX5075175,SMARCA4,340
chr1,205543441,205543932,SRX5075168,SMARCA4,491
chr1,205543453,205543771,SRX5716469,SMARCA4,318
chr1,205543467,205543779,SRX5716464,SMARCA4,312
chr1,205543469,205544014,SRX20140895,INTS13,545
chr1,205543488,205543826,SRX5716454,SOX3,338
chr1,205543492,205543910,SRX5716463,SMARCA4,418
chr1,205543518,205543925,SRX5716470,SMARCA4,407
chr1,205543524,205543805,SRX20140868,INTS10,281
chr1,205543527,205543869,SRX5716451,SOX2,342
chr1,205582545,205582812,SRX5075170,SMARCA4,267
chr1,205588742,205588921,SRX5075170,SMARCA4,179
chr1,205591728,205592221,SRX16500061,CTCF,493
chr1,205591735,205592306,SRX16500059,CTCF,571
chr1,205591755,205592264,SRX16500060,CTCF,509
chr1,205591756,205592245,SRX16500062,CTCF,489
chr1,205591862,205592275,SRX5075168,SMARCA4,413
chr1,205591866,205592207,SRX5075174,SMARCA4,341
chr1,205591884,205592161,SRX5075169,SMARCA4,277
chr1,205591891,205592325,SRX4174629,CTCF,434
chr1,205591915,205592196,SRX5716464,SMARCA4,281
chr1,205591933,205592190,SRX5716470,SMARCA4,257
chr1,205591938,205592140,SRX5075170,SMARCA4,202
chr1,205591941,205592168,SRX5075176,SMARCA4,227
chr1,205591970,205592174,SRX5716463,SMARCA4,204
chr1,205597915,205598276,SRX5075176,SMARCA4,361
chr1,205597931,205598214,SRX5020211,SMARCA2,283
chr1,205597958,205598301,SRX5075170,SMARCA4,343
chr1,205597961,205598290,SRX5716470,SMARCA4,329
chr1,205597966,205598295,SRX5075169,SMARCA4,329
chr1,205597973,205598244,SRX5716469,SMARCA4,271
chr1,205597978,205598234,SRX5716468,SMARCA2,256
chr1,205597983,205598251,SRX5716467,SMARCA2,268
chr1,205597999,205598244,SRX5075175,SMARCA4,245
chr1,205598032,205598264,SRX5075181,SMARCA2,232
chr1,205599270,205599732,SRX5075170,SMARCA4,462
chr1,205599278,205599719,SRX5075169,SMARCA4,441
chr1,205599286,205599701,SRX5075175,SMARCA4,415
chr1,205599314,205599766,SRX5075176,SMARCA4,452
chr1,205599341,205599679,SRX5054309,FOSL2,338
chr1,205599352,205599695,SRX5054308,FOSL2,343
chr1,205599360,205599724,SRX5716469,SMARCA4,364
chr1,205599363,205599811,SRX5716470,SMARCA4,448
chr1,205599394,205599657,SRX5716468,SMARCA2,263
chr1,205599413,205599723,SRX5716467,SMARCA2,310
chr1,205599421,205599638,SRX5075182,SMARCA2,217
chr1,205600187,205600417,SRX5075169,SMARCA4,230
chr1,205600219,205600399,SRX5054308,FOSL2,180
chr1,205600221,205600455,SRX5054309,FOSL2,234
chr1,205600227,205600416,SRX5075176,SMARCA4,189
chr1,205600253,205600449,SRX5075170,SMARCA4,196
chr1,205610035,205610379,SRX5075169,SMARCA4,344
chr1,205610051,205610383,SRX5075176,SMARCA4,332
chr1,205610064,205610412,SRX5054308,FOSL2,348
chr1,205610068,205610361,SRX5075170,SMARCA4,293
chr1,205610069,205610364,SRX5054309,FOSL2,295
chr1,205610089,205610286,SRX5075168,SMARCA4,197
chr1,205630924,205631538,SRX5075174,SMARCA4,614
chr1,205630970,205631332,SRX5075176,SMARCA4,362
chr1,205630986,205631279,SRX5075168,SMARCA4,293
chr1,205630998,205631344,SRX5075170,SMARCA4,346
chr1,205631055,205631374,SRX5716470,SMARCA4,319
chr1,205631167,205632404,SRX20140895,INTS13,1237
chr1,205631186,205631443,SRX20140897,INTS13,257
chr1,205631210,205632203,SRX20140869,INTS10,993
chr1,205631391,205632359,SRX20140868,INTS10,968
chr1,205631467,205632297,SRX20140867,INTS10,830
chr1,205631705,205632238,SRX20140896,INTS13,533
chr1,205631918,205632297,SRX20140897,INTS13,379
chr1,205631933,205632201,SRX5075175,SMARCA4,268
chr1,205631942,205632327,SRX5075174,SMARCA4,385
chr1,205631945,205632298,SRX5075168,SMARCA4,353
chr1,205631947,205632410,SRX16500059,CTCF,463
chr1,205631953,205632345,SRX16500060,CTCF,392
chr1,205631955,205632249,SRX5075170,SMARCA4,294
chr1,205631976,205632225,SRX5075176,SMARCA4,249
chr1,205631985,205632233,SRX5716470,SMARCA4,248
chr1,205631985,205632331,SRX16500062,CTCF,346
chr1,205631986,205632321,SRX16500061,CTCF,335
chr1,205632002,205632350,SRX20140881,CPSF3L,348
chr1,205632021,205632344,SRX20140879,CPSF3L,323
chr1,205632071,205632473,SRX4174629,CTCF,402
chr1,205637010,205637243,SRX5075176,SMARCA4,233
chr1,205656315,205656525,SRX5054309,FOSL2,210
chr1,205656323,205656503,SRX5054308,FOSL2,180
chr1,205657439,205657971,SRX16500060,CTCF,532
chr1,205657486,205657944,SRX16500059,CTCF,458
chr1,205657514,205657921,SRX16500062,CTCF,407
chr1,205657518,205657942,SRX16500061,CTCF,424
chr1,205657572,205657883,SRX4174629,CTCF,311
chr1,205657605,205657843,SRX5075168,SMARCA4,238
chr1,205657619,205657900,SRX5075174,SMARCA4,281
chr1,205658873,205659314,SRX16500060,CTCF,441
chr1,205658886,205659322,SRX16500059,CTCF,436
chr1,205658893,205659285,SRX16500061,CTCF,392
chr1,205658906,205659262,SRX16500062,CTCF,356
chr1,205658910,205659193,SRX4174629,CTCF,283
chr1,205658983,205659204,SRX5075174,SMARCA4,221
chr1,205658991,205659253,SRX5075170,SMARCA4,262
chr1,205658995,205659287,SRX5075175,SMARCA4,292
chr1,205659003,205659258,SRX5075169,SMARCA4,255
chr1,205659005,205659287,SRX5075176,SMARCA4,282
chr1,205659007,205659313,SRX5716470,SMARCA4,306
chr1,205659046,205659258,SRX5075168,SMARCA4,212
chr1,205670401,205671020,SRX20140868,INTS10,619
chr1,205670402,205671078,SRX20140895,INTS13,676
chr1,205670518,205671211,SRX5075168,SMARCA4,693
chr1,205670528,205671190,SRX5075174,SMARCA4,662
chr1,205670627,205671029,SRX20140879,CPSF3L,402
chr1,205670726,205671096,SRX20140894,INTS13,370
chr1,205670790,205671043,SRX20140860,SOX2,253
chr1,205670791,205671054,SRX20140867,INTS10,263
chr1,205670826,205671151,SRX5716463,SMARCA4,325
chr1,205672162,205672372,SRX16500062,CTCF,210
chr1,205672287,205672569,SRX16500060,CTCF,282
chr1,205679729,205680251,SRX5075170,SMARCA4,522
chr1,205679735,205680347,SRX5075174,SMARCA4,612
chr1,205679738,205680091,SRX5054308,FOSL2,353
chr1,205679769,205680222,SRX5075169,SMARCA4,453
chr1,205679781,205680499,SRX5075168,SMARCA4,718
chr1,205679789,205680137,SRX5716469,SMARCA4,348
chr1,205679799,205680219,SRX5075176,SMARCA4,420
chr1,205679800,205680077,SRX5054309,FOSL2,277
chr1,205679824,205680260,SRX5075175,SMARCA4,436
chr1,205679844,205680118,SRX5054307,FOSL2,274
chr1,205687277,205687606,SRX5075176,SMARCA4,329
chr1,205687413,205687620,SRX5075170,SMARCA4,207
chr1,205689471,205689769,SRX20140867,INTS10,298
chr1,205689511,205689834,SRX20140895,INTS13,323
chr1,205695700,205696061,SRX5075176,SMARCA4,361
chr1,205695711,205696065,SRX5075170,SMARCA4,354
chr1,205700926,205701420,SRX5075176,SMARCA4,494
chr1,205700948,205701496,SRX5075170,SMARCA4,548
chr1,205701005,205701431,SRX5075175,SMARCA4,426
chr1,205701021,205701249,SRX5716467,SMARCA2,228
chr1,205701036,205701447,SRX5075169,SMARCA4,411
chr1,205709088,205709303,SRX5075176,SMARCA4,215
chr1,205709100,205709308,SRX5075170,SMARCA4,208
chr1,205709121,205709339,SRX5716469,SMARCA4,218
chr1,205711007,205711608,SRX16500059,CTCF,601
chr1,205711044,205711520,SRX16500061,CTCF,476
chr1,205711057,205711535,SRX16500060,CTCF,478
chr1,205711071,205711633,SRX16500062,CTCF,562
chr1,205711121,205711577,SRX4174629,CTCF,456
chr1,205711134,205711412,SRX5075176,SMARCA4,278
chr1,205711149,205711402,SRX5075169,SMARCA4,253
chr1,205711159,205711419,SRX5716470,SMARCA4,260
chr1,205711161,205711434,SRX5716464,SMARCA4,273
chr1,205711166,205711437,SRX5716463,SMARCA4,271
chr1,205711167,205711455,SRX5075174,SMARCA4,288
chr1,205711183,205711431,SRX5075170,SMARCA4,248
chr1,205711187,205711418,SRX5075168,SMARCA4,231
chr1,205711201,205711437,SRX5075175,SMARCA4,236
chr1,205734466,205734665,SRX5054308,FOSL2,199
chr1,205734468,205734780,SRX5054309,FOSL2,312
chr1,205749239,205749646,SRX5075170,SMARCA4,407
chr1,205749259,205749819,SRX5075174,SMARCA4,560
chr1,205749329,205749631,SRX20140879,CPSF3L,302
chr1,205749330,205749896,SRX20140881,CPSF3L,566
chr1,205749345,205749744,SRX5075176,SMARCA4,399
chr1,205749354,205750568,SRX20140895,INTS13,1214
chr1,205749400,205749618,SRX5075175,SMARCA4,218
chr1,205749415,205749784,SRX5716470,SMARCA4,369
chr1,205749427,205749836,SRX5075168,SMARCA4,409
chr1,205749428,205750391,SRX20140868,INTS10,963
chr1,205749440,205749873,SRX5075169,SMARCA4,433
chr1,205749462,205749993,SRX20140867,INTS10,531
chr1,205750128,205750617,SRX20140867,INTS10,489
chr1,205750177,205750390,SRX5054308,FOSL2,213
chr1,205750214,205750395,SRX5054307,FOSL2,181
chr1,205765951,205766409,SRX5075176,SMARCA4,458
chr1,205765986,205766318,SRX5075169,SMARCA4,332
chr1,205766063,205766376,SRX5075170,SMARCA4,313
chr1,205766071,205766290,SRX5054309,FOSL2,219
chr1,205766089,205766284,SRX5075175,SMARCA4,195
chr1,205766090,205766373,SRX5054308,FOSL2,283
chr1,205775080,205775360,SRX5716469,SMARCA4,280
chr1,205775130,205775386,SRX5075175,SMARCA4,256
chr1,205775154,205775714,SRX20140895,INTS13,560
chr1,205775189,205775537,SRX5075168,SMARCA4,348
chr1,205775204,205775534,SRX5075174,SMARCA4,330
chr1,205775251,205775680,SRX20140897,INTS13,429
chr1,205775272,205775471,SRX5075170,SMARCA4,199
chr1,205775604,205776059,SRX5075169,SMARCA4,455
chr1,205775677,205776041,SRX5075170,SMARCA4,364
chr1,205775680,205776069,SRX5075176,SMARCA4,389
chr1,205775690,205776035,SRX5075175,SMARCA4,345
chr1,205775729,205775979,SRX5054309,FOSL2,250
chr1,205775739,205776022,SRX5054308,FOSL2,283
chr1,205775756,205776043,SRX5716470,SMARCA4,287
chr1,205791526,205791986,SRX16500059,CTCF,460
chr1,205791528,205791916,SRX16500062,CTCF,388
chr1,205791561,205791986,SRX16500060,CTCF,425
chr1,205791572,205791965,SRX16500061,CTCF,393
chr1,205791580,205791908,SRX4174629,CTCF,328
chr1,205791734,205791913,SRX5075168,SMARCA4,179
chr1,205791737,205791906,SRX5075170,SMARCA4,169
chr1,205812738,205813588,SRX20140895,INTS13,850
chr1,205812930,205813561,SRX20140868,INTS10,631
chr1,205812934,205813715,SRX5075168,SMARCA4,781
chr1,205812945,205813475,SRX5075170,SMARCA4,530
chr1,205812967,205813210,SRX5075175,SMARCA4,243
chr1,205813003,205813326,SRX20140897,INTS13,323
chr1,205813032,205813363,SRX5075176,SMARCA4,331
chr1,205813175,205813354,SRX5054307,FOSL2,179
chr1,205813207,205813675,SRX5075174,SMARCA4,468
chr1,205813325,205813565,SRX5716463,SMARCA4,240
chr1,205889765,205890058,SRX5054309,FOSL2,293
chr1,205889785,205889992,SRX5075169,SMARCA4,207
chr1,205889794,205890036,SRX5075175,SMARCA4,242
chr1,205907378,205907558,SRX5075169,SMARCA4,180
chr1,205907776,205908064,SRX16500060,CTCF,288
chr1,205907786,205908114,SRX16500059,CTCF,328
chr1,205907837,205908140,SRX16500061,CTCF,303
chr1,205907848,205908058,SRX16500062,CTCF,210
chr1,205913610,205913950,SRX5075170,SMARCA4,340
chr1,205913636,205913995,SRX5075176,SMARCA4,359
chr1,205918886,205919398,SRX16500059,CTCF,512
chr1,205918888,205919383,SRX16500061,CTCF,495
chr1,205918905,205919390,SRX4174629,CTCF,485
chr1,205918943,205919396,SRX16500060,CTCF,453
chr1,205918955,205919368,SRX16500062,CTCF,413
chr1,205918995,205919325,SRX5075174,SMARCA4,330
chr1,205919049,205919297,SRX5075168,SMARCA4,248
chr1,205919053,205919361,SRX5075176,SMARCA4,308
chr1,205919059,205919287,SRX5075169,SMARCA4,228
chr1,205919067,205919367,SRX5716469,SMARCA4,300
chr1,205919077,205919402,SRX5075170,SMARCA4,325
chr1,205919111,205919335,SRX5716463,SMARCA4,224
chr1,205919135,205919322,SRX5075175,SMARCA4,187
chr1,205919140,205919357,SRX5716470,SMARCA4,217
chr1,205925741,205926107,SRX5075176,SMARCA4,366
chr1,205925752,205926090,SRX5075169,SMARCA4,338
chr1,205925769,205926170,SRX5075170,SMARCA4,401
chr1,205925774,205925985,SRX5716470,SMARCA4,211
chr1,205925774,205926112,SRX5716469,SMARCA4,338
chr1,205925776,205926075,SRX5075175,SMARCA4,299
chr1,205925777,205926115,SRX5054309,FOSL2,338
chr1,205933512,205934131,SRX5075168,SMARCA4,619
chr1,205933513,205934179,SRX5075174,SMARCA4,666
chr1,205933603,205934066,SRX5054308,FOSL2,463
chr1,205933638,205934066,SRX5075170,SMARCA4,428
chr1,205933646,205933836,SRX5716451,SOX2,190
chr1,205933667,205934147,SRX5075169,SMARCA4,480
chr1,205933682,205934142,SRX5054309,FOSL2,460
chr1,205933697,205934164,SRX5075175,SMARCA4,467
chr1,205933898,205934599,SRX5075176,SMARCA4,701
chr1,205934299,205934611,SRX5075170,SMARCA4,312
chr1,205934310,205934631,SRX5716469,SMARCA4,321
chr1,205934328,205934598,SRX5716470,SMARCA4,270
chr1,205934342,205934602,SRX5075169,SMARCA4,260
chr1,205937270,205937458,SRX5075169,SMARCA4,188
chr1,205937284,205937487,SRX5054309,FOSL2,203
chr1,205939772,205940109,SRX16500059,CTCF,337
chr1,205939862,205940086,SRX16500061,CTCF,224
chr1,205977277,205977853,SRX16500060,CTCF,576
chr1,205977285,205977902,SRX16500059,CTCF,617
chr1,205977302,205977867,SRX16500061,CTCF,565
chr1,205977350,205977791,SRX16500062,CTCF,441
chr1,205977356,205977653,SRX5075170,SMARCA4,297
chr1,205977362,205977823,SRX4174629,CTCF,461
chr1,205977395,205977643,SRX5075176,SMARCA4,248
chr1,205977411,205977667,SRX5075174,SMARCA4,256
chr1,205977428,205977617,SRX5075175,SMARCA4,189
chr1,205977474,205977654,SRX5075169,SMARCA4,180
chr1,205977486,205977689,SRX5075168,SMARCA4,203
chr1,205984040,205984551,SRX16500059,CTCF,511
chr1,205984089,205984508,SRX16500060,CTCF,419
chr1,205984119,205984508,SRX16500062,CTCF,389
chr1,205984132,205984491,SRX16500061,CTCF,359
chr1,205984157,205984419,SRX5716470,SMARCA4,262
chr1,205984193,205984522,SRX4174629,CTCF,329
chr1,205984199,205984502,SRX5075176,SMARCA4,303
chr1,205984212,205984506,SRX5075169,SMARCA4,294
chr1,205984226,205984466,SRX5075175,SMARCA4,240
chr1,205984240,205984433,SRX5075168,SMARCA4,193
chr1,205984252,205984466,SRX5075174,SMARCA4,214
chr1,205984263,205984463,SRX5075170,SMARCA4,200
chr1,205991268,205991597,SRX5054309,FOSL2,329
chr1,205991333,205991535,SRX5054308,FOSL2,202
chr1,206001418,206001729,SRX5054309,FOSL2,311
chr1,206001441,206001700,SRX5054308,FOSL2,259
chr1,206001444,206001672,SRX5716469,SMARCA4,228
chr1,206001447,206001689,SRX5075175,SMARCA4,242
chr1,206001461,206001735,SRX5075169,SMARCA4,274
chr1,206001471,206001759,SRX5075176,SMARCA4,288
chr1,206001474,206001726,SRX5075170,SMARCA4,252
chr1,206001498,206001688,SRX5075168,SMARCA4,190
chr1,206003327,206003595,SRX5075169,SMARCA4,268
chr1,206003351,206003575,SRX5075176,SMARCA4,224
chr1,206003408,206003681,SRX5075170,SMARCA4,273
chr1,206021682,206022008,SRX5054309,FOSL2,326
chr1,206021718,206022014,SRX5075169,SMARCA4,296
chr1,206021740,206021998,SRX5054308,FOSL2,258
chr1,206021812,206022020,SRX5075170,SMARCA4,208
chr1,206021846,206022021,SRX5075176,SMARCA4,175
chr1,206030556,206030986,SRX16500061,CTCF,430
chr1,206030587,206031052,SRX16500060,CTCF,465
chr1,206030604,206031053,SRX16500059,CTCF,449
chr1,206030619,206031064,SRX16500062,CTCF,445
chr1,206030680,206031036,SRX5075174,SMARCA4,356
chr1,206030691,206030895,SRX5716463,SMARCA4,204
chr1,206030711,206030978,SRX5075168,SMARCA4,267
chr1,206030744,206031056,SRX4174629,CTCF,312
chr1,206030755,206030930,SRX5075176,SMARCA4,175
chr1,206052821,206053171,SRX5075174,SMARCA4,350
chr1,206053014,206053193,SRX5075168,SMARCA4,179
chr1,206106451,206106890,SRX5075176,SMARCA4,439
chr1,206106503,206106814,SRX5716470,SMARCA4,311
chr1,206106541,206106772,SRX5054309,FOSL2,231
chr1,206106541,206106883,SRX5075170,SMARCA4,342
chr1,206106543,206106748,SRX5075175,SMARCA4,205
chr1,206106544,206107011,SRX16500062,CTCF,467
chr1,206106544,206107019,SRX16500060,CTCF,475
chr1,206106545,206107101,SRX16500059,CTCF,556
chr1,206106550,206106879,SRX5716469,SMARCA4,329
chr1,206106553,206106975,SRX16500061,CTCF,422
chr1,206106561,206106826,SRX5075169,SMARCA4,265
chr1,206106562,206106999,SRX4174629,CTCF,437
chr1,206106602,206106899,SRX5075174,SMARCA4,297
chr1,206106624,206106877,SRX5716463,SMARCA4,253
chr1,206106624,206106890,SRX5075168,SMARCA4,266
chr1,206106627,206106870,SRX5716464,SMARCA4,243
chr1,206117178,206117413,SRX5075170,SMARCA4,235
chr1,206117180,206117575,SRX5075174,SMARCA4,395
chr1,206117211,206117510,SRX5075169,SMARCA4,299
chr1,206117230,206117571,SRX5075168,SMARCA4,341
chr1,206134167,206134430,SRX5054308,FOSL2,263
chr1,206134169,206134375,SRX5075176,SMARCA4,206
chr1,206134183,206134392,SRX5054309,FOSL2,209
chr1,206134199,206134395,SRX5075170,SMARCA4,196
chr1,206145953,206146235,SRX20140881,CPSF3L,282
chr1,206167277,206167786,SRX16500059,CTCF,509
chr1,206167300,206167801,SRX16500060,CTCF,501
chr1,206167301,206167800,SRX16500061,CTCF,499
chr1,206167307,206167806,SRX16500062,CTCF,499
chr1,206167324,206167918,SRX4174629,CTCF,594
chr1,206167409,206167803,SRX5075176,SMARCA4,394
chr1,206167414,206167669,SRX5075174,SMARCA4,255
chr1,206167461,206167697,SRX5075170,SMARCA4,236
chr1,206167462,206167736,SRX5075168,SMARCA4,274
chr1,206167478,206167787,SRX5075175,SMARCA4,309
chr1,206167486,206167702,SRX5716464,SMARCA4,216
chr1,206167529,206167734,SRX5075169,SMARCA4,205
chr1,206174453,206174819,SRX16500062,CTCF,366
chr1,206174490,206174858,SRX16500061,CTCF,368
chr1,206174521,206174888,SRX4174629,CTCF,367
chr1,206174559,206174804,SRX16500060,CTCF,245
chr1,206176112,206176482,SRX5075169,SMARCA4,370
chr1,206176121,206176486,SRX5054309,FOSL2,365
chr1,206176132,206176570,SRX5075175,SMARCA4,438
chr1,206176188,206176478,SRX5075170,SMARCA4,290
chr1,206176189,206176477,SRX5075176,SMARCA4,288
chr1,206176220,206176475,SRX5054308,FOSL2,255
chr1,206182260,206182831,SRX5075176,SMARCA4,571
chr1,206182261,206182618,SRX5716469,SMARCA4,357
chr1,206182317,206182850,SRX5075175,SMARCA4,533
chr1,206182325,206182724,SRX5075170,SMARCA4,399
chr1,206182352,206182709,SRX5716467,SMARCA2,357
chr1,206182353,206182687,SRX5716468,SMARCA2,334
chr1,206182379,206182760,SRX5075169,SMARCA4,381
chr1,206182382,206182874,SRX5716470,SMARCA4,492
chr1,206182862,206183194,SRX5075170,SMARCA4,332
chr1,206182894,206183257,SRX5054308,FOSL2,363
chr1,206182899,206183259,SRX5054309,FOSL2,360
chr1,206182919,206183213,SRX5075169,SMARCA4,294
chr1,206182956,206183161,SRX5020214,SMARCA2,205
chr1,206182960,206183158,SRX5075176,SMARCA4,198
chr1,206182976,206183251,SRX5075175,SMARCA4,275
chr1,206202876,206203519,SRX5054307,FOSL2,643
chr1,206202910,206203280,SRX5054308,FOSL2,370
chr1,206202960,206203511,SRX5075174,SMARCA4,551
chr1,206203086,206203355,SRX5716451,SOX2,269
chr1,206203216,206203427,SRX5075170,SMARCA4,211
chr1,206203252,206203431,SRX5075168,SMARCA4,179
chr1,206203435,206203988,SRX20140895,INTS13,553
chr1,206233125,206233304,SRX5075170,SMARCA4,179
chr1,206235292,206235521,SRX5075170,SMARCA4,229
chr1,206250363,206250926,SRX5075174,SMARCA4,563
chr1,206250475,206250992,SRX5075168,SMARCA4,517
chr1,206250536,206250772,SRX20140867,INTS10,236
chr1,206252414,206253342,SRX5075170,SMARCA4,928
chr1,206252427,206253272,SRX5075176,SMARCA4,845
chr1,206252478,206253254,SRX5716470,SMARCA4,776
chr1,206252493,206253053,SRX5075175,SMARCA4,560
chr1,206252495,206253079,SRX5075169,SMARCA4,584
chr1,206252497,206253107,SRX5716469,SMARCA4,610
chr1,206252499,206252907,SRX5054309,FOSL2,408
chr1,206252537,206252987,SRX5716467,SMARCA2,450
chr1,206252537,206253021,SRX5716468,SMARCA2,484
chr1,206252579,206252811,SRX5020211,SMARCA2,232
chr1,206252583,206252765,SRX5054308,FOSL2,182
chr1,206252629,206253014,SRX5075181,SMARCA2,385
chr1,206262522,206262750,SRX5075168,SMARCA4,228
chr1,206262560,206262764,SRX5075169,SMARCA4,204
chr1,206262562,206262821,SRX5054308,FOSL2,259
chr1,206262579,206262786,SRX5075170,SMARCA4,207
chr1,206262580,206262846,SRX5075175,SMARCA4,266
chr1,206262601,206262838,SRX5054309,FOSL2,237
chr1,206264120,206264300,SRX5075169,SMARCA4,180
chr1,206264122,206264340,SRX5075176,SMARCA4,218
chr1,206264824,206265375,SRX5075175,SMARCA4,551
chr1,206264864,206265387,SRX5075170,SMARCA4,523
chr1,206264971,206265294,SRX5075176,SMARCA4,323
chr1,206265085,206265297,SRX5716470,SMARCA4,212
chr1,206265086,206265404,SRX5075169,SMARCA4,318
chr1,206282297,206282940,SRX5075176,SMARCA4,643
chr1,206282352,206282966,SRX5075170,SMARCA4,614
chr1,206282353,206282854,SRX5075169,SMARCA4,501
chr1,206282366,206282741,SRX5075175,SMARCA4,375
chr1,206282389,206282810,SRX5054309,FOSL2,421
chr1,206282406,206282739,SRX5054308,FOSL2,333
chr1,206282412,206282787,SRX5716470,SMARCA4,375
chr1,206282465,206282738,SRX5716469,SMARCA4,273
chr1,206282521,206282812,SRX5716467,SMARCA2,291
chr1,206288460,206288832,SRX5075169,SMARCA4,372
chr1,206288474,206288808,SRX5075176,SMARCA4,334
chr1,206288491,206288703,SRX5716469,SMARCA4,212
chr1,206288496,206288829,SRX5075175,SMARCA4,333
chr1,206288499,206288852,SRX5054308,FOSL2,353
chr1,206288515,206288854,SRX5054309,FOSL2,339
chr1,206288572,206288821,SRX5075170,SMARCA4,249
chr1,206288590,206288790,SRX5020211,SMARCA2,200
chr1,206299336,206299712,SRX5075174,SMARCA4,376
chr1,206299396,206299765,SRX5075168,SMARCA4,369
chr1,206304064,206304474,SRX5075170,SMARCA4,410
chr1,206304072,206304422,SRX5716467,SMARCA2,350
chr1,206304087,206304413,SRX5020211,SMARCA2,326
chr1,206304123,206304441,SRX5075175,SMARCA4,318
chr1,206304128,206304427,SRX5716468,SMARCA2,299
chr1,206304137,206304470,SRX5075176,SMARCA4,333
chr1,206304155,206304401,SRX5075169,SMARCA4,246
chr1,206304176,206304356,SRX5054308,FOSL2,180
chr1,206304187,206304405,SRX5075181,SMARCA2,218
chr1,206304190,206304411,SRX5716470,SMARCA4,221
chr1,206311591,206312131,SRX5075168,SMARCA4,540
chr1,206311643,206312088,SRX5075174,SMARCA4,445
chr1,206311656,206312203,SRX20140867,INTS10,547
chr1,206311696,206311952,SRX20140879,CPSF3L,256
chr1,206311715,206311938,SRX5716463,SMARCA4,223
chr1,206311738,206312161,SRX20140895,INTS13,423
chr1,206311740,206312023,SRX20140868,INTS10,283
chr1,206311787,206312021,SRX5716451,SOX2,234
chr1,206311788,206312197,SRX20140881,CPSF3L,409
chr1,206316767,206317568,SRX5075174,SMARCA4,801
chr1,206316814,206317477,SRX5075168,SMARCA4,663
chr1,206316836,206317278,SRX5716464,SMARCA4,442
chr1,206316881,206317296,SRX5716463,SMARCA4,415
chr1,206317135,206317465,SRX5716451,SOX2,330
chr1,206317988,206318192,SRX5075170,SMARCA4,204
chr1,206320299,206320589,SRX5054308,FOSL2,290
chr1,206320313,206320608,SRX5054309,FOSL2,295
chr1,206322919,206323094,SRX5075174,SMARCA4,175
chr1,206326203,206326464,SRX20140881,CPSF3L,261
chr1,206326225,206326411,SRX5075169,SMARCA4,186
chr1,206326262,206326529,SRX5075174,SMARCA4,267
chr1,206326263,206326495,SRX5075168,SMARCA4,232
chr1,206326326,206326502,SRX5075170,SMARCA4,176
chr1,206337103,206337363,SRX5075176,SMARCA4,260
chr1,206337112,206337383,SRX5075174,SMARCA4,271
chr1,206337119,206337400,SRX5075170,SMARCA4,281
chr1,206337144,206337375,SRX5075168,SMARCA4,231
chr1,206337159,206337363,SRX5075175,SMARCA4,204
chr1,206349677,206350129,SRX5075170,SMARCA4,452
chr1,206349730,206350023,SRX5075169,SMARCA4,293
chr1,206349758,206350091,SRX5075176,SMARCA4,333
chr1,206349764,206349961,SRX5054309,FOSL2,197
chr1,206349767,206350031,SRX5716469,SMARCA4,264
chr1,206349767,206350082,SRX5075175,SMARCA4,315
chr1,206349781,206350043,SRX5054308,FOSL2,262
chr1,206349823,206350074,SRX5716467,SMARCA2,251
chr1,206356300,206356639,SRX5075169,SMARCA4,339
chr1,206356348,206356608,SRX5054309,FOSL2,260
chr1,206356350,206356632,SRX5075170,SMARCA4,282
chr1,206356353,206356634,SRX5716469,SMARCA4,281
chr1,206356363,206356744,SRX5075168,SMARCA4,381
chr1,206356366,206356664,SRX5075176,SMARCA4,298
chr1,206356375,206356637,SRX5075174,SMARCA4,262
chr1,206356396,206356619,SRX5054308,FOSL2,223
chr1,206366159,206366591,SRX20140881,CPSF3L,432
chr1,206366163,206366465,SRX5716464,SMARCA4,302
chr1,206366220,206366560,SRX5075168,SMARCA4,340
chr1,206366224,206366542,SRX20140867,INTS10,318
chr1,206366244,206366448,SRX5716463,SMARCA4,204
chr1,206366248,206366519,SRX20140896,INTS13,271
chr1,206374722,206375143,SRX5075170,SMARCA4,421
chr1,206374797,206375125,SRX5075175,SMARCA4,328
chr1,206374819,206375224,SRX5075176,SMARCA4,405
chr1,206374867,206375065,SRX5075174,SMARCA4,198
chr1,206374888,206375130,SRX5075169,SMARCA4,242
chr1,206380263,206380666,SRX5716469,SMARCA4,403
chr1,206380331,206381172,SRX5075170,SMARCA4,841
chr1,206380364,206380879,SRX5075175,SMARCA4,515
chr1,206380420,206380705,SRX5054308,FOSL2,285
chr1,206380440,206380717,SRX5054309,FOSL2,277
chr1,206380466,206380910,SRX5075169,SMARCA4,444
chr1,206380475,206381129,SRX5075176,SMARCA4,654
chr1,206380541,206381004,SRX5075174,SMARCA4,463
chr1,206380639,206381048,SRX5075168,SMARCA4,409
chr1,206381182,206381357,SRX5075174,SMARCA4,175
chr1,206381287,206381585,SRX5075168,SMARCA4,298
chr1,206381317,206381559,SRX5054309,FOSL2,242
chr1,206387642,206387988,SRX5075170,SMARCA4,346
chr1,206393762,206394039,SRX5075176,SMARCA4,277
chr1,206393785,206394042,SRX5075175,SMARCA4,257
chr1,206393788,206394126,SRX5054309,FOSL2,338
chr1,206393801,206394019,SRX5075169,SMARCA4,218
chr1,206393824,206394038,SRX5054308,FOSL2,214
chr1,206403415,206404511,SRX5075170,SMARCA4,1096
chr1,206403815,206404267,SRX5075176,SMARCA4,452
chr1,206403848,206404249,SRX5075169,SMARCA4,401
chr1,206403877,206404286,SRX5716469,SMARCA4,409
chr1,206403902,206404226,SRX5716470,SMARCA4,324
chr1,206403930,206404113,SRX5054309,FOSL2,183
chr1,206403962,206404217,SRX5075175,SMARCA4,255
chr1,206416488,206416759,SRX5716469,SMARCA4,271
chr1,206416496,206416791,SRX5075175,SMARCA4,295
chr1,206416500,206416836,SRX5075170,SMARCA4,336
chr1,206416570,206416848,SRX5075176,SMARCA4,278
chr1,206416585,206416841,SRX5716470,SMARCA4,256
chr1,206430373,206430651,SRX5075169,SMARCA4,278
chr1,206430452,206430652,SRX5075175,SMARCA4,200
chr1,206445171,206445472,SRX5075170,SMARCA4,301
chr1,206445205,206445410,SRX5075176,SMARCA4,205
chr1,206449571,206449860,SRX5054309,FOSL2,289
chr1,206449603,206449861,SRX5054308,FOSL2,258
chr1,206449618,206449817,SRX5075169,SMARCA4,199
chr1,206449631,206449804,SRX5075174,SMARCA4,173
chr1,206449634,206449823,SRX5075176,SMARCA4,189
chr1,206449640,206449823,SRX5075170,SMARCA4,183
chr1,206449677,206449882,SRX5075175,SMARCA4,205
chr1,206455570,206455899,SRX20140867,INTS10,329
chr1,206455732,206456301,SRX5075170,SMARCA4,569
chr1,206455742,206456320,SRX5075176,SMARCA4,578
chr1,206455798,206456143,SRX5075169,SMARCA4,345
chr1,206455810,206456058,SRX5075175,SMARCA4,248
chr1,206455843,206456277,SRX5716470,SMARCA4,434
chr1,206455844,206456245,SRX5716469,SMARCA4,401
chr1,206455854,206456046,SRX5075174,SMARCA4,192
chr1,206461781,206462367,SRX16500060,CTCF,586
chr1,206461793,206462337,SRX16500059,CTCF,544
chr1,206461841,206462312,SRX16500061,CTCF,471
chr1,206461859,206462295,SRX16500062,CTCF,436
chr1,206461879,206462198,SRX5075168,SMARCA4,319
chr1,206461911,206462164,SRX5075174,SMARCA4,253
chr1,206461929,206462178,SRX5075176,SMARCA4,249
chr1,206461937,206462120,SRX5075169,SMARCA4,183
chr1,206461967,206462273,SRX4174629,CTCF,306
chr1,206461999,206462203,SRX5716463,SMARCA4,204
chr1,206464689,206465012,SRX5075176,SMARCA4,323
chr1,206464691,206464982,SRX5075170,SMARCA4,291
chr1,206464723,206465031,SRX5075169,SMARCA4,308
chr1,206464738,206465015,SRX5716469,SMARCA4,277
chr1,206464750,206465053,SRX5054309,FOSL2,303
chr1,206464755,206464977,SRX5054308,FOSL2,222
chr1,206464811,206465006,SRX5075175,SMARCA4,195
chr1,206470310,206470541,SRX5075170,SMARCA4,231
chr1,206470388,206470580,SRX5075174,SMARCA4,192
chr1,206471026,206471308,SRX5075176,SMARCA4,282
chr1,206471095,206471274,SRX5075168,SMARCA4,179
chr1,206471137,206471364,SRX5075170,SMARCA4,227
chr1,206472580,206472798,SRX5075175,SMARCA4,218
chr1,206479385,206479878,SRX16500062,CTCF,493
chr1,206479395,206479946,SRX16500060,CTCF,551
chr1,206479409,206479957,SRX16500061,CTCF,548
chr1,206479430,206479973,SRX16500059,CTCF,543
chr1,206479509,206479802,SRX5075168,SMARCA4,293
chr1,206479523,206479838,SRX4174629,CTCF,315
chr1,206479540,206479810,SRX5075174,SMARCA4,270
chr1,206479567,206479813,SRX5075170,SMARCA4,246
chr1,206479570,206479822,SRX5075176,SMARCA4,252
chr1,206481198,206481519,SRX5075169,SMARCA4,321
chr1,206481199,206481478,SRX5054309,FOSL2,279
chr1,206481202,206481515,SRX5075175,SMARCA4,313
chr1,206481211,206481539,SRX5054308,FOSL2,328
chr1,206481230,206481495,SRX5075176,SMARCA4,265
chr1,206481257,206481457,SRX5020211,SMARCA2,200
chr1,206481287,206481542,SRX5075170,SMARCA4,255
chr1,206481288,206481523,SRX5716469,SMARCA4,235
chr1,206489963,206490526,SRX16500059,CTCF,563
chr1,206490001,206490477,SRX16500062,CTCF,476
chr1,206490032,206490526,SRX16500060,CTCF,494
chr1,206490033,206490512,SRX16500061,CTCF,479
chr1,206490043,206490505,SRX4174629,CTCF,462
chr1,206490145,206490434,SRX5075174,SMARCA4,289
chr1,206490151,206490435,SRX5075168,SMARCA4,284
chr1,206490161,206490363,SRX5075176,SMARCA4,202
chr1,206490173,206490419,SRX5075170,SMARCA4,246
chr1,206495415,206495847,SRX5075176,SMARCA4,432
chr1,206495474,206495740,SRX5075170,SMARCA4,266
chr1,206504064,206504498,SRX5054308,FOSL2,434
chr1,206504074,206504545,SRX5075175,SMARCA4,471
chr1,206504076,206504492,SRX5075176,SMARCA4,416
chr1,206504080,206504540,SRX5075169,SMARCA4,460
chr1,206504100,206504485,SRX5054309,FOSL2,385
chr1,206504138,206504453,SRX5716469,SMARCA4,315
chr1,206504151,206504419,SRX5020211,SMARCA2,268
chr1,206504156,206504498,SRX5075170,SMARCA4,342
chr1,206504189,206504454,SRX5716467,SMARCA2,265
chr1,206504259,206504470,SRX5716470,SMARCA4,211
chr1,206505990,206506373,SRX16500060,CTCF,383
chr1,206506004,206506279,SRX16500062,CTCF,275
chr1,206506015,206506303,SRX16500059,CTCF,288
chr1,206506054,206506363,SRX16500061,CTCF,309
chr1,206512409,206512736,SRX5075168,SMARCA4,327
chr1,206513510,206513901,SRX5075175,SMARCA4,391
chr1,206513512,206513951,SRX5075170,SMARCA4,439
chr1,206513565,206513846,SRX5716469,SMARCA4,281
chr1,206513585,206513938,SRX5075176,SMARCA4,353
chr1,206513597,206513840,SRX5054309,FOSL2,243
chr1,206513615,206513918,SRX5075169,SMARCA4,303
chr1,206526307,206526548,SRX5075175,SMARCA4,241
chr1,206526343,206526665,SRX5075176,SMARCA4,322
chr1,206544727,206545263,SRX16500060,CTCF,536
chr1,206544745,206545223,SRX16500062,CTCF,478
chr1,206544746,206545240,SRX16500059,CTCF,494
chr1,206544759,206545257,SRX16500061,CTCF,498
chr1,206544783,206545161,SRX5075168,SMARCA4,378
chr1,206544806,206545201,SRX5075174,SMARCA4,395
chr1,206544813,206545126,SRX5716470,SMARCA4,313
chr1,206544835,206545182,SRX5716463,SMARCA4,347
chr1,206544837,206545180,SRX5075176,SMARCA4,343
chr1,206544839,206545155,SRX5075170,SMARCA4,316
chr1,206544848,206545151,SRX5075169,SMARCA4,303
chr1,206544867,206545129,SRX5075175,SMARCA4,262
chr1,206544875,206545162,SRX4174629,CTCF,287
chr1,206544883,206545139,SRX20140895,INTS13,256
chr1,206544927,206545132,SRX5716464,SMARCA4,205
chr1,206556975,206557543,SRX5075174,SMARCA4,568
chr1,206556996,206557579,SRX20140895,INTS13,583
chr1,206557294,206557530,SRX5716470,SMARCA4,236
chr1,206557380,206557577,SRX5075176,SMARCA4,197
chr1,206575162,206575430,SRX5075176,SMARCA4,268
chr1,206575227,206575436,SRX5075170,SMARCA4,209
chr1,206583590,206584144,SRX16500060,CTCF,554
chr1,206583599,206584128,SRX16500059,CTCF,529
chr1,206583604,206583951,SRX4174629,CTCF,347
chr1,206583621,206584043,SRX16500062,CTCF,422
chr1,206583627,206584101,SRX16500061,CTCF,474
chr1,206583700,206583921,SRX5075168,SMARCA4,221
chr1,206583704,206583973,SRX5075174,SMARCA4,269
chr1,206589136,206589515,SRX5075169,SMARCA4,379
chr1,206589157,206589542,SRX5075175,SMARCA4,385
chr1,206589160,206589449,SRX5054309,FOSL2,289
chr1,206589161,206589430,SRX5075170,SMARCA4,269
chr1,206589169,206589436,SRX5054308,FOSL2,267
chr1,206589183,206589427,SRX5075176,SMARCA4,244
chr1,206589193,206589457,SRX5716469,SMARCA4,264
chr1,206589223,206589492,SRX5716470,SMARCA4,269
chr1,206590458,206590680,SRX16500061,CTCF,222
chr1,206590574,206590804,SRX16500060,CTCF,230
chr1,206606867,206607286,SRX16500062,CTCF,419
chr1,206606894,206607292,SRX16500059,CTCF,398
chr1,206606895,206607231,SRX16500060,CTCF,336
chr1,206606929,206607188,SRX16500061,CTCF,259
chr1,206607231,206607585,SRX4174629,CTCF,354
chr1,206608062,206608301,SRX4174629,CTCF,239
chr1,206608117,206608417,SRX16500060,CTCF,300
chr1,206608141,206608414,SRX16500059,CTCF,273
chr1,206612061,206612674,SRX20140869,INTS10,613
chr1,206612093,206612769,SRX20140895,INTS13,676
chr1,206612113,206612718,SRX20140868,INTS10,605
chr1,206612138,206612630,SRX20140881,CPSF3L,492
chr1,206612160,206612662,SRX20140897,INTS13,502
chr1,206612162,206612688,SRX20140867,INTS10,526
chr1,206612175,206612683,SRX5716470,SMARCA4,508
chr1,206612178,206612626,SRX20140894,INTS13,448
chr1,206612187,206612687,SRX20140879,CPSF3L,500
chr1,206612207,206612662,SRX20140896,INTS13,455
chr1,206612210,206612733,SRX5075176,SMARCA4,523
chr1,206612214,206612766,SRX5075170,SMARCA4,552
chr1,206612224,206612767,SRX16500060,CTCF,543
chr1,206612242,206612743,SRX16500062,CTCF,501
chr1,206612249,206612662,SRX20140870,INTS10,413
chr1,206612254,206612766,SRX16500061,CTCF,512
chr1,206612259,206612811,SRX5716464,SMARCA4,552
chr1,206612265,206612792,SRX5075174,SMARCA4,527
chr1,206612295,206612779,SRX5075168,SMARCA4,484
chr1,206612300,206612771,SRX16500059,CTCF,471
chr1,206612308,206612711,SRX5075175,SMARCA4,403
chr1,206612407,206612795,SRX5716463,SMARCA4,388
chr1,206612428,206612692,SRX5020214,SMARCA2,264
chr1,206612437,206612734,SRX5075169,SMARCA4,297
chr1,206631157,206631391,SRX16500060,CTCF,234
chr1,206634124,206634728,SRX16500060,CTCF,604
chr1,206634164,206634722,SRX16500061,CTCF,558
chr1,206634171,206634725,SRX16500059,CTCF,554
chr1,206634200,206634693,SRX16500062,CTCF,493
chr1,206634318,206634593,SRX5075168,SMARCA4,275
chr1,206634318,206634669,SRX4174629,CTCF,351
chr1,206634338,206634627,SRX5075174,SMARCA4,289
chr1,206634343,206634560,SRX5716470,SMARCA4,217
chr1,206634388,206634622,SRX5075170,SMARCA4,234
chr1,206634393,206634634,SRX5075176,SMARCA4,241
chr1,206635171,206635879,SRX20140895,INTS13,708
chr1,206635257,206635592,SRX5716463,SMARCA4,335
chr1,206635275,206635630,SRX5075170,SMARCA4,355
chr1,206635280,206635681,SRX20140868,INTS10,401
chr1,206635285,206635660,SRX5075174,SMARCA4,375
chr1,206635316,206635554,SRX5075176,SMARCA4,238
chr1,206635344,206635533,SRX5054309,FOSL2,189
chr1,206635344,206635755,SRX5075168,SMARCA4,411
chr1,206635361,206635659,SRX20140867,INTS10,298
chr1,206658463,206658805,SRX16500062,CTCF,342
chr1,206658538,206658903,SRX16500061,CTCF,365
chr1,206658543,206658813,SRX16500060,CTCF,270
chr1,206658553,206658845,SRX16500059,CTCF,292
chr1,206664057,206664639,SRX16500059,CTCF,582
chr1,206664114,206664626,SRX16500061,CTCF,512
chr1,206664119,206664493,SRX5075168,SMARCA4,374
chr1,206664122,206664643,SRX16500062,CTCF,521
chr1,206664127,206664689,SRX16500060,CTCF,562
chr1,206664182,206664589,SRX4174629,CTCF,407
chr1,206664183,206664352,SRX5075170,SMARCA4,169
chr1,206664216,206664401,SRX5075176,SMARCA4,185
chr1,206664216,206664513,SRX5716463,SMARCA4,297
chr1,206664222,206664534,SRX5075174,SMARCA4,312
chr1,206664228,206664452,SRX5716464,SMARCA4,224
chr1,206672064,206672298,SRX5075174,SMARCA4,234
chr1,206672257,206672436,SRX5075168,SMARCA4,179
chr1,206673374,206673700,SRX20140895,INTS13,326
chr1,206673391,206673710,SRX5075168,SMARCA4,319
chr1,206673412,206673670,SRX5075174,SMARCA4,258
chr1,206673438,206673747,SRX20140868,INTS10,309
chr1,206674888,206675110,SRX5075169,SMARCA4,222
chr1,206684874,206685065,SRX5075174,SMARCA4,191
chr1,206685730,206686270,SRX20140895,INTS13,540
chr1,206685813,206686147,SRX20140868,INTS10,334
chr1,206685906,206686114,SRX5075174,SMARCA4,208
chr1,206685955,206686205,SRX5075176,SMARCA4,250
chr1,206685994,206686221,SRX5075168,SMARCA4,227
chr1,206686026,206686238,SRX5716469,SMARCA4,212
chr1,206686029,206686273,SRX5716470,SMARCA4,244
chr1,206686061,206686314,SRX5075169,SMARCA4,253
chr1,206700539,206700935,SRX5075176,SMARCA4,396
chr1,206700619,206700948,SRX5075170,SMARCA4,329
chr1,206705135,206705497,SRX20140895,INTS13,362
chr1,206705198,206705463,SRX5075174,SMARCA4,265
chr1,206705201,206705479,SRX5075168,SMARCA4,278
chr1,206706475,206706707,SRX5075169,SMARCA4,232
chr1,206723799,206724112,SRX5054309,FOSL2,313
chr1,206723804,206724112,SRX5075176,SMARCA4,308
chr1,206723838,206724058,SRX5075170,SMARCA4,220
chr1,206723870,206724082,SRX5716469,SMARCA4,212
chr1,206723902,206724105,SRX5075169,SMARCA4,203
chr1,206723904,206724084,SRX5054308,FOSL2,180
chr1,206725567,206725945,SRX16500059,CTCF,378
chr1,206725597,206725974,SRX16500061,CTCF,377
chr1,206725632,206725922,SRX16500062,CTCF,290
chr1,206725641,206726723,SRX16500060,CTCF,1082
chr1,206726171,206726650,SRX16500061,CTCF,479
chr1,206726246,206726688,SRX16500059,CTCF,442
chr1,206726251,206726718,SRX16500062,CTCF,467
chr1,206726253,206726530,SRX4174629,CTCF,277
chr1,206734466,206734942,SRX16500061,CTCF,476
chr1,206734474,206734997,SRX16500060,CTCF,523
chr1,206734486,206734937,SRX16500062,CTCF,451
chr1,206734486,206734991,SRX16500059,CTCF,505
chr1,206766425,206766615,SRX5054309,FOSL2,190
chr1,206770531,206770796,SRX5054309,FOSL2,265
chr1,206770574,206770754,SRX5054308,FOSL2,180
chr1,206798075,206798348,SRX16500062,CTCF,273
chr1,206798085,206798498,SRX16500059,CTCF,413
chr1,206798095,206798440,SRX16500060,CTCF,345
chr1,206798171,206798448,SRX16500061,CTCF,277
chr1,206814956,206815409,SRX5075176,SMARCA4,453
chr1,206814964,206815472,SRX5075170,SMARCA4,508
chr1,206814972,206815250,SRX5716470,SMARCA4,278
chr1,206814976,206815273,SRX5075169,SMARCA4,297
chr1,206815009,206815280,SRX5075175,SMARCA4,271
chr1,206823791,206824041,SRX5075176,SMARCA4,250
chr1,206823833,206824161,SRX5075169,SMARCA4,328
chr1,206823866,206824074,SRX5075170,SMARCA4,208
chr1,206839865,206840159,SRX5054309,FOSL2,294
chr1,206839912,206840147,SRX5075169,SMARCA4,235
chr1,206839916,206840085,SRX5075170,SMARCA4,169
chr1,206839929,206840128,SRX5075175,SMARCA4,199
chr1,206842829,206843121,SRX5075168,SMARCA4,292
chr1,206842845,206843206,SRX5075174,SMARCA4,361
chr1,206864909,206865345,SRX16500060,CTCF,436
chr1,206864914,206865283,SRX16500061,CTCF,369
chr1,206864915,206865270,SRX16500059,CTCF,355
chr1,206864947,206865306,SRX16500062,CTCF,359
chr1,206882633,206882854,SRX16500060,CTCF,221
chr1,206898478,206898819,SRX5054309,FOSL2,341
chr1,206898489,206898767,SRX5075175,SMARCA4,278
chr1,206898492,206898782,SRX5075176,SMARCA4,290
chr1,206898503,206898802,SRX5075169,SMARCA4,299
chr1,206898541,206898750,SRX5054308,FOSL2,209
chr1,206898541,206898759,SRX5075170,SMARCA4,218
chr1,206905316,206905670,SRX5054309,FOSL2,354
chr1,206905329,206905610,SRX5075174,SMARCA4,281
chr1,206905364,206905584,SRX5075169,SMARCA4,220
chr1,206905383,206905587,SRX5054308,FOSL2,204
chr1,206905397,206905605,SRX5075175,SMARCA4,208
chr1,206905401,206905595,SRX5075168,SMARCA4,194
chr1,206905411,206905601,SRX5075170,SMARCA4,190
chr1,206905413,206905588,SRX5075176,SMARCA4,175
chr1,206910988,206911516,SRX16500059,CTCF,528
chr1,206910993,206911431,SRX16500062,CTCF,438
chr1,206911007,206911499,SRX16500060,CTCF,492
chr1,206911048,206911541,SRX16500061,CTCF,493
chr1,206911163,206911426,SRX5075170,SMARCA4,263
chr1,206911172,206911433,SRX5075176,SMARCA4,261
chr1,206911189,206911388,SRX5075175,SMARCA4,199
chr1,206911194,206911379,SRX5075169,SMARCA4,185
chr1,206911198,206911478,SRX5054309,FOSL2,280
chr1,206911216,206911453,SRX5054308,FOSL2,237
chr1,206912423,206912878,SRX16500060,CTCF,455
chr1,206912434,206912900,SRX16500059,CTCF,466
chr1,206912443,206912851,SRX16500062,CTCF,408
chr1,206912470,206912921,SRX16500061,CTCF,451
chr1,206912474,206912863,SRX4174629,CTCF,389
chr1,206912514,206912741,SRX5075176,SMARCA4,227
chr1,206912532,206912798,SRX5075168,SMARCA4,266
chr1,206912560,206912768,SRX5075174,SMARCA4,208
chr1,206912563,206912743,SRX5075170,SMARCA4,180
chr1,206933457,206933712,SRX16500060,CTCF,255
chr1,206947612,206947942,SRX5075176,SMARCA4,330
chr1,206947646,206948066,SRX5075170,SMARCA4,420
chr1,206982104,206982501,SRX16500060,CTCF,397
chr1,206982129,206982483,SRX16500061,CTCF,354
chr1,206982131,206982444,SRX16500062,CTCF,313
chr1,206982144,206982502,SRX16500059,CTCF,358
chr1,206982214,206982448,SRX4174629,CTCF,234
chr1,207004942,207005413,SRX16500059,CTCF,471
chr1,207004951,207005334,SRX16500061,CTCF,383
chr1,207004964,207005368,SRX16500060,CTCF,404
chr1,207004977,207005354,SRX16500062,CTCF,377
chr1,207005025,207005224,SRX5075168,SMARCA4,199
chr1,207005065,207005251,SRX5075174,SMARCA4,186
chr1,207007371,207007719,SRX5075176,SMARCA4,348
chr1,207007379,207007782,SRX5075170,SMARCA4,403
chr1,207007386,207007766,SRX5054309,FOSL2,380
chr1,207007409,207007733,SRX5716470,SMARCA4,324
chr1,207007411,207007733,SRX5075169,SMARCA4,322
chr1,207007427,207007657,SRX5054308,FOSL2,230
chr1,207007431,207007709,SRX5075175,SMARCA4,278
chr1,207007443,207007653,SRX5020211,SMARCA2,210
chr1,207007445,207007789,SRX5716469,SMARCA4,344
chr1,207007484,207007678,SRX5075181,SMARCA2,194
chr1,207007502,207007746,SRX5020214,SMARCA2,244
chr1,207025508,207025754,SRX5075169,SMARCA4,246
chr1,207049851,207050307,SRX16500062,CTCF,456
chr1,207049857,207050402,SRX16500061,CTCF,545
chr1,207049865,207050395,SRX16500060,CTCF,530
chr1,207049873,207050403,SRX16500059,CTCF,530
chr1,207050021,207050204,SRX5075168,SMARCA4,183
chr1,207050614,207051127,SRX20140895,INTS13,513
chr1,207050724,207050963,SRX5716470,SMARCA4,239
chr1,207050857,207051200,SRX5075174,SMARCA4,343
chr1,207052803,207053320,SRX5075170,SMARCA4,517
chr1,207052845,207053326,SRX5075176,SMARCA4,481
chr1,207052875,207053398,SRX5075174,SMARCA4,523
chr1,207052970,207053260,SRX5716463,SMARCA4,290
chr1,207053033,207053289,SRX5075168,SMARCA4,256
chr1,207053066,207053489,SRX20140897,INTS13,423
chr1,207059620,207059841,SRX16500060,CTCF,221
chr1,207077729,207078292,SRX16500060,CTCF,563
chr1,207077730,207078260,SRX16500059,CTCF,530
chr1,207077758,207078235,SRX16500061,CTCF,477
chr1,207077761,207078256,SRX16500062,CTCF,495
chr1,207077786,207078076,SRX4174629,CTCF,290
chr1,207077795,207078139,SRX5075174,SMARCA4,344
chr1,207077809,207078137,SRX5075168,SMARCA4,328
chr1,207077816,207078096,SRX5716470,SMARCA4,280
chr1,207077830,207078097,SRX5716463,SMARCA4,267
chr1,207077844,207078108,SRX5075170,SMARCA4,264
chr1,207077845,207078142,SRX5075176,SMARCA4,297
chr1,207077847,207078132,SRX5716464,SMARCA4,285
chr1,207077848,207078110,SRX5075169,SMARCA4,262
chr1,207077867,207078065,SRX5075175,SMARCA4,198
chr1,207084596,207085046,SRX16500059,CTCF,450
chr1,207084616,207085160,SRX16500060,CTCF,544
chr1,207084616,207085198,SRX16500062,CTCF,582
chr1,207084671,207085178,SRX16500061,CTCF,507
chr1,207084704,207085081,SRX4174629,CTCF,377
chr1,207205136,207205374,SRX5075168,SMARCA4,238
chr1,207205165,207205415,SRX5075174,SMARCA4,250
chr1,207309684,207309901,SRX5075170,SMARCA4,217
chr1,207309695,207310073,SRX5075169,SMARCA4,378
chr1,207309715,207309894,SRX5075176,SMARCA4,179
chr1,207309723,207309975,SRX5054309,FOSL2,252
chr1,207309732,207309963,SRX5716470,SMARCA4,231
chr1,207309750,207310031,SRX5075175,SMARCA4,281
chr1,207309780,207310066,SRX5716469,SMARCA4,286
chr1,207309946,207310160,SRX5075176,SMARCA4,214
chr1,207311263,207311547,SRX5054308,FOSL2,284
chr1,207321141,207321362,SRX16500061,CTCF,221
chr1,207321146,207321388,SRX16500060,CTCF,242
chr1,207321173,207321369,SRX5075170,SMARCA4,196
chr1,207321391,207321874,SRX5075174,SMARCA4,483
chr1,207321428,207321643,SRX5716469,SMARCA4,215
chr1,207321441,207321889,SRX5075170,SMARCA4,448
chr1,207321452,207322042,SRX20140895,INTS13,590
chr1,207321463,207321980,SRX20140881,CPSF3L,517
chr1,207321466,207321987,SRX5075175,SMARCA4,521
chr1,207321473,207321656,SRX5054309,FOSL2,183
chr1,207321551,207321853,SRX5075169,SMARCA4,302
chr1,207321552,207321809,SRX20140867,INTS10,257
chr1,207321598,207321867,SRX5075168,SMARCA4,269
chr1,207321633,207321974,SRX5716470,SMARCA4,341
chr1,207393505,207393973,SRX5075170,SMARCA4,468
chr1,207393535,207393944,SRX5075169,SMARCA4,409
chr1,207393559,207393963,SRX5075176,SMARCA4,404
chr1,207393597,207393933,SRX5716469,SMARCA4,336
chr1,207393641,207393961,SRX5075175,SMARCA4,320
chr1,207393647,207393987,SRX5716470,SMARCA4,340
chr1,207393660,207393946,SRX5054309,FOSL2,286
chr1,207393674,207393938,SRX5716467,SMARCA2,264
chr1,207393695,207393898,SRX5054308,FOSL2,203
chr1,207404854,207405288,SRX16500061,CTCF,434
chr1,207404857,207405341,SRX16500060,CTCF,484
chr1,207404859,207405316,SRX16500059,CTCF,457
chr1,207404889,207405272,SRX16500062,CTCF,383
chr1,207404941,207405252,SRX5075168,SMARCA4,311
chr1,207404975,207405259,SRX5075174,SMARCA4,284
chr1,207404991,207405209,SRX5075170,SMARCA4,218
chr1,207405027,207405232,SRX5716464,SMARCA4,205
chr1,207454654,207454886,SRX16500061,CTCF,232
chr1,207499427,207499978,SRX4174629,CTCF,551
chr1,207499469,207499954,SRX16500060,CTCF,485
chr1,207499477,207499885,SRX16500059,CTCF,408
chr1,207499495,207499885,SRX16500062,CTCF,390
chr1,207499500,207499884,SRX16500061,CTCF,384
chr1,207499521,207499719,SRX5075176,SMARCA4,198
chr1,207528434,207528736,SRX16500061,CTCF,302
chr1,207528447,207528760,SRX16500060,CTCF,313
chr1,207528455,207528860,SRX4174629,CTCF,405
chr1,207528460,207528808,SRX16500059,CTCF,348
chr1,207528473,207528766,SRX16500062,CTCF,293
chr1,207546940,207547342,SRX4174629,CTCF,402
chr1,207546968,207547336,SRX16500062,CTCF,368
chr1,207546989,207547313,SRX16500060,CTCF,324
chr1,207547003,207547404,SRX16500059,CTCF,401
chr1,207547011,207547232,SRX16500061,CTCF,221
chr1,207547020,207547195,SRX5075174,SMARCA4,175
chr1,207547043,207547305,SRX5075168,SMARCA4,262
chr1,207565550,207565954,SRX16500059,CTCF,404
chr1,207565556,207565904,SRX16500061,CTCF,348
chr1,207565575,207565855,SRX5075174,SMARCA4,280
chr1,207565579,207565864,SRX4174629,CTCF,285
chr1,207565582,207565839,SRX5075168,SMARCA4,257
chr1,207565586,207565890,SRX16500060,CTCF,304
chr1,207565621,207565928,SRX16500062,CTCF,307
chr1,207579120,207579602,SRX16500062,CTCF,482
chr1,207579279,207579586,SRX4174629,CTCF,307
chr1,207579306,207579728,SRX16500059,CTCF,422
chr1,207579345,207579667,SRX16500060,CTCF,322
chr1,207579356,207579679,SRX16500061,CTCF,323
chr1,207579434,207579637,SRX5075174,SMARCA4,203
chr1,207579458,207579689,SRX5075168,SMARCA4,231
chr1,207581723,207582009,SRX5075168,SMARCA4,286
chr1,207581765,207582077,SRX5075174,SMARCA4,312
chr1,207581872,207582076,SRX5716463,SMARCA4,204
chr1,207620218,207620821,SRX16500061,CTCF,603
chr1,207620223,207620764,SRX16500060,CTCF,541
chr1,207620226,207620816,SRX16500062,CTCF,590
chr1,207620235,207620790,SRX16500059,CTCF,555
chr1,207620328,207620612,SRX5075168,SMARCA4,284
chr1,207620354,207620599,SRX5075174,SMARCA4,245
chr1,207654327,207654638,SRX16500059,CTCF,311
chr1,207654373,207654700,SRX16500061,CTCF,327
chr1,207672448,207672879,SRX16500059,CTCF,431
chr1,207672473,207672831,SRX4174629,CTCF,358
chr1,207672530,207672924,SRX16500061,CTCF,394
chr1,207672539,207672919,SRX16500060,CTCF,380
chr1,207672605,207672898,SRX16500062,CTCF,293
chr1,207672606,207672820,SRX5075174,SMARCA4,214
chr1,207680638,207680875,SRX5054309,FOSL2,237
chr1,207698851,207699262,SRX4174629,CTCF,411
chr1,207698855,207699188,SRX5075168,SMARCA4,333
chr1,207698867,207699213,SRX5075174,SMARCA4,346
chr1,207698878,207699259,SRX16500059,CTCF,381
chr1,207698884,207699281,SRX16500060,CTCF,397
chr1,207698889,207699285,SRX16500062,CTCF,396
chr1,207698903,207699262,SRX16500061,CTCF,359
chr1,207698905,207699110,SRX5716464,SMARCA4,205
chr1,207698931,207699150,SRX5716470,SMARCA4,219
chr1,207698941,207699183,SRX5075170,SMARCA4,242
chr1,207698950,207699183,SRX5075176,SMARCA4,233
chr1,207698953,207699181,SRX5075169,SMARCA4,228
chr1,207745399,207745600,SRX5054309,FOSL2,201
chr1,207751648,207752378,SRX20140895,INTS13,730
chr1,207751672,207752339,SRX20140868,INTS10,667
chr1,207751689,207752017,SRX20140869,INTS10,328
chr1,207751689,207752224,SRX20140897,INTS13,535
chr1,207751717,207752176,SRX5075168,SMARCA4,459
chr1,207751745,207752107,SRX20140867,INTS10,362
chr1,207751762,207752035,SRX5075174,SMARCA4,273
chr1,207751774,207752297,SRX5075170,SMARCA4,523
chr1,207751779,207752004,SRX5075169,SMARCA4,225
chr1,207751826,207752274,SRX5075175,SMARCA4,448
chr1,207751834,207752173,SRX20140896,INTS13,339
chr1,207751948,207752222,SRX5716464,SMARCA4,274
chr1,207751996,207752410,SRX5075176,SMARCA4,414
chr1,207752029,207752242,SRX5716463,SMARCA4,213
chr1,207797219,207797747,SRX16500060,CTCF,528
chr1,207797269,207797653,SRX5054308,FOSL2,384
chr1,207797277,207797677,SRX5054309,FOSL2,400
chr1,207797294,207797744,SRX16500062,CTCF,450
chr1,207797302,207797649,SRX5075168,SMARCA4,347
chr1,207797308,207797701,SRX5075170,SMARCA4,393
chr1,207797309,207797700,SRX16500061,CTCF,391
chr1,207797311,207797814,SRX16500059,CTCF,503
chr1,207797312,207797645,SRX5075169,SMARCA4,333
chr1,207797313,207797669,SRX5716470,SMARCA4,356
chr1,207797323,207797673,SRX5075176,SMARCA4,350
chr1,207797330,207797674,SRX5075175,SMARCA4,344
chr1,207797346,207797627,SRX5054307,FOSL2,281
chr1,207797349,207797688,SRX5075174,SMARCA4,339
chr1,207797375,207797587,SRX5716469,SMARCA4,212
chr1,207797433,207797700,SRX4174629,CTCF,267
chr1,207805874,207806191,SRX5075169,SMARCA4,317
chr1,207805876,207806134,SRX5075170,SMARCA4,258
chr1,207805889,207806179,SRX5075176,SMARCA4,290
chr1,207805925,207806108,SRX5054309,FOSL2,183
chr1,207805948,207806141,SRX5075175,SMARCA4,193
chr1,207818980,207819169,SRX5075174,SMARCA4,189
chr1,207818981,207819216,SRX5075175,SMARCA4,235
chr1,207819027,207819223,SRX5075168,SMARCA4,196
chr1,207819029,207819214,SRX5075170,SMARCA4,185
chr1,207823914,207824183,SRX5716469,SMARCA4,269
chr1,207823933,207824199,SRX5075176,SMARCA4,266
chr1,207823934,207824203,SRX5716470,SMARCA4,269
chr1,207823945,207824207,SRX5075170,SMARCA4,262
chr1,207823967,207824175,SRX5075169,SMARCA4,208
chr1,207823969,207824182,SRX5075175,SMARCA4,213
chr1,207823980,207824173,SRX5075174,SMARCA4,193
chr1,207823993,207824219,SRX16500061,CTCF,226
chr1,207826800,207827029,SRX20140867,INTS10,229
chr1,207826817,207827091,SRX20140881,CPSF3L,274
chr1,207828573,207828952,SRX16500060,CTCF,379
chr1,207828577,207828921,SRX16500062,CTCF,344
chr1,207828616,207828911,SRX16500061,CTCF,295
chr1,207828620,207828960,SRX16500059,CTCF,340
chr1,207828663,207828832,SRX5075170,SMARCA4,169
chr1,207868836,207869364,SRX20140895,INTS13,528
chr1,207868859,207869120,SRX20140868,INTS10,261
chr1,207868870,207869376,SRX5716470,SMARCA4,506
chr1,207868965,207869536,SRX16500060,CTCF,571
chr1,207868968,207869407,SRX5075168,SMARCA4,439
chr1,207868974,207869369,SRX5075175,SMARCA4,395
chr1,207868977,207869345,SRX5075176,SMARCA4,368
chr1,207868988,207869482,SRX16500059,CTCF,494
chr1,207868989,207869289,SRX5716463,SMARCA4,300
chr1,207868999,207869451,SRX5075170,SMARCA4,452
chr1,207869006,207869354,SRX5716464,SMARCA4,348
chr1,207869007,207869437,SRX5716469,SMARCA4,430
chr1,207869025,207869426,SRX16500062,CTCF,401
chr1,207869048,207869444,SRX5075174,SMARCA4,396
chr1,207869062,207869344,SRX5075169,SMARCA4,282
chr1,207869123,207869425,SRX16500061,CTCF,302
chr1,207884987,207885479,SRX16500059,CTCF,492
chr1,207885015,207885479,SRX16500060,CTCF,464
chr1,207885026,207885384,SRX5716464,SMARCA4,358
chr1,207885043,207885471,SRX16500062,CTCF,428
chr1,207885054,207885527,SRX16500061,CTCF,473
chr1,207885073,207885484,SRX5716470,SMARCA4,411
chr1,207885093,207885449,SRX5075174,SMARCA4,356
chr1,207885103,207885427,SRX5075176,SMARCA4,324
chr1,207885105,207885461,SRX4174629,CTCF,356
chr1,207885129,207885460,SRX5075170,SMARCA4,331
chr1,207885139,207885403,SRX5075168,SMARCA4,264
chr1,207885139,207885431,SRX5716463,SMARCA4,292
chr1,207885156,207885427,SRX5075169,SMARCA4,271
chr1,207885158,207885457,SRX5075175,SMARCA4,299
chr1,207885167,207885379,SRX5716469,SMARCA4,212
chr1,207890109,207890677,SRX5075175,SMARCA4,568
chr1,207890118,207890522,SRX5054309,FOSL2,404
chr1,207890128,207890839,SRX5075176,SMARCA4,711
chr1,207890154,207890479,SRX5054308,FOSL2,325
chr1,207890154,207890815,SRX5075170,SMARCA4,661
chr1,207890174,207890791,SRX5075169,SMARCA4,617
chr1,207890211,207890447,SRX5075174,SMARCA4,236
chr1,207890316,207890697,SRX5716470,SMARCA4,381
chr1,207890352,207890726,SRX5716469,SMARCA4,374
chr1,207890358,207890599,SRX5716468,SMARCA2,241
chr1,207897062,207897473,SRX16500060,CTCF,411
chr1,207897080,207897499,SRX16500061,CTCF,419
chr1,207897111,207897465,SRX16500062,CTCF,354
chr1,207897112,207897525,SRX16500059,CTCF,413
chr1,207902702,207902916,SRX5075176,SMARCA4,214
chr1,207910849,207911360,SRX5075176,SMARCA4,511
chr1,207910909,207911304,SRX5075169,SMARCA4,395
chr1,207910910,207911159,SRX5075175,SMARCA4,249
chr1,207910969,207911424,SRX5075170,SMARCA4,455
chr1,207912419,207912642,SRX5075168,SMARCA4,223
chr1,207912480,207912779,SRX5075174,SMARCA4,299
chr1,207919779,207920159,SRX5075170,SMARCA4,380
chr1,207919802,207920052,SRX5075176,SMARCA4,250
chr1,207925213,207925640,SRX5075170,SMARCA4,427
chr1,207925225,207925651,SRX5075169,SMARCA4,426
chr1,207925277,207925607,SRX5075175,SMARCA4,330
chr1,207925291,207925643,SRX5075176,SMARCA4,352
chr1,207925298,207925664,SRX5716470,SMARCA4,366
chr1,207925336,207925633,SRX5716468,SMARCA2,297
chr1,207925338,207925558,SRX5075174,SMARCA4,220
chr1,207925377,207925641,SRX5716469,SMARCA4,264
chr1,207938153,207938380,SRX5075174,SMARCA4,227
chr1,207944527,207944947,SRX5075168,SMARCA4,420
chr1,207944540,207944979,SRX5075174,SMARCA4,439
chr1,207944568,207944904,SRX5075176,SMARCA4,336
chr1,207944575,207944948,SRX5075170,SMARCA4,373
chr1,207944582,207944897,SRX5075175,SMARCA4,315
chr1,207944589,207944933,SRX5054309,FOSL2,344
chr1,207944608,207944964,SRX5054308,FOSL2,356
chr1,207944682,207944924,SRX5075169,SMARCA4,242
chr1,207948556,207948752,SRX5075170,SMARCA4,196
chr1,207963279,207963847,SRX20140895,INTS13,568
chr1,207963359,207963817,SRX20140868,INTS10,458
chr1,207963361,207963702,SRX20140869,INTS10,341
chr1,207963369,207963651,SRX20140897,INTS13,282
chr1,207963369,207963736,SRX20140867,INTS10,367
chr1,207963400,207963903,SRX5075170,SMARCA4,503
chr1,207963405,207963836,SRX5075175,SMARCA4,431
chr1,207963416,207963677,SRX20140879,CPSF3L,261
chr1,207963419,207963972,SRX5075176,SMARCA4,553
chr1,207963445,207963973,SRX16500059,CTCF,528
chr1,207963450,207963963,SRX5716470,SMARCA4,513
chr1,207963468,207963673,SRX5020214,SMARCA2,205
chr1,207963475,207963998,SRX16500060,CTCF,523
chr1,207963477,207963933,SRX5075169,SMARCA4,456
chr1,207963477,207963973,SRX16500061,CTCF,496
chr1,207963482,207963782,SRX5716469,SMARCA4,300
chr1,207963483,207963931,SRX16500062,CTCF,448
chr1,207963484,207963948,SRX5075174,SMARCA4,464
chr1,207963498,207963788,SRX5075181,SMARCA2,290
chr1,207963511,207963928,SRX5075168,SMARCA4,417
chr1,207963534,207963790,SRX5716464,SMARCA4,256
chr1,207963575,207963925,SRX4174629,CTCF,350
chr1,207963586,207963848,SRX5716463,SMARCA4,262
chr1,207963599,207963782,SRX5054309,FOSL2,183
chr1,207981944,207982352,SRX16500059,CTCF,408
chr1,207981978,207982368,SRX16500060,CTCF,390
chr1,207981988,207982314,SRX16500062,CTCF,326
chr1,207982037,207982279,SRX16500061,CTCF,242
chr1,207987100,207987451,SRX5075168,SMARCA4,351
chr1,207987140,207987474,SRX5075174,SMARCA4,334
chr1,207987197,207987405,SRX5054309,FOSL2,208
chr1,207997723,207998205,SRX16500060,CTCF,482
chr1,207997794,207998191,SRX16500061,CTCF,397
chr1,207997800,207998103,SRX5075174,SMARCA4,303
chr1,207997810,207998102,SRX5075168,SMARCA4,292
chr1,207997810,207998203,SRX16500059,CTCF,393
chr1,207997813,207998092,SRX5075170,SMARCA4,279
chr1,207997825,207998092,SRX5716463,SMARCA4,267
chr1,207997830,207998058,SRX5075176,SMARCA4,228
chr1,207997835,207998222,SRX16500062,CTCF,387
chr1,207997846,207998083,SRX5716464,SMARCA4,237
chr1,207997852,207998122,SRX5075169,SMARCA4,270
chr1,207997861,207998238,SRX4174629,CTCF,377
chr1,207997869,207998080,SRX5075175,SMARCA4,211
chr1,207997873,207998093,SRX5716470,SMARCA4,220
chr1,208006612,208006807,SRX5054309,FOSL2,195
chr1,208007789,208008308,SRX5054309,FOSL2,519
chr1,208007791,208008208,SRX5075175,SMARCA4,417
chr1,208007846,208008335,SRX5054308,FOSL2,489
chr1,208007906,208008189,SRX5075176,SMARCA4,283
chr1,208007924,208008156,SRX5075169,SMARCA4,232
chr1,208021743,208022108,SRX16500061,CTCF,365
chr1,208021748,208022089,SRX16500059,CTCF,341
chr1,208021751,208022119,SRX16500060,CTCF,368
chr1,208021761,208022119,SRX16500062,CTCF,358
chr1,208021786,208022133,SRX4174629,CTCF,347
chr1,208021835,208022178,SRX5075174,SMARCA4,343
chr1,208021889,208022153,SRX5075168,SMARCA4,264
chr1,208021889,208022251,SRX5075170,SMARCA4,362
chr1,208021903,208022195,SRX5075175,SMARCA4,292
chr1,208021925,208022257,SRX5075169,SMARCA4,332
chr1,208021931,208022261,SRX5075176,SMARCA4,330
chr1,208021992,208022191,SRX5054309,FOSL2,199
chr1,208022007,208022231,SRX5716470,SMARCA4,224
chr1,208022051,208022276,SRX5054308,FOSL2,225
chr1,208029568,208029864,SRX5075170,SMARCA4,296
chr1,208029622,208029887,SRX5075176,SMARCA4,265
chr1,208029964,208030421,SRX5075170,SMARCA4,457
chr1,208030017,208030431,SRX5075175,SMARCA4,414
chr1,208030047,208030377,SRX5075176,SMARCA4,330
chr1,208030048,208030308,SRX5054309,FOSL2,260
chr1,208030057,208030351,SRX5075169,SMARCA4,294
chr1,208030074,208030328,SRX5054308,FOSL2,254
chr1,208030085,208030362,SRX5716470,SMARCA4,277
chr1,208030522,208030931,SRX5075176,SMARCA4,409
chr1,208030562,208030942,SRX5075170,SMARCA4,380
chr1,208036118,208036549,SRX16500062,CTCF,431
chr1,208036229,208036545,SRX16500059,CTCF,316
chr1,208036246,208036561,SRX16500060,CTCF,315
chr1,208045111,208045347,SRX5075170,SMARCA4,236
chr1,208045190,208045541,SRX5075176,SMARCA4,351
chr1,208047489,208047704,SRX5716467,SMARCA2,215
chr1,208047494,208047799,SRX5075170,SMARCA4,305
chr1,208047497,208047735,SRX5716470,SMARCA4,238
chr1,208047518,208047741,SRX5716468,SMARCA2,223
chr1,208047563,208047799,SRX5075176,SMARCA4,236
chr1,208058309,208058489,SRX5075169,SMARCA4,180
chr1,208065904,208066129,SRX5075170,SMARCA4,225
chr1,208065935,208066215,SRX5075176,SMARCA4,280
chr1,208068310,208068846,SRX5075168,SMARCA4,536
chr1,208068335,208068821,SRX5075174,SMARCA4,486
chr1,208068395,208068788,SRX20140868,INTS10,393
chr1,208068429,208068752,SRX20140895,INTS13,323
chr1,208068431,208068777,SRX5716463,SMARCA4,346
chr1,208068435,208068653,SRX5716464,SMARCA4,218
chr1,208071606,208071903,SRX5075174,SMARCA4,297
chr1,208071633,208071928,SRX5075175,SMARCA4,295
chr1,208071647,208071993,SRX5075176,SMARCA4,346
chr1,208071669,208072045,SRX5075170,SMARCA4,376
chr1,208071683,208071940,SRX5054309,FOSL2,257
chr1,208071689,208071869,SRX5075169,SMARCA4,180
chr1,208082007,208082431,SRX16500061,CTCF,424
chr1,208082051,208082266,SRX20140867,INTS10,215
chr1,208082069,208082509,SRX16500060,CTCF,440
chr1,208082073,208082384,SRX16500062,CTCF,311
chr1,208082087,208082496,SRX16500059,CTCF,409
chr1,208090325,208090696,SRX5075176,SMARCA4,371
chr1,208090379,208090721,SRX5075170,SMARCA4,342
chr1,208090488,208090699,SRX5075175,SMARCA4,211
chr1,208093711,208094175,SRX16500060,CTCF,464
chr1,208093722,208094163,SRX16500059,CTCF,441
chr1,208093749,208094164,SRX16500062,CTCF,415
chr1,208093782,208094108,SRX16500061,CTCF,326
chr1,208093815,208094078,SRX4174629,CTCF,263
chr1,208093862,208094098,SRX5075174,SMARCA4,236
chr1,208094326,208094656,SRX5075174,SMARCA4,330
chr1,208094415,208094642,SRX5075168,SMARCA4,227
chr1,208102147,208102408,SRX5075170,SMARCA4,261
chr1,208102221,208102435,SRX5075176,SMARCA4,214
chr1,208103649,208103963,SRX5075170,SMARCA4,314
chr1,208103729,208104003,SRX5075176,SMARCA4,274
chr1,208107914,208108085,SRX5075170,SMARCA4,171
chr1,208107938,208108202,SRX5054309,FOSL2,264
chr1,208107955,208108153,SRX5075176,SMARCA4,198
chr1,208111843,208112337,SRX20140881,CPSF3L,494
chr1,208111945,208112127,SRX5075174,SMARCA4,182
chr1,208120087,208120275,SRX5075169,SMARCA4,188
chr1,208127982,208128219,SRX5075170,SMARCA4,237
chr1,208132088,208132607,SRX16500061,CTCF,519
chr1,208132089,208132588,SRX16500059,CTCF,499
chr1,208132128,208132604,SRX16500060,CTCF,476
chr1,208132145,208132562,SRX16500062,CTCF,417
chr1,208132276,208132487,SRX5075174,SMARCA4,211
chr1,208137242,208137476,SRX5075169,SMARCA4,234
chr1,208137364,208137652,SRX5075170,SMARCA4,288
chr1,208142729,208143306,SRX5075170,SMARCA4,577
chr1,208142978,208143258,SRX5075169,SMARCA4,280
chr1,208143006,208143274,SRX5075176,SMARCA4,268
chr1,208143014,208143225,SRX5716470,SMARCA4,211
chr1,208149744,208150052,SRX5075170,SMARCA4,308
chr1,208149800,208150008,SRX5075175,SMARCA4,208
chr1,208149817,208150096,SRX5075176,SMARCA4,279
chr1,208159877,208160208,SRX5075176,SMARCA4,331
chr1,208159893,208160172,SRX5075169,SMARCA4,279
chr1,208159910,208160246,SRX5075170,SMARCA4,336
chr1,208159924,208160137,SRX5716469,SMARCA4,213
chr1,208159944,208160184,SRX5075175,SMARCA4,240
chr1,208159945,208160162,SRX5716468,SMARCA2,217
chr1,208161119,208161296,SRX5075174,SMARCA4,177
chr1,208185289,208185561,SRX5075176,SMARCA4,272
chr1,208185298,208185654,SRX5075169,SMARCA4,356
chr1,208185358,208185573,SRX5075175,SMARCA4,215
chr1,208185377,208185657,SRX5716470,SMARCA4,280
chr1,208185380,208185652,SRX5075170,SMARCA4,272
chr1,208185416,208185599,SRX5054309,FOSL2,183
chr1,208198079,208198635,SRX5075168,SMARCA4,556
chr1,208198175,208198739,SRX5075174,SMARCA4,564
chr1,208198193,208198576,SRX20140867,INTS10,383
chr1,208198205,208198806,SRX20140895,INTS13,601
chr1,208198253,208198609,SRX20140868,INTS10,356
chr1,208198272,208198592,SRX5716454,SOX3,320
chr1,208198304,208198527,SRX5716463,SMARCA4,223
chr1,208198328,208198636,SRX5716451,SOX2,308
chr1,208201168,208201632,SRX5075169,SMARCA4,464
chr1,208201203,208201675,SRX5075170,SMARCA4,472
chr1,208201216,208201658,SRX5075175,SMARCA4,442
chr1,208201232,208201688,SRX5075176,SMARCA4,456
chr1,208201250,208201563,SRX5716469,SMARCA4,313
chr1,208201286,208201666,SRX5054309,FOSL2,380
chr1,208201287,208201595,SRX5054308,FOSL2,308
chr1,208201296,208201546,SRX5075174,SMARCA4,250
chr1,208201300,208201623,SRX5075168,SMARCA4,323
chr1,208201341,208201556,SRX5716467,SMARCA2,215
chr1,208203138,208203462,SRX5075170,SMARCA4,324
chr1,208203288,208203632,SRX5075169,SMARCA4,344
chr1,208203390,208203631,SRX5075176,SMARCA4,241
chr1,208207501,208207857,SRX5075169,SMARCA4,356
chr1,208207513,208207804,SRX5075175,SMARCA4,291
chr1,208207564,208207879,SRX5054309,FOSL2,315
chr1,208207573,208207838,SRX5075174,SMARCA4,265
chr1,208207626,208207972,SRX5075168,SMARCA4,346
chr1,208211921,208212262,SRX5075170,SMARCA4,341
chr1,208211978,208212382,SRX5075176,SMARCA4,404
chr1,208211999,208212233,SRX5075175,SMARCA4,234
chr1,208219587,208220076,SRX5075176,SMARCA4,489
chr1,208219626,208219967,SRX5075175,SMARCA4,341
chr1,208219658,208219963,SRX5054308,FOSL2,305
chr1,208219666,208219991,SRX5716469,SMARCA4,325
chr1,208219667,208220131,SRX5075170,SMARCA4,464
chr1,208219688,208219905,SRX5054309,FOSL2,217
chr1,208219691,208219919,SRX5075169,SMARCA4,228
chr1,208219745,208220047,SRX5716467,SMARCA2,302
chr1,208219774,208220086,SRX5716470,SMARCA4,312
chr1,208226595,208226911,SRX20140879,CPSF3L,316
chr1,208231835,208232119,SRX5054309,FOSL2,284
chr1,208231862,208232297,SRX5075170,SMARCA4,435
chr1,208231864,208232316,SRX5075175,SMARCA4,452
chr1,208231874,208232232,SRX5075169,SMARCA4,358
chr1,208231886,208232289,SRX5075176,SMARCA4,403
chr1,208231894,208232125,SRX5054308,FOSL2,231
chr1,208233551,208233901,SRX20140895,INTS13,350
chr1,208233576,208233754,SRX5075170,SMARCA4,178
chr1,208233592,208233871,SRX5075168,SMARCA4,279
chr1,208233606,208233921,SRX5075174,SMARCA4,315
chr1,208233625,208233870,SRX5716463,SMARCA4,245
chr1,208236028,208236264,SRX5075169,SMARCA4,236
chr1,208236059,208236281,SRX5075176,SMARCA4,222
chr1,208238944,208239412,SRX16500060,CTCF,468
chr1,208238946,208239461,SRX16500059,CTCF,515
chr1,208238976,208239409,SRX16500061,CTCF,433
chr1,208238994,208239383,SRX16500062,CTCF,389
chr1,208239053,208239395,SRX4174629,CTCF,342
chr1,208244152,208244564,SRX5075170,SMARCA4,412
chr1,208244189,208244584,SRX5075174,SMARCA4,395
chr1,208244220,208244457,SRX5075175,SMARCA4,237
chr1,208244250,208244556,SRX5075168,SMARCA4,306
chr1,208245187,208245595,SRX4174629,CTCF,408
chr1,208245188,208245665,SRX16500061,CTCF,477
chr1,208245192,208245673,SRX16500059,CTCF,481
chr1,208245203,208245734,SRX16500060,CTCF,531
chr1,208245222,208245540,SRX5075174,SMARCA4,318
chr1,208245236,208245680,SRX16500062,CTCF,444
chr1,208245256,208245560,SRX5075168,SMARCA4,304
chr1,208245260,208245512,SRX5075170,SMARCA4,252
chr1,208245273,208245525,SRX5075176,SMARCA4,252
chr1,208252366,208252612,SRX16500060,CTCF,246
chr1,208267794,208268171,SRX5075174,SMARCA4,377
chr1,208267875,208268116,SRX5075168,SMARCA4,241
chr1,208270816,208271056,SRX5075176,SMARCA4,240
chr1,208335483,208335739,SRX20140895,INTS13,256
chr1,208336070,208336555,SRX5075174,SMARCA4,485
chr1,208336119,208336497,SRX20140895,INTS13,378
chr1,208336130,208336634,SRX5075168,SMARCA4,504
chr1,208349739,208350002,SRX5075174,SMARCA4,263
chr1,208374726,208374963,SRX5716469,SMARCA4,237
chr1,208374733,208374960,SRX20140867,INTS10,227
chr1,208374745,208374928,SRX5054309,FOSL2,183
chr1,208374769,208374981,SRX5075176,SMARCA4,212
chr1,208374775,208374977,SRX5075170,SMARCA4,202
chr1,208431824,208432046,SRX5054309,FOSL2,222
chr1,208433113,208433347,SRX5075174,SMARCA4,234
chr1,208455868,208456213,SRX5054309,FOSL2,345
chr1,208455905,208456192,SRX5075174,SMARCA4,287
chr1,208455906,208456160,SRX5075168,SMARCA4,254
chr1,208455908,208456152,SRX5075176,SMARCA4,244
chr1,208455915,208456193,SRX5075169,SMARCA4,278
chr1,208455937,208456187,SRX5075175,SMARCA4,250
chr1,208455978,208456193,SRX5054308,FOSL2,215
chr1,208461678,208461917,SRX16500061,CTCF,239
chr1,208461740,208462031,SRX16500062,CTCF,291
chr1,208461792,208462049,SRX16500060,CTCF,257
chr1,208475524,208475797,SRX5075176,SMARCA4,273
chr1,208475531,208475819,SRX5054309,FOSL2,288
chr1,208475532,208475788,SRX5054308,FOSL2,256
chr1,208475534,208475762,SRX5075170,SMARCA4,228
chr1,208475540,208475779,SRX5075169,SMARCA4,239
chr1,208475580,208475778,SRX5075174,SMARCA4,198
chr1,208476223,208476600,SRX16500059,CTCF,377
chr1,208476233,208476612,SRX16500060,CTCF,379
chr1,208476247,208476614,SRX16500061,CTCF,367
chr1,208476258,208476608,SRX5716470,SMARCA4,350
chr1,208476258,208476629,SRX5716464,SMARCA4,371
chr1,208476277,208476578,SRX5075168,SMARCA4,301
chr1,208476284,208476579,SRX5075174,SMARCA4,295
chr1,208476289,208476612,SRX5075176,SMARCA4,323
chr1,208476298,208476662,SRX5716463,SMARCA4,364
chr1,208476304,208476602,SRX16500062,CTCF,298
chr1,208476336,208476621,SRX5075170,SMARCA4,285
chr1,208476375,208476580,SRX5075169,SMARCA4,205
chr1,208510233,208510473,SRX5054309,FOSL2,240
chr1,208537327,208537655,SRX5075174,SMARCA4,328
chr1,208537360,208537715,SRX20140895,INTS13,355
chr1,208537364,208537675,SRX5075168,SMARCA4,311
chr1,208537387,208537788,SRX20140867,INTS10,401
chr1,208553009,208553269,SRX5054309,FOSL2,260
chr1,208581277,208581534,SRX5075176,SMARCA4,257
chr1,208581351,208581569,SRX5075169,SMARCA4,218
chr1,208581381,208581596,SRX5075170,SMARCA4,215
chr1,208595792,208596045,SRX5054308,FOSL2,253
chr1,208595800,208596122,SRX5054309,FOSL2,322
chr1,208595808,208596028,SRX5075176,SMARCA4,220
chr1,208595816,208596032,SRX5075175,SMARCA4,216
chr1,208595862,208596094,SRX5075170,SMARCA4,232
chr1,208600948,208601154,SRX5075174,SMARCA4,206
chr1,208601008,208601195,SRX5075168,SMARCA4,187
chr1,208601517,208601921,SRX5075174,SMARCA4,404
chr1,208601615,208601992,SRX5075168,SMARCA4,377
chr1,208601652,208601890,SRX5075170,SMARCA4,238
chr1,208601734,208601927,SRX5075176,SMARCA4,193
chr1,208604416,208604643,SRX5075175,SMARCA4,227
chr1,208604469,208604640,SRX5075170,SMARCA4,171
chr1,208606995,208607504,SRX5075174,SMARCA4,509
chr1,208607003,208607400,SRX5075168,SMARCA4,397
chr1,208607014,208607340,SRX5716463,SMARCA4,326
chr1,208607052,208607268,SRX5716451,SOX2,216
chr1,208607067,208607348,SRX5716454,SOX3,281
chr1,208652206,208652452,SRX5716469,SMARCA4,246
chr1,208652230,208652564,SRX5716470,SMARCA4,334
chr1,208652230,208652584,SRX5075169,SMARCA4,354
chr1,208652233,208652722,SRX16500059,CTCF,489
chr1,208652250,208652594,SRX5075170,SMARCA4,344
chr1,208652251,208652688,SRX5075176,SMARCA4,437
chr1,208652255,208652769,SRX16500061,CTCF,514
chr1,208652257,208652453,SRX5054308,FOSL2,196
chr1,208652258,208652511,SRX5716464,SMARCA4,253
chr1,208652271,208652680,SRX5075174,SMARCA4,409
chr1,208652274,208652509,SRX5020211,SMARCA2,235
chr1,208652274,208652784,SRX16500060,CTCF,510
chr1,208652287,208652711,SRX16500062,CTCF,424
chr1,208652301,208652634,SRX5075168,SMARCA4,333
chr1,208652315,208652536,SRX5054309,FOSL2,221
chr1,208652351,208652651,SRX4174629,CTCF,300
chr1,208653607,208653831,SRX5054309,FOSL2,224
chr1,208654226,208654591,SRX16500060,CTCF,365
chr1,208654242,208654582,SRX16500061,CTCF,340
chr1,208654281,208654603,SRX16500059,CTCF,322
chr1,208654303,208654591,SRX16500062,CTCF,288
chr1,208669075,208669337,SRX5075170,SMARCA4,262
chr1,208682008,208682428,SRX5054309,FOSL2,420
chr1,208682155,208682511,SRX5075176,SMARCA4,356
chr1,208682172,208682506,SRX5075169,SMARCA4,334
chr1,208682209,208682498,SRX5075170,SMARCA4,289
chr1,208682260,208682509,SRX5075175,SMARCA4,249
chr1,208682304,208682520,SRX5716467,SMARCA2,216
chr1,208732397,208732993,SRX5075174,SMARCA4,596
chr1,208732585,208732898,SRX5075168,SMARCA4,313
chr1,208732599,208732803,SRX5716463,SMARCA4,204
chr1,208732605,208732826,SRX5716464,SMARCA4,221
chr1,208757835,208758123,SRX5075169,SMARCA4,288
chr1,208757898,208758091,SRX5075170,SMARCA4,193
chr1,208772993,208773266,SRX5075170,SMARCA4,273
chr1,208781674,208782059,SRX5075174,SMARCA4,385
chr1,208781700,208781998,SRX5075168,SMARCA4,298
chr1,208791555,208791808,SRX5075169,SMARCA4,253
chr1,208811775,208811959,SRX5075168,SMARCA4,184
chr1,208811827,208812083,SRX5054309,FOSL2,256
chr1,208834329,208834792,SRX5075174,SMARCA4,463
chr1,208834389,208834635,SRX5075170,SMARCA4,246
chr1,208834408,208834615,SRX5075168,SMARCA4,207
chr1,208834432,208834640,SRX5075176,SMARCA4,208
chr1,208834780,208834955,SRX5075176,SMARCA4,175
chr1,208834939,208835425,SRX5075168,SMARCA4,486
chr1,208835049,208835288,SRX5716463,SMARCA4,239
chr1,208835082,208835412,SRX20140895,INTS13,330
chr1,208835160,208835426,SRX5075174,SMARCA4,266
chr1,208848828,208849011,SRX5075176,SMARCA4,183
chr1,208848841,208849065,SRX5075169,SMARCA4,224
chr1,208853041,208853224,SRX5075176,SMARCA4,183
chr1,208868561,208868904,SRX5054309,FOSL2,343
chr1,208880351,208880853,SRX5075176,SMARCA4,502
chr1,208880416,208880813,SRX5716469,SMARCA4,397
chr1,208880430,208880839,SRX5075175,SMARCA4,409
chr1,208880439,208880796,SRX5020214,SMARCA2,357
chr1,208880439,208880866,SRX5075169,SMARCA4,427
chr1,208880442,208880823,SRX5075170,SMARCA4,381
chr1,208880448,208880694,SRX5054308,FOSL2,246
chr1,208880450,208880764,SRX5054309,FOSL2,314
chr1,208880463,208880745,SRX5716467,SMARCA2,282
chr1,208880465,208880743,SRX5075181,SMARCA2,278
chr1,208880482,208880840,SRX5716470,SMARCA4,358
chr1,208880489,208880821,SRX5020211,SMARCA2,332
chr1,208880531,208880809,SRX5716468,SMARCA2,278
chr1,208919416,208919596,SRX5054308,FOSL2,180
chr1,208919454,208919665,SRX5054309,FOSL2,211
chr1,208924017,208924283,SRX5075170,SMARCA4,266
chr1,208924033,208924619,SRX5716470,SMARCA4,586
chr1,208924254,208924500,SRX5716469,SMARCA4,246
chr1,208929600,208930023,SRX5075176,SMARCA4,423
chr1,208929611,208929916,SRX5054308,FOSL2,305
chr1,208929634,208930002,SRX5075170,SMARCA4,368
chr1,208929654,208929943,SRX5075169,SMARCA4,289
chr1,208929654,208929951,SRX5054309,FOSL2,297
chr1,208929676,208929913,SRX5075175,SMARCA4,237
chr1,208942503,208942687,SRX5054308,FOSL2,184
chr1,208942509,208942705,SRX5054309,FOSL2,196
chr1,208945071,208945322,SRX5075169,SMARCA4,251
chr1,208962909,208963170,SRX5075176,SMARCA4,261
chr1,208962919,208963141,SRX5075175,SMARCA4,222
chr1,208962958,208963174,SRX5075170,SMARCA4,216
chr1,208965477,208965688,SRX5054309,FOSL2,211
chr1,208971146,208971315,SRX5075170,SMARCA4,169
chr1,208988677,208989093,SRX5716470,SMARCA4,416
chr1,208988718,208988984,SRX5075169,SMARCA4,266
chr1,208988731,208989031,SRX5075175,SMARCA4,300
chr1,208988762,208988974,SRX5716469,SMARCA4,212
chr1,208988793,208989172,SRX5075176,SMARCA4,379
chr1,208988870,208989148,SRX5075170,SMARCA4,278
chr1,208997932,208998189,SRX16500061,CTCF,257
chr1,208997984,208998274,SRX16500060,CTCF,290
chr1,209001390,209001693,SRX5075176,SMARCA4,303
chr1,209001444,209001765,SRX5075170,SMARCA4,321
chr1,209039287,209039905,SRX5075176,SMARCA4,618
chr1,209039301,209039910,SRX5075170,SMARCA4,609
chr1,209039305,209039749,SRX5075175,SMARCA4,444
chr1,209039312,209039890,SRX5075169,SMARCA4,578
chr1,209039325,209039727,SRX5054309,FOSL2,402
chr1,209039331,209039560,SRX5716469,SMARCA4,229
chr1,209039372,209039735,SRX5054308,FOSL2,363
chr1,209039643,209039944,SRX5716470,SMARCA4,301
chr1,209048990,209049324,SRX5075175,SMARCA4,334
chr1,209049032,209049244,SRX5716469,SMARCA4,212
chr1,209049046,209049261,SRX5075176,SMARCA4,215
chr1,209049047,209049296,SRX5020214,SMARCA2,249
chr1,209049117,209049363,SRX5075169,SMARCA4,246
chr1,209049175,209049386,SRX5716470,SMARCA4,211
chr1,209051581,209051798,SRX5075168,SMARCA4,217
chr1,209080454,209080677,SRX5075170,SMARCA4,223
chr1,209080506,209080689,SRX5075176,SMARCA4,183
chr1,209080558,209080738,SRX5075169,SMARCA4,180
chr1,209096046,209096528,SRX5075175,SMARCA4,482
chr1,209096055,209096420,SRX5716470,SMARCA4,365
chr1,209096057,209096474,SRX5075170,SMARCA4,417
chr1,209096074,209096469,SRX5716469,SMARCA4,395
chr1,209096082,209096488,SRX5075176,SMARCA4,406
chr1,209096120,209096443,SRX5054309,FOSL2,323
chr1,209096129,209096480,SRX5716460,Epitope tags,351
chr1,209096139,209096583,SRX5075169,SMARCA4,444
chr1,209096179,209096464,SRX5054308,FOSL2,285
chr1,209096254,209096564,SRX5716467,SMARCA2,310
chr1,209106168,209106611,SRX5075175,SMARCA4,443
chr1,209106269,209106676,SRX5075169,SMARCA4,407
chr1,209106308,209106861,SRX5075176,SMARCA4,553
chr1,209106411,209106795,SRX5075170,SMARCA4,384
chr1,209150142,209150473,SRX5075168,SMARCA4,331
chr1,209150149,209150496,SRX5075176,SMARCA4,347
chr1,209150160,209150477,SRX5075174,SMARCA4,317
chr1,209150168,209150378,SRX5716463,SMARCA4,210
chr1,209150171,209150496,SRX5716470,SMARCA4,325
chr1,209150182,209150484,SRX5075175,SMARCA4,302
chr1,209150187,209150445,SRX5075170,SMARCA4,258
chr1,209150190,209150486,SRX5075169,SMARCA4,296
chr1,209150252,209150516,SRX5716469,SMARCA4,264
chr1,209155508,209155857,SRX5075168,SMARCA4,349
chr1,209155570,209156027,SRX5075174,SMARCA4,457
chr1,209190582,209191015,SRX16500062,CTCF,433
chr1,209190593,209191062,SRX16500059,CTCF,469
chr1,209190600,209190946,SRX4174629,CTCF,346
chr1,209190616,209191030,SRX5075174,SMARCA4,414
chr1,209190628,209191038,SRX16500060,CTCF,410
chr1,209190645,209191014,SRX16500061,CTCF,369
chr1,209190654,209190858,SRX5075170,SMARCA4,204
chr1,209190676,209191003,SRX5075168,SMARCA4,327
chr1,209202790,209203312,SRX16500059,CTCF,522
chr1,209202809,209203210,SRX16500061,CTCF,401
chr1,209202814,209203257,SRX16500060,CTCF,443
chr1,209202855,209203274,SRX16500062,CTCF,419
chr1,209202882,209203106,SRX5075168,SMARCA4,224
chr1,209207634,209208036,SRX16500059,CTCF,402
chr1,209207637,209207978,SRX4174629,CTCF,341
chr1,209207640,209208116,SRX16500060,CTCF,476
chr1,209207646,209208018,SRX5075176,SMARCA4,372
chr1,209207649,209208025,SRX5075174,SMARCA4,376
chr1,209207654,209208036,SRX5716470,SMARCA4,382
chr1,209207667,209208036,SRX5075170,SMARCA4,369
chr1,209207675,209208117,SRX5075168,SMARCA4,442
chr1,209207680,209207904,SRX5075175,SMARCA4,224
chr1,209207684,209208107,SRX16500062,CTCF,423
chr1,209207686,209208207,SRX16500061,CTCF,521
chr1,209207704,209207968,SRX5716469,SMARCA4,264
chr1,209207717,209207916,SRX5054309,FOSL2,199
chr1,209207719,209208022,SRX5075169,SMARCA4,303
chr1,209207747,209207987,SRX5716463,SMARCA4,240
chr1,209207815,209207995,SRX5054308,FOSL2,180
chr1,209246804,209246995,SRX5075175,SMARCA4,191
chr1,209246828,209247172,SRX5054309,FOSL2,344
chr1,209246831,209247065,SRX5075169,SMARCA4,234
chr1,209246848,209247027,SRX5075170,SMARCA4,179
chr1,209246851,209247026,SRX5075176,SMARCA4,175
chr1,209248574,209249111,SRX16500060,CTCF,537
chr1,209248588,209249193,SRX16500059,CTCF,605
chr1,209248618,209249173,SRX16500062,CTCF,555
chr1,209248633,209249095,SRX16500061,CTCF,462
chr1,209248681,209248973,SRX5075174,SMARCA4,292
chr1,209248686,209248992,SRX5716463,SMARCA4,306
chr1,209248724,209248988,SRX5716470,SMARCA4,264
chr1,209248736,209249003,SRX5075168,SMARCA4,267
chr1,209248754,209248929,SRX5075176,SMARCA4,175
chr1,209248879,209249132,SRX4174629,CTCF,253
chr1,209291735,209292091,SRX5075170,SMARCA4,356
chr1,209291769,209292152,SRX5075175,SMARCA4,383
chr1,209291790,209292072,SRX5716470,SMARCA4,282
chr1,209291793,209292143,SRX5075169,SMARCA4,350
chr1,209291808,209292101,SRX5716469,SMARCA4,293
chr1,209291819,209292157,SRX5075176,SMARCA4,338
chr1,209291855,209292099,SRX5716467,SMARCA2,244
chr1,209291857,209292181,SRX5054308,FOSL2,324
chr1,209291933,209292169,SRX5054309,FOSL2,236
chr1,209291947,209292159,SRX5020214,SMARCA2,212
chr1,209302868,209303631,SRX5075176,SMARCA4,763
chr1,209302961,209303642,SRX5075170,SMARCA4,681
chr1,209302975,209303296,SRX5075175,SMARCA4,321
chr1,209303110,209303451,SRX5020211,SMARCA2,341
chr1,209303133,209303379,SRX5716468,SMARCA2,246
chr1,209303150,209303399,SRX5075169,SMARCA4,249
chr1,209303341,209303562,SRX5054308,FOSL2,221
chr1,209318902,209319106,SRX5075169,SMARCA4,204
chr1,209334873,209335484,SRX16500060,CTCF,611
chr1,209334936,209335520,SRX16500059,CTCF,584
chr1,209334996,209335510,SRX16500062,CTCF,514
chr1,209335055,209335479,SRX16500061,CTCF,424
chr1,209335113,209335369,SRX5075174,SMARCA4,256
chr1,209335121,209335388,SRX5075168,SMARCA4,267
chr1,209349376,209349726,SRX5075176,SMARCA4,350
chr1,209349389,209349828,SRX5075169,SMARCA4,439
chr1,209349396,209349681,SRX5075170,SMARCA4,285
chr1,209349424,209349702,SRX5054309,FOSL2,278
chr1,209349425,209349718,SRX5075175,SMARCA4,293
chr1,209349437,209349701,SRX5075174,SMARCA4,264
chr1,209349458,209349717,SRX5075168,SMARCA4,259
chr1,209349461,209349699,SRX5054308,FOSL2,238
chr1,209349490,209349704,SRX5716470,SMARCA4,214
chr1,209350125,209350312,SRX5075170,SMARCA4,187
chr1,209354219,209354763,SRX16500059,CTCF,544
chr1,209354235,209354689,SRX16500060,CTCF,454
chr1,209354285,209354727,SRX16500062,CTCF,442
chr1,209354286,209354733,SRX16500061,CTCF,447
chr1,209354339,209354660,SRX5075168,SMARCA4,321
chr1,209354341,209354687,SRX4174629,CTCF,346
chr1,209354363,209354624,SRX5075174,SMARCA4,261
chr1,209354388,209354616,SRX5075170,SMARCA4,228
chr1,209369020,209369641,SRX5075176,SMARCA4,621
chr1,209369058,209369628,SRX5075170,SMARCA4,570
chr1,209369096,209369549,SRX5054309,FOSL2,453
chr1,209369113,209369638,SRX5075169,SMARCA4,525
chr1,209369131,209369596,SRX5075175,SMARCA4,465
chr1,209369138,209369504,SRX5020211,SMARCA2,366
chr1,209369143,209369600,SRX5716470,SMARCA4,457
chr1,209369149,209369565,SRX5054308,FOSL2,416
chr1,209369155,209369512,SRX5716469,SMARCA4,357
chr1,209369170,209369621,SRX5716467,SMARCA2,451
chr1,209369192,209369498,SRX5020214,SMARCA2,306
chr1,209369214,209369585,SRX5716468,SMARCA2,371
chr1,209369230,209369491,SRX5075181,SMARCA2,261
chr1,209375622,209376070,SRX5075174,SMARCA4,448
chr1,209375665,209376126,SRX5716470,SMARCA4,461
chr1,209375692,209376225,SRX5075169,SMARCA4,533
chr1,209375716,209376091,SRX5075168,SMARCA4,375
chr1,209375733,209375948,SRX5716467,SMARCA2,215
chr1,209375733,209375981,SRX5075170,SMARCA4,248
chr1,209375746,209376109,SRX5075175,SMARCA4,363
chr1,209375753,209375953,SRX5075176,SMARCA4,200
chr1,209375936,209376266,SRX5054309,FOSL2,330
chr1,209376035,209376239,SRX5054308,FOSL2,204
chr1,209382249,209382556,SRX5075176,SMARCA4,307
chr1,209382252,209382572,SRX5075170,SMARCA4,320
chr1,209389196,209389588,SRX5075176,SMARCA4,392
chr1,209389206,209389608,SRX5075170,SMARCA4,402
chr1,209389209,209389477,SRX5075169,SMARCA4,268
chr1,209389245,209389611,SRX5054309,FOSL2,366
chr1,209389260,209389552,SRX5054308,FOSL2,292
chr1,209389273,209389625,SRX5075175,SMARCA4,352
chr1,209389299,209389594,SRX5075174,SMARCA4,295
chr1,209389312,209389593,SRX5716469,SMARCA4,281
chr1,209389350,209389562,SRX5075168,SMARCA4,212
chr1,209398576,209398982,SRX5075176,SMARCA4,406
chr1,209398634,209398855,SRX5716470,SMARCA4,221
chr1,209398637,209399022,SRX5075170,SMARCA4,385
chr1,209398705,209398903,SRX5075175,SMARCA4,198
chr1,209398714,209398906,SRX5075169,SMARCA4,192
chr1,209404546,209404894,SRX5075168,SMARCA4,348
chr1,209404656,209404927,SRX5075174,SMARCA4,271
chr1,209405218,209405436,SRX5054309,FOSL2,218
chr1,209405261,209405505,SRX5075175,SMARCA4,244
chr1,209405335,209405638,SRX5075170,SMARCA4,303
chr1,209405371,209405640,SRX5075176,SMARCA4,269
chr1,209409847,209410154,SRX5054309,FOSL2,307
chr1,209411725,209411968,SRX5075170,SMARCA4,243
chr1,209411749,209411951,SRX5075176,SMARCA4,202
chr1,209411822,209412050,SRX5075175,SMARCA4,228
chr1,209435621,209436093,SRX16500059,CTCF,472
chr1,209435631,209436113,SRX16500060,CTCF,482
chr1,209435659,209436054,SRX16500062,CTCF,395
chr1,209435670,209435990,SRX5075170,SMARCA4,320
chr1,209435691,209436139,SRX16500061,CTCF,448
chr1,209435706,209435932,SRX5075176,SMARCA4,226
chr1,209435744,209435990,SRX5075168,SMARCA4,246
chr1,209435749,209435981,SRX4174629,CTCF,232
chr1,209435749,209435997,SRX5075174,SMARCA4,248
chr1,209455698,209455982,SRX5075174,SMARCA4,284
chr1,209455730,209456009,SRX5075168,SMARCA4,279
chr1,209455758,209456019,SRX20140895,INTS13,261
chr1,209455795,209455992,SRX5075176,SMARCA4,197
chr1,209456930,209457171,SRX5054308,FOSL2,241
chr1,209456931,209457152,SRX5054309,FOSL2,221
chr1,209456975,209457174,SRX5075175,SMARCA4,199
chr1,209489982,209490334,SRX16500060,CTCF,352
chr1,209490028,209490320,SRX16500061,CTCF,292
chr1,209490032,209490288,SRX16500062,CTCF,256
chr1,209493624,209493873,SRX5716470,SMARCA4,249
chr1,209493637,209493838,SRX5075176,SMARCA4,201
chr1,209493638,209493906,SRX5075170,SMARCA4,268
chr1,209513268,209513735,SRX16500060,CTCF,467
chr1,209513280,209513715,SRX16500061,CTCF,435
chr1,209513324,209513706,SRX16500059,CTCF,382
chr1,209513337,209513678,SRX16500062,CTCF,341
chr1,209544164,209544439,SRX5075168,SMARCA4,275
chr1,209544167,209544452,SRX5075174,SMARCA4,285
chr1,209544176,209544404,SRX5716463,SMARCA4,228
chr1,209546716,209546934,SRX5075176,SMARCA4,218
chr1,209549562,209549997,SRX16500060,CTCF,435
chr1,209549585,209550007,SRX16500061,CTCF,422
chr1,209549587,209549936,SRX16500062,CTCF,349
chr1,209549599,209549994,SRX16500059,CTCF,395
chr1,209556199,209556653,SRX5075174,SMARCA4,454
chr1,209556201,209556630,SRX5075168,SMARCA4,429
chr1,209556213,209556569,SRX5716463,SMARCA4,356
chr1,209556234,209556553,SRX5716470,SMARCA4,319
chr1,209556243,209556531,SRX5075175,SMARCA4,288
chr1,209556294,209556486,SRX5075169,SMARCA4,192
chr1,209556297,209556558,SRX5716464,SMARCA4,261
chr1,209566055,209566380,SRX5075168,SMARCA4,325
chr1,209566061,209566465,SRX16500060,CTCF,404
chr1,209566064,209566414,SRX16500061,CTCF,350
chr1,209566067,209566435,SRX16500062,CTCF,368
chr1,209566067,209566468,SRX16500059,CTCF,401
chr1,209566103,209566379,SRX5075174,SMARCA4,276
chr1,209566125,209566330,SRX5075170,SMARCA4,205
chr1,209566155,209566446,SRX4174629,CTCF,291
chr1,209567761,209568085,SRX5054309,FOSL2,324
chr1,209567791,209568175,SRX5075176,SMARCA4,384
chr1,209567800,209568011,SRX5716470,SMARCA4,211
chr1,209567810,209568149,SRX5075170,SMARCA4,339
chr1,209567847,209568118,SRX5054308,FOSL2,271
chr1,209567886,209568157,SRX5020214,SMARCA2,271
chr1,209569360,209569807,SRX16500061,CTCF,447
chr1,209569366,209569801,SRX16500062,CTCF,435
chr1,209569388,209569845,SRX16500059,CTCF,457
chr1,209569403,209569842,SRX16500060,CTCF,439
chr1,209569517,209569795,SRX4174629,CTCF,278
chr1,209569530,209569709,SRX5075168,SMARCA4,179
chr1,209569569,209569809,SRX5075174,SMARCA4,240
chr1,209575142,209575346,SRX5716463,SMARCA4,204
chr1,209575201,209575449,SRX5075174,SMARCA4,248
chr1,209576510,209577133,SRX16500060,CTCF,623
chr1,209576569,209577127,SRX16500061,CTCF,558
chr1,209576596,209577157,SRX16500062,CTCF,561
chr1,209576610,209577133,SRX16500059,CTCF,523
chr1,209576688,209577147,SRX4174629,CTCF,459
chr1,209576764,209577047,SRX5075174,SMARCA4,283
chr1,209576794,209577044,SRX5075169,SMARCA4,250
chr1,209576800,209577044,SRX5075170,SMARCA4,244
chr1,209576818,209577050,SRX5716469,SMARCA4,232
chr1,209576819,209576994,SRX5075176,SMARCA4,175
chr1,209576820,209577084,SRX5075168,SMARCA4,264
chr1,209576899,209577106,SRX5075175,SMARCA4,207
chr1,209580446,209580741,SRX5054309,FOSL2,295
chr1,209583434,209583839,SRX5075174,SMARCA4,405
chr1,209583474,209583805,SRX5075168,SMARCA4,331
chr1,209585730,209585903,SRX5075174,SMARCA4,173
chr1,209585755,209585998,SRX5075176,SMARCA4,243
chr1,209590505,209590831,SRX16500060,CTCF,326
chr1,209590526,209590761,SRX16500059,CTCF,235
chr1,209590545,209590893,SRX16500062,CTCF,348
chr1,209597522,209597727,SRX5054308,FOSL2,205
chr1,209597523,209597838,SRX5075170,SMARCA4,315
chr1,209601996,209602447,SRX16500059,CTCF,451
chr1,209602018,209602481,SRX16500060,CTCF,463
chr1,209602030,209602509,SRX16500061,CTCF,479
chr1,209602085,209602416,SRX4174629,CTCF,331
chr1,209602095,209602439,SRX16500062,CTCF,344
chr1,209602223,209602405,SRX5075174,SMARCA4,182
chr1,209620615,209620891,SRX5075176,SMARCA4,276
chr1,209620630,209620948,SRX5716469,SMARCA4,318
chr1,209620690,209620956,SRX5716470,SMARCA4,266
chr1,209620694,209620913,SRX5075170,SMARCA4,219
chr1,209620725,209620918,SRX5075169,SMARCA4,193
chr1,209627532,209627836,SRX5075175,SMARCA4,304
chr1,209627549,209627871,SRX5075176,SMARCA4,322
chr1,209627567,209627949,SRX5075168,SMARCA4,382
chr1,209627568,209628190,SRX16500060,CTCF,622
chr1,209627574,209627921,SRX5075170,SMARCA4,347
chr1,209627576,209627872,SRX5075169,SMARCA4,296
chr1,209627581,209628102,SRX16500059,CTCF,521
chr1,209627583,209627861,SRX5716469,SMARCA4,278
chr1,209627590,209628118,SRX16500061,CTCF,528
chr1,209627591,209628098,SRX16500062,CTCF,507
chr1,209627602,209627911,SRX5075174,SMARCA4,309
chr1,209627628,209627929,SRX5054309,FOSL2,301
chr1,209627637,209627900,SRX5054308,FOSL2,263
chr1,209627640,209627994,SRX4174629,CTCF,354
chr1,209627669,209627915,SRX5716470,SMARCA4,246
chr1,209643264,209643589,SRX5075176,SMARCA4,325
chr1,209649143,209649660,SRX5075169,SMARCA4,517
chr1,209649162,209649575,SRX5716469,SMARCA4,413
chr1,209649189,209649622,SRX5075176,SMARCA4,433
chr1,209649194,209649689,SRX5075170,SMARCA4,495
chr1,209649202,209649638,SRX5075175,SMARCA4,436
chr1,209649206,209649469,SRX5020211,SMARCA2,263
chr1,209649228,209649610,SRX5054309,FOSL2,382
chr1,209649261,209649537,SRX5020214,SMARCA2,276
chr1,209649282,209649615,SRX5054308,FOSL2,333
chr1,209649284,209649499,SRX5716470,SMARCA4,215
chr1,209649294,209649613,SRX5716467,SMARCA2,319
chr1,209649354,209649558,SRX5075174,SMARCA4,204
chr1,209649380,209649559,SRX5075168,SMARCA4,179
chr1,209675255,209675496,SRX5075176,SMARCA4,241
chr1,209675294,209675603,SRX5075169,SMARCA4,309
chr1,209675441,209675668,SRX5716470,SMARCA4,227
chr1,209692780,209693210,SRX5075176,SMARCA4,430
chr1,209692796,209693125,SRX5054309,FOSL2,329
chr1,209692821,209693055,SRX5716469,SMARCA4,234
chr1,209692823,209693315,SRX16500061,CTCF,492
chr1,209692831,209693341,SRX16500059,CTCF,510
chr1,209692832,209693126,SRX5075169,SMARCA4,294
chr1,209692836,209693154,SRX5075170,SMARCA4,318
chr1,209692837,209693289,SRX16500062,CTCF,452
chr1,209692855,209693109,SRX5054308,FOSL2,254
chr1,209692856,209693347,SRX16500060,CTCF,491
chr1,209692857,209693139,SRX5716470,SMARCA4,282
chr1,209692867,209693233,SRX5020211,SMARCA2,366
chr1,209692875,209693229,SRX4174629,CTCF,354
chr1,209692884,209693169,SRX5075175,SMARCA4,285
chr1,209692896,209693177,SRX5075168,SMARCA4,281
chr1,209692945,209693164,SRX5075174,SMARCA4,219
chr1,209733860,209734096,SRX5075176,SMARCA4,236
chr1,209733893,209734124,SRX5054308,FOSL2,231
chr1,209733901,209734124,SRX5054309,FOSL2,223
chr1,209733916,209734150,SRX5075169,SMARCA4,234
chr1,209743043,209743239,SRX5075170,SMARCA4,196
chr1,209743126,209743385,SRX5075176,SMARCA4,259
chr1,209747499,209748168,SRX4174629,CTCF,669
chr1,209747566,209748223,SRX16500060,CTCF,657
chr1,209747598,209748232,SRX16500059,CTCF,634
chr1,209747614,209748189,SRX16500061,CTCF,575
chr1,209747642,209748223,SRX16500062,CTCF,581
chr1,209747665,209748141,SRX5075174,SMARCA4,476
chr1,209747674,209748149,SRX5075176,SMARCA4,475
chr1,209747715,209748144,SRX5075168,SMARCA4,429
chr1,209747723,209748083,SRX5716463,SMARCA4,360
chr1,209747727,209748129,SRX5075169,SMARCA4,402
chr1,209747752,209748210,SRX5075170,SMARCA4,458
chr1,209747760,209748050,SRX5054309,FOSL2,290
chr1,209747784,209748015,SRX5054308,FOSL2,231
chr1,209747791,209748111,SRX5716469,SMARCA4,320
chr1,209747792,209748126,SRX5075175,SMARCA4,334
chr1,209747797,209748010,SRX5716464,SMARCA4,213
chr1,209747822,209748011,SRX5054307,FOSL2,189
chr1,209747822,209748184,SRX5716470,SMARCA4,362
chr1,209769199,209769911,SRX5075175,SMARCA4,712
chr1,209769277,209769838,SRX5075170,SMARCA4,561
chr1,209769301,209769862,SRX5075169,SMARCA4,561
chr1,209769344,209769672,SRX5716469,SMARCA4,328
chr1,209769347,209769821,SRX5075176,SMARCA4,474
chr1,209769349,209769670,SRX5054309,FOSL2,321
chr1,209769373,209769612,SRX5716468,SMARCA2,239
chr1,209769393,209769601,SRX5054308,FOSL2,208
chr1,209769399,209769660,SRX5020211,SMARCA2,261
chr1,209769456,209769691,SRX5020214,SMARCA2,235
chr1,209769477,209769735,SRX5716467,SMARCA2,258
chr1,209770493,209771181,SRX20140895,INTS13,688
chr1,209784208,209784881,SRX5075176,SMARCA4,673
chr1,209784234,209784903,SRX20140895,INTS13,669
chr1,209784238,209784826,SRX5716470,SMARCA4,588
chr1,209784246,209784658,SRX20140868,INTS10,412
chr1,209784253,209784562,SRX20140879,CPSF3L,309
chr1,209784267,209784839,SRX5716464,SMARCA4,572
chr1,209784278,209784551,SRX5716469,SMARCA4,273
chr1,209784279,209784612,SRX20140881,CPSF3L,333
chr1,209784290,209784900,SRX5075168,SMARCA4,610
chr1,209784300,209784494,SRX5075175,SMARCA4,194
chr1,209784311,209784910,SRX5075174,SMARCA4,599
chr1,209784313,209784546,SRX5075169,SMARCA4,233
chr1,209784319,209784539,SRX5020211,SMARCA2,220
chr1,209784328,209784908,SRX5075170,SMARCA4,580
chr1,209784338,209784863,SRX20140897,INTS13,525
chr1,209784352,209784792,SRX20140867,INTS10,440
chr1,209784440,209784911,SRX20140869,INTS10,471
chr1,209784510,209784826,SRX5716463,SMARCA4,316
chr1,209784556,209784744,SRX5054309,FOSL2,188
chr1,209790425,209790655,SRX5054309,FOSL2,230
chr1,209800860,209801057,SRX5075170,SMARCA4,197
chr1,209801208,209801724,SRX5075170,SMARCA4,516
chr1,209801227,209801810,SRX5075176,SMARCA4,583
chr1,209801312,209801502,SRX5075169,SMARCA4,190
chr1,209806100,209806379,SRX5075168,SMARCA4,279
chr1,209806124,209806466,SRX5075174,SMARCA4,342
chr1,209808034,209808499,SRX5075170,SMARCA4,465
chr1,209808043,209808560,SRX5075176,SMARCA4,517
chr1,209808073,209808421,SRX5075175,SMARCA4,348
chr1,209808082,209808457,SRX5075169,SMARCA4,375
chr1,209808089,209808316,SRX5020214,SMARCA2,227
chr1,209808091,209808456,SRX5716469,SMARCA4,365
chr1,209808095,209808431,SRX5054309,FOSL2,336
chr1,209808099,209808427,SRX5054308,FOSL2,328
chr1,209808099,209808432,SRX5716467,SMARCA2,333
chr1,209808222,209808447,SRX5716470,SMARCA4,225
chr1,209823068,209823545,SRX16500059,CTCF,477
chr1,209823084,209823507,SRX16500060,CTCF,423
chr1,209823098,209823538,SRX16500061,CTCF,440
chr1,209823132,209823427,SRX5075174,SMARCA4,295
chr1,209823145,209823549,SRX16500062,CTCF,404
chr1,209823156,209823389,SRX5075168,SMARCA4,233
chr1,209823176,209823391,SRX5075169,SMARCA4,215
chr1,209823184,209823388,SRX5075170,SMARCA4,204
chr1,209823275,209823470,SRX5075176,SMARCA4,195
chr1,209827564,209828025,SRX16500060,CTCF,461
chr1,209827625,209828014,SRX16500061,CTCF,389
chr1,209827655,209828005,SRX16500059,CTCF,350
chr1,209827658,209828172,SRX5075168,SMARCA4,514
chr1,209827685,209828107,SRX20140895,INTS13,422
chr1,209827710,209828084,SRX16500062,CTCF,374
chr1,209827711,209828088,SRX5075174,SMARCA4,377
chr1,209827739,209828022,SRX5075170,SMARCA4,283
chr1,209827740,209827972,SRX5716464,SMARCA4,232
chr1,209827740,209828063,SRX5075176,SMARCA4,323
chr1,209827754,209827992,SRX5716470,SMARCA4,238
chr1,209827775,209828097,SRX5716463,SMARCA4,322
chr1,209827802,209828046,SRX20140897,INTS13,244
chr1,209836075,209836255,SRX5054308,FOSL2,180
chr1,209839832,209840551,SRX5075176,SMARCA4,719
chr1,209839837,209840456,SRX5075170,SMARCA4,619
chr1,209839841,209840293,SRX5075175,SMARCA4,452
chr1,209839859,209840372,SRX5716469,SMARCA4,513
chr1,209839861,209840433,SRX5075169,SMARCA4,572
chr1,209839867,209840311,SRX5716470,SMARCA4,444
chr1,209839880,209840345,SRX5054308,FOSL2,465
chr1,209839881,209840214,SRX5716467,SMARCA2,333
chr1,209839883,209840290,SRX5054309,FOSL2,407
chr1,209839914,209840235,SRX5075174,SMARCA4,321
chr1,209839951,209840161,SRX5020211,SMARCA2,210
chr1,209839958,209840316,SRX5075168,SMARCA4,358
chr1,209839964,209840235,SRX5020214,SMARCA2,271
chr1,209839972,209840213,SRX5075182,SMARCA2,241
chr1,209845922,209846111,SRX5075169,SMARCA4,189
chr1,209850331,209850752,SRX5075176,SMARCA4,421
chr1,209850360,209850809,SRX16500060,CTCF,449
chr1,209850380,209850773,SRX16500059,CTCF,393
chr1,209850406,209850754,SRX4174629,CTCF,348
chr1,209850434,209850809,SRX16500062,CTCF,375
chr1,209850446,209850736,SRX5075169,SMARCA4,290
chr1,209850451,209850799,SRX5075170,SMARCA4,348
chr1,209850462,209850742,SRX16500061,CTCF,280
chr1,209850487,209850683,SRX5075175,SMARCA4,196
chr1,209850508,209850713,SRX5075168,SMARCA4,205
chr1,209860205,209860678,SRX16500061,CTCF,473
chr1,209860222,209860742,SRX16500059,CTCF,520
chr1,209860230,209860720,SRX16500060,CTCF,490
chr1,209860240,209860690,SRX16500062,CTCF,450
chr1,209860358,209860655,SRX5075174,SMARCA4,297
chr1,209860362,209860654,SRX5075168,SMARCA4,292
chr1,209860365,209860694,SRX4174629,CTCF,329
chr1,209860372,209860620,SRX5075170,SMARCA4,248
chr1,209860382,209860654,SRX5075169,SMARCA4,272
chr1,209860390,209860635,SRX5075176,SMARCA4,245
chr1,209860399,209860596,SRX5075175,SMARCA4,197
chr1,209869268,209869604,SRX5075176,SMARCA4,336
chr1,209869304,209869583,SRX5075170,SMARCA4,279
chr1,209870060,209870722,SRX5075170,SMARCA4,662
chr1,209870084,209870837,SRX5075176,SMARCA4,753
chr1,209870187,209870374,SRX5075175,SMARCA4,187
chr1,209875471,209875699,SRX5075169,SMARCA4,228
chr1,209875491,209875719,SRX5716470,SMARCA4,228
chr1,209875508,209875813,SRX5075170,SMARCA4,305
chr1,209875532,209875820,SRX5075176,SMARCA4,288
chr1,209875538,209875841,SRX16500059,CTCF,303
chr1,209875556,209875821,SRX16500062,CTCF,265
chr1,209875568,209875971,SRX16500060,CTCF,403
chr1,209875600,209875888,SRX4174629,CTCF,288
chr1,209875627,209875849,SRX16500061,CTCF,222
chr1,209875670,209875843,SRX5075174,SMARCA4,173
chr1,209879678,209879967,SRX5075169,SMARCA4,289
chr1,209879733,209879952,SRX5075170,SMARCA4,219
chr1,209883425,209883633,SRX5075175,SMARCA4,208
chr1,209884288,209884522,SRX5075170,SMARCA4,234
chr1,209884301,209885115,SRX5054309,FOSL2,814
chr1,209884598,209885184,SRX5075176,SMARCA4,586
chr1,209884599,209885142,SRX5716469,SMARCA4,543
chr1,209884644,209885163,SRX5075170,SMARCA4,519
chr1,209884661,209885184,SRX5075169,SMARCA4,523
chr1,209884673,209885072,SRX5054308,FOSL2,399
chr1,209884673,209885073,SRX5716460,Epitope tags,400
chr1,209884676,209885142,SRX5075175,SMARCA4,466
chr1,209884699,209884962,SRX5075168,SMARCA4,263
chr1,209884741,209885064,SRX5075174,SMARCA4,323
chr1,209884747,209885099,SRX5716470,SMARCA4,352
chr1,209884758,209885074,SRX5020214,SMARCA2,316
chr1,209884781,209885136,SRX5716467,SMARCA2,355
chr1,209884782,209885160,SRX5075181,SMARCA2,378
chr1,209884798,209885081,SRX5020211,SMARCA2,283
chr1,209884817,209885035,SRX5716468,SMARCA2,218
chr1,209884830,209885056,SRX5075182,SMARCA2,226
chr1,209890871,209891285,SRX5075170,SMARCA4,414
chr1,209890922,209891298,SRX5020211,SMARCA2,376
chr1,209890925,209891309,SRX5075169,SMARCA4,384
chr1,209890932,209891391,SRX5075176,SMARCA4,459
chr1,209890936,209891284,SRX5054308,FOSL2,348
chr1,209890974,209891322,SRX5075175,SMARCA4,348
chr1,209891009,209891275,SRX5054309,FOSL2,266
chr1,209926071,209926481,SRX5075175,SMARCA4,410
chr1,209926089,209926547,SRX5075176,SMARCA4,458
chr1,209926132,209926434,SRX5716470,SMARCA4,302
chr1,209926132,209926522,SRX5075170,SMARCA4,390
chr1,209926132,209926550,SRX5054309,FOSL2,418
chr1,209926140,209926483,SRX5075169,SMARCA4,343
chr1,209926182,209926460,SRX5716469,SMARCA4,278
chr1,209926197,209926505,SRX5054308,FOSL2,308
chr1,209926201,209926443,SRX5020214,SMARCA2,242
chr1,209926222,209926438,SRX5020211,SMARCA2,216
chr1,209929836,209930036,SRX5075176,SMARCA4,200
chr1,209929854,209930058,SRX5075170,SMARCA4,204
chr1,209937557,209937879,SRX5716464,SMARCA4,322
chr1,209937579,209937963,SRX5075176,SMARCA4,384
chr1,209937609,209937937,SRX5075175,SMARCA4,328
chr1,209937611,209937958,SRX5075169,SMARCA4,347
chr1,209937615,209937900,SRX5716469,SMARCA4,285
chr1,209937618,209937909,SRX5716470,SMARCA4,291
chr1,209937625,209937941,SRX5075174,SMARCA4,316
chr1,209937626,209938005,SRX5075168,SMARCA4,379
chr1,209937655,209937925,SRX5075170,SMARCA4,270
chr1,209937782,209938548,SRX20140895,INTS13,766
chr1,209938102,209938675,SRX5075174,SMARCA4,573
chr1,209938191,209938481,SRX5075168,SMARCA4,290
chr1,209989489,209989953,SRX16500061,CTCF,464
chr1,209989493,209989948,SRX16500059,CTCF,455
chr1,209989538,209989915,SRX16500062,CTCF,377
chr1,209989550,209989951,SRX16500060,CTCF,401
chr1,210043224,210043423,SRX5075174,SMARCA4,199
chr1,210061989,210062294,SRX5075174,SMARCA4,305
chr1,210061992,210062325,SRX5075168,SMARCA4,333
chr1,210072134,210072565,SRX5075174,SMARCA4,431
chr1,210072143,210072519,SRX5075168,SMARCA4,376
chr1,210072163,210072480,SRX5716463,SMARCA4,317
chr1,210072205,210072502,SRX5716464,SMARCA4,297
chr1,210072223,210072430,SRX5075175,SMARCA4,207
chr1,210072223,210072469,SRX5075170,SMARCA4,246
chr1,210072225,210072512,SRX5075176,SMARCA4,287
chr1,210072250,210072446,SRX5075169,SMARCA4,196
chr1,210117498,210117684,SRX5054308,FOSL2,186
chr1,210124088,210124615,SRX5075170,SMARCA4,527
chr1,210124108,210124601,SRX5075169,SMARCA4,493
chr1,210124127,210124734,SRX5075176,SMARCA4,607
chr1,210124175,210124562,SRX5054308,FOSL2,387
chr1,210124178,210124530,SRX5054309,FOSL2,352
chr1,210124182,210124596,SRX5075175,SMARCA4,414
chr1,210124186,210124526,SRX5020211,SMARCA2,340
chr1,210124207,210124461,SRX5716467,SMARCA2,254
chr1,210124208,210124537,SRX5716469,SMARCA4,329
chr1,210124270,210124531,SRX5020214,SMARCA2,261
chr1,210125114,210125532,SRX5075176,SMARCA4,418
chr1,210125249,210125533,SRX5075170,SMARCA4,284
chr1,210125268,210125480,SRX5716469,SMARCA4,212
chr1,210125273,210125490,SRX5075175,SMARCA4,217
chr1,210125317,210125543,SRX5075169,SMARCA4,226
chr1,210132628,210132946,SRX5075176,SMARCA4,318
chr1,210132630,210132936,SRX5075170,SMARCA4,306
chr1,210132642,210132929,SRX5075175,SMARCA4,287
chr1,210132653,210132953,SRX5075168,SMARCA4,300
chr1,210132655,210132940,SRX5075169,SMARCA4,285
chr1,210132656,210132908,SRX5716470,SMARCA4,252
chr1,210132685,210132936,SRX5075174,SMARCA4,251
chr1,210143342,210143959,SRX16500059,CTCF,617
chr1,210143397,210143922,SRX16500060,CTCF,525
chr1,210143416,210143891,SRX16500061,CTCF,475
chr1,210143438,210143943,SRX16500062,CTCF,505
chr1,210143505,210143832,SRX5075174,SMARCA4,327
chr1,210143518,210143775,SRX5075168,SMARCA4,257
chr1,210143554,210143753,SRX5075169,SMARCA4,199
chr1,210143560,210143790,SRX5075176,SMARCA4,230
chr1,210143572,210143781,SRX5075170,SMARCA4,209
chr1,210159144,210159642,SRX5075168,SMARCA4,498
chr1,210159181,210159615,SRX5075174,SMARCA4,434
chr1,210159196,210159600,SRX5716463,SMARCA4,404
chr1,210159198,210159547,SRX5716464,SMARCA4,349
chr1,210188206,210188568,SRX5075169,SMARCA4,362
chr1,210188240,210188518,SRX5054309,FOSL2,278
chr1,210188261,210188546,SRX5075176,SMARCA4,285
chr1,210188264,210188586,SRX5075175,SMARCA4,322
chr1,210188292,210188536,SRX5075170,SMARCA4,244
chr1,210201805,210202027,SRX5054309,FOSL2,222
chr1,210222312,210222599,SRX5075170,SMARCA4,287
chr1,210222317,210222532,SRX5075176,SMARCA4,215
chr1,210222363,210222543,SRX5075174,SMARCA4,180
chr1,210232081,210232419,SRX5075170,SMARCA4,338
chr1,210232085,210232466,SRX5075176,SMARCA4,381
chr1,210232177,210232392,SRX5716467,SMARCA2,215
chr1,210232687,210232989,SRX20140895,INTS13,302
chr1,210233717,210233908,SRX5075168,SMARCA4,191
chr1,210233808,210234074,SRX5054308,FOSL2,266
chr1,210237098,210237399,SRX5075170,SMARCA4,301
chr1,210237114,210237379,SRX5075176,SMARCA4,265
chr1,210239288,210239820,SRX5075169,SMARCA4,532
chr1,210239291,210239614,SRX5075170,SMARCA4,323
chr1,210239295,210239600,SRX5075176,SMARCA4,305
chr1,210239301,210239582,SRX5020214,SMARCA2,281
chr1,210239322,210239570,SRX5054309,FOSL2,248
chr1,210239339,210239550,SRX5716468,SMARCA2,211
chr1,210239343,210239933,SRX5020211,SMARCA2,590
chr1,210239360,210239860,SRX5075175,SMARCA4,500
chr1,210239381,210239814,SRX5716469,SMARCA4,433
chr1,210239393,210239810,SRX5716467,SMARCA2,417
chr1,210239421,210239833,SRX5716470,SMARCA4,412
chr1,210239479,210239878,SRX5054308,FOSL2,399
chr1,210239669,210240110,SRX5075176,SMARCA4,441
chr1,210239803,210240210,SRX16500059,CTCF,407
chr1,210239840,210240108,SRX16500061,CTCF,268
chr1,210239856,210240090,SRX5075170,SMARCA4,234
chr1,210239861,210240160,SRX5054309,FOSL2,299
chr1,210239866,210240144,SRX16500060,CTCF,278
chr1,210239920,210240110,SRX5075175,SMARCA4,190
chr1,210251164,210251732,SRX5075176,SMARCA4,568
chr1,210251187,210251490,SRX5075170,SMARCA4,303
chr1,210251234,210251836,SRX20140895,INTS13,602
chr1,210251276,210251716,SRX5075175,SMARCA4,440
chr1,210251304,210251769,SRX5075174,SMARCA4,465
chr1,210251313,210251611,SRX5716469,SMARCA4,298
chr1,210251345,210251772,SRX5075168,SMARCA4,427
chr1,210251423,210251684,SRX20140868,INTS10,261
chr1,210251481,210251812,SRX5716470,SMARCA4,331
chr1,210251611,210251862,SRX5075169,SMARCA4,251
chr1,210259462,210259898,SRX5054309,FOSL2,436
chr1,210259498,210259911,SRX5075170,SMARCA4,413
chr1,210259520,210259868,SRX5075176,SMARCA4,348
chr1,210259555,210259833,SRX5075169,SMARCA4,278
chr1,210259566,210259785,SRX5020211,SMARCA2,219
chr1,210259590,210259866,SRX5054308,FOSL2,276
chr1,210259628,210259840,SRX5716469,SMARCA4,212
chr1,210259637,210259821,SRX5075168,SMARCA4,184
chr1,210262094,210262333,SRX5716470,SMARCA4,239
chr1,210262115,210262302,SRX5075170,SMARCA4,187
chr1,210262164,210262807,SRX5075175,SMARCA4,643
chr1,210262478,210262888,SRX5075170,SMARCA4,410
chr1,210262499,210262764,SRX5716468,SMARCA2,265
chr1,210262505,210262833,SRX5075176,SMARCA4,328
chr1,210262523,210262869,SRX5716467,SMARCA2,346
chr1,210262529,210262853,SRX5075169,SMARCA4,324
chr1,210262530,210262815,SRX5716470,SMARCA4,285
chr1,210262544,210262820,SRX5716469,SMARCA4,276
chr1,210262545,210262774,SRX5075181,SMARCA2,229
chr1,210262605,210262798,SRX5054308,FOSL2,193
chr1,210272579,210273045,SRX5075176,SMARCA4,466
chr1,210272668,210273105,SRX5075170,SMARCA4,437
chr1,210272708,210272923,SRX5716467,SMARCA2,215
chr1,210272716,210272935,SRX5716470,SMARCA4,219
chr1,210291788,210292297,SRX5075170,SMARCA4,509
chr1,210291792,210292266,SRX5075176,SMARCA4,474
chr1,210291803,210292617,SRX5075175,SMARCA4,814
chr1,210291838,210292137,SRX5075169,SMARCA4,299
chr1,210291851,210292177,SRX5716470,SMARCA4,326
chr1,210291888,210292111,SRX5716467,SMARCA2,223
chr1,210291943,210292555,SRX5716469,SMARCA4,612
chr1,210292340,210292603,SRX5075174,SMARCA4,263
chr1,210292342,210292564,SRX5075169,SMARCA4,222
chr1,210292465,210292831,SRX16500059,CTCF,366
chr1,210292515,210292698,SRX5075168,SMARCA4,183
chr1,210292520,210292815,SRX16500060,CTCF,295
chr1,210292595,210292850,SRX16500061,CTCF,255
chr1,210293090,210293593,SRX5075176,SMARCA4,503
chr1,210293103,210293484,SRX5716470,SMARCA4,381
chr1,210293168,210293457,SRX5075169,SMARCA4,289
chr1,210293169,210293614,SRX5075170,SMARCA4,445
chr1,210293176,210293453,SRX5716467,SMARCA2,277
chr1,210293191,210293447,SRX5054308,FOSL2,256
chr1,210293193,210293420,SRX5075181,SMARCA2,227
chr1,210293196,210293533,SRX5075175,SMARCA4,337
chr1,210293242,210293425,SRX5054309,FOSL2,183
chr1,210293257,210293509,SRX5020211,SMARCA2,252
chr1,210293286,210293497,SRX5716468,SMARCA2,211
chr1,210293292,210293504,SRX5716469,SMARCA4,212
chr1,210310977,210311539,SRX16500059,CTCF,562
chr1,210310996,210311554,SRX16500061,CTCF,558
chr1,210311005,210311432,SRX4174629,CTCF,427
chr1,210311008,210311565,SRX16500060,CTCF,557
chr1,210311027,210311509,SRX16500062,CTCF,482
chr1,210311033,210311530,SRX5075168,SMARCA4,497
chr1,210311054,210311488,SRX5075169,SMARCA4,434
chr1,210311065,210311538,SRX5075174,SMARCA4,473
chr1,210311073,210311493,SRX5716463,SMARCA4,420
chr1,210311074,210311534,SRX5075170,SMARCA4,460
chr1,210311095,210311521,SRX5075175,SMARCA4,426
chr1,210311107,210311158,SRX1424893,POU3F2,51
chr1,210311108,210311153,SRX1424892,POU3F2,45
chr1,210311110,210311150,SRX1424891,POU3F2,40
chr1,210311114,210311557,SRX5075176,SMARCA4,443
chr1,210311156,210311499,SRX5716469,SMARCA4,343
chr1,210311162,210311440,SRX5054309,FOSL2,278
chr1,210311223,210311518,SRX20140895,INTS13,295
chr1,210328536,210329482,SRX20140895,INTS13,946
chr1,210328625,210329403,SRX20140868,INTS10,778
chr1,210328632,210329549,SRX5075174,SMARCA4,917
chr1,210328644,210329465,SRX5075168,SMARCA4,821
chr1,210328646,210329105,SRX5075170,SMARCA4,459
chr1,210328662,210328978,SRX5716463,SMARCA4,316
chr1,210328663,210329584,SRX5075169,SMARCA4,921
chr1,210328689,210329073,SRX20140879,CPSF3L,384
chr1,210328692,210328974,SRX5716464,SMARCA4,282
chr1,210328705,210329185,SRX5075176,SMARCA4,480
chr1,210328747,210329112,SRX5075175,SMARCA4,365
chr1,210328791,210329091,SRX5716469,SMARCA4,300
chr1,210328884,210329431,SRX5716470,SMARCA4,547
chr1,210329027,210329282,SRX20140867,INTS10,255
chr1,210329198,210329538,SRX5075170,SMARCA4,340
chr1,210329240,210329591,SRX5075176,SMARCA4,351
chr1,210329249,210329533,SRX5075175,SMARCA4,284
chr1,210360751,210361156,SRX16500060,CTCF,405
chr1,210360776,210361172,SRX16500061,CTCF,396
chr1,210360797,210361155,SRX16500062,CTCF,358
chr1,210360812,210361264,SRX16500059,CTCF,452
chr1,210360867,210361135,SRX5075176,SMARCA4,268
chr1,210360875,210361129,SRX5075170,SMARCA4,254
chr1,210360887,210361133,SRX5075174,SMARCA4,246
chr1,210360892,210361123,SRX5075168,SMARCA4,231
chr1,210360901,210361135,SRX5075175,SMARCA4,234
chr1,210360911,210361184,SRX5075169,SMARCA4,273
chr1,210364459,210364760,SRX5075170,SMARCA4,301
chr1,210364485,210364801,SRX5075176,SMARCA4,316
chr1,210373317,210374361,SRX20140867,INTS10,1044
chr1,210373539,210374318,SRX20140881,CPSF3L,779
chr1,210373793,210374098,SRX20140896,INTS13,305
chr1,210373812,210374130,SRX5075174,SMARCA4,318
chr1,210373854,210374360,SRX20140895,INTS13,506
chr1,210373950,210374194,SRX5054309,FOSL2,244
chr1,210374050,210374340,SRX20140897,INTS13,290
chr1,210374296,210374767,SRX16500059,CTCF,471
chr1,210374301,210374789,SRX16500060,CTCF,488
chr1,210374314,210374621,SRX5054308,FOSL2,307
chr1,210374324,210374631,SRX5054309,FOSL2,307
chr1,210374342,210374763,SRX16500062,CTCF,421
chr1,210374353,210374783,SRX16500061,CTCF,430
chr1,210374419,210374662,SRX5075168,SMARCA4,243
chr1,210374427,210374677,SRX5075174,SMARCA4,250
chr1,210376958,210377231,SRX5075170,SMARCA4,273
chr1,210376990,210377309,SRX5075176,SMARCA4,319
chr1,210377009,210377255,SRX5075169,SMARCA4,246
chr1,210377012,210377256,SRX5716469,SMARCA4,244
chr1,210377022,210377323,SRX5054309,FOSL2,301
chr1,210377982,210378187,SRX5075176,SMARCA4,205
chr1,210378010,210378260,SRX5075169,SMARCA4,250
chr1,210378012,210378261,SRX5075175,SMARCA4,249
chr1,210378015,210378222,SRX5054309,FOSL2,207
chr1,210378023,210378218,SRX5075170,SMARCA4,195
chr1,210378026,210378247,SRX5054308,FOSL2,221
chr1,210384728,210384999,SRX5075175,SMARCA4,271
chr1,210384757,210384932,SRX5075176,SMARCA4,175
chr1,210384789,210385124,SRX5075169,SMARCA4,335
chr1,210393568,210394087,SRX5075176,SMARCA4,519
chr1,210393572,210394005,SRX5075175,SMARCA4,433
chr1,210393599,210394137,SRX5075170,SMARCA4,538
chr1,210393605,210394000,SRX5054308,FOSL2,395
chr1,210393612,210394027,SRX5054309,FOSL2,415
chr1,210393617,210394040,SRX5075169,SMARCA4,423
chr1,210393651,210394040,SRX5716469,SMARCA4,389
chr1,210393663,210394016,SRX5716470,SMARCA4,353
chr1,210393684,210393999,SRX5020211,SMARCA2,315
chr1,210393693,210393984,SRX5716467,SMARCA2,291
chr1,210393718,210393944,SRX5716468,SMARCA2,226
chr1,210394383,210394581,SRX5075176,SMARCA4,198
chr1,210400480,210400959,SRX4174629,CTCF,479
chr1,210400558,210401057,SRX16500060,CTCF,499
chr1,210400568,210401052,SRX16500059,CTCF,484
chr1,210400580,210400988,SRX16500062,CTCF,408
chr1,210400590,210401023,SRX16500061,CTCF,433
chr1,210400651,210400881,SRX5075174,SMARCA4,230
chr1,210400664,210400947,SRX5075168,SMARCA4,283
chr1,210400669,210400921,SRX5075170,SMARCA4,252
chr1,210400674,210400918,SRX5075169,SMARCA4,244
chr1,210400691,210400885,SRX5075176,SMARCA4,194
chr1,210407135,210407662,SRX16500060,CTCF,527
chr1,210407153,210407674,SRX4174629,CTCF,521
chr1,210407158,210407631,SRX16500061,CTCF,473
chr1,210407161,210407655,SRX16500059,CTCF,494
chr1,210407190,210407659,SRX16500062,CTCF,469
chr1,210407264,210407601,SRX5075174,SMARCA4,337
chr1,210407282,210407569,SRX5075168,SMARCA4,287
chr1,210407305,210407607,SRX5075176,SMARCA4,302
chr1,210407310,210407583,SRX5075170,SMARCA4,273
chr1,210407330,210407560,SRX5075169,SMARCA4,230
chr1,210426743,210426945,SRX5075176,SMARCA4,202
chr1,210426768,210427020,SRX5075170,SMARCA4,252
chr1,210434265,210434490,SRX5075176,SMARCA4,225
chr1,210434274,210434495,SRX5716470,SMARCA4,221
chr1,210438924,210439733,SRX5054309,FOSL2,809
chr1,210438966,210439780,SRX5075169,SMARCA4,814
chr1,210438987,210439659,SRX5054308,FOSL2,672
chr1,210439008,210439781,SRX5075170,SMARCA4,773
chr1,210439051,210439715,SRX5075175,SMARCA4,664
chr1,210439067,210439683,SRX5716470,SMARCA4,616
chr1,210439106,210439695,SRX5716469,SMARCA4,589
chr1,210439126,210439691,SRX5075176,SMARCA4,565
chr1,210439139,210439688,SRX5020211,SMARCA2,549
chr1,210439177,210439658,SRX5716468,SMARCA2,481
chr1,210439203,210439638,SRX5020214,SMARCA2,435
chr1,210439209,210439670,SRX5716467,SMARCA2,461
chr1,210439291,210439609,SRX5075182,SMARCA2,318
chr1,210446443,210446845,SRX5075168,SMARCA4,402
chr1,210446463,210446832,SRX5075174,SMARCA4,369
chr1,210446491,210446748,SRX5054308,FOSL2,257
chr1,210448271,210448723,SRX16500060,CTCF,452
chr1,210448279,210448782,SRX16500059,CTCF,503
chr1,210448303,210448739,SRX16500062,CTCF,436
chr1,210448304,210448748,SRX16500061,CTCF,444
chr1,210448370,210448594,SRX5075168,SMARCA4,224
chr1,210448400,210448681,SRX5075176,SMARCA4,281
chr1,210448420,210448640,SRX5075169,SMARCA4,220
chr1,210448424,210448633,SRX5075170,SMARCA4,209
chr1,210457516,210457914,SRX5075168,SMARCA4,398
chr1,210457590,210457834,SRX5075174,SMARCA4,244
chr1,210457710,210457750,SRX1424891,POU3F2,40
chr1,210467333,210467831,SRX5075176,SMARCA4,498
chr1,210467357,210467758,SRX5075170,SMARCA4,401
chr1,210487895,210488249,SRX5075176,SMARCA4,354
chr1,210487945,210488215,SRX5075170,SMARCA4,270
chr1,210489370,210489848,SRX5716469,SMARCA4,478
chr1,210489431,210489886,SRX5716470,SMARCA4,455
chr1,210489500,210489968,SRX5075170,SMARCA4,468
chr1,210489507,210489990,SRX5075176,SMARCA4,483
chr1,210489537,210489874,SRX5716467,SMARCA2,337
chr1,210489554,210489877,SRX5075175,SMARCA4,323
chr1,210489588,210489872,SRX5716468,SMARCA2,284
chr1,210489599,210489884,SRX5020211,SMARCA2,285
chr1,210525675,210525957,SRX5075170,SMARCA4,282
chr1,210525720,210525948,SRX5054309,FOSL2,228
chr1,210525771,210526003,SRX5075176,SMARCA4,232
chr1,210532012,210532239,SRX5075176,SMARCA4,227
chr1,210536221,210536521,SRX5075174,SMARCA4,300
chr1,210536230,210536592,SRX5075170,SMARCA4,362
chr1,210536242,210536548,SRX5075168,SMARCA4,306
chr1,210536266,210536537,SRX5075176,SMARCA4,271
chr1,210541745,210541956,SRX5054309,FOSL2,211
chr1,210541846,210542050,SRX5075176,SMARCA4,204
chr1,210547479,210547722,SRX5075170,SMARCA4,243
chr1,210547507,210547753,SRX5054309,FOSL2,246
chr1,210547507,210547797,SRX5075176,SMARCA4,290
chr1,210547552,210547785,SRX5054308,FOSL2,233
chr1,210558346,210558696,SRX5075176,SMARCA4,350
chr1,210558372,210558661,SRX5075169,SMARCA4,289
chr1,210558379,210558715,SRX5075170,SMARCA4,336
chr1,210558410,210558689,SRX5716470,SMARCA4,279
chr1,210558431,210558618,SRX5075175,SMARCA4,187
chr1,210558449,210558670,SRX5716468,SMARCA2,221
chr1,210568677,210568911,SRX5075170,SMARCA4,234
chr1,210584189,210584747,SRX16500061,CTCF,558
chr1,210584256,210584771,SRX16500062,CTCF,515
chr1,210584272,210584754,SRX16500060,CTCF,482
chr1,210584297,210584771,SRX16500059,CTCF,474
chr1,210584352,210584814,SRX4174629,CTCF,462
chr1,210584485,210584763,SRX5075174,SMARCA4,278
chr1,210584530,210584780,SRX5075168,SMARCA4,250
chr1,210586897,210587075,SRX5075176,SMARCA4,178
chr1,210587588,210587883,SRX5075170,SMARCA4,295
chr1,210587638,210587885,SRX5075169,SMARCA4,247
chr1,210587672,210587847,SRX5075176,SMARCA4,175
chr1,210597758,210598123,SRX5075168,SMARCA4,365
chr1,210597771,210598598,SRX5075170,SMARCA4,827
chr1,210597795,210598537,SRX5075176,SMARCA4,742
chr1,210597796,210598111,SRX5054309,FOSL2,315
chr1,210597801,210598591,SRX5075175,SMARCA4,790
chr1,210597807,210598586,SRX5075169,SMARCA4,779
chr1,210597814,210598116,SRX5075174,SMARCA4,302
chr1,210597815,210598123,SRX5716470,SMARCA4,308
chr1,210597829,210598145,SRX5054308,FOSL2,316
chr1,210597894,210598521,SRX5716469,SMARCA4,627
chr1,210597988,210598508,SRX5716467,SMARCA2,520
chr1,210598002,210598209,SRX5020214,SMARCA2,207
chr1,210598199,210598442,SRX5020211,SMARCA2,243
chr1,210598199,210598582,SRX5054309,FOSL2,383
chr1,210598206,210598517,SRX5054308,FOSL2,311
chr1,210624788,210625075,SRX5075170,SMARCA4,287
chr1,210624825,210625120,SRX5075176,SMARCA4,295
chr1,210647578,210647767,SRX5075176,SMARCA4,189
chr1,210647596,210647858,SRX5075170,SMARCA4,262
chr1,210647699,210647879,SRX5075169,SMARCA4,180
chr1,210647880,210648331,SRX5075175,SMARCA4,451
chr1,210648004,210648364,SRX5054309,FOSL2,360
chr1,210648005,210648384,SRX5075176,SMARCA4,379
chr1,210648115,210648320,SRX5075170,SMARCA4,205
chr1,210648129,210648324,SRX5075169,SMARCA4,195
chr1,210648137,210648355,SRX5054308,FOSL2,218
chr1,210653906,210654173,SRX20140895,INTS13,267
chr1,210653929,210654017,SRX1424893,POU3F2,88
chr1,210653936,210653976,SRX1424894,POU3F2,40
chr1,210654128,210654169,SRX1424894,POU3F2,41
chr1,210696716,210696967,SRX5075168,SMARCA4,251
chr1,210708044,210708398,SRX5075174,SMARCA4,354
chr1,210708113,210708384,SRX5075168,SMARCA4,271
chr1,210720516,210720725,SRX5075176,SMARCA4,209
chr1,210726650,210726936,SRX5075168,SMARCA4,286
chr1,210726657,210726938,SRX5075176,SMARCA4,281
chr1,210726670,210726933,SRX5075170,SMARCA4,263
chr1,210726701,210726986,SRX5075174,SMARCA4,285
chr1,210739703,210739902,SRX5075170,SMARCA4,199
chr1,210754919,210755138,SRX5075174,SMARCA4,219
chr1,210755258,210755678,SRX5075176,SMARCA4,420
chr1,210755274,210755668,SRX5075168,SMARCA4,394
chr1,210755295,210755700,SRX5075174,SMARCA4,405
chr1,210755381,210755658,SRX5075170,SMARCA4,277
chr1,210755393,210755612,SRX5075169,SMARCA4,219
chr1,210792663,210793047,SRX5716460,Epitope tags,384
chr1,210792697,210793069,SRX5075169,SMARCA4,372
chr1,210792705,210793080,SRX5054309,FOSL2,375
chr1,210792711,210793084,SRX5075170,SMARCA4,373
chr1,210792715,210793038,SRX5075175,SMARCA4,323
chr1,210792716,210793038,SRX5716469,SMARCA4,322
chr1,210792720,210793090,SRX5054308,FOSL2,370
chr1,210792747,210793056,SRX5075176,SMARCA4,309
chr1,210792749,210793032,SRX5075174,SMARCA4,283
chr1,210792760,210792988,SRX5020211,SMARCA2,228
chr1,210792770,210793023,SRX5075168,SMARCA4,253
chr1,210792801,210792997,SRX5054307,FOSL2,196
chr1,210792826,210793042,SRX5716467,SMARCA2,216
chr1,210801014,210801202,SRX5075176,SMARCA4,188
chr1,210830592,210830939,SRX5716467,SMARCA2,347
chr1,210830705,210830965,SRX5075169,SMARCA4,260
chr1,210857119,210857552,SRX5075174,SMARCA4,433
chr1,210857153,210857513,SRX5075168,SMARCA4,360
chr1,210857606,210857870,SRX5054309,FOSL2,264
chr1,210857611,210857923,SRX5054308,FOSL2,312
chr1,210857644,210857894,SRX5716469,SMARCA4,250
chr1,210857654,210857884,SRX5075170,SMARCA4,230
chr1,210857683,210857906,SRX5075176,SMARCA4,223
chr1,210857701,210857944,SRX5075169,SMARCA4,243
chr1,210882384,210883217,SRX5075169,SMARCA4,833
chr1,210882441,210883179,SRX5075170,SMARCA4,738
chr1,210882456,210883167,SRX5716469,SMARCA4,711
chr1,210882490,210883217,SRX5075175,SMARCA4,727
chr1,210882496,210883140,SRX5054308,FOSL2,644
chr1,210882511,210883141,SRX5054309,FOSL2,630
chr1,210882516,210883140,SRX5075176,SMARCA4,624
chr1,210882546,210882977,SRX5716460,Epitope tags,431
chr1,210882604,210883199,SRX5716470,SMARCA4,595
chr1,210882697,210883163,SRX5716467,SMARCA2,466
chr1,210882724,210883076,SRX5020214,SMARCA2,352
chr1,210882825,210883144,SRX5716468,SMARCA2,319
chr1,210882895,210883116,SRX5020211,SMARCA2,221
chr1,210949935,210950227,SRX16500059,CTCF,292
chr1,210949941,210950247,SRX16500060,CTCF,306
chr1,210949965,210950221,SRX16500062,CTCF,256
chr1,210950003,210950260,SRX16500061,CTCF,257
chr1,210951321,210951535,SRX5075176,SMARCA4,214
chr1,211036903,211037344,SRX20140869,INTS10,441
chr1,211036918,211037449,SRX5075176,SMARCA4,531
chr1,211036972,211037499,SRX5075170,SMARCA4,527
chr1,211036989,211037577,SRX5075169,SMARCA4,588
chr1,211036994,211037484,SRX5075175,SMARCA4,490
chr1,211037016,211037444,SRX5054308,FOSL2,428
chr1,211037016,211037465,SRX5054309,FOSL2,449
chr1,211037039,211037417,SRX5716470,SMARCA4,378
chr1,211037040,211037346,SRX5075168,SMARCA4,306
chr1,211037061,211037455,SRX5716469,SMARCA4,394
chr1,211037071,211037480,SRX5020214,SMARCA2,409
chr1,211037095,211037308,SRX5075182,SMARCA2,213
chr1,211037108,211037421,SRX5716467,SMARCA2,313
chr1,211037119,211037403,SRX5075174,SMARCA4,284
chr1,211037131,211037479,SRX5716460,Epitope tags,348
chr1,211037154,211037397,SRX5020211,SMARCA2,243
chr1,211118264,211118936,SRX5075170,SMARCA4,672
chr1,211118327,211118965,SRX5075169,SMARCA4,638
chr1,211118338,211119021,SRX5075176,SMARCA4,683
chr1,211118351,211118829,SRX5075175,SMARCA4,478
chr1,211118369,211118759,SRX5020211,SMARCA2,390
chr1,211118385,211118815,SRX5716470,SMARCA4,430
chr1,211118402,211118947,SRX5716467,SMARCA2,545
chr1,211118404,211118781,SRX5054308,FOSL2,377
chr1,211118424,211118895,SRX5054309,FOSL2,471
chr1,211118432,211118916,SRX5716469,SMARCA4,484
chr1,211118444,211118704,SRX5075181,SMARCA2,260
chr1,211118450,211118654,SRX5075182,SMARCA2,204
chr1,211118473,211118799,SRX5716459,Epitope tags,326
chr1,211118498,211118754,SRX5020214,SMARCA2,256
chr1,211133916,211134376,SRX5075175,SMARCA4,460
chr1,211133935,211134339,SRX20140895,INTS13,404
chr1,211133954,211134419,SRX5075168,SMARCA4,465
chr1,211133976,211134559,SRX16500059,CTCF,583
chr1,211133984,211134534,SRX16500060,CTCF,550
chr1,211134004,211134529,SRX16500061,CTCF,525
chr1,211134024,211134433,SRX5075174,SMARCA4,409
chr1,211134026,211134369,SRX5716470,SMARCA4,343
chr1,211134028,211134404,SRX5075176,SMARCA4,376
chr1,211134028,211134451,SRX5075169,SMARCA4,423
chr1,211134037,211134452,SRX5075170,SMARCA4,415
chr1,211134052,211134532,SRX16500062,CTCF,480
chr1,211134071,211134369,SRX5716469,SMARCA4,298
chr1,211134105,211134432,SRX5716464,SMARCA4,327
chr1,211134149,211134406,SRX5716463,SMARCA4,257
chr1,211134223,211134635,SRX4174629,CTCF,412
chr1,211135004,211135223,SRX5054309,FOSL2,219
chr1,211135340,211135647,SRX16500059,CTCF,307
chr1,211135351,211135651,SRX16500062,CTCF,300
chr1,211135367,211135682,SRX16500060,CTCF,315
chr1,211135375,211135687,SRX16500061,CTCF,312
chr1,211155039,211155474,SRX5075170,SMARCA4,435
chr1,211155061,211155510,SRX5075176,SMARCA4,449
chr1,211155062,211155354,SRX5716470,SMARCA4,292
chr1,211155074,211155395,SRX5020211,SMARCA2,321
chr1,211155075,211155336,SRX5716468,SMARCA2,261
chr1,211155079,211155295,SRX5716469,SMARCA4,216
chr1,211155079,211155401,SRX5075169,SMARCA4,322
chr1,211155084,211155382,SRX5075175,SMARCA4,298
chr1,211155112,211155348,SRX5716467,SMARCA2,236
chr1,211155135,211155332,SRX5054309,FOSL2,197
chr1,211198153,211198456,SRX5054309,FOSL2,303
chr1,211198198,211198378,SRX5054308,FOSL2,180
chr1,211248040,211248353,SRX5075174,SMARCA4,313
chr1,211248070,211248355,SRX5075168,SMARCA4,285
chr1,211257436,211257666,SRX5075168,SMARCA4,230
chr1,211258245,211258528,SRX5075169,SMARCA4,283
chr1,211258250,211258556,SRX5075170,SMARCA4,306
chr1,211258284,211258599,SRX5075176,SMARCA4,315
chr1,211258615,211259678,SRX20140895,INTS13,1063
chr1,211258763,211259376,SRX20140868,INTS10,613
chr1,211258869,211259302,SRX20140879,CPSF3L,433
chr1,211258877,211259301,SRX16500062,CTCF,424
chr1,211258887,211259302,SRX16500060,CTCF,415
chr1,211258894,211259276,SRX16500061,CTCF,382
chr1,211258894,211259431,SRX20140867,INTS10,537
chr1,211258911,211259361,SRX16500059,CTCF,450
chr1,211258962,211259464,SRX20140897,INTS13,502
chr1,211259029,211259283,SRX5075168,SMARCA4,254
chr1,211259062,211259350,SRX5075176,SMARCA4,288
chr1,211259074,211259249,SRX5075174,SMARCA4,175
chr1,211260720,211261027,SRX20140895,INTS13,307
chr1,211304947,211305310,SRX5075169,SMARCA4,363
chr1,211305002,211305292,SRX5075170,SMARCA4,290
chr1,211305109,211305284,SRX5075176,SMARCA4,175
chr1,211305112,211305300,SRX5075168,SMARCA4,188
chr1,211323361,211323891,SRX16500061,CTCF,530
chr1,211323391,211323899,SRX16500059,CTCF,508
chr1,211323392,211323979,SRX16500060,CTCF,587
chr1,211323426,211323905,SRX16500062,CTCF,479
chr1,211323435,211323822,SRX4174629,CTCF,387
chr1,211323537,211323825,SRX5075174,SMARCA4,288
chr1,211323563,211323851,SRX5075168,SMARCA4,288
chr1,211323568,211323766,SRX5075170,SMARCA4,198
chr1,211323617,211323798,SRX5075176,SMARCA4,181
chr1,211323648,211323879,SRX5716463,SMARCA4,231
chr1,211326632,211327128,SRX20140895,INTS13,496
chr1,211326824,211327006,SRX5075174,SMARCA4,182
chr1,211332773,211333075,SRX5075176,SMARCA4,302
chr1,211332869,211333106,SRX5054309,FOSL2,237
chr1,211332883,211333103,SRX5075170,SMARCA4,220
chr1,211332886,211333112,SRX5054308,FOSL2,226
chr1,211332889,211333080,SRX5075169,SMARCA4,191
chr1,211352881,211353238,SRX16500059,CTCF,357
chr1,211352902,211353242,SRX16500060,CTCF,340
chr1,211352904,211353253,SRX16500061,CTCF,349
chr1,211352932,211353211,SRX16500062,CTCF,279
chr1,211357107,211357348,SRX5075169,SMARCA4,241
chr1,211357138,211357371,SRX5075175,SMARCA4,233
chr1,211360057,211360263,SRX5075168,SMARCA4,206
chr1,211360060,211360240,SRX5054308,FOSL2,180
chr1,211371390,211371690,SRX5054308,FOSL2,300
chr1,211371394,211371966,SRX5075170,SMARCA4,572
chr1,211371397,211371728,SRX5075169,SMARCA4,331
chr1,211371408,211371826,SRX5716469,SMARCA4,418
chr1,211371472,211371824,SRX5075175,SMARCA4,352
chr1,211378972,211379164,SRX5075170,SMARCA4,192
chr1,211382431,211383206,SRX20140895,INTS13,775
chr1,211382493,211382955,SRX5075174,SMARCA4,462
chr1,211382561,211383016,SRX5075168,SMARCA4,455
chr1,211382666,211383112,SRX20140897,INTS13,446
chr1,211382685,211383031,SRX20140868,INTS10,346
chr1,211382709,211383026,SRX20140867,INTS10,317
chr1,211382806,211383185,SRX20140869,INTS10,379
chr1,211398350,211398640,SRX5075176,SMARCA4,290
chr1,211398378,211398889,SRX5075174,SMARCA4,511
chr1,211398423,211398858,SRX5075168,SMARCA4,435
chr1,211398475,211398779,SRX20140881,CPSF3L,304
chr1,211398538,211398707,SRX5075170,SMARCA4,169
chr1,211416230,211416530,SRX5075168,SMARCA4,300
chr1,211416294,211416473,SRX5075174,SMARCA4,179
chr1,211416300,211416580,SRX5075170,SMARCA4,280
chr1,211416827,211417247,SRX5075176,SMARCA4,420
chr1,211416892,211417204,SRX5054309,FOSL2,312
chr1,211416896,211417166,SRX5075169,SMARCA4,270
chr1,211416909,211417230,SRX5075175,SMARCA4,321
chr1,211416915,211417291,SRX5075170,SMARCA4,376
chr1,211420411,211420761,SRX5075174,SMARCA4,350
chr1,211420442,211420762,SRX5075176,SMARCA4,320
chr1,211420455,211420762,SRX5075170,SMARCA4,307
chr1,211420459,211420683,SRX5075168,SMARCA4,224
chr1,211420460,211420738,SRX5716469,SMARCA4,278
chr1,211420461,211420733,SRX5054309,FOSL2,272
chr1,211420472,211420727,SRX5054308,FOSL2,255
chr1,211420475,211420686,SRX5075169,SMARCA4,211
chr1,211420494,211420730,SRX5075175,SMARCA4,236
chr1,211469996,211470447,SRX16500060,CTCF,451
chr1,211470010,211470465,SRX16500059,CTCF,455
chr1,211470028,211470349,SRX5075174,SMARCA4,321
chr1,211470044,211470490,SRX16500062,CTCF,446
chr1,211470046,211470453,SRX16500061,CTCF,407
chr1,211470072,211470299,SRX5075168,SMARCA4,227
chr1,211476101,211476623,SRX16500061,CTCF,522
chr1,211476143,211476605,SRX16500060,CTCF,462
chr1,211476159,211476643,SRX16500059,CTCF,484
chr1,211476199,211476606,SRX16500062,CTCF,407
chr1,211476241,211476517,SRX5075176,SMARCA4,276
chr1,211476258,211476503,SRX5075170,SMARCA4,245
chr1,211476275,211476522,SRX5075174,SMARCA4,247
chr1,211476277,211476456,SRX5075168,SMARCA4,179
chr1,211476303,211476490,SRX5075175,SMARCA4,187
chr1,211513903,211514354,SRX16500060,CTCF,451
chr1,211513934,211514295,SRX5075170,SMARCA4,361
chr1,211513939,211514241,SRX5054309,FOSL2,302
chr1,211513944,211514363,SRX16500059,CTCF,419
chr1,211513949,211514279,SRX5075176,SMARCA4,330
chr1,211513956,211514329,SRX5075169,SMARCA4,373
chr1,211513960,211514233,SRX5075175,SMARCA4,273
chr1,211513963,211514304,SRX5075174,SMARCA4,341
chr1,211513966,211514378,SRX16500062,CTCF,412
chr1,211513968,211514214,SRX5054308,FOSL2,246
chr1,211513968,211514438,SRX16500061,CTCF,470
chr1,211513985,211514297,SRX5075168,SMARCA4,312
chr1,211514002,211514282,SRX5716463,SMARCA4,280
chr1,211514010,211514274,SRX5716470,SMARCA4,264
chr1,211514023,211514341,SRX4174629,CTCF,318
chr1,211515215,211515765,SRX5075175,SMARCA4,550
chr1,211515236,211515749,SRX5075169,SMARCA4,513
chr1,211515253,211515623,SRX5716470,SMARCA4,370
chr1,211515257,211515729,SRX5075176,SMARCA4,472
chr1,211515264,211515741,SRX5716469,SMARCA4,477
chr1,211515273,211515648,SRX5054309,FOSL2,375
chr1,211515273,211515727,SRX5075170,SMARCA4,454
chr1,211515276,211515554,SRX5020214,SMARCA2,278
chr1,211515284,211515570,SRX5716467,SMARCA2,286
chr1,211515302,211515587,SRX5716468,SMARCA2,285
chr1,211515323,211515621,SRX5054308,FOSL2,298
chr1,211515339,211515612,SRX5020211,SMARCA2,273
chr1,211515409,211515737,SRX16500060,CTCF,328
chr1,211515417,211515733,SRX16500061,CTCF,316
chr1,211515421,211515818,SRX16500059,CTCF,397
chr1,211515475,211515764,SRX5075168,SMARCA4,289
chr1,211515520,211515779,SRX5075174,SMARCA4,259
chr1,211515546,211515786,SRX16500062,CTCF,240
chr1,211515578,211515805,SRX5716464,SMARCA4,227
chr1,211525351,211525718,SRX5075174,SMARCA4,367
chr1,211541743,211542014,SRX5716470,SMARCA4,271
chr1,211541768,211542080,SRX5716469,SMARCA4,312
chr1,211541785,211542000,SRX5075170,SMARCA4,215
chr1,211541790,211542045,SRX5075176,SMARCA4,255
chr1,211574758,211574962,SRX5054309,FOSL2,204
chr1,211574794,211575035,SRX5054308,FOSL2,241
chr1,211577689,211578315,SRX16500060,CTCF,626
chr1,211577701,211578274,SRX16500059,CTCF,573
chr1,211577749,211578304,SRX16500062,CTCF,555
chr1,211577750,211578058,SRX5075174,SMARCA4,308
chr1,211577758,211578032,SRX5075175,SMARCA4,274
chr1,211577768,211578259,SRX16500061,CTCF,491
chr1,211577801,211578019,SRX5075176,SMARCA4,218
chr1,211578949,211579431,SRX20140895,INTS13,482
chr1,211579245,211579548,SRX5075174,SMARCA4,303
chr1,211579245,211579688,SRX5075168,SMARCA4,443
chr1,211592051,211592568,SRX5075170,SMARCA4,517
chr1,211592083,211592653,SRX5716460,Epitope tags,570
chr1,211592087,211592560,SRX5075169,SMARCA4,473
chr1,211592093,211592580,SRX5716469,SMARCA4,487
chr1,211592111,211592612,SRX5075175,SMARCA4,501
chr1,211592122,211592523,SRX5054309,FOSL2,401
chr1,211592125,211592510,SRX5716467,SMARCA2,385
chr1,211592130,211592652,SRX5075176,SMARCA4,522
chr1,211592156,211592530,SRX5075174,SMARCA4,374
chr1,211592163,211592559,SRX5054308,FOSL2,396
chr1,211592164,211592648,SRX5716470,SMARCA4,484
chr1,211592166,211592584,SRX5075168,SMARCA4,418
chr1,211592201,211592589,SRX5716459,Epitope tags,388
chr1,211592202,211592462,SRX5716468,SMARCA2,260
chr1,211592227,211592457,SRX5075182,SMARCA2,230
chr1,211592237,211592541,SRX5020211,SMARCA2,304
chr1,211592239,211592457,SRX5054307,FOSL2,218
chr1,211592245,211592450,SRX5020214,SMARCA2,205
chr1,211611090,211611298,SRX5075170,SMARCA4,208
chr1,211611095,211611292,SRX5075176,SMARCA4,197
chr1,211613337,211613636,SRX5075169,SMARCA4,299
chr1,211613351,211613694,SRX5075175,SMARCA4,343
chr1,211613377,211613656,SRX5075176,SMARCA4,279
chr1,211613379,211613669,SRX5716469,SMARCA4,290
chr1,211613387,211613612,SRX5075170,SMARCA4,225
chr1,211613399,211613618,SRX5054308,FOSL2,219
chr1,211613422,211613659,SRX5054309,FOSL2,237
chr1,211613530,211613750,SRX5716467,SMARCA2,220
chr1,211616647,211616857,SRX5075176,SMARCA4,210
chr1,211639451,211640167,SRX5075170,SMARCA4,716
chr1,211639466,211640102,SRX5075175,SMARCA4,636
chr1,211639470,211640163,SRX5075176,SMARCA4,693
chr1,211639479,211640133,SRX5075169,SMARCA4,654
chr1,211639492,211640123,SRX5054309,FOSL2,631
chr1,211639495,211640045,SRX5716469,SMARCA4,550
chr1,211639499,211639829,SRX5054308,FOSL2,330
chr1,211639507,211639845,SRX5020214,SMARCA2,338
chr1,211648261,211648472,SRX5075174,SMARCA4,211
chr1,211650228,211650474,SRX5054309,FOSL2,246
chr1,211655119,211655630,SRX16500059,CTCF,511
chr1,211655120,211655584,SRX4174629,CTCF,464
chr1,211655149,211655618,SRX16500060,CTCF,469
chr1,211655156,211655509,SRX5075168,SMARCA4,353
chr1,211655168,211655601,SRX16500061,CTCF,433
chr1,211655176,211655501,SRX5075174,SMARCA4,325
chr1,211655177,211655636,SRX16500062,CTCF,459
chr1,211655206,211655533,SRX5075176,SMARCA4,327
chr1,211655208,211655498,SRX5075175,SMARCA4,290
chr1,211655209,211655508,SRX5716463,SMARCA4,299
chr1,211655218,211655510,SRX5716464,SMARCA4,292
chr1,211655231,211655529,SRX5075170,SMARCA4,298
chr1,211655237,211655500,SRX5716470,SMARCA4,263
chr1,211655272,211655513,SRX5075169,SMARCA4,241
chr1,211675378,211676026,SRX20140895,INTS13,648
chr1,211675450,211676135,SRX5075174,SMARCA4,685
chr1,211675536,211676143,SRX5075168,SMARCA4,607
chr1,211675550,211675968,SRX5075170,SMARCA4,418
chr1,211675557,211675868,SRX20140879,CPSF3L,311
chr1,211675566,211675847,SRX5716454,SOX3,281
chr1,211675582,211675978,SRX5075176,SMARCA4,396
chr1,211675630,211675900,SRX5716464,SMARCA4,270
chr1,211675631,211675821,SRX5716451,SOX2,190
chr1,211675635,211675888,SRX5075169,SMARCA4,253
chr1,211675738,211676201,SRX5054309,FOSL2,463
chr1,211675909,211676156,SRX5054308,FOSL2,247
chr1,211675931,211676191,SRX5054307,FOSL2,260
chr1,211680557,211681160,SRX16500059,CTCF,603
chr1,211680639,211681186,SRX16500060,CTCF,547
chr1,211680641,211681161,SRX16500061,CTCF,520
chr1,211680644,211681139,SRX16500062,CTCF,495
chr1,211680677,211681101,SRX4174629,CTCF,424
chr1,211680702,211681130,SRX5075168,SMARCA4,428
chr1,211680722,211681130,SRX5716470,SMARCA4,408
chr1,211680743,211681137,SRX5075174,SMARCA4,394
chr1,211680752,211680993,SRX5716463,SMARCA4,241
chr1,211680762,211681097,SRX5075176,SMARCA4,335
chr1,211680779,211681072,SRX5075170,SMARCA4,293
chr1,211680815,211681063,SRX5716464,SMARCA4,248
chr1,211680828,211681074,SRX5075169,SMARCA4,246
chr1,211680880,211681092,SRX5716469,SMARCA4,212
chr1,211698346,211698874,SRX16500062,CTCF,528
chr1,211698417,211698907,SRX16500060,CTCF,490
chr1,211698424,211698940,SRX16500059,CTCF,516
chr1,211698428,211698875,SRX16500061,CTCF,447
chr1,211698524,211698832,SRX5716464,SMARCA4,308
chr1,211698524,211698851,SRX4174629,CTCF,327
chr1,211698551,211698864,SRX5075174,SMARCA4,313
chr1,211698553,211698802,SRX5075170,SMARCA4,249
chr1,211698554,211698793,SRX5075168,SMARCA4,239
chr1,211698573,211698852,SRX5075176,SMARCA4,279
chr1,211698589,211698811,SRX5075169,SMARCA4,222
chr1,211698590,211698846,SRX5716470,SMARCA4,256
chr1,211698591,211698782,SRX5075175,SMARCA4,191
chr1,211716040,211716261,SRX5075170,SMARCA4,221
chr1,211724613,211725269,SRX5075176,SMARCA4,656
chr1,211724639,211725177,SRX5716470,SMARCA4,538
chr1,211724643,211725143,SRX5716468,SMARCA2,500
chr1,211724656,211725262,SRX5075170,SMARCA4,606
chr1,211724666,211725122,SRX5716469,SMARCA4,456
chr1,211724690,211725179,SRX5716467,SMARCA2,489
chr1,211724727,211725104,SRX5075169,SMARCA4,377
chr1,211724894,211725247,SRX5075174,SMARCA4,353
chr1,211724902,211725260,SRX20140868,INTS10,358
chr1,211724913,211725143,SRX5716464,SMARCA4,230
chr1,211724945,211725195,SRX5716463,SMARCA4,250
chr1,211725014,211725263,SRX5075168,SMARCA4,249
chr1,211725023,211725310,SRX20140895,INTS13,287
chr1,211735613,211736088,SRX5075175,SMARCA4,475
chr1,211735648,211736157,SRX5075176,SMARCA4,509
chr1,211735649,211736064,SRX5075170,SMARCA4,415
chr1,211735650,211736091,SRX5075169,SMARCA4,441
chr1,211735651,211736113,SRX5075174,SMARCA4,462
chr1,211735652,211736095,SRX5054309,FOSL2,443
chr1,211735673,211736007,SRX5716469,SMARCA4,334
chr1,211735680,211736109,SRX5075168,SMARCA4,429
chr1,211735689,211736035,SRX5054308,FOSL2,346
chr1,211735712,211736078,SRX5716470,SMARCA4,366
chr1,211735753,211736009,SRX5054307,FOSL2,256
chr1,211735759,211735964,SRX5020214,SMARCA2,205
chr1,211741857,211742051,SRX5075169,SMARCA4,194
chr1,211788704,211788979,SRX5716470,SMARCA4,275
chr1,211788716,211788951,SRX5075176,SMARCA4,235
chr1,211788725,211788951,SRX5716469,SMARCA4,226
chr1,211826079,211826313,SRX5054309,FOSL2,234
chr1,211829385,211829561,SRX5075174,SMARCA4,176
chr1,211829998,211830202,SRX5075169,SMARCA4,204
chr1,211830098,211830909,SRX20140895,INTS13,811
chr1,211830350,211830802,SRX20140868,INTS10,452
chr1,211830406,211830936,SRX20140867,INTS10,530
chr1,211830468,211831080,SRX16500059,CTCF,612
chr1,211830499,211830921,SRX5075169,SMARCA4,422
chr1,211830532,211830843,SRX5075175,SMARCA4,311
chr1,211830597,211830998,SRX5075174,SMARCA4,401
chr1,211830598,211831135,SRX16500060,CTCF,537
chr1,211830603,211831041,SRX5075170,SMARCA4,438
chr1,211830615,211830977,SRX5075176,SMARCA4,362
chr1,211830622,211831078,SRX16500061,CTCF,456
chr1,211830660,211831029,SRX16500062,CTCF,369
chr1,211830725,211831016,SRX5075168,SMARCA4,291
chr1,211889323,211889505,SRX5075169,SMARCA4,182
chr1,211917909,211918305,SRX5054308,FOSL2,396
chr1,211917913,211918347,SRX5075169,SMARCA4,434
chr1,211917922,211918316,SRX5075175,SMARCA4,394
chr1,211917935,211918308,SRX5075170,SMARCA4,373
chr1,211917937,211918309,SRX5054309,FOSL2,372
chr1,211917941,211918327,SRX5075176,SMARCA4,386
chr1,211917963,211918253,SRX5716469,SMARCA4,290
chr1,211918028,211918235,SRX5020211,SMARCA2,207
chr1,211918038,211918269,SRX5716470,SMARCA4,231
chr1,211918066,211918285,SRX5716467,SMARCA2,219
chr1,212011865,212012356,SRX16500061,CTCF,491
chr1,212011907,212012441,SRX16500060,CTCF,534
chr1,212011911,212012390,SRX16500062,CTCF,479
chr1,212011920,212012342,SRX16500059,CTCF,422
chr1,212011961,212012313,SRX5075168,SMARCA4,352
chr1,212012012,212012297,SRX5075174,SMARCA4,285
chr1,212012022,212012281,SRX5075170,SMARCA4,259
chr1,212012082,212012306,SRX4174629,CTCF,224
chr1,212012089,212012311,SRX5716469,SMARCA4,222
chr1,212030561,212030788,SRX5054309,FOSL2,227
chr1,212030969,212031325,SRX5054309,FOSL2,356
chr1,212031000,212031337,SRX5054308,FOSL2,337
chr1,212031010,212031231,SRX5075176,SMARCA4,221
chr1,212031011,212031342,SRX5075169,SMARCA4,331
chr1,212031040,212031276,SRX5075170,SMARCA4,236
chr1,212031054,212031349,SRX5075175,SMARCA4,295
chr1,212034856,212035531,SRX16500060,CTCF,675
chr1,212034859,212035489,SRX16500061,CTCF,630
chr1,212034871,212035518,SRX16500062,CTCF,647
chr1,212034877,212035407,SRX5075176,SMARCA4,530
chr1,212034883,212035545,SRX16500059,CTCF,662
chr1,212034894,212035467,SRX5075174,SMARCA4,573
chr1,212034913,212035469,SRX5075168,SMARCA4,556
chr1,212034944,212035358,SRX5075170,SMARCA4,414
chr1,212034951,212035542,SRX4174629,CTCF,591
chr1,212034976,212035188,SRX5716470,SMARCA4,212
chr1,212034982,212035232,SRX5716469,SMARCA4,250
chr1,212035012,212035375,SRX5075169,SMARCA4,363
chr1,212035013,212035444,SRX5716463,SMARCA4,431
chr1,212035070,212035343,SRX5716464,SMARCA4,273
chr1,212035162,212035614,SRX20140897,INTS13,452
chr1,212035166,212035782,SRX20140895,INTS13,616
chr1,212035177,212035657,SRX20140867,INTS10,480
chr1,212035288,212035722,SRX20140881,CPSF3L,434
chr1,212035359,212035640,SRX20140868,INTS10,281
chr1,212035413,212035743,SRX20140896,INTS13,330
chr1,212062700,212063277,SRX16500060,CTCF,577
chr1,212062721,212063299,SRX16500059,CTCF,578
chr1,212062745,212063273,SRX16500061,CTCF,528
chr1,212062830,212063306,SRX16500062,CTCF,476
chr1,212062939,212063219,SRX5075174,SMARCA4,280
chr1,212062973,212063179,SRX5075170,SMARCA4,206
chr1,212063022,212063240,SRX5075168,SMARCA4,218
chr1,212070707,212071094,SRX16500059,CTCF,387
chr1,212070728,212071112,SRX16500061,CTCF,384
chr1,212070730,212071084,SRX16500060,CTCF,354
chr1,212070746,212071077,SRX16500062,CTCF,331
chr1,212088412,212088732,SRX5716469,SMARCA4,320
chr1,212088429,212088857,SRX5075176,SMARCA4,428
chr1,212088432,212088772,SRX5075169,SMARCA4,340
chr1,212088451,212088817,SRX5075175,SMARCA4,366
chr1,212088468,212088818,SRX5075170,SMARCA4,350
chr1,212088531,212088839,SRX5716470,SMARCA4,308
chr1,212088545,212088772,SRX5716467,SMARCA2,227
chr1,212110673,212111029,SRX5075176,SMARCA4,356
chr1,212110674,212110989,SRX5075170,SMARCA4,315
chr1,212110714,212110968,SRX5716470,SMARCA4,254
chr1,212110715,212110988,SRX5075175,SMARCA4,273
chr1,212110727,212110994,SRX5075169,SMARCA4,267
chr1,212110730,212110953,SRX5716469,SMARCA4,223
chr1,212121013,212121224,SRX5716470,SMARCA4,211
chr1,212127169,212127509,SRX5075174,SMARCA4,340
chr1,212161173,212161435,SRX5716469,SMARCA4,262
chr1,212161424,212161775,SRX5075175,SMARCA4,351
chr1,212161427,212161760,SRX5075169,SMARCA4,333
chr1,212161463,212161701,SRX5075170,SMARCA4,238
chr1,212161463,212161773,SRX5054309,FOSL2,310
chr1,212161486,212161760,SRX5054308,FOSL2,274
chr1,212161521,212161729,SRX5075176,SMARCA4,208
chr1,212179568,212180100,SRX5075176,SMARCA4,532
chr1,212179613,212180089,SRX5075169,SMARCA4,476
chr1,212179635,212180130,SRX5075175,SMARCA4,495
chr1,212179640,212180093,SRX5075170,SMARCA4,453
chr1,212179688,212180144,SRX5054309,FOSL2,456
chr1,212179707,212180078,SRX5054308,FOSL2,371
chr1,212179709,212180016,SRX5020214,SMARCA2,307
chr1,212179731,212180080,SRX5716469,SMARCA4,349
chr1,212179733,212180049,SRX5716467,SMARCA2,316
chr1,212179739,212179999,SRX5716470,SMARCA4,260
chr1,212179859,212180038,SRX5075182,SMARCA2,179
chr1,212212894,212213376,SRX5075168,SMARCA4,482
chr1,212212989,212213444,SRX5075174,SMARCA4,455
chr1,212218876,212219298,SRX5075176,SMARCA4,422
chr1,212218939,212219359,SRX5075170,SMARCA4,420
chr1,212218949,212219282,SRX5716470,SMARCA4,333
chr1,212218964,212219301,SRX5054308,FOSL2,337
chr1,212218977,212219279,SRX5075169,SMARCA4,302
chr1,212218978,212219301,SRX5075175,SMARCA4,323
chr1,212218982,212219221,SRX5716467,SMARCA2,239
chr1,212219108,212219291,SRX5054309,FOSL2,183
chr1,212219690,212220055,SRX5075174,SMARCA4,365
chr1,212219761,212220003,SRX5075168,SMARCA4,242
chr1,212228135,212228358,SRX5054308,FOSL2,223
chr1,212234564,212235082,SRX5075176,SMARCA4,518
chr1,212234601,212234989,SRX5716470,SMARCA4,388
chr1,212234603,212235012,SRX5075168,SMARCA4,409
chr1,212234604,212235008,SRX5075170,SMARCA4,404
chr1,212234606,212235032,SRX5075175,SMARCA4,426
chr1,212234610,212234996,SRX5054308,FOSL2,386
chr1,212234624,212235005,SRX5054309,FOSL2,381
chr1,212234633,212235198,SRX5075174,SMARCA4,565
chr1,212234634,212235061,SRX5075169,SMARCA4,427
chr1,212234644,212234953,SRX5716467,SMARCA2,309
chr1,212234648,212235050,SRX5716469,SMARCA4,402
chr1,212234665,212234967,SRX5054307,FOSL2,302
chr1,212234673,212234966,SRX5020211,SMARCA2,293
chr1,212234685,212234930,SRX5075182,SMARCA2,245
chr1,212234691,212234960,SRX5716468,SMARCA2,269
chr1,212247477,212247702,SRX5075169,SMARCA4,225
chr1,212247517,212247715,SRX5054309,FOSL2,198
chr1,212284726,212284990,SRX16500059,CTCF,264
chr1,212284745,212285009,SRX16500062,CTCF,264
chr1,212284803,212285082,SRX16500060,CTCF,279
chr1,212285080,212285379,SRX5054307,FOSL2,299
chr1,212285139,212285319,SRX5054308,FOSL2,180
chr1,212285164,212285559,SRX5075168,SMARCA4,395
chr1,212285197,212285515,SRX5075174,SMARCA4,318
chr1,212285240,212285718,SRX20140895,INTS13,478
chr1,212285253,212285544,SRX5075170,SMARCA4,291
chr1,212285337,212285587,SRX5075175,SMARCA4,250
chr1,212285352,212285527,SRX5075176,SMARCA4,175
chr1,212285376,212285561,SRX5075169,SMARCA4,185
chr1,212286100,212286416,SRX20140895,INTS13,316
chr1,212291439,212291886,SRX16500060,CTCF,447
chr1,212291470,212291897,SRX16500059,CTCF,427
chr1,212291497,212291728,SRX5716464,SMARCA4,231
chr1,212291505,212291833,SRX5075168,SMARCA4,328
chr1,212291523,212291840,SRX5075174,SMARCA4,317
chr1,212291523,212291907,SRX16500062,CTCF,384
chr1,212291524,212291892,SRX16500061,CTCF,368
chr1,212291529,212291830,SRX5716463,SMARCA4,301
chr1,212291549,212291804,SRX5075169,SMARCA4,255
chr1,212291562,212291784,SRX5075176,SMARCA4,222
chr1,212291566,212291782,SRX5075170,SMARCA4,216
chr1,212301594,212301837,SRX5075176,SMARCA4,243
chr1,212301649,212301882,SRX5075170,SMARCA4,233
chr1,212303047,212303251,SRX5054308,FOSL2,204
chr1,212306004,212306386,SRX5075174,SMARCA4,382
chr1,212306126,212306451,SRX5075168,SMARCA4,325
chr1,212313669,212313976,SRX5075175,SMARCA4,307
chr1,212313670,212313975,SRX5075169,SMARCA4,305
chr1,212313676,212313952,SRX5075176,SMARCA4,276
chr1,212313702,212313932,SRX5075170,SMARCA4,230
chr1,212313728,212313970,SRX5716467,SMARCA2,242
chr1,212367938,212368382,SRX16500059,CTCF,444
chr1,212367942,212368367,SRX16500060,CTCF,425
chr1,212368011,212368370,SRX16500061,CTCF,359
chr1,212368029,212368402,SRX16500062,CTCF,373
chr1,212414367,212414549,SRX5075168,SMARCA4,182
chr1,212414424,212415054,SRX5075169,SMARCA4,630
chr1,212414650,212415313,SRX5075174,SMARCA4,663
chr1,212414715,212415305,SRX20140895,INTS13,590
chr1,212414753,212415196,SRX5075176,SMARCA4,443
chr1,212414818,212415187,SRX5075168,SMARCA4,369
chr1,212414827,212415098,SRX5716464,SMARCA4,271
chr1,212414840,212415127,SRX20140894,INTS13,287
chr1,212414852,212415181,SRX20140867,INTS10,329
chr1,212414892,212415153,SRX20140868,INTS10,261
chr1,212414905,212415259,SRX20140879,CPSF3L,354
chr1,212414948,212415157,SRX5716463,SMARCA4,209
chr1,212432587,212433336,SRX5075169,SMARCA4,749
chr1,212432610,212433166,SRX5075176,SMARCA4,556
chr1,212432633,212433323,SRX5716469,SMARCA4,690
chr1,212432640,212433318,SRX5075168,SMARCA4,678
chr1,212432664,212433135,SRX5075174,SMARCA4,471
chr1,212432673,212433146,SRX5716470,SMARCA4,473
chr1,212432679,212433147,SRX5075170,SMARCA4,468
chr1,212432682,212433128,SRX5075175,SMARCA4,446
chr1,212432709,212433284,SRX20140895,INTS13,575
chr1,212432745,212433225,SRX20140868,INTS10,480
chr1,212452806,212453181,SRX5075170,SMARCA4,375
chr1,212452833,212453105,SRX5716470,SMARCA4,272
chr1,212452847,212453115,SRX5075176,SMARCA4,268
chr1,212452856,212453114,SRX5716469,SMARCA4,258
chr1,212455793,212456298,SRX16500060,CTCF,505
chr1,212455837,212456300,SRX16500059,CTCF,463
chr1,212455837,212456304,SRX16500061,CTCF,467
chr1,212455854,212456276,SRX4174629,CTCF,422
chr1,212455863,212456291,SRX16500062,CTCF,428
chr1,212455881,212456138,SRX5716463,SMARCA4,257
chr1,212455897,212456226,SRX5075174,SMARCA4,329
chr1,212455922,212456091,SRX5075170,SMARCA4,169
chr1,212455955,212456192,SRX5075176,SMARCA4,237
chr1,212455965,212456182,SRX5075169,SMARCA4,217
chr1,212455966,212456174,SRX5075175,SMARCA4,208
chr1,212455966,212456176,SRX5075168,SMARCA4,210
chr1,212457779,212458088,SRX16500060,CTCF,309
chr1,212457818,212458093,SRX16500062,CTCF,275
chr1,212457845,212458064,SRX16500061,CTCF,219
chr1,212457849,212458084,SRX16500059,CTCF,235
chr1,212469930,212470436,SRX5075175,SMARCA4,506
chr1,212469953,212470475,SRX5075176,SMARCA4,522
chr1,212469968,212470519,SRX5716469,SMARCA4,551
chr1,212469986,212470512,SRX5075169,SMARCA4,526
chr1,212470009,212470485,SRX5716470,SMARCA4,476
chr1,212470017,212470509,SRX5075170,SMARCA4,492
chr1,212470033,212470383,SRX5054309,FOSL2,350
chr1,212470043,212470430,SRX5716467,SMARCA2,387
chr1,212470045,212470407,SRX5054308,FOSL2,362
chr1,212470070,212470407,SRX5020211,SMARCA2,337
chr1,212470100,212470359,SRX5716459,Epitope tags,259
chr1,212470131,212470342,SRX5716468,SMARCA2,211
chr1,212470152,212470469,SRX5716460,Epitope tags,317
chr1,212477057,212477533,SRX16500062,CTCF,476
chr1,212477062,212477567,SRX16500061,CTCF,505
chr1,212477065,212477586,SRX16500059,CTCF,521
chr1,212477077,212477712,SRX16500060,CTCF,635
chr1,212477104,212477508,SRX5075168,SMARCA4,404
chr1,212477122,212477543,SRX4174629,CTCF,421
chr1,212477171,212477513,SRX5716464,SMARCA4,342
chr1,212477184,212477476,SRX5716463,SMARCA4,292
chr1,212477190,212477530,SRX5075174,SMARCA4,340
chr1,212477191,212477510,SRX5075176,SMARCA4,319
chr1,212477193,212477482,SRX5716470,SMARCA4,289
chr1,212477208,212477454,SRX5075170,SMARCA4,246
chr1,212477241,212477499,SRX5075169,SMARCA4,258
chr1,212477242,212477464,SRX5716469,SMARCA4,222
chr1,212477257,212477468,SRX5075175,SMARCA4,211
chr1,212484954,212485157,SRX5054309,FOSL2,203
chr1,212485909,212486319,SRX5075168,SMARCA4,410
chr1,212485928,212486433,SRX5075174,SMARCA4,505
chr1,212485966,212486205,SRX5075170,SMARCA4,239
chr1,212485981,212486285,SRX5054308,FOSL2,304
chr1,212486016,212486254,SRX5075176,SMARCA4,238
chr1,212486090,212486290,SRX5075175,SMARCA4,200
chr1,212488643,212488911,SRX5075170,SMARCA4,268
chr1,212498300,212498480,SRX5054308,FOSL2,180
chr1,212506608,212507054,SRX5075168,SMARCA4,446
chr1,212506648,212507086,SRX5075174,SMARCA4,438
chr1,212506650,212507053,SRX5716463,SMARCA4,403
chr1,212506751,212507050,SRX5716464,SMARCA4,299
chr1,212507179,212507541,SRX20140867,INTS10,362
chr1,212507219,212507718,SRX20140895,INTS13,499
chr1,212507383,212507567,SRX5075168,SMARCA4,184
chr1,212513023,212513495,SRX5716469,SMARCA4,472
chr1,212513038,212513502,SRX5075175,SMARCA4,464
chr1,212513046,212513469,SRX5075176,SMARCA4,423
chr1,212513055,212513485,SRX5075170,SMARCA4,430
chr1,212513083,212513399,SRX5716468,SMARCA2,316
chr1,212513086,212513485,SRX5054309,FOSL2,399
chr1,212513087,212513499,SRX5716467,SMARCA2,412
chr1,212513087,212513544,SRX5075169,SMARCA4,457
chr1,212513119,212513425,SRX5054308,FOSL2,306
chr1,212513119,212513569,SRX5716470,SMARCA4,450
chr1,212513167,212513363,SRX5075181,SMARCA2,196
chr1,212513270,212513479,SRX5020214,SMARCA2,209
chr1,212514024,212514308,SRX5075168,SMARCA4,284
chr1,212518370,212518854,SRX5075170,SMARCA4,484
chr1,212518414,212518797,SRX5716470,SMARCA4,383
chr1,212518478,212518979,SRX5075176,SMARCA4,501
chr1,212518586,212518939,SRX5716469,SMARCA4,353
chr1,212518590,212518892,SRX5075175,SMARCA4,302
chr1,212518672,212518884,SRX5716468,SMARCA2,212
chr1,212525852,212526070,SRX5054309,FOSL2,218
chr1,212525863,212526045,SRX5075176,SMARCA4,182
chr1,212525866,212526093,SRX5054308,FOSL2,227
chr1,212529147,212529413,SRX5716468,SMARCA2,266
chr1,212529153,212529404,SRX5716469,SMARCA4,251
chr1,212529198,212529438,SRX5075176,SMARCA4,240
chr1,212529216,212529417,SRX5075169,SMARCA4,201
chr1,212529244,212529452,SRX5075170,SMARCA4,208
chr1,212546052,212546225,SRX5075174,SMARCA4,173
chr1,212558560,212559256,SRX5716470,SMARCA4,696
chr1,212558572,212559078,SRX20140869,INTS10,506
chr1,212558746,212559232,SRX5075170,SMARCA4,486
chr1,212558755,212559142,SRX5075175,SMARCA4,387
chr1,212558762,212559037,SRX20140897,INTS13,275
chr1,212558773,212559193,SRX5075174,SMARCA4,420
chr1,212558782,212559219,SRX5020211,SMARCA2,437
chr1,212558783,212559221,SRX5075169,SMARCA4,438
chr1,212558784,212559137,SRX20140895,INTS13,353
chr1,212558788,212559191,SRX5716469,SMARCA4,403
chr1,212558791,212559236,SRX5075176,SMARCA4,445
chr1,212558807,212559196,SRX5075168,SMARCA4,389
chr1,212558824,212559222,SRX5054308,FOSL2,398
chr1,212558830,212559224,SRX5054309,FOSL2,394
chr1,212558842,212559185,SRX5716463,SMARCA4,343
chr1,212558874,212559179,SRX5054307,FOSL2,305
chr1,212561456,212561707,SRX5075174,SMARCA4,251
chr1,212561470,212561718,SRX5075168,SMARCA4,248
chr1,212561512,212561896,SRX5075175,SMARCA4,384
chr1,212561537,212561799,SRX20140867,INTS10,262
chr1,212561594,212561843,SRX5075169,SMARCA4,249
chr1,212566952,212567507,SRX5075175,SMARCA4,555
chr1,212566953,212567565,SRX5075176,SMARCA4,612
chr1,212566978,212567500,SRX5075169,SMARCA4,522
chr1,212566980,212567571,SRX5075170,SMARCA4,591
chr1,212566993,212567500,SRX5075168,SMARCA4,507
chr1,212566994,212567497,SRX5075174,SMARCA4,503
chr1,212567008,212567523,SRX5716469,SMARCA4,515
chr1,212567066,212567459,SRX5716470,SMARCA4,393
chr1,212567070,212567445,SRX5054309,FOSL2,375
chr1,212567076,212567400,SRX5020211,SMARCA2,324
chr1,212567094,212567438,SRX5716468,SMARCA2,344
chr1,212567112,212567450,SRX5054308,FOSL2,338
chr1,212567146,212567371,SRX5020214,SMARCA2,225
chr1,212567147,212567451,SRX5716467,SMARCA2,304
chr1,212567200,212567408,SRX5054307,FOSL2,208
chr1,212584174,212584376,SRX5054308,FOSL2,202
chr1,212587333,212587543,SRX5054309,FOSL2,210
chr1,212595254,212595451,SRX5075168,SMARCA4,197
chr1,212595867,212596199,SRX16500060,CTCF,332
chr1,212595930,212596194,SRX16500062,CTCF,264
chr1,212595937,212596234,SRX16500059,CTCF,297
chr1,212595964,212596224,SRX16500061,CTCF,260
chr1,212596039,212596741,SRX5075176,SMARCA4,702
chr1,212596112,212596636,SRX5054309,FOSL2,524
chr1,212596135,212596596,SRX5075169,SMARCA4,461
chr1,212596193,212596598,SRX5075175,SMARCA4,405
chr1,212596242,212596445,SRX5020211,SMARCA2,203
chr1,212596243,212596616,SRX5075170,SMARCA4,373
chr1,212596249,212596696,SRX5054308,FOSL2,447
chr1,212596262,212596726,SRX5716469,SMARCA4,464
chr1,212596306,212596660,SRX5716470,SMARCA4,354
chr1,212596407,212596580,SRX5075174,SMARCA4,173
chr1,212601007,212601343,SRX5075170,SMARCA4,336
chr1,212601041,212601317,SRX5054309,FOSL2,276
chr1,212601127,212601377,SRX5075176,SMARCA4,250
chr1,212608192,212609405,SRX20140895,INTS13,1213
chr1,212608240,212609241,SRX20140867,INTS10,1001
chr1,212608271,212608461,SRX5075169,SMARCA4,190
chr1,212608293,212609153,SRX20140868,INTS10,860
chr1,212608308,212608743,SRX5716469,SMARCA4,435
chr1,212608308,212608776,SRX5075176,SMARCA4,468
chr1,212608310,212608678,SRX5716467,SMARCA2,368
chr1,212608310,212608783,SRX5075170,SMARCA4,473
chr1,212608338,212608798,SRX5054309,FOSL2,460
chr1,212608350,212608800,SRX5075174,SMARCA4,450
chr1,212608350,212608817,SRX5716463,SMARCA4,467
chr1,212608378,212608794,SRX5075168,SMARCA4,416
chr1,212608424,212608635,SRX5716470,SMARCA4,211
chr1,212608437,212608747,SRX5054308,FOSL2,310
chr1,212608530,212608789,SRX5075175,SMARCA4,259
chr1,212608547,212609054,SRX20140897,INTS13,507
chr1,212608551,212609169,SRX20140881,CPSF3L,618
chr1,212608565,212609119,SRX20140879,CPSF3L,554
chr1,212608574,212609146,SRX20140896,INTS13,572
chr1,212608588,212608972,SRX20140869,INTS10,384
chr1,212608609,212609078,SRX20140880,CPSF3L,469
chr1,212608634,212609156,SRX20140894,INTS13,522
chr1,212609264,212609692,SRX16500060,CTCF,428
chr1,212609266,212609726,SRX16500059,CTCF,460
chr1,212609282,212609739,SRX16500061,CTCF,457
chr1,212609302,212609724,SRX16500062,CTCF,422
chr1,212609424,212609669,SRX5075174,SMARCA4,245
chr1,212609428,212609634,SRX5075168,SMARCA4,206
chr1,212621380,212621559,SRX5075168,SMARCA4,179
chr1,212629942,212630502,SRX16500059,CTCF,560
chr1,212629962,212630469,SRX16500060,CTCF,507
chr1,212629972,212630471,SRX16500061,CTCF,499
chr1,212630011,212630437,SRX16500062,CTCF,426
chr1,212630027,212630389,SRX5075170,SMARCA4,362
chr1,212630035,212630356,SRX5075174,SMARCA4,321
chr1,212630040,212630320,SRX5075169,SMARCA4,280
chr1,212630046,212630356,SRX5075168,SMARCA4,310
chr1,212630053,212630314,SRX5716469,SMARCA4,261
chr1,212630053,212630340,SRX5716463,SMARCA4,287
chr1,212630056,212630372,SRX5075175,SMARCA4,316
chr1,212630080,212630400,SRX5075176,SMARCA4,320
chr1,212630087,212630368,SRX5716470,SMARCA4,281
chr1,212636360,212637085,SRX5075170,SMARCA4,725
chr1,212636388,212636993,SRX5075169,SMARCA4,605
chr1,212636405,212637030,SRX5716470,SMARCA4,625
chr1,212636425,212637117,SRX5075176,SMARCA4,692
chr1,212636546,212636952,SRX5716469,SMARCA4,406
chr1,212636560,212636962,SRX5716467,SMARCA2,402
chr1,212636593,212637023,SRX5075175,SMARCA4,430
chr1,212636614,212636942,SRX5054308,FOSL2,328
chr1,212636700,212636987,SRX5054309,FOSL2,287
chr1,212638451,212638724,SRX5054309,FOSL2,273
chr1,212638468,212638716,SRX5054308,FOSL2,248
chr1,212638480,212638769,SRX5716470,SMARCA4,289
chr1,212638589,212638785,SRX5075169,SMARCA4,196
chr1,212649089,212649371,SRX5716470,SMARCA4,282
chr1,212649135,212649411,SRX5075169,SMARCA4,276
chr1,212649167,212649361,SRX5075175,SMARCA4,194
chr1,212655961,212656221,SRX5075176,SMARCA4,260
chr1,212656023,212656327,SRX5075170,SMARCA4,304
chr1,212656049,212656240,SRX5054309,FOSL2,191
chr1,212658361,212658674,SRX5075174,SMARCA4,313
chr1,212658389,212658592,SRX5075168,SMARCA4,203
chr1,212665137,212665639,SRX16500060,CTCF,502
chr1,212665168,212665678,SRX16500059,CTCF,510
chr1,212665169,212665646,SRX16500061,CTCF,477
chr1,212665194,212665635,SRX16500062,CTCF,441
chr1,212665290,212665615,SRX5075168,SMARCA4,325
chr1,212665352,212665559,SRX5075174,SMARCA4,207
chr1,212665367,212665626,SRX4174629,CTCF,259
chr1,212665382,212665686,SRX20140895,INTS13,304
chr1,212667249,212668240,SRX5075176,SMARCA4,991
chr1,212667308,212668088,SRX5075168,SMARCA4,780
chr1,212667316,212668139,SRX5075174,SMARCA4,823
chr1,212667319,212668208,SRX5075169,SMARCA4,889
chr1,212667380,212668128,SRX5716470,SMARCA4,748
chr1,212667393,212668092,SRX5716467,SMARCA2,699
chr1,212667397,212667749,SRX5054309,FOSL2,352
chr1,212667397,212668181,SRX5054308,FOSL2,784
chr1,212667404,212668222,SRX5075170,SMARCA4,818
chr1,212667417,212667721,SRX5716464,SMARCA4,304
chr1,212667419,212667814,SRX5716463,SMARCA4,395
chr1,212667420,212667766,SRX5054307,FOSL2,346
chr1,212667434,212668160,SRX5716469,SMARCA4,726
chr1,212667464,212668145,SRX5075175,SMARCA4,681
chr1,212667486,212667711,SRX5075182,SMARCA2,225
chr1,212667494,212667754,SRX5716451,SOX2,260
chr1,212667507,212667812,SRX5020211,SMARCA2,305
chr1,212667508,212668135,SRX5716468,SMARCA2,627
chr1,212667884,212668205,SRX5054309,FOSL2,321
chr1,212667936,212668199,SRX5020214,SMARCA2,263
chr1,212669203,212669385,SRX5075174,SMARCA4,182
chr1,212671635,212672018,SRX5075176,SMARCA4,383
chr1,212671645,212671970,SRX5075170,SMARCA4,325
chr1,212671683,212671954,SRX5716469,SMARCA4,271
chr1,212671721,212671998,SRX5075175,SMARCA4,277
chr1,212671731,212672007,SRX5075169,SMARCA4,276
chr1,212680812,212680985,SRX5075174,SMARCA4,173
chr1,212693082,212693308,SRX5075169,SMARCA4,226
chr1,212693105,212693334,SRX5075175,SMARCA4,229
chr1,212693112,212693361,SRX5054309,FOSL2,249
chr1,212699091,212699590,SRX16500060,CTCF,499
chr1,212699107,212699537,SRX16500059,CTCF,430
chr1,212699141,212699589,SRX16500061,CTCF,448
chr1,212699285,212699527,SRX16500062,CTCF,242
chr1,212712337,212712557,SRX5075175,SMARCA4,220
chr1,212712384,212712739,SRX5075169,SMARCA4,355
chr1,212712416,212712886,SRX5075170,SMARCA4,470
chr1,212712456,212712639,SRX5054309,FOSL2,183
chr1,212712474,212712836,SRX5716460,Epitope tags,362
chr1,212718626,212718873,SRX5075176,SMARCA4,247
chr1,212721563,212721852,SRX5075169,SMARCA4,289
chr1,212721572,212721906,SRX5054309,FOSL2,334
chr1,212721576,212721893,SRX5075170,SMARCA4,317
chr1,212721593,212721898,SRX5054308,FOSL2,305
chr1,212721606,212721863,SRX5075176,SMARCA4,257
chr1,212721616,212721861,SRX5075175,SMARCA4,245
chr1,212727888,212728071,SRX5054309,FOSL2,183
chr1,212738382,212738764,SRX5716469,SMARCA4,382
chr1,212749722,212750250,SRX16500059,CTCF,528
chr1,212749744,212750318,SRX16500060,CTCF,574
chr1,212749817,212750322,SRX16500061,CTCF,505
chr1,212749827,212750281,SRX16500062,CTCF,454
chr1,212749892,212750176,SRX5075170,SMARCA4,284
chr1,212749896,212750214,SRX5075168,SMARCA4,318
chr1,212749906,212750259,SRX5716464,SMARCA4,353
chr1,212749917,212750249,SRX5075174,SMARCA4,332
chr1,212749966,212750166,SRX5054309,FOSL2,200
chr1,212749974,212750199,SRX5716470,SMARCA4,225
chr1,212749985,212750198,SRX5075176,SMARCA4,213
chr1,212749989,212750191,SRX5075169,SMARCA4,202
chr1,212750009,212750230,SRX5075175,SMARCA4,221
chr1,212750013,212750224,SRX5716463,SMARCA4,211
chr1,212774633,212774842,SRX5075176,SMARCA4,209
chr1,212774649,212774917,SRX5075175,SMARCA4,268
chr1,212774743,212774913,SRX5075170,SMARCA4,170
chr1,212782331,212782850,SRX16500059,CTCF,519
chr1,212782377,212782855,SRX16500060,CTCF,478
chr1,212782409,212782834,SRX16500061,CTCF,425
chr1,212782437,212782833,SRX16500062,CTCF,396
chr1,212782492,212782677,SRX5075174,SMARCA4,185
chr1,212782503,212782731,SRX5075176,SMARCA4,228
chr1,212782717,212783202,SRX5075175,SMARCA4,485
chr1,212782778,212783194,SRX5075169,SMARCA4,416
chr1,212782823,212783174,SRX5075170,SMARCA4,351
chr1,212782830,212783127,SRX5716469,SMARCA4,297
chr1,212782841,212783203,SRX5075176,SMARCA4,362
chr1,212782860,212783071,SRX5716470,SMARCA4,211
chr1,212782870,212783133,SRX5054308,FOSL2,263
chr1,212782905,212783120,SRX5075168,SMARCA4,215
chr1,212782911,212783166,SRX5054309,FOSL2,255
chr1,212791518,212791693,SRX5075176,SMARCA4,175
chr1,212791530,212792166,SRX20140895,INTS13,636
chr1,212791540,212792111,SRX20140879,CPSF3L,571
chr1,212791544,212792156,SRX5075174,SMARCA4,612
chr1,212791548,212791791,SRX5716469,SMARCA4,243
chr1,212791550,212792018,SRX5075170,SMARCA4,468
chr1,212791559,212792036,SRX5075168,SMARCA4,477
chr1,212791560,212791740,SRX5075169,SMARCA4,180
chr1,212791583,212791811,SRX5075175,SMARCA4,228
chr1,212791586,212792008,SRX20140867,INTS10,422
chr1,212791592,212792143,SRX20140868,INTS10,551
chr1,212791690,212792079,SRX20140869,INTS10,389
chr1,212791736,212792119,SRX20140881,CPSF3L,383
chr1,212791766,212791943,SRX5075176,SMARCA4,177
chr1,212791790,212791886,SRX1424894,POU3F2,96
chr1,212814970,212815362,SRX16500059,CTCF,392
chr1,212815018,212815379,SRX16500062,CTCF,361
chr1,212815059,212815310,SRX16500061,CTCF,251
chr1,212815072,212815354,SRX16500060,CTCF,282
chr1,212816661,212816849,SRX5054309,FOSL2,188
chr1,212857493,212858031,SRX20140869,INTS10,538
chr1,212857741,212858070,SRX5716470,SMARCA4,329
chr1,212857761,212858414,SRX5075174,SMARCA4,653
chr1,212857801,212858334,SRX20140867,INTS10,533
chr1,212857808,212858388,SRX5075170,SMARCA4,580
chr1,212857813,212858518,SRX20140895,INTS13,705
chr1,212857871,212858149,SRX20140881,CPSF3L,278
chr1,212857884,212858102,SRX5716469,SMARCA4,218
chr1,212857926,212858148,SRX5075175,SMARCA4,222
chr1,212857948,212858335,SRX20140868,INTS10,387
chr1,212857964,212858422,SRX5075168,SMARCA4,458
chr1,212858000,212858392,SRX5075176,SMARCA4,392
chr1,212858006,212858345,SRX20140897,INTS13,339
chr1,212858096,212858316,SRX5716464,SMARCA4,220
chr1,212858132,212858348,SRX5075169,SMARCA4,216
chr1,212858237,212858594,SRX5716470,SMARCA4,357
chr1,212915274,212915618,SRX16500060,CTCF,344
chr1,212915281,212915468,SRX5075175,SMARCA4,187
chr1,212915291,212915513,SRX5716470,SMARCA4,222
chr1,212915298,212915602,SRX5075176,SMARCA4,304
chr1,212915323,212915554,SRX16500062,CTCF,231
chr1,212915332,212915622,SRX16500059,CTCF,290
chr1,212915334,212915581,SRX5075170,SMARCA4,247
chr1,212915335,212915515,SRX5075169,SMARCA4,180
chr1,212915374,212915593,SRX16500061,CTCF,219
chr1,212924670,212925333,SRX5075176,SMARCA4,663
chr1,212924673,212925302,SRX5075175,SMARCA4,629
chr1,212924708,212925368,SRX5075170,SMARCA4,660
chr1,212924731,212925412,SRX5716470,SMARCA4,681
chr1,212924786,212925054,SRX5054309,FOSL2,268
chr1,212924789,212925227,SRX5716469,SMARCA4,438
chr1,212924791,212925351,SRX5075169,SMARCA4,560
chr1,212924812,212925128,SRX5054308,FOSL2,316
chr1,212924823,212925213,SRX5716467,SMARCA2,390
chr1,212928745,212929456,SRX5075168,SMARCA4,711
chr1,212928911,212929461,SRX5075174,SMARCA4,550
chr1,212950199,212950471,SRX5075169,SMARCA4,272
chr1,212950236,212950570,SRX5075168,SMARCA4,334
chr1,212950237,212950567,SRX5075170,SMARCA4,330
chr1,212950274,212950544,SRX5075176,SMARCA4,270
chr1,212950288,212950787,SRX5075174,SMARCA4,499
chr1,212950303,212950615,SRX5716463,SMARCA4,312
chr1,212950318,212950876,SRX20140895,INTS13,558
chr1,212950386,212950591,SRX5716454,SOX3,205
chr1,212950387,212950685,SRX5716451,SOX2,298
chr1,212950635,212950970,SRX5716470,SMARCA4,335
chr1,212950685,212951063,SRX5075169,SMARCA4,378
chr1,212950761,212950961,SRX5075168,SMARCA4,200
chr1,212950786,212950988,SRX5075176,SMARCA4,202
chr1,212967788,212968169,SRX16500061,CTCF,381
chr1,212967791,212968261,SRX16500060,CTCF,470
chr1,212967794,212968285,SRX16500059,CTCF,491
chr1,212967826,212968174,SRX16500062,CTCF,348
chr1,212967910,212968159,SRX5075170,SMARCA4,249
chr1,212967952,212968161,SRX5075176,SMARCA4,209
chr1,212967976,212968159,SRX5054309,FOSL2,183
chr1,212969075,212969257,SRX5075170,SMARCA4,182
chr1,212980122,212980361,SRX5716470,SMARCA4,239
chr1,212980214,212980712,SRX5075174,SMARCA4,498
chr1,212980280,212980793,SRX5075176,SMARCA4,513
chr1,212980413,212980676,SRX5075169,SMARCA4,263
chr1,212980440,212980717,SRX5075168,SMARCA4,277
chr1,212980459,212980716,SRX5716470,SMARCA4,257
chr1,212980461,212980726,SRX5075170,SMARCA4,265
chr1,212980490,212980700,SRX5075175,SMARCA4,210
chr1,212987823,212988215,SRX5075176,SMARCA4,392
chr1,212987969,212988172,SRX5075170,SMARCA4,203
chr1,212995379,212995973,SRX16500059,CTCF,594
chr1,212995414,212995904,SRX16500060,CTCF,490
chr1,212995430,212995927,SRX16500062,CTCF,497
chr1,212995434,212995948,SRX16500061,CTCF,514
chr1,212995460,212995800,SRX5075174,SMARCA4,340
chr1,212995478,212995834,SRX5075176,SMARCA4,356
chr1,212995483,212995776,SRX5716464,SMARCA4,293
chr1,212995503,212995834,SRX5075168,SMARCA4,331
chr1,212995509,212995821,SRX5075169,SMARCA4,312
chr1,212995515,212995813,SRX5075170,SMARCA4,298
chr1,212995537,212995820,SRX5716470,SMARCA4,283
chr1,212995541,212995782,SRX5075175,SMARCA4,241
chr1,212995542,212995788,SRX5716469,SMARCA4,246
chr1,213015080,213015394,SRX5716470,SMARCA4,314
chr1,213015130,213015418,SRX5075175,SMARCA4,288
chr1,213015139,213015470,SRX5075170,SMARCA4,331
chr1,213015157,213016037,SRX20140895,INTS13,880
chr1,213015178,213015462,SRX5075176,SMARCA4,284
chr1,213015261,213015487,SRX5075169,SMARCA4,226
chr1,213015541,213015980,SRX5716464,SMARCA4,439
chr1,213015613,213015968,SRX20140897,INTS13,355
chr1,213015617,213015843,SRX5075169,SMARCA4,226
chr1,213015620,213015889,SRX20140867,INTS10,269
chr1,213015627,213015994,SRX5075174,SMARCA4,367
chr1,213015629,213015923,SRX5075176,SMARCA4,294
chr1,213015629,213015952,SRX5075168,SMARCA4,323
chr1,213015639,213015917,SRX20140868,INTS10,278
chr1,213015641,213015949,SRX20140879,CPSF3L,308
chr1,213015651,213015904,SRX5075170,SMARCA4,253
chr1,213041470,213041720,SRX5075169,SMARCA4,250
chr1,213041490,213041706,SRX5075175,SMARCA4,216
chr1,213041502,213041771,SRX5054309,FOSL2,269
chr1,213041531,213041827,SRX5054308,FOSL2,296
chr1,213041562,213041741,SRX5075168,SMARCA4,179
chr1,213050967,213051272,SRX20140869,INTS10,305
chr1,213050977,213051551,SRX20140895,INTS13,574
chr1,213051038,213051305,SRX20140868,INTS10,267
chr1,213051051,213051333,SRX20140867,INTS10,282
chr1,213051053,213051529,SRX5075168,SMARCA4,476
chr1,213051062,213051432,SRX5075176,SMARCA4,370
chr1,213051065,213051442,SRX5075174,SMARCA4,377
chr1,213051188,213051499,SRX5716470,SMARCA4,311
chr1,213051194,213051452,SRX5075170,SMARCA4,258
chr1,213051250,213051492,SRX5716463,SMARCA4,242
chr1,213051259,213051502,SRX5075175,SMARCA4,243
chr1,213051688,213051879,SRX5054309,FOSL2,191
chr1,213051708,213051909,SRX5054308,FOSL2,201
chr1,213070360,213070722,SRX5075176,SMARCA4,362
chr1,213070367,213070618,SRX5054308,FOSL2,251
chr1,213070380,213070653,SRX5075175,SMARCA4,273
chr1,213070381,213070626,SRX5716469,SMARCA4,245
chr1,213070409,213070735,SRX5075170,SMARCA4,326
chr1,213070441,213070706,SRX5075169,SMARCA4,265
chr1,213070446,213070759,SRX5716470,SMARCA4,313
chr1,213122214,213122880,SRX16500061,CTCF,666
chr1,213122323,213122982,SRX16500062,CTCF,659
chr1,213122352,213122891,SRX16500059,CTCF,539
chr1,213122398,213122920,SRX16500060,CTCF,522
chr1,213122534,213122840,SRX5716470,SMARCA4,306
chr1,213122542,213122817,SRX5075176,SMARCA4,275
chr1,213122552,213122793,SRX5075174,SMARCA4,241
chr1,213122559,213122819,SRX5075168,SMARCA4,260
chr1,213122577,213122786,SRX5075170,SMARCA4,209
chr1,213123608,213123876,SRX5054308,FOSL2,268
chr1,213123629,213123973,SRX5054309,FOSL2,344
chr1,213123633,213123863,SRX5075174,SMARCA4,230
chr1,213123654,213123885,SRX5075169,SMARCA4,231
chr1,213123669,213123838,SRX5075170,SMARCA4,169
chr1,213192129,213192434,SRX5075176,SMARCA4,305
chr1,213192136,213192367,SRX5054308,FOSL2,231
chr1,213192153,213192379,SRX5054309,FOSL2,226
chr1,213192166,213192335,SRX5075170,SMARCA4,169
chr1,213231907,213232177,SRX5075168,SMARCA4,270
chr1,213231958,213232293,SRX20140881,CPSF3L,335
chr1,213232023,213232270,SRX5075174,SMARCA4,247
chr1,213244388,213245002,SRX16500061,CTCF,614
chr1,213244406,213245015,SRX16500059,CTCF,609
chr1,213244466,213245000,SRX16500062,CTCF,534
chr1,213244543,213245027,SRX16500060,CTCF,484
chr1,213244638,213244954,SRX5075174,SMARCA4,316
chr1,213244681,213244893,SRX5075170,SMARCA4,212
chr1,213244690,213244923,SRX5716463,SMARCA4,233
chr1,213244730,213244960,SRX5075168,SMARCA4,230
chr1,213252177,213252481,SRX5075168,SMARCA4,304
chr1,213274754,213275073,SRX5716463,SMARCA4,319
chr1,213274794,213275078,SRX5075174,SMARCA4,284
chr1,213274817,213275018,SRX5075168,SMARCA4,201
chr1,213284725,213284954,SRX5054308,FOSL2,229
chr1,213284729,213284955,SRX5054309,FOSL2,226
chr1,213286322,213286553,SRX16500062,CTCF,231
chr1,213286326,213286595,SRX16500061,CTCF,269
chr1,213326909,213327604,SRX5075175,SMARCA4,695
chr1,213327280,213327636,SRX5716469,SMARCA4,356
chr1,213327291,213327580,SRX5716467,SMARCA2,289
chr1,213327294,213327669,SRX5075170,SMARCA4,375
chr1,213327297,213327638,SRX5075176,SMARCA4,341
chr1,213327299,213327573,SRX5054307,FOSL2,274
chr1,213327300,213327668,SRX5716470,SMARCA4,368
chr1,213327312,213327611,SRX20140897,INTS13,299
chr1,213327315,213327625,SRX5054309,FOSL2,310
chr1,213327316,213327677,SRX5075169,SMARCA4,361
chr1,213327320,213327633,SRX5054308,FOSL2,313
chr1,213327322,213327612,SRX5075168,SMARCA4,290
chr1,213327357,213327609,SRX5075174,SMARCA4,252
chr1,213327435,213327635,SRX5020211,SMARCA2,200
chr1,213331542,213331984,SRX5075174,SMARCA4,442
chr1,213331580,213331934,SRX20140867,INTS10,354
chr1,213331605,213331905,SRX5075168,SMARCA4,300
chr1,213374196,213374735,SRX16500059,CTCF,539
chr1,213374211,213374717,SRX16500061,CTCF,506
chr1,213374220,213374704,SRX16500060,CTCF,484
chr1,213374272,213374698,SRX16500062,CTCF,426
chr1,213374352,213374579,SRX5716464,SMARCA4,227
chr1,213374359,213374667,SRX5075174,SMARCA4,308
chr1,213374374,213374577,SRX5075176,SMARCA4,203
chr1,213374377,213374695,SRX5075168,SMARCA4,318
chr1,213374380,213374610,SRX5075169,SMARCA4,230
chr1,213374388,213374591,SRX5075170,SMARCA4,203
chr1,213374400,213374653,SRX4174629,CTCF,253
chr1,213374410,213374605,SRX5075175,SMARCA4,195
chr1,213374413,213374624,SRX5716470,SMARCA4,211
chr1,213399698,213400149,SRX5075174,SMARCA4,451
chr1,213399739,213400214,SRX5075168,SMARCA4,475
chr1,213399859,213400157,SRX5716463,SMARCA4,298
chr1,213496447,213496646,SRX5054309,FOSL2,199
chr1,213564197,213564512,SRX16500060,CTCF,315
chr1,213564251,213564471,SRX16500061,CTCF,220
chr1,213564253,213564512,SRX16500062,CTCF,259
chr1,213564299,213564493,SRX5075174,SMARCA4,194
chr1,213618117,213618662,SRX5054309,FOSL2,545
chr1,213618171,213618351,SRX5054308,FOSL2,180
chr1,213661301,213661564,SRX20140867,INTS10,263
chr1,213661329,213661602,SRX5075174,SMARCA4,273
chr1,213661356,213661599,SRX5075168,SMARCA4,243
chr1,213690155,213690391,SRX5075174,SMARCA4,236
chr1,213724998,213725619,SRX5075176,SMARCA4,621
chr1,213725010,213725595,SRX5075170,SMARCA4,585
chr1,213725038,213725482,SRX5075169,SMARCA4,444
chr1,213725103,213725566,SRX5716470,SMARCA4,463
chr1,213725131,213725387,SRX5716467,SMARCA2,256
chr1,213725144,213725385,SRX5075175,SMARCA4,241
chr1,213725155,213725375,SRX5716469,SMARCA4,220
chr1,213762085,213762420,SRX5075168,SMARCA4,335
chr1,213762116,213762397,SRX5075174,SMARCA4,281
chr1,213783257,213783489,SRX5075168,SMARCA4,232
chr1,213783293,213783494,SRX5075174,SMARCA4,201
chr1,213970246,213970591,SRX5075176,SMARCA4,345
chr1,213982675,213983266,SRX20140895,INTS13,591
chr1,213982806,213983112,SRX20140868,INTS10,306
chr1,213982886,213983130,SRX5075174,SMARCA4,244
chr1,213987679,213988106,SRX5075169,SMARCA4,427
chr1,213987709,213988101,SRX5075175,SMARCA4,392
chr1,213987742,213988170,SRX5716469,SMARCA4,428
chr1,213987743,213988166,SRX20140895,INTS13,423
chr1,213987744,213988164,SRX5716470,SMARCA4,420
chr1,213987910,213988133,SRX5075176,SMARCA4,223
chr1,213987922,213988142,SRX5075170,SMARCA4,220
chr1,214002516,214002869,SRX5075168,SMARCA4,353
chr1,214002527,214002841,SRX5075176,SMARCA4,314
chr1,214002535,214002836,SRX5075174,SMARCA4,301
chr1,214002536,214002838,SRX5075170,SMARCA4,302
chr1,214002594,214002859,SRX5054309,FOSL2,265
chr1,214002635,214002815,SRX5054308,FOSL2,180
chr1,214009040,214009291,SRX5075174,SMARCA4,251
chr1,214009053,214009240,SRX5075168,SMARCA4,187
chr1,214009518,214010001,SRX5075174,SMARCA4,483
chr1,214009622,214010153,SRX5075168,SMARCA4,531
chr1,214017513,214017696,SRX5075168,SMARCA4,183
chr1,214018840,214019179,SRX5075168,SMARCA4,339
chr1,214018863,214019183,SRX5075174,SMARCA4,320
chr1,214029826,214030248,SRX5075174,SMARCA4,422
chr1,214029835,214030188,SRX5075168,SMARCA4,353
chr1,214029948,214030224,SRX20140895,INTS13,276
chr1,214102864,214103289,SRX5075170,SMARCA4,425
chr1,214102885,214103326,SRX5075174,SMARCA4,441
chr1,214102896,214103298,SRX5075169,SMARCA4,402
chr1,214102915,214103248,SRX5054309,FOSL2,333
chr1,214102922,214103333,SRX5075176,SMARCA4,411
chr1,214102959,214103321,SRX5075168,SMARCA4,362
chr1,214102972,214103198,SRX5054308,FOSL2,226
chr1,214102982,214103330,SRX5075175,SMARCA4,348
chr1,214102999,214103223,SRX5716469,SMARCA4,224
chr1,214123114,214123507,SRX16500061,CTCF,393
chr1,214123114,214123892,SRX5075170,SMARCA4,778
chr1,214123131,214123568,SRX16500059,CTCF,437
chr1,214123159,214123526,SRX5075174,SMARCA4,367
chr1,214123160,214123585,SRX16500060,CTCF,425
chr1,214123174,214123521,SRX4174629,CTCF,347
chr1,214123174,214123871,SRX5075176,SMARCA4,697
chr1,214123208,214123751,SRX5716470,SMARCA4,543
chr1,214123209,214123458,SRX5075168,SMARCA4,249
chr1,214123210,214123566,SRX16500062,CTCF,356
chr1,214123243,214123863,SRX5075169,SMARCA4,620
chr1,214123341,214123782,SRX5054308,FOSL2,441
chr1,214123348,214123708,SRX5716469,SMARCA4,360
chr1,214123357,214123838,SRX5054309,FOSL2,481
chr1,214123390,214123782,SRX5075175,SMARCA4,392
chr1,214123431,214123647,SRX5020211,SMARCA2,216
chr1,214123488,214123790,SRX5020214,SMARCA2,302
chr1,214123509,214123792,SRX5716467,SMARCA2,283
chr1,214123602,214123796,SRX5075181,SMARCA2,194
chr1,214135901,214136196,SRX5075176,SMARCA4,295
chr1,214135912,214136172,SRX5075170,SMARCA4,260
chr1,214135914,214136382,SRX5054309,FOSL2,468
chr1,214135915,214136332,SRX5054308,FOSL2,417
chr1,214135938,214136118,SRX5075169,SMARCA4,180
chr1,214136252,214136554,SRX5716470,SMARCA4,302
chr1,214136278,214136508,SRX5075168,SMARCA4,230
chr1,214136290,214136807,SRX5075176,SMARCA4,517
chr1,214136292,214136725,SRX5075169,SMARCA4,433
chr1,214136369,214136778,SRX5075175,SMARCA4,409
chr1,214136380,214136812,SRX5075174,SMARCA4,432
chr1,214136454,214136839,SRX5075170,SMARCA4,385
chr1,214136514,214136694,SRX5054308,FOSL2,180
chr1,214136538,214136771,SRX5054309,FOSL2,233
chr1,214143490,214143956,SRX5075168,SMARCA4,466
chr1,214143634,214143911,SRX5075174,SMARCA4,277
chr1,214154783,214155113,SRX5075168,SMARCA4,330
chr1,214154803,214155222,SRX5075174,SMARCA4,419
chr1,214187150,214187455,SRX5075174,SMARCA4,305
chr1,214187211,214187426,SRX5716467,SMARCA2,215
chr1,214187243,214187435,SRX5075175,SMARCA4,192
chr1,214187267,214187537,SRX5075168,SMARCA4,270
chr1,214192784,214193559,SRX5075168,SMARCA4,775
chr1,214192813,214193745,SRX5075174,SMARCA4,932
chr1,214192899,214193082,SRX5054309,FOSL2,183
chr1,214192910,214193210,SRX5075170,SMARCA4,300
chr1,214193048,214193282,SRX5716463,SMARCA4,234
chr1,214193166,214193511,SRX20140895,INTS13,345
chr1,214204996,214205662,SRX5075174,SMARCA4,666
chr1,214205011,214205648,SRX5075168,SMARCA4,637
chr1,214205093,214205475,SRX20140895,INTS13,382
chr1,214205117,214205492,SRX20140868,INTS10,375
chr1,214205137,214205394,SRX5716463,SMARCA4,257
chr1,214205205,214205430,SRX5716454,SOX3,225
chr1,214205207,214205455,SRX5716451,SOX2,248
chr1,214208543,214208813,SRX5075168,SMARCA4,270
chr1,214213726,214214143,SRX16500062,CTCF,417
chr1,214213820,214214154,SRX16500061,CTCF,334
chr1,214213854,214214171,SRX16500059,CTCF,317
chr1,214213874,214214140,SRX16500060,CTCF,266
chr1,214213979,214214153,SRX5075174,SMARCA4,174
chr1,214214051,214214288,SRX4174629,CTCF,237
chr1,214248353,214248627,SRX5075175,SMARCA4,274
chr1,214248357,214248602,SRX5054308,FOSL2,245
chr1,214248379,214248679,SRX5054309,FOSL2,300
chr1,214248401,214248923,SRX5075170,SMARCA4,522
chr1,214248402,214248866,SRX5075169,SMARCA4,464
chr1,214248462,214248725,SRX5075176,SMARCA4,263
chr1,214248721,214248901,SRX5075168,SMARCA4,180
chr1,214248754,214249053,SRX5075174,SMARCA4,299
chr1,214261369,214261924,SRX16500059,CTCF,555
chr1,214261403,214261941,SRX16500062,CTCF,538
chr1,214261414,214261957,SRX16500060,CTCF,543
chr1,214261453,214261881,SRX16500061,CTCF,428
chr1,214261491,214261906,SRX5075168,SMARCA4,415
chr1,214261530,214261901,SRX5716463,SMARCA4,371
chr1,214261538,214261871,SRX5075174,SMARCA4,333
chr1,214261539,214261917,SRX5716470,SMARCA4,378
chr1,214261547,214261905,SRX4174629,CTCF,358
chr1,214261556,214261880,SRX5075170,SMARCA4,324
chr1,214261563,214261951,SRX5075176,SMARCA4,388
chr1,214261567,214261866,SRX5075169,SMARCA4,299
chr1,214261579,214261885,SRX5075175,SMARCA4,306
chr1,214261583,214261874,SRX5716464,SMARCA4,291
chr1,214261623,214261883,SRX5716469,SMARCA4,260
chr1,214266845,214266885,SRX1424891,POU3F2,40
chr1,214270331,214270659,SRX5075176,SMARCA4,328
chr1,214270346,214270573,SRX5054309,FOSL2,227
chr1,214270404,214270573,SRX5075170,SMARCA4,169
chr1,214271548,214271822,SRX5075168,SMARCA4,274
chr1,214271553,214271772,SRX5075174,SMARCA4,219
chr1,214280639,214281535,SRX20140895,INTS13,896
chr1,214280675,214280946,SRX20140868,INTS10,271
chr1,214281125,214281694,SRX5075174,SMARCA4,569
chr1,214281129,214281477,SRX20140868,INTS10,348
chr1,214281195,214281426,SRX5075168,SMARCA4,231
chr1,214281376,214281700,SRX5075170,SMARCA4,324
chr1,214281467,214281689,SRX5075176,SMARCA4,222
chr1,214289772,214290242,SRX5075168,SMARCA4,470
chr1,214289836,214290250,SRX5075174,SMARCA4,414
chr1,214296164,214296337,SRX5075174,SMARCA4,173
chr1,214296947,214297418,SRX5054308,FOSL2,471
chr1,214296949,214297551,SRX5075169,SMARCA4,602
chr1,214296986,214297528,SRX5075175,SMARCA4,542
chr1,214296990,214297428,SRX5716469,SMARCA4,438
chr1,214296994,214297489,SRX5075170,SMARCA4,495
chr1,214297006,214297437,SRX5054309,FOSL2,431
chr1,214297018,214297454,SRX5020214,SMARCA2,436
chr1,214297025,214297583,SRX5075176,SMARCA4,558
chr1,214297097,214297393,SRX5716467,SMARCA2,296
chr1,214297124,214297364,SRX5716470,SMARCA4,240
chr1,214297139,214297342,SRX5075182,SMARCA2,203
chr1,214303301,214303570,SRX5075176,SMARCA4,269
chr1,214314200,214314460,SRX5075174,SMARCA4,260
chr1,214314238,214314526,SRX5075168,SMARCA4,288
chr1,214316556,214316941,SRX5075169,SMARCA4,385
chr1,214316590,214316850,SRX5716470,SMARCA4,260
chr1,214316623,214316911,SRX5075176,SMARCA4,288
chr1,214316707,214316919,SRX5075170,SMARCA4,212
chr1,214316727,214316943,SRX5054308,FOSL2,216
chr1,214316732,214316982,SRX5054309,FOSL2,250
chr1,214318119,214318789,SRX5075170,SMARCA4,670
chr1,214318248,214318800,SRX5075176,SMARCA4,552
chr1,214318312,214318781,SRX5075169,SMARCA4,469
chr1,214318327,214318763,SRX5075175,SMARCA4,436
chr1,214318380,214318782,SRX5054309,FOSL2,402
chr1,214318394,214318758,SRX5716469,SMARCA4,364
chr1,214318417,214318832,SRX5054308,FOSL2,415
chr1,214318427,214318659,SRX5716470,SMARCA4,232
chr1,214318439,214318695,SRX5020211,SMARCA2,256
chr1,214319961,214320236,SRX16500062,CTCF,275
chr1,214327625,214327848,SRX5075174,SMARCA4,223
chr1,214328790,214329172,SRX16500060,CTCF,382
chr1,214328795,214329165,SRX16500062,CTCF,370
chr1,214328816,214329181,SRX16500061,CTCF,365
chr1,214328824,214329196,SRX16500059,CTCF,372
chr1,214328894,214329081,SRX5075168,SMARCA4,187
chr1,214328901,214329144,SRX5075170,SMARCA4,243
chr1,214328932,214329177,SRX5054309,FOSL2,245
chr1,214328935,214329134,SRX5054308,FOSL2,199
chr1,214328951,214329126,SRX5075176,SMARCA4,175
chr1,214331868,214332147,SRX16500060,CTCF,279
chr1,214331874,214332217,SRX16500059,CTCF,343
chr1,214331883,214332177,SRX16500061,CTCF,294
chr1,214331889,214332125,SRX5075168,SMARCA4,236
chr1,214331894,214332113,SRX5075174,SMARCA4,219
chr1,214331896,214332130,SRX16500062,CTCF,234
chr1,214332908,214333317,SRX16500060,CTCF,409
chr1,214332985,214333298,SRX16500062,CTCF,313
chr1,214332985,214333324,SRX16500059,CTCF,339
chr1,214333001,214333343,SRX16500061,CTCF,342
chr1,214337466,214338001,SRX5716470,SMARCA4,535
chr1,214337475,214337803,SRX5075176,SMARCA4,328
chr1,214337488,214337785,SRX5716467,SMARCA2,297
chr1,214337502,214337920,SRX5716469,SMARCA4,418
chr1,214337511,214337799,SRX5075170,SMARCA4,288
chr1,214337519,214337768,SRX5075169,SMARCA4,249
chr1,214337534,214337817,SRX5075175,SMARCA4,283
chr1,214337591,214337824,SRX5716468,SMARCA2,233
chr1,214378035,214378306,SRX5716470,SMARCA4,271
chr1,214378044,214378380,SRX5075175,SMARCA4,336
chr1,214378068,214378316,SRX5075181,SMARCA2,248
chr1,214378069,214378347,SRX5716469,SMARCA4,278
chr1,214378081,214378327,SRX5075169,SMARCA4,246
chr1,214378116,214378325,SRX5020211,SMARCA2,209
chr1,214380418,214380633,SRX5716470,SMARCA4,215
chr1,214380418,214380748,SRX5075170,SMARCA4,330
chr1,214380429,214380731,SRX5075176,SMARCA4,302
chr1,214380485,214380679,SRX5075174,SMARCA4,194
chr1,214381004,214381261,SRX5075176,SMARCA4,257
chr1,214386813,214387082,SRX5075169,SMARCA4,269
chr1,214386833,214387020,SRX5075175,SMARCA4,187
chr1,214404154,214404424,SRX5075170,SMARCA4,270
chr1,214404184,214404512,SRX5075176,SMARCA4,328
chr1,214404226,214404471,SRX5054309,FOSL2,245
chr1,214404235,214404476,SRX5716469,SMARCA4,241
chr1,214404246,214404513,SRX5054308,FOSL2,267
chr1,214416336,214416703,SRX5075169,SMARCA4,367
chr1,214416337,214416749,SRX5075170,SMARCA4,412
chr1,214416362,214416684,SRX5716469,SMARCA4,322
chr1,214416370,214416705,SRX5054309,FOSL2,335
chr1,214416373,214416650,SRX5020211,SMARCA2,277
chr1,214416374,214416726,SRX5054308,FOSL2,352
chr1,214416377,214416707,SRX5075175,SMARCA4,330
chr1,214416383,214416666,SRX5716467,SMARCA2,283
chr1,214416393,214416715,SRX5075176,SMARCA4,322
chr1,214422199,214422401,SRX5075170,SMARCA4,202
chr1,214422269,214422667,SRX5075169,SMARCA4,398
chr1,214422355,214422671,SRX5075175,SMARCA4,316
chr1,214422375,214422628,SRX5054308,FOSL2,253
chr1,214427642,214428267,SRX5075168,SMARCA4,625
chr1,214427694,214428320,SRX5075174,SMARCA4,626
chr1,214427758,214428201,SRX5075176,SMARCA4,443
chr1,214427808,214428054,SRX5716463,SMARCA4,246
chr1,214427821,214428134,SRX5075175,SMARCA4,313
chr1,214427843,214428123,SRX5075169,SMARCA4,280
chr1,214427845,214428015,SRX5075170,SMARCA4,170
chr1,214439436,214439633,SRX5075174,SMARCA4,197
chr1,214439535,214440031,SRX5075168,SMARCA4,496
chr1,214439867,214440040,SRX5075174,SMARCA4,173
chr1,214445697,214446256,SRX5716470,SMARCA4,559
chr1,214445732,214446224,SRX5075170,SMARCA4,492
chr1,214445783,214446282,SRX5075176,SMARCA4,499
chr1,214445805,214446295,SRX5716469,SMARCA4,490
chr1,214445808,214446338,SRX5054308,FOSL2,530
chr1,214445810,214446252,SRX5075169,SMARCA4,442
chr1,214445812,214446258,SRX5075175,SMARCA4,446
chr1,214445817,214446204,SRX5075181,SMARCA2,387
chr1,214445820,214446215,SRX5716467,SMARCA2,395
chr1,214445826,214446308,SRX5054309,FOSL2,482
chr1,214445839,214446305,SRX5020211,SMARCA2,466
chr1,214445850,214446226,SRX5020214,SMARCA2,376
chr1,214445854,214446166,SRX5716468,SMARCA2,312
chr1,214445967,214446161,SRX5075182,SMARCA2,194
chr1,214446786,214447348,SRX5075169,SMARCA4,562
chr1,214446859,214447317,SRX5716470,SMARCA4,458
chr1,214446863,214447384,SRX5716469,SMARCA4,521
chr1,214446881,214447364,SRX5075175,SMARCA4,483
chr1,214446933,214447383,SRX5075176,SMARCA4,450
chr1,214446968,214447328,SRX5075170,SMARCA4,360
chr1,214446984,214447305,SRX5054308,FOSL2,321
chr1,214446987,214447302,SRX5075174,SMARCA4,315
chr1,214446991,214447235,SRX5075168,SMARCA4,244
chr1,214446991,214447335,SRX5054309,FOSL2,344
chr1,214447040,214447295,SRX5020211,SMARCA2,255
chr1,214454843,214455397,SRX5075176,SMARCA4,554
chr1,214454948,214455353,SRX5075170,SMARCA4,405
chr1,214454993,214455368,SRX5075169,SMARCA4,375
chr1,214455004,214455336,SRX5075175,SMARCA4,332
chr1,214455089,214455320,SRX5716469,SMARCA4,231
chr1,214473413,214473637,SRX5716470,SMARCA4,224
chr1,214473483,214473731,SRX5075170,SMARCA4,248
chr1,214500457,214500668,SRX5075174,SMARCA4,211
chr1,214513978,214514299,SRX5075175,SMARCA4,321
chr1,214514042,214514278,SRX5075170,SMARCA4,236
chr1,214514047,214514318,SRX5075176,SMARCA4,271
chr1,214514056,214514288,SRX5075169,SMARCA4,232
chr1,214514484,214514968,SRX5075176,SMARCA4,484
chr1,214514531,214514823,SRX5075170,SMARCA4,292
chr1,214514561,214514816,SRX5075175,SMARCA4,255
chr1,214514696,214514913,SRX5716469,SMARCA4,217
chr1,214518401,214518644,SRX5054308,FOSL2,243
chr1,214518467,214518680,SRX5075169,SMARCA4,213
chr1,214538616,214538794,SRX5075176,SMARCA4,178
chr1,214538654,214538844,SRX5075170,SMARCA4,190
chr1,214551214,214552186,SRX20140895,INTS13,972
chr1,214551433,214552282,SRX20140867,INTS10,849
chr1,214551473,214552054,SRX5716470,SMARCA4,581
chr1,214551516,214552030,SRX20140868,INTS10,514
chr1,214551531,214552203,SRX5075168,SMARCA4,672
chr1,214551554,214551974,SRX20140896,INTS13,420
chr1,214551567,214552056,SRX5075170,SMARCA4,489
chr1,214551601,214552082,SRX5075174,SMARCA4,481
chr1,214551625,214552196,SRX5075176,SMARCA4,571
chr1,214551646,214552180,SRX5716469,SMARCA4,534
chr1,214551647,214551975,SRX5716468,SMARCA2,328
chr1,214551649,214552091,SRX5716464,SMARCA4,442
chr1,214551652,214552077,SRX5075169,SMARCA4,425
chr1,214551676,214552106,SRX5075175,SMARCA4,430
chr1,214551694,214551992,SRX5054308,FOSL2,298
chr1,214551707,214552018,SRX5054309,FOSL2,311
chr1,214551708,214552085,SRX5716463,SMARCA4,377
chr1,214551744,214551964,SRX5716467,SMARCA2,220
chr1,214551832,214552074,SRX5020211,SMARCA2,242
chr1,214551857,214552114,SRX16500060,CTCF,257
chr1,214551905,214552141,SRX16500059,CTCF,236
chr1,214551914,214552164,SRX16500062,CTCF,250
chr1,214558045,214558350,SRX5075169,SMARCA4,305
chr1,214558058,214558345,SRX5075170,SMARCA4,287
chr1,214558093,214558376,SRX5075176,SMARCA4,283
chr1,214558098,214558353,SRX5075175,SMARCA4,255
chr1,214558108,214558382,SRX5054309,FOSL2,274
chr1,214558161,214558341,SRX5054308,FOSL2,180
chr1,214566635,214567078,SRX5075169,SMARCA4,443
chr1,214566664,214567126,SRX5075175,SMARCA4,462
chr1,214566727,214567050,SRX5075170,SMARCA4,323
chr1,214566742,214567073,SRX5054309,FOSL2,331
chr1,214566754,214567000,SRX5716467,SMARCA2,246
chr1,214566765,214567045,SRX5075176,SMARCA4,280
chr1,214570589,214570782,SRX5075176,SMARCA4,193
chr1,214581805,214582196,SRX5075176,SMARCA4,391
chr1,214581806,214582181,SRX5075169,SMARCA4,375
chr1,214581868,214582082,SRX5716469,SMARCA4,214
chr1,214581871,214582197,SRX5075175,SMARCA4,326
chr1,214581902,214582179,SRX5075170,SMARCA4,277
chr1,214585119,214585457,SRX5054308,FOSL2,338
chr1,214585121,214585536,SRX16500059,CTCF,415
chr1,214585137,214585450,SRX5054309,FOSL2,313
chr1,214585145,214585472,SRX5075176,SMARCA4,327
chr1,214585146,214585400,SRX5075170,SMARCA4,254
chr1,214585152,214585548,SRX16500062,CTCF,396
chr1,214585158,214585441,SRX5075175,SMARCA4,283
chr1,214585158,214585553,SRX16500061,CTCF,395
chr1,214585180,214585557,SRX16500060,CTCF,377
chr1,214585187,214585410,SRX5075168,SMARCA4,223
chr1,214585196,214585407,SRX5716470,SMARCA4,211
chr1,214585199,214585448,SRX5075174,SMARCA4,249
chr1,214602748,214603037,SRX5716469,SMARCA4,289
chr1,214602750,214603087,SRX5075176,SMARCA4,337
chr1,214602799,214603181,SRX5075168,SMARCA4,382
chr1,214602802,214603147,SRX5075174,SMARCA4,345
chr1,214602803,214603093,SRX5716463,SMARCA4,290
chr1,214602805,214603047,SRX5716470,SMARCA4,242
chr1,214602830,214603461,SRX20140895,INTS13,631
chr1,214602833,214603034,SRX5075175,SMARCA4,201
chr1,214602850,214603139,SRX5075170,SMARCA4,289
chr1,214602893,214603118,SRX5054308,FOSL2,225
chr1,214602909,214603292,SRX16500062,CTCF,383
chr1,214602923,214603335,SRX16500060,CTCF,412
chr1,214602983,214603347,SRX16500059,CTCF,364
chr1,214603064,214603243,SRX5054307,FOSL2,179
chr1,214603231,214603517,SRX20140867,INTS10,286
chr1,214603244,214603451,SRX5075174,SMARCA4,207
chr1,214627941,214628611,SRX4174629,CTCF,670
chr1,214628009,214628570,SRX16500062,CTCF,561
chr1,214628020,214628588,SRX16500059,CTCF,568
chr1,214628028,214628519,SRX16500061,CTCF,491
chr1,214628031,214628576,SRX16500060,CTCF,545
chr1,214628162,214628437,SRX5075176,SMARCA4,275
chr1,214628176,214628356,SRX5075169,SMARCA4,180
chr1,214628194,214628511,SRX5075168,SMARCA4,317
chr1,214628224,214628509,SRX5075174,SMARCA4,285
chr1,214628255,214628456,SRX5075170,SMARCA4,201
chr1,214637692,214638170,SRX16500060,CTCF,478
chr1,214637724,214638126,SRX16500062,CTCF,402
chr1,214637751,214637995,SRX5075176,SMARCA4,244
chr1,214637752,214638124,SRX16500061,CTCF,372
chr1,214637789,214638164,SRX16500059,CTCF,375
chr1,214637804,214638014,SRX5075170,SMARCA4,210
chr1,214637824,214638007,SRX5075169,SMARCA4,183
chr1,214637826,214638005,SRX5075168,SMARCA4,179
chr1,214658807,214659093,SRX16500059,CTCF,286
chr1,214658867,214659145,SRX16500060,CTCF,278
chr1,214660915,214661247,SRX16500059,CTCF,332
chr1,214660956,214661238,SRX16500060,CTCF,282
chr1,214660963,214661294,SRX5075170,SMARCA4,331
chr1,214660980,214661271,SRX5716470,SMARCA4,291
chr1,214660994,214661332,SRX5075176,SMARCA4,338
chr1,214660997,214661243,SRX5075168,SMARCA4,246
chr1,214661008,214661218,SRX16500062,CTCF,210
chr1,214661026,214661266,SRX5075174,SMARCA4,240
chr1,214670074,214670491,SRX5075176,SMARCA4,417
chr1,214670213,214670386,SRX5075170,SMARCA4,173
chr1,214683580,214684016,SRX5075168,SMARCA4,436
chr1,214683590,214683912,SRX5716463,SMARCA4,322
chr1,214683646,214683982,SRX20140867,INTS10,336
chr1,214683663,214683922,SRX5075174,SMARCA4,259
chr1,214683690,214684003,SRX20140881,CPSF3L,313
chr1,214685668,214686223,SRX5075170,SMARCA4,555
chr1,214685917,214686237,SRX5075175,SMARCA4,320
chr1,214685922,214686311,SRX5075176,SMARCA4,389
chr1,214700455,214700823,SRX5075168,SMARCA4,368
chr1,214700475,214700831,SRX5075174,SMARCA4,356
chr1,214700563,214700840,SRX5716463,SMARCA4,277
chr1,214702452,214702772,SRX5075176,SMARCA4,320
chr1,214702489,214702709,SRX5075170,SMARCA4,220
chr1,214702497,214702772,SRX5075169,SMARCA4,275
chr1,214702619,214702806,SRX5075175,SMARCA4,187
chr1,214715076,214715511,SRX20140895,INTS13,435
chr1,214715130,214715605,SRX5075168,SMARCA4,475
chr1,214715206,214715544,SRX5716463,SMARCA4,338
chr1,214715232,214715579,SRX5075174,SMARCA4,347
chr1,214715299,214715528,SRX5716464,SMARCA4,229
chr1,214718746,214718958,SRX5075169,SMARCA4,212
chr1,214718797,214719055,SRX5054309,FOSL2,258
chr1,214718814,214718994,SRX5075170,SMARCA4,180
chr1,214833294,214833673,SRX5075169,SMARCA4,379
chr1,214833334,214833593,SRX5075170,SMARCA4,259
chr1,214833381,214833632,SRX5054309,FOSL2,251
chr1,214833381,214833638,SRX5075176,SMARCA4,257
chr1,214833408,214833638,SRX5054308,FOSL2,230
chr1,214838366,214838639,SRX5075176,SMARCA4,273
chr1,214838396,214838742,SRX5054309,FOSL2,346
chr1,214838422,214838774,SRX5075175,SMARCA4,352
chr1,214838434,214838749,SRX5075169,SMARCA4,315
chr1,214838448,214838753,SRX5054308,FOSL2,305
chr1,214838466,214838677,SRX5716468,SMARCA2,211
chr1,214838468,214838683,SRX5716467,SMARCA2,215
chr1,214838477,214838723,SRX5716469,SMARCA4,246
chr1,214838518,214838687,SRX5075170,SMARCA4,169
chr1,214840482,214840657,SRX5075176,SMARCA4,175
chr1,214895245,214895615,SRX5075168,SMARCA4,370
chr1,214895270,214895617,SRX5075174,SMARCA4,347
chr1,214895294,214895525,SRX5716470,SMARCA4,231
chr1,214895301,214895580,SRX5716464,SMARCA4,279
chr1,214895333,214895531,SRX5075169,SMARCA4,198
chr1,214895383,214895614,SRX5716463,SMARCA4,231
chr1,214901691,214901973,SRX5075169,SMARCA4,282
chr1,214901875,214902058,SRX5054309,FOSL2,183
chr1,214902806,214903186,SRX5054309,FOSL2,380
chr1,214920407,214920665,SRX5075174,SMARCA4,258
chr1,214946672,214946921,SRX5075170,SMARCA4,249
chr1,214946691,214946926,SRX5075169,SMARCA4,235
chr1,214946712,214946901,SRX5075176,SMARCA4,189
chr1,214957255,214958078,SRX5716470,SMARCA4,823
chr1,214957256,214958216,SRX5075169,SMARCA4,960
chr1,214957257,214958133,SRX5075176,SMARCA4,876
chr1,214957278,214957658,SRX5054309,FOSL2,380
chr1,214957295,214958189,SRX5075170,SMARCA4,894
chr1,214957309,214958033,SRX5075175,SMARCA4,724
chr1,214957329,214957607,SRX5716467,SMARCA2,278
chr1,214957335,214957515,SRX5054308,FOSL2,180
chr1,214957353,214957788,SRX5020214,SMARCA2,435
chr1,214957573,214957919,SRX5716468,SMARCA2,346
chr1,214957697,214958071,SRX5716469,SMARCA4,374
chr1,214957698,214958057,SRX5075174,SMARCA4,359
chr1,214957721,214957978,SRX5020211,SMARCA2,257
chr1,214957728,214958152,SRX5054308,FOSL2,424
chr1,214957746,214958147,SRX5054309,FOSL2,401
chr1,214957763,214958174,SRX5075168,SMARCA4,411
chr1,214957841,214958046,SRX5020214,SMARCA2,205
chr1,214967961,214968163,SRX5075175,SMARCA4,202
chr1,214967961,214968193,SRX5075169,SMARCA4,232
chr1,214967972,214968217,SRX5075176,SMARCA4,245
chr1,214967979,214968194,SRX5054309,FOSL2,215
chr1,214967984,214968198,SRX5054308,FOSL2,214
chr1,214977129,214977462,SRX5075174,SMARCA4,333
chr1,214977143,214977557,SRX5075168,SMARCA4,414
chr1,214977240,214977509,SRX5716463,SMARCA4,269
chr1,214990614,214990940,SRX5054309,FOSL2,326
chr1,214990632,214990866,SRX5020214,SMARCA2,234
chr1,214990632,214990909,SRX5075169,SMARCA4,277
chr1,214990665,214990851,SRX5075176,SMARCA4,186
chr1,214990668,214990958,SRX5054308,FOSL2,290
chr1,214990700,214990927,SRX5075175,SMARCA4,227
chr1,214993537,214993870,SRX5075170,SMARCA4,333
chr1,214993567,214993903,SRX5075176,SMARCA4,336
chr1,214993570,214993825,SRX5075169,SMARCA4,255
chr1,214993650,214993844,SRX5075175,SMARCA4,194
chr1,215002706,215002937,SRX5054309,FOSL2,231
chr1,215004453,215004807,SRX5075170,SMARCA4,354
chr1,215004531,215005005,SRX5075169,SMARCA4,474
chr1,215004677,215004961,SRX5075176,SMARCA4,284
chr1,215023176,215023378,SRX5075176,SMARCA4,202
chr1,215023236,215023480,SRX5075170,SMARCA4,244
chr1,215045967,215046309,SRX5075176,SMARCA4,342
chr1,215046001,215046283,SRX5075170,SMARCA4,282
chr1,215052863,215053047,SRX5054309,FOSL2,184
chr1,215083330,215083603,SRX20140895,INTS13,273
chr1,215083584,215083852,SRX5075176,SMARCA4,268
chr1,215087539,215087769,SRX5054308,FOSL2,230
chr1,215087564,215087785,SRX5054309,FOSL2,221
chr1,215104287,215104581,SRX5075169,SMARCA4,294
chr1,215104388,215104649,SRX5075170,SMARCA4,261
chr1,215113932,215114904,SRX5075169,SMARCA4,972
chr1,215114052,215114873,SRX5075176,SMARCA4,821
chr1,215114106,215114719,SRX5075170,SMARCA4,613
chr1,215114138,215114945,SRX5075175,SMARCA4,807
chr1,215114160,215114423,SRX5716469,SMARCA4,263
chr1,215114198,215114890,SRX5054309,FOSL2,692
chr1,215114214,215114836,SRX5054308,FOSL2,622
chr1,215114247,215114488,SRX5716470,SMARCA4,241
chr1,215115761,215115931,SRX5075170,SMARCA4,170
chr1,215118093,215118362,SRX5075176,SMARCA4,269
chr1,215118146,215118349,SRX5075170,SMARCA4,203
chr1,215146176,215146501,SRX5075170,SMARCA4,325
chr1,215146199,215146651,SRX16500060,CTCF,452
chr1,215146207,215146470,SRX5075176,SMARCA4,263
chr1,215146232,215146649,SRX16500061,CTCF,417
chr1,215146236,215146643,SRX16500059,CTCF,407
chr1,215146260,215146471,SRX5716470,SMARCA4,211
chr1,215146260,215146582,SRX16500062,CTCF,322
chr1,215146330,215146536,SRX5075169,SMARCA4,206
chr1,215156258,215156550,SRX5075170,SMARCA4,292
chr1,215156292,215156551,SRX5075176,SMARCA4,259
chr1,215156301,215156513,SRX5716469,SMARCA4,212
chr1,215192241,215192791,SRX5075169,SMARCA4,550
chr1,215192263,215192648,SRX5716467,SMARCA2,385
chr1,215192278,215192779,SRX5075176,SMARCA4,501
chr1,215192287,215192743,SRX5020211,SMARCA2,456
chr1,215192298,215192799,SRX5716470,SMARCA4,501
chr1,215192299,215192809,SRX5075170,SMARCA4,510
chr1,215192307,215192832,SRX5075175,SMARCA4,525
chr1,215192339,215192723,SRX5054309,FOSL2,384
chr1,215192345,215192778,SRX5716469,SMARCA4,433
chr1,215192346,215192700,SRX5054308,FOSL2,354
chr1,215192350,215192638,SRX5020214,SMARCA2,288
chr1,215192410,215192744,SRX5716468,SMARCA2,334
chr1,215201315,215201620,SRX5075169,SMARCA4,305
chr1,215201381,215201673,SRX5054309,FOSL2,292
chr1,215212912,215213145,SRX5075170,SMARCA4,233
chr1,215226827,215227065,SRX5054309,FOSL2,238
chr1,215226838,215227039,SRX5075170,SMARCA4,201
chr1,215226838,215227061,SRX5075169,SMARCA4,223
chr1,215226863,215227067,SRX5075176,SMARCA4,204
chr1,215226868,215227075,SRX5075175,SMARCA4,207
chr1,215273664,215274352,SRX5075176,SMARCA4,688
chr1,215273687,215274268,SRX5075170,SMARCA4,581
chr1,215273695,215274179,SRX5716469,SMARCA4,484
chr1,215273696,215274285,SRX5075175,SMARCA4,589
chr1,215273732,215274260,SRX5020211,SMARCA2,528
chr1,215273776,215274028,SRX5075181,SMARCA2,252
chr1,215273791,215274130,SRX5020214,SMARCA2,339
chr1,215273807,215274292,SRX5075169,SMARCA4,485
chr1,215273808,215274343,SRX5054309,FOSL2,535
chr1,215273821,215274254,SRX5716470,SMARCA4,433
chr1,215273826,215274172,SRX5716467,SMARCA2,346
chr1,215273838,215274276,SRX5054308,FOSL2,438
chr1,215273882,215274132,SRX5716468,SMARCA2,250
chr1,215282654,215282894,SRX5054309,FOSL2,240
chr1,215285006,215285880,SRX5075176,SMARCA4,874
chr1,215285034,215285239,SRX5075169,SMARCA4,205
chr1,215285037,215285942,SRX5075170,SMARCA4,905
chr1,215285183,215285856,SRX5716470,SMARCA4,673
chr1,215285227,215285872,SRX5075175,SMARCA4,645
chr1,215285249,215285810,SRX5716468,SMARCA2,561
chr1,215285348,215285787,SRX5716467,SMARCA2,439
chr1,215285352,215285946,SRX5716469,SMARCA4,594
chr1,215285409,215285618,SRX5075181,SMARCA2,209
chr1,215285415,215285750,SRX5054308,FOSL2,335
chr1,215285434,215285868,SRX5075169,SMARCA4,434
chr1,215285533,215285923,SRX5020211,SMARCA2,390
chr1,215313997,215314177,SRX5075169,SMARCA4,180
chr1,215345804,215346160,SRX5075170,SMARCA4,356
chr1,215345835,215346183,SRX5075176,SMARCA4,348
chr1,215345892,215346096,SRX5075169,SMARCA4,204
chr1,215359987,215360346,SRX5075174,SMARCA4,359
chr1,215360073,215360384,SRX5075168,SMARCA4,311
chr1,215360866,215361091,SRX5716463,SMARCA4,225
chr1,215360877,215361056,SRX5075168,SMARCA4,179
chr1,215360894,215361078,SRX5075174,SMARCA4,184
chr1,215376815,215377200,SRX5075169,SMARCA4,385
chr1,215376816,215377167,SRX5716470,SMARCA4,351
chr1,215376842,215377218,SRX5075176,SMARCA4,376
chr1,215376843,215377234,SRX5075170,SMARCA4,391
chr1,215376852,215377197,SRX5075175,SMARCA4,345
chr1,215376874,215377095,SRX5716468,SMARCA2,221
chr1,215376882,215377133,SRX5716469,SMARCA4,251
chr1,215376941,215377176,SRX5716467,SMARCA2,235
chr1,215377045,215377245,SRX5020211,SMARCA2,200
chr1,215384550,215384733,SRX5054309,FOSL2,183
chr1,215393477,215393757,SRX5075170,SMARCA4,280
chr1,215393529,215393790,SRX5075176,SMARCA4,261
chr1,215405197,215405621,SRX5054309,FOSL2,424
chr1,215405219,215405594,SRX5075169,SMARCA4,375
chr1,215405257,215405616,SRX5075175,SMARCA4,359
chr1,215405270,215405535,SRX5054308,FOSL2,265
chr1,215405301,215405528,SRX5020214,SMARCA2,227
chr1,215405318,215405493,SRX5075176,SMARCA4,175
chr1,215405335,215405514,SRX5075168,SMARCA4,179
chr1,215405368,215405619,SRX5075174,SMARCA4,251
chr1,215449175,215449449,SRX5075176,SMARCA4,274
chr1,215449208,215449464,SRX5075170,SMARCA4,256
chr1,215449214,215449439,SRX5075169,SMARCA4,225
chr1,215449236,215449424,SRX5075175,SMARCA4,188
chr1,215449245,215449475,SRX5054309,FOSL2,230
chr1,215458341,215458510,SRX5075170,SMARCA4,169
chr1,215475664,215476555,SRX5075176,SMARCA4,891
chr1,215475685,215476539,SRX5075175,SMARCA4,854
chr1,215475691,215476592,SRX5075169,SMARCA4,901
chr1,215475719,215476650,SRX5716470,SMARCA4,931
chr1,215475732,215476606,SRX5075170,SMARCA4,874
chr1,215475740,215476543,SRX5716469,SMARCA4,803
chr1,215475773,215476532,SRX5716467,SMARCA2,759
chr1,215475784,215476012,SRX5075181,SMARCA2,228
chr1,215475807,215476012,SRX5020214,SMARCA2,205
chr1,215475835,215476158,SRX5054308,FOSL2,323
chr1,215475843,215476200,SRX5020211,SMARCA2,357
chr1,215475852,215476434,SRX5054309,FOSL2,582
chr1,215475926,215476186,SRX5716460,Epitope tags,260
chr1,215476158,215476461,SRX5716468,SMARCA2,303
chr1,215484166,215484339,SRX5075174,SMARCA4,173
chr1,215484234,215484490,SRX5075168,SMARCA4,256
chr1,215489944,215490173,SRX5075170,SMARCA4,229
chr1,215489946,215490216,SRX5075175,SMARCA4,270
chr1,215489966,215490244,SRX5716470,SMARCA4,278
chr1,215489987,215490340,SRX5075169,SMARCA4,353
chr1,215489988,215490206,SRX5075176,SMARCA4,218
chr1,215504101,215504325,SRX5054309,FOSL2,224
chr1,215504104,215504284,SRX5054308,FOSL2,180
chr1,215517285,215517739,SRX5054309,FOSL2,454
chr1,215517313,215517741,SRX5054308,FOSL2,428
chr1,215517341,215517933,SRX5075170,SMARCA4,592
chr1,215517348,215517829,SRX5075176,SMARCA4,481
chr1,215517363,215517877,SRX5075169,SMARCA4,514
chr1,215517371,215517792,SRX5075175,SMARCA4,421
chr1,215517380,215517761,SRX5716469,SMARCA4,381
chr1,215517387,215517651,SRX5716467,SMARCA2,264
chr1,215526486,215526967,SRX16500061,CTCF,481
chr1,215526497,215526988,SRX16500059,CTCF,491
chr1,215526520,215527031,SRX16500060,CTCF,511
chr1,215526543,215527028,SRX16500062,CTCF,485
chr1,215540167,215540514,SRX5075169,SMARCA4,347
chr1,215540280,215540494,SRX5075170,SMARCA4,214
chr1,215540289,215540484,SRX5075176,SMARCA4,195
chr1,215566951,215567325,SRX5075169,SMARCA4,374
chr1,215566993,215567409,SRX5075174,SMARCA4,416
chr1,215567015,215567950,SRX20140895,INTS13,935
chr1,215567021,215567312,SRX5075176,SMARCA4,291
chr1,215567042,215567350,SRX5075170,SMARCA4,308
chr1,215567043,215567267,SRX5716470,SMARCA4,224
chr1,215567057,215567504,SRX5075168,SMARCA4,447
chr1,215567216,215567604,SRX20140868,INTS10,388
chr1,215568450,215568699,SRX5054309,FOSL2,249
chr1,215568482,215568713,SRX5054308,FOSL2,231
chr1,215595350,215595597,SRX5054309,FOSL2,247
chr1,215595360,215595543,SRX5054308,FOSL2,183
chr1,215606520,215606957,SRX16500062,CTCF,437
chr1,215606536,215606931,SRX16500061,CTCF,395
chr1,215606549,215607003,SRX16500059,CTCF,454
chr1,215606557,215606961,SRX16500060,CTCF,404
chr1,215606611,215606899,SRX5075176,SMARCA4,288
chr1,215606635,215606804,SRX5075170,SMARCA4,169
chr1,215631538,215631767,SRX5075176,SMARCA4,229
chr1,215631565,215631739,SRX5075170,SMARCA4,174
chr1,215636528,215636810,SRX5075169,SMARCA4,282
chr1,215636528,215636890,SRX5075176,SMARCA4,362
chr1,215636558,215636938,SRX5075170,SMARCA4,380
chr1,215636582,215636936,SRX5075175,SMARCA4,354
chr1,215637165,215637334,SRX5075170,SMARCA4,169
chr1,215637182,215637538,SRX5075176,SMARCA4,356
chr1,215637261,215637593,SRX5716470,SMARCA4,332
chr1,215637389,215637577,SRX5075170,SMARCA4,188
chr1,215682322,215682548,SRX16500060,CTCF,226
chr1,215704588,215704776,SRX5075174,SMARCA4,188
chr1,215710358,215710752,SRX16500059,CTCF,394
chr1,215710393,215710749,SRX16500060,CTCF,356
chr1,215710399,215710714,SRX16500061,CTCF,315
chr1,215710424,215710722,SRX16500062,CTCF,298
chr1,215749418,215749822,SRX5075169,SMARCA4,404
chr1,215749422,215749746,SRX5054309,FOSL2,324
chr1,215749467,215749734,SRX5075175,SMARCA4,267
chr1,215749496,215749739,SRX5716469,SMARCA4,243
chr1,215777488,215777686,SRX5054309,FOSL2,198
chr1,215777510,215777686,SRX5075176,SMARCA4,176
chr1,215792520,215792839,SRX5075174,SMARCA4,319
chr1,215792593,215792916,SRX5075168,SMARCA4,323
chr1,215792627,215792974,SRX5716464,SMARCA4,347
chr1,215793189,215793520,SRX5075175,SMARCA4,331
chr1,215793230,215793561,SRX5075169,SMARCA4,331
chr1,215793244,215793532,SRX5054308,FOSL2,288
chr1,215793244,215793541,SRX5054309,FOSL2,297
chr1,215793322,215793558,SRX5075170,SMARCA4,236
chr1,215793332,215793637,SRX16500060,CTCF,305
chr1,215793343,215793605,SRX16500062,CTCF,262
chr1,215793351,215793538,SRX5075176,SMARCA4,187
chr1,215793361,215793638,SRX16500059,CTCF,277
chr1,215824273,215824512,SRX16500061,CTCF,239
chr1,215824293,215824562,SRX16500059,CTCF,269
chr1,215824302,215824528,SRX16500060,CTCF,226
chr1,215845186,215845635,SRX5054309,FOSL2,449
chr1,215845215,215845685,SRX5075176,SMARCA4,470
chr1,215845239,215845632,SRX5075169,SMARCA4,393
chr1,215845240,215845574,SRX5075175,SMARCA4,334
chr1,215845248,215845585,SRX5054308,FOSL2,337
chr1,215845254,215845576,SRX5075170,SMARCA4,322
chr1,215845285,215845632,SRX5075168,SMARCA4,347
chr1,215845301,215845555,SRX5716469,SMARCA4,254
chr1,215845304,215845539,SRX5716467,SMARCA2,235
chr1,215845350,215845535,SRX5075174,SMARCA4,185
chr1,215905531,215906159,SRX5075176,SMARCA4,628
chr1,215905568,215906167,SRX5075170,SMARCA4,599
chr1,215905645,215905849,SRX5075169,SMARCA4,204
chr1,215905679,215905949,SRX5075175,SMARCA4,270
chr1,215905763,215906159,SRX5054309,FOSL2,396
chr1,215905792,215906091,SRX5716469,SMARCA4,299
chr1,215905891,215906127,SRX5054308,FOSL2,236
chr1,215911609,215911915,SRX5075170,SMARCA4,306
chr1,215911634,215911828,SRX5054309,FOSL2,194
chr1,215911634,215911873,SRX5075169,SMARCA4,239
chr1,215911647,215911928,SRX5075176,SMARCA4,281
chr1,215911648,215911864,SRX5054308,FOSL2,216
chr1,215911697,215911935,SRX5075175,SMARCA4,238
chr1,215920035,215920329,SRX5075174,SMARCA4,294
chr1,215920084,215920304,SRX5075168,SMARCA4,220
chr1,215957752,215958013,SRX5075174,SMARCA4,261
chr1,215970392,215970752,SRX5075174,SMARCA4,360
chr1,215970394,215970735,SRX5054309,FOSL2,341
chr1,215970404,215970615,SRX5054307,FOSL2,211
chr1,215970404,215970786,SRX5075168,SMARCA4,382
chr1,215970446,215970672,SRX5075169,SMARCA4,226
chr1,215970453,215970699,SRX5054308,FOSL2,246
chr1,215992599,215993097,SRX16500059,CTCF,498
chr1,215992611,215992927,SRX5075174,SMARCA4,316
chr1,215992612,215993091,SRX16500060,CTCF,479
chr1,215992661,215993071,SRX16500061,CTCF,410
chr1,215992667,215992939,SRX5075168,SMARCA4,272
chr1,215992668,215992872,SRX5716463,SMARCA4,204
chr1,215992673,215993089,SRX16500062,CTCF,416
chr1,215992744,215992913,SRX5075170,SMARCA4,169
chr1,215992966,215993176,SRX4174629,CTCF,210
chr1,216005894,216006312,SRX5075170,SMARCA4,418
chr1,216005895,216006239,SRX5054309,FOSL2,344
chr1,216005958,216006254,SRX5075176,SMARCA4,296
chr1,216005984,216006222,SRX5054308,FOSL2,238
chr1,216006006,216006269,SRX5075169,SMARCA4,263
chr1,216034605,216034860,SRX16500061,CTCF,255
chr1,216034609,216034928,SRX16500060,CTCF,319
chr1,216034628,216034949,SRX16500059,CTCF,321
chr1,216034658,216034882,SRX16500062,CTCF,224
chr1,216045284,216045735,SRX5075175,SMARCA4,451
chr1,216045298,216045737,SRX5054309,FOSL2,439
chr1,216045303,216045754,SRX5075176,SMARCA4,451
chr1,216045310,216045698,SRX5054308,FOSL2,388
chr1,216045318,216045744,SRX5716470,SMARCA4,426
chr1,216045364,216045795,SRX5075169,SMARCA4,431
chr1,216045375,216045822,SRX5716469,SMARCA4,447
chr1,216045444,216045711,SRX5716467,SMARCA2,267
chr1,216045458,216045732,SRX5075170,SMARCA4,274
chr1,216073823,216074386,SRX5075174,SMARCA4,563
chr1,216073856,216074319,SRX5075168,SMARCA4,463
chr1,216073926,216074203,SRX5716464,SMARCA4,277
chr1,216073933,216074255,SRX5716463,SMARCA4,322
chr1,216073976,216074191,SRX5716451,SOX2,215
chr1,216074038,216074294,SRX20140895,INTS13,256
chr1,216075348,216075703,SRX5054309,FOSL2,355
chr1,216075370,216075719,SRX5075175,SMARCA4,349
chr1,216075380,216075689,SRX5075170,SMARCA4,309
chr1,216075393,216075764,SRX5075176,SMARCA4,371
chr1,216075401,216075669,SRX5716469,SMARCA4,268
chr1,216075402,216075671,SRX5716470,SMARCA4,269
chr1,216075403,216075712,SRX5075169,SMARCA4,309
chr1,216075405,216075665,SRX5054308,FOSL2,260
chr1,216075447,216075698,SRX5716467,SMARCA2,251
chr1,216075484,216075689,SRX5020214,SMARCA2,205
chr1,216119677,216119985,SRX16500060,CTCF,308
chr1,216140818,216141078,SRX5075176,SMARCA4,260
chr1,216140879,216141109,SRX5075170,SMARCA4,230
chr1,216140890,216141102,SRX5716469,SMARCA4,212
chr1,216140894,216141167,SRX5075169,SMARCA4,273
chr1,216140930,216141123,SRX5054308,FOSL2,193
chr1,216140951,216141176,SRX5716470,SMARCA4,225
chr1,216173344,216173679,SRX5075170,SMARCA4,335
chr1,216173367,216173658,SRX5075176,SMARCA4,291
chr1,216173422,216173633,SRX5716470,SMARCA4,211
chr1,216178293,216178476,SRX5054309,FOSL2,183
chr1,216178332,216178685,SRX5716470,SMARCA4,353
chr1,216178340,216178644,SRX5075176,SMARCA4,304
chr1,216178348,216178670,SRX5075169,SMARCA4,322
chr1,216178359,216178620,SRX5075175,SMARCA4,261
chr1,216178377,216178659,SRX5075170,SMARCA4,282
chr1,216178416,216178630,SRX5716469,SMARCA4,214
chr1,216182985,216183430,SRX5075174,SMARCA4,445
chr1,216182987,216183249,SRX5075175,SMARCA4,262
chr1,216182994,216183342,SRX5075168,SMARCA4,348
chr1,216183038,216183359,SRX5075169,SMARCA4,321
chr1,216183056,216183362,SRX5075170,SMARCA4,306
chr1,216183071,216183363,SRX5075176,SMARCA4,292
chr1,216183106,216183384,SRX5716470,SMARCA4,278
chr1,216183129,216183334,SRX5716454,SOX3,205
chr1,216183456,216183631,SRX5075176,SMARCA4,175
chr1,216186271,216186480,SRX5716464,SMARCA4,209
chr1,216186913,216187109,SRX5075176,SMARCA4,196
chr1,216194664,216195143,SRX5075176,SMARCA4,479
chr1,216194711,216195178,SRX5075170,SMARCA4,467
chr1,216194742,216195008,SRX5716467,SMARCA2,266
chr1,216194770,216195148,SRX5075169,SMARCA4,378
chr1,216194772,216194970,SRX5075175,SMARCA4,198
chr1,216194832,216195043,SRX5716470,SMARCA4,211
chr1,216194854,216195112,SRX5716469,SMARCA4,258
chr1,216221130,216221519,SRX16500059,CTCF,389
chr1,216221143,216221588,SRX5075170,SMARCA4,445
chr1,216221152,216221534,SRX5075168,SMARCA4,382
chr1,216221165,216221538,SRX5075176,SMARCA4,373
chr1,216221171,216221504,SRX5716464,SMARCA4,333
chr1,216221173,216221525,SRX16500061,CTCF,352
chr1,216221178,216221512,SRX5075175,SMARCA4,334
chr1,216221178,216221551,SRX16500062,CTCF,373
chr1,216221184,216221553,SRX4174629,CTCF,369
chr1,216221187,216221580,SRX5075174,SMARCA4,393
chr1,216221188,216221506,SRX5075169,SMARCA4,318
chr1,216221196,216221533,SRX16500060,CTCF,337
chr1,216221196,216221537,SRX5716463,SMARCA4,341
chr1,216221215,216221497,SRX5716469,SMARCA4,282
chr1,216221238,216221688,SRX5716470,SMARCA4,450
chr1,216310741,216311147,SRX16500060,CTCF,406
chr1,216310779,216311106,SRX16500062,CTCF,327
chr1,216310807,216311095,SRX5075174,SMARCA4,288
chr1,216310812,216311156,SRX16500061,CTCF,344
chr1,216310818,216311135,SRX16500059,CTCF,317
chr1,216310914,216311120,SRX5075168,SMARCA4,206
chr1,216387683,216388229,SRX5075174,SMARCA4,546
chr1,216387693,216388143,SRX5075168,SMARCA4,450
chr1,216387745,216388153,SRX5716463,SMARCA4,408
chr1,216387746,216388110,SRX5716464,SMARCA4,364
chr1,216387836,216388198,SRX20140881,CPSF3L,362
chr1,216387867,216388117,SRX5716454,SOX3,250
chr1,216387868,216388096,SRX5716451,SOX2,228
chr1,216388490,216388970,SRX5075174,SMARCA4,480
chr1,216388583,216388938,SRX5716464,SMARCA4,355
chr1,216388601,216388957,SRX5075168,SMARCA4,356
chr1,216388639,216388959,SRX5716463,SMARCA4,320
chr1,216416517,216416863,SRX5075174,SMARCA4,346
chr1,216416541,216416873,SRX5075169,SMARCA4,332
chr1,216423040,216423478,SRX5075174,SMARCA4,438
chr1,216423068,216423516,SRX5075168,SMARCA4,448
chr1,216423118,216423500,SRX5716463,SMARCA4,382
chr1,216423131,216423482,SRX5716464,SMARCA4,351
chr1,216447935,216448123,SRX5054308,FOSL2,188
chr1,216456650,216457115,SRX5075175,SMARCA4,465
chr1,216456667,216457157,SRX5075169,SMARCA4,490
chr1,216456691,216457026,SRX5716469,SMARCA4,335
chr1,216456759,216456938,SRX5075174,SMARCA4,179
chr1,216456776,216457097,SRX5054309,FOSL2,321
chr1,216456789,216457049,SRX5075176,SMARCA4,260
chr1,216456796,216457063,SRX5075170,SMARCA4,267
chr1,216456814,216457144,SRX5054308,FOSL2,330
chr1,216456916,216457136,SRX5716470,SMARCA4,220
chr1,216464355,216464804,SRX5054308,FOSL2,449
chr1,216464363,216464906,SRX5054309,FOSL2,543
chr1,216464393,216464727,SRX5075175,SMARCA4,334
chr1,216464421,216464835,SRX5075169,SMARCA4,414
chr1,216464461,216464649,SRX5075182,SMARCA2,188
chr1,216464482,216464863,SRX5075176,SMARCA4,381
chr1,216464488,216464732,SRX5020211,SMARCA2,244
chr1,216464502,216464784,SRX5020214,SMARCA2,282
chr1,216582231,216582454,SRX5716463,SMARCA4,223
chr1,216582273,216582551,SRX5075174,SMARCA4,278
chr1,216582350,216582598,SRX5075168,SMARCA4,248
chr1,216600693,216601426,SRX20140895,INTS13,733
chr1,216600715,216601533,SRX5075176,SMARCA4,818
chr1,216600746,216601532,SRX5075174,SMARCA4,786
chr1,216600763,216601479,SRX5075170,SMARCA4,716
chr1,216600814,216601464,SRX5075168,SMARCA4,650
chr1,216600870,216601116,SRX5716469,SMARCA4,246
chr1,216600881,216601450,SRX5075169,SMARCA4,569
chr1,216600941,216601363,SRX20140868,INTS10,422
chr1,216600953,216601534,SRX5716470,SMARCA4,581
chr1,216600980,216601509,SRX5075175,SMARCA4,529
chr1,216601115,216601435,SRX16500062,CTCF,320
chr1,216601128,216601550,SRX16500059,CTCF,422
chr1,216601148,216601677,SRX16500060,CTCF,529
chr1,216601213,216601432,SRX16500061,CTCF,219
chr1,216601215,216601555,SRX5716469,SMARCA4,340
chr1,216614153,216614382,SRX5075168,SMARCA4,229
chr1,216630523,216630935,SRX5075174,SMARCA4,412
chr1,216630605,216630882,SRX5075168,SMARCA4,277
chr1,216630628,216630818,SRX5716451,SOX2,190
chr1,216658858,216658904,SRX1424892,POU3F2,46
chr1,216700917,216701100,SRX5054309,FOSL2,183
chr1,216722927,216723155,SRX5075168,SMARCA4,228
chr1,216723217,216723731,SRX5075168,SMARCA4,514
chr1,216723295,216723793,SRX5075174,SMARCA4,498
chr1,216723427,216723729,SRX5075170,SMARCA4,302
chr1,216723468,216723797,SRX5716469,SMARCA4,329
chr1,216726487,216726831,SRX16500060,CTCF,344
chr1,216726493,216726713,SRX16500062,CTCF,220
chr1,216726513,216726753,SRX16500059,CTCF,240
chr1,216726538,216726759,SRX16500061,CTCF,221
chr1,216740368,216740651,SRX5075168,SMARCA4,283
chr1,216740531,216740707,SRX5075174,SMARCA4,176
chr1,216742643,216743006,SRX16500061,CTCF,363
chr1,216742656,216743015,SRX16500060,CTCF,359
chr1,216742661,216743034,SRX16500059,CTCF,373
chr1,216742663,216743016,SRX16500062,CTCF,353
chr1,216749955,216750419,SRX16500062,CTCF,464
chr1,216749972,216750400,SRX16500061,CTCF,428
chr1,216749980,216750465,SRX16500059,CTCF,485
chr1,216750011,216750464,SRX16500060,CTCF,453
chr1,216750038,216750389,SRX5075174,SMARCA4,351
chr1,216750053,216750399,SRX5716463,SMARCA4,346
chr1,216750074,216750322,SRX5075168,SMARCA4,248
chr1,216750102,216750332,SRX4174629,CTCF,230
chr1,216750102,216750362,SRX5075176,SMARCA4,260
chr1,216750119,216750330,SRX5075170,SMARCA4,211
chr1,216910350,216910887,SRX5075168,SMARCA4,537
chr1,216910457,216910843,SRX5075174,SMARCA4,386
chr1,216926682,216927134,SRX5075174,SMARCA4,452
chr1,216926691,216927073,SRX5075168,SMARCA4,382
chr1,216927297,216927491,SRX5075168,SMARCA4,194
chr1,217021122,217021497,SRX20140867,INTS10,375
chr1,217021137,217021617,SRX20140895,INTS13,480
chr1,217021150,217021480,SRX20140868,INTS10,330
chr1,217021151,217021493,SRX20140880,CPSF3L,342
chr1,217029169,217029475,SRX5075169,SMARCA4,306
chr1,217029181,217029524,SRX5075175,SMARCA4,343
chr1,217029191,217029551,SRX5075176,SMARCA4,360
chr1,217029204,217029528,SRX5054309,FOSL2,324
chr1,217029230,217029525,SRX5054308,FOSL2,295
chr1,217029239,217029712,SRX5075170,SMARCA4,473
chr1,217029288,217029596,SRX5075168,SMARCA4,308
chr1,217029434,217029668,SRX5716469,SMARCA4,234
chr1,217076918,217077377,SRX5075168,SMARCA4,459
chr1,217076983,217077495,SRX5075174,SMARCA4,512
chr1,217077043,217077361,SRX5716463,SMARCA4,318
chr1,217077070,217077291,SRX5716464,SMARCA4,221
chr1,217089634,217089844,SRX5075168,SMARCA4,210
chr1,217106223,217106952,SRX5075174,SMARCA4,729
chr1,217106343,217106937,SRX5075168,SMARCA4,594
chr1,217139632,217139845,SRX5075168,SMARCA4,213
chr1,217275239,217275561,SRX5054309,FOSL2,322
chr1,217275340,217275569,SRX5075176,SMARCA4,229
chr1,217275371,217275581,SRX5075175,SMARCA4,210
chr1,217276029,217276447,SRX5075176,SMARCA4,418
chr1,217276035,217276383,SRX5075169,SMARCA4,348
chr1,217276057,217276366,SRX5054308,FOSL2,309
chr1,217276072,217276324,SRX5054309,FOSL2,252
chr1,217276105,217276396,SRX5075170,SMARCA4,291
chr1,217276181,217276420,SRX5075175,SMARCA4,239
chr1,217333904,217334314,SRX16500059,CTCF,410
chr1,217333939,217334327,SRX16500062,CTCF,388
chr1,217333967,217334281,SRX16500060,CTCF,314
chr1,217333988,217334301,SRX16500061,CTCF,313
chr1,217425430,217425609,SRX5075168,SMARCA4,179
chr1,217482459,217482784,SRX5054309,FOSL2,325
chr1,217482472,217482761,SRX5054308,FOSL2,289
chr1,217525859,217526033,SRX5075170,SMARCA4,174
chr1,217525886,217526072,SRX5054308,FOSL2,186
chr1,217562433,217562791,SRX5020211,SMARCA2,358
chr1,217562448,217562917,SRX5075176,SMARCA4,469
chr1,217562466,217562874,SRX5075175,SMARCA4,408
chr1,217562484,217562951,SRX5716469,SMARCA4,467
chr1,217562486,217562958,SRX5716470,SMARCA4,472
chr1,217562487,217562881,SRX5075170,SMARCA4,394
chr1,217562501,217562972,SRX5075169,SMARCA4,471
chr1,217562514,217562936,SRX5054309,FOSL2,422
chr1,217562547,217562924,SRX5054308,FOSL2,377
chr1,217562595,217562812,SRX5716467,SMARCA2,217
chr1,217630543,217630987,SRX5075176,SMARCA4,444
chr1,217630595,217630791,SRX5075170,SMARCA4,196
chr1,217630619,217630903,SRX5075169,SMARCA4,284
chr1,217630771,217631130,SRX20140895,INTS13,359
chr1,217630774,217631083,SRX5716470,SMARCA4,309
chr1,217630809,217631505,SRX20140897,INTS13,696
chr1,217630859,217631289,SRX20140869,INTS10,430
chr1,217630982,217631399,SRX5075174,SMARCA4,417
chr1,217631037,217631247,SRX16500062,CTCF,210
chr1,217631044,217631263,SRX16500061,CTCF,219
chr1,217631124,217631376,SRX5075168,SMARCA4,252
chr1,217631173,217631519,SRX5075176,SMARCA4,346
chr1,217660348,217660615,SRX5075170,SMARCA4,267
chr1,217660381,217660668,SRX5075169,SMARCA4,287
chr1,217660382,217660587,SRX5075175,SMARCA4,205
chr1,217660409,217660612,SRX5054309,FOSL2,203
chr1,217660453,217660659,SRX5075176,SMARCA4,206
chr1,217660811,217661039,SRX16500061,CTCF,228
chr1,217660898,217661133,SRX16500059,CTCF,235
chr1,217747002,217747618,SRX16500061,CTCF,616
chr1,217747003,217747622,SRX16500060,CTCF,619
chr1,217747096,217747685,SRX16500059,CTCF,589
chr1,217747114,217747599,SRX16500062,CTCF,485
chr1,217747302,217747496,SRX5075168,SMARCA4,194
chr1,217856433,217856671,SRX5075170,SMARCA4,238
chr1,217857145,217857356,SRX5716470,SMARCA4,211
chr1,217857161,217857345,SRX5075169,SMARCA4,184
chr1,217857196,217857485,SRX5075175,SMARCA4,289
chr1,217857262,217857591,SRX5075176,SMARCA4,329
chr1,217857277,217857616,SRX5075170,SMARCA4,339
chr1,217881059,217881464,SRX5075170,SMARCA4,405
chr1,217881077,217881462,SRX5075176,SMARCA4,385
chr1,217881151,217881511,SRX5054309,FOSL2,360
chr1,217889450,217889709,SRX16500062,CTCF,259
chr1,217889473,217889704,SRX16500060,CTCF,231
chr1,217892036,217892242,SRX5054309,FOSL2,206
chr1,217896478,217896919,SRX5075176,SMARCA4,441
chr1,217896480,217896867,SRX5075170,SMARCA4,387
chr1,217896506,217896803,SRX5075169,SMARCA4,297
chr1,217896516,217896841,SRX5075175,SMARCA4,325
chr1,217896580,217896836,SRX5054309,FOSL2,256
chr1,217896586,217896816,SRX5054308,FOSL2,230
chr1,217896587,217896798,SRX5716470,SMARCA4,211
chr1,217896636,217896850,SRX5716469,SMARCA4,214
chr1,217910103,217910481,SRX20140881,CPSF3L,378
chr1,217910207,217910462,SRX20140867,INTS10,255
chr1,217911853,217912101,SRX16500059,CTCF,248
chr1,218005115,218005155,SRX1424892,POU3F2,40
chr1,218014775,218015069,SRX9989505,GFP,294
chr1,218025655,218025852,SRX5054309,FOSL2,197
chr1,218034425,218034937,SRX5075174,SMARCA4,512
chr1,218034446,218034898,SRX5075168,SMARCA4,452
chr1,218034476,218034800,SRX5716463,SMARCA4,324
chr1,218034484,218034858,SRX20140895,INTS13,374
chr1,218034490,218034844,SRX5716464,SMARCA4,354
chr1,218101494,218101914,SRX5075168,SMARCA4,420
chr1,218101566,218101893,SRX5075174,SMARCA4,327
chr1,218108772,218109028,SRX5075174,SMARCA4,256
chr1,218164411,218165035,SRX20140895,INTS13,624
chr1,218164481,218164808,SRX5075176,SMARCA4,327
chr1,218164630,218164853,SRX5075168,SMARCA4,223
chr1,218171202,218171807,SRX16500059,CTCF,605
chr1,218171245,218171745,SRX16500060,CTCF,500
chr1,218171254,218171771,SRX16500062,CTCF,517
chr1,218171315,218171751,SRX16500061,CTCF,436
chr1,218171330,218171565,SRX5716463,SMARCA4,235
chr1,218171347,218171616,SRX5075174,SMARCA4,269
chr1,218171362,218171569,SRX5075168,SMARCA4,207
chr1,218171367,218171597,SRX5075175,SMARCA4,230
chr1,218171369,218171581,SRX5075176,SMARCA4,212
chr1,218171381,218171615,SRX5075170,SMARCA4,234
chr1,218171437,218171620,SRX5075169,SMARCA4,183
chr1,218211382,218211589,SRX5054309,FOSL2,207
chr1,218254449,218254821,SRX5075176,SMARCA4,372
chr1,218254451,218254856,SRX5716470,SMARCA4,405
chr1,218254480,218254793,SRX5716469,SMARCA4,313
chr1,218254496,218254866,SRX5054309,FOSL2,370
chr1,218254520,218254855,SRX5716467,SMARCA2,335
chr1,218254540,218254880,SRX5716468,SMARCA2,340
chr1,218254558,218254824,SRX5075170,SMARCA4,266
chr1,218254560,218254837,SRX5075169,SMARCA4,277
chr1,218284853,218285464,SRX5075174,SMARCA4,611
chr1,218284888,218285540,SRX20140895,INTS13,652
chr1,218284904,218285265,SRX5716470,SMARCA4,361
chr1,218284939,218285287,SRX5075169,SMARCA4,348
chr1,218284949,218285448,SRX20140868,INTS10,499
chr1,218284966,218285411,SRX5075170,SMARCA4,445
chr1,218284978,218285178,SRX5075175,SMARCA4,200
chr1,218284982,218285340,SRX20140881,CPSF3L,358
chr1,218284983,218285366,SRX20140867,INTS10,383
chr1,218284987,218285354,SRX5075176,SMARCA4,367
chr1,218285009,218285428,SRX5075168,SMARCA4,419
chr1,218285043,218285487,SRX20140869,INTS10,444
chr1,218285067,218285446,SRX20140897,INTS13,379
chr1,218285198,218285441,SRX5716464,SMARCA4,243
chr1,218299398,218299701,SRX16500059,CTCF,303
chr1,218299433,218299759,SRX16500060,CTCF,326
chr1,218299446,218299701,SRX5075168,SMARCA4,255
chr1,218299453,218299751,SRX5075176,SMARCA4,298
chr1,218299463,218299895,SRX16500061,CTCF,432
chr1,218299464,218299781,SRX16500062,CTCF,317
chr1,218299469,218299708,SRX5075170,SMARCA4,239
chr1,218299512,218299738,SRX5075174,SMARCA4,226
chr1,218304600,218305226,SRX5075170,SMARCA4,626
chr1,218304604,218305154,SRX5075176,SMARCA4,550
chr1,218304657,218305134,SRX5716470,SMARCA4,477
chr1,218304670,218305045,SRX5075175,SMARCA4,375
chr1,218304680,218305166,SRX5716469,SMARCA4,486
chr1,218304692,218305169,SRX5075169,SMARCA4,477
chr1,218304698,218305050,SRX5716467,SMARCA2,352
chr1,218304706,218304913,SRX5075168,SMARCA4,207
chr1,218304734,218305122,SRX5716459,Epitope tags,388
chr1,218304735,218305007,SRX5054309,FOSL2,272
chr1,218304755,218305036,SRX5075174,SMARCA4,281
chr1,218304771,218305097,SRX5716468,SMARCA2,326
chr1,218304823,218305044,SRX5020211,SMARCA2,221
chr1,218304850,218305057,SRX5020214,SMARCA2,207
chr1,218312651,218312831,SRX5075169,SMARCA4,180
chr1,218329961,218330457,SRX16500059,CTCF,496
chr1,218329975,218330535,SRX16500062,CTCF,560
chr1,218330014,218330495,SRX16500061,CTCF,481
chr1,218330019,218330545,SRX16500060,CTCF,526
chr1,218330070,218330389,SRX5075168,SMARCA4,319
chr1,218330170,218330412,SRX5075170,SMARCA4,242
chr1,218330174,218330361,SRX5075175,SMARCA4,187
chr1,218330176,218330410,SRX5075176,SMARCA4,234
chr1,218336363,218336536,SRX5075174,SMARCA4,173
chr1,218339040,218339680,SRX16500060,CTCF,640
chr1,218339058,218339682,SRX16500059,CTCF,624
chr1,218339157,218339660,SRX16500062,CTCF,503
chr1,218339167,218339705,SRX16500061,CTCF,538
chr1,218339326,218339531,SRX5716464,SMARCA4,205
chr1,218339348,218339576,SRX5075168,SMARCA4,228
chr1,218339376,218339553,SRX5075174,SMARCA4,177
chr1,218339384,218339577,SRX5075170,SMARCA4,193
chr1,218345187,218345451,SRX20140895,INTS13,264
chr1,218345708,218346139,SRX20140895,INTS13,431
chr1,218351595,218351833,SRX5075176,SMARCA4,238
chr1,218351810,218352023,SRX5054309,FOSL2,213
chr1,218361304,218361762,SRX16500059,CTCF,458
chr1,218361315,218361752,SRX16500060,CTCF,437
chr1,218361344,218361748,SRX16500061,CTCF,404
chr1,218361369,218361700,SRX16500062,CTCF,331
chr1,218361416,218361673,SRX4174629,CTCF,257
chr1,218361430,218361657,SRX5075176,SMARCA4,227
chr1,218361436,218361647,SRX5075168,SMARCA4,211
chr1,218361475,218361781,SRX5075170,SMARCA4,306
chr1,218371990,218372366,SRX5075176,SMARCA4,376
chr1,218372037,218372357,SRX5075170,SMARCA4,320
chr1,218374936,218375327,SRX5075174,SMARCA4,391
chr1,218374998,218375387,SRX5054309,FOSL2,389
chr1,218375047,218375351,SRX5054308,FOSL2,304
chr1,218375053,218375371,SRX5075168,SMARCA4,318
chr1,218375101,218375301,SRX5020211,SMARCA2,200
chr1,218377237,218377663,SRX5716470,SMARCA4,426
chr1,218377239,218377571,SRX5020211,SMARCA2,332
chr1,218377257,218377669,SRX5075175,SMARCA4,412
chr1,218377265,218377620,SRX5716467,SMARCA2,355
chr1,218377278,218377708,SRX5075169,SMARCA4,430
chr1,218377284,218377573,SRX5075182,SMARCA2,289
chr1,218377293,218377705,SRX5075170,SMARCA4,412
chr1,218377293,218377719,SRX5075176,SMARCA4,426
chr1,218377294,218377731,SRX5054309,FOSL2,437
chr1,218377297,218377633,SRX5716469,SMARCA4,336
chr1,218377310,218377645,SRX5020214,SMARCA2,335
chr1,218377311,218377721,SRX5054308,FOSL2,410
chr1,218377337,218377563,SRX5075174,SMARCA4,226
chr1,218377348,218377607,SRX5054307,FOSL2,259
chr1,218377348,218377630,SRX5075181,SMARCA2,282
chr1,218377367,218377624,SRX5716468,SMARCA2,257
chr1,218380507,218380860,SRX5716470,SMARCA4,353
chr1,218380536,218380786,SRX5075169,SMARCA4,250
chr1,218380602,218380835,SRX5075176,SMARCA4,233
chr1,218384662,218384903,SRX5075176,SMARCA4,241
chr1,218384684,218384963,SRX5075168,SMARCA4,279
chr1,218384711,218384959,SRX5054308,FOSL2,248
chr1,218384714,218384885,SRX5075170,SMARCA4,171
chr1,218384715,218384911,SRX5075174,SMARCA4,196
chr1,218384719,218384927,SRX5054309,FOSL2,208
chr1,218390647,218390912,SRX5075169,SMARCA4,265
chr1,218409983,218410188,SRX5054308,FOSL2,205
chr1,218410001,218410213,SRX5075176,SMARCA4,212
chr1,218424554,218424818,SRX5075168,SMARCA4,264
chr1,218426322,218426523,SRX5075176,SMARCA4,201
chr1,218426340,218426540,SRX5075170,SMARCA4,200
chr1,218433888,218434064,SRX5075176,SMARCA4,176
chr1,218433923,218434290,SRX5075170,SMARCA4,367
chr1,218439236,218439451,SRX5716467,SMARCA2,215
chr1,218439260,218439638,SRX5075170,SMARCA4,378
chr1,218439294,218439791,SRX5075176,SMARCA4,497
chr1,218439327,218439779,SRX5716470,SMARCA4,452
chr1,218439336,218439581,SRX5075169,SMARCA4,245
chr1,218451493,218451829,SRX5075174,SMARCA4,336
chr1,218459857,218460280,SRX5716469,SMARCA4,423
chr1,218459869,218460329,SRX5075175,SMARCA4,460
chr1,218459873,218460323,SRX5716470,SMARCA4,450
chr1,218459879,218460334,SRX5075174,SMARCA4,455
chr1,218459882,218460304,SRX5075170,SMARCA4,422
chr1,218459890,218460270,SRX5020211,SMARCA2,380
chr1,218459906,218460291,SRX5054308,FOSL2,385
chr1,218459909,218460264,SRX5075169,SMARCA4,355
chr1,218459915,218460267,SRX5075176,SMARCA4,352
chr1,218459917,218460757,SRX5075168,SMARCA4,840
chr1,218459918,218460287,SRX5054309,FOSL2,369
chr1,218459924,218460276,SRX5716467,SMARCA2,352
chr1,218459929,218460221,SRX5020214,SMARCA2,292
chr1,218459937,218460200,SRX5075181,SMARCA2,263
chr1,218459968,218460298,SRX5054307,FOSL2,330
chr1,218460017,218460274,SRX5716463,SMARCA4,257
chr1,218460019,218460322,SRX5716468,SMARCA2,303
chr1,218460476,218460728,SRX5075176,SMARCA4,252
chr1,218460488,218460668,SRX5075169,SMARCA4,180
chr1,218460538,218460847,SRX5075174,SMARCA4,309
chr1,218460547,218460750,SRX5075170,SMARCA4,203
chr1,218463517,218463853,SRX5075176,SMARCA4,336
chr1,218463526,218463820,SRX5075170,SMARCA4,294
chr1,218463538,218463776,SRX5075175,SMARCA4,238
chr1,218463540,218463846,SRX5054308,FOSL2,306
chr1,218463576,218463870,SRX5054309,FOSL2,294
chr1,218473656,218473935,SRX5054308,FOSL2,279
chr1,218473657,218473923,SRX5054309,FOSL2,266
chr1,218473659,218473890,SRX5075176,SMARCA4,231
chr1,218473687,218473876,SRX5075169,SMARCA4,189
chr1,218476470,218476678,SRX5054308,FOSL2,208
chr1,218476482,218476676,SRX5075176,SMARCA4,194
chr1,218476489,218476721,SRX5054309,FOSL2,232
chr1,218476491,218476669,SRX5075170,SMARCA4,178
chr1,218480179,218480369,SRX5075176,SMARCA4,190
chr1,218480220,218480397,SRX5075170,SMARCA4,177
chr1,218480241,218480971,SRX5075169,SMARCA4,730
chr1,218480248,218480994,SRX5054309,FOSL2,746
chr1,218480333,218480931,SRX5075175,SMARCA4,598
chr1,218480599,218480894,SRX5716467,SMARCA2,295
chr1,218480625,218480903,SRX5075176,SMARCA4,278
chr1,218480647,218480982,SRX5054308,FOSL2,335
chr1,218480651,218480881,SRX5020211,SMARCA2,230
chr1,218487726,218488024,SRX5054309,FOSL2,298
chr1,218487783,218487980,SRX5054308,FOSL2,197
chr1,218487861,218488105,SRX5075170,SMARCA4,244
chr1,218487865,218488152,SRX5075169,SMARCA4,287
chr1,218487867,218488064,SRX5075176,SMARCA4,197
chr1,218496590,218496973,SRX5054309,FOSL2,383
chr1,218496599,218496929,SRX5075169,SMARCA4,330
chr1,218496614,218496961,SRX5075170,SMARCA4,347
chr1,218496623,218496997,SRX5075175,SMARCA4,374
chr1,218496633,218496959,SRX5075176,SMARCA4,326
chr1,218496667,218496878,SRX5054308,FOSL2,211
chr1,218496696,218496901,SRX5020214,SMARCA2,205
chr1,218498998,218499318,SRX5075170,SMARCA4,320
chr1,218499011,218499338,SRX5075176,SMARCA4,327
chr1,218499126,218499346,SRX5075169,SMARCA4,220
chr1,218499128,218499316,SRX5075175,SMARCA4,188
chr1,218499130,218499385,SRX5054309,FOSL2,255
chr1,218499142,218499395,SRX5716467,SMARCA2,253
chr1,218499159,218499414,SRX5716469,SMARCA4,255
chr1,218499180,218499360,SRX5054308,FOSL2,180
chr1,218521586,218521955,SRX16500062,CTCF,369
chr1,218521593,218521971,SRX16500059,CTCF,378
chr1,218521636,218521979,SRX16500060,CTCF,343
chr1,218521669,218521971,SRX16500061,CTCF,302
chr1,218525078,218525268,SRX5075170,SMARCA4,190
chr1,218536565,218536785,SRX5075170,SMARCA4,220
chr1,218536631,218536806,SRX5075176,SMARCA4,175
chr1,218537141,218537605,SRX5075174,SMARCA4,464
chr1,218537222,218537524,SRX5075168,SMARCA4,302
chr1,218537307,218537518,SRX5716463,SMARCA4,211
chr1,218537559,218537813,SRX5054309,FOSL2,254
chr1,218557869,218558155,SRX5075176,SMARCA4,286
chr1,218557905,218558170,SRX5075170,SMARCA4,265
chr1,218569005,218569568,SRX5054309,FOSL2,563
chr1,218569108,218569388,SRX5054308,FOSL2,280
chr1,218569206,218569375,SRX5075170,SMARCA4,169
chr1,218585267,218586291,SRX5075170,SMARCA4,1024
chr1,218585308,218586191,SRX5075176,SMARCA4,883
chr1,218585316,218585951,SRX5020211,SMARCA2,635
chr1,218585343,218586206,SRX5075169,SMARCA4,863
chr1,218585377,218586218,SRX5716470,SMARCA4,841
chr1,218585401,218586163,SRX5716469,SMARCA4,762
chr1,218585409,218585996,SRX5054309,FOSL2,587
chr1,218585409,218586236,SRX5075175,SMARCA4,827
chr1,218585412,218586017,SRX5054308,FOSL2,605
chr1,218585426,218585761,SRX5716467,SMARCA2,335
chr1,218585511,218586372,SRX5075168,SMARCA4,861
chr1,218585567,218585891,SRX5075182,SMARCA2,324
chr1,218585578,218586272,SRX5075174,SMARCA4,694
chr1,218585663,218585871,SRX5075181,SMARCA2,208
chr1,218585905,218586171,SRX20140869,INTS10,266
chr1,218585985,218586229,SRX20140867,INTS10,244
chr1,218604335,218604518,SRX5054309,FOSL2,183
chr1,218604351,218604538,SRX5075175,SMARCA4,187
chr1,218604380,218604591,SRX5075176,SMARCA4,211
chr1,218604409,218604596,SRX5075169,SMARCA4,187
chr1,218616813,218617002,SRX5075176,SMARCA4,189
chr1,218658934,218659225,SRX5075169,SMARCA4,291
chr1,218658959,218659204,SRX5054309,FOSL2,245
chr1,218658962,218659193,SRX5075175,SMARCA4,231
chr1,218658973,218659157,SRX5075176,SMARCA4,184
chr1,218658979,218659206,SRX5716469,SMARCA4,227
chr1,218658981,218659213,SRX5054308,FOSL2,232
chr1,218658992,218659192,SRX5075170,SMARCA4,200
chr1,218660428,218660777,SRX20140869,INTS10,349
chr1,218660711,218661074,SRX5054308,FOSL2,363
chr1,218660719,218661040,SRX5054309,FOSL2,321
chr1,218660741,218661042,SRX5075170,SMARCA4,301
chr1,218660761,218660998,SRX5075175,SMARCA4,237
chr1,218660770,218660991,SRX5716467,SMARCA2,221
chr1,218660791,218661015,SRX5075169,SMARCA4,224
chr1,218660803,218661076,SRX5075176,SMARCA4,273
chr1,218660859,218661049,SRX5075168,SMARCA4,190
chr1,218661520,218661702,SRX5075174,SMARCA4,182
chr1,218664840,218665473,SRX5075176,SMARCA4,633
chr1,218664869,218665159,SRX5075170,SMARCA4,290
chr1,218665190,218665447,SRX5075169,SMARCA4,257
chr1,218665215,218665485,SRX5075170,SMARCA4,270
chr1,218674415,218674860,SRX5075169,SMARCA4,445
chr1,218674420,218674845,SRX5075176,SMARCA4,425
chr1,218674427,218674830,SRX5075174,SMARCA4,403
chr1,218674427,218674873,SRX5075168,SMARCA4,446
chr1,218674445,218674857,SRX5075170,SMARCA4,412
chr1,218674451,218674853,SRX5716470,SMARCA4,402
chr1,218674475,218674802,SRX5716468,SMARCA2,327
chr1,218674486,218674820,SRX5716464,SMARCA4,334
chr1,218674502,218674833,SRX5054309,FOSL2,331
chr1,218674510,218674851,SRX5716469,SMARCA4,341
chr1,218674516,218674833,SRX5054308,FOSL2,317
chr1,218674538,218674740,SRX5075182,SMARCA2,202
chr1,218674538,218674817,SRX5075181,SMARCA2,279
chr1,218674542,218674855,SRX5075175,SMARCA4,313
chr1,218674559,218674824,SRX5716460,Epitope tags,265
chr1,218674559,218674829,SRX5716463,SMARCA4,270
chr1,218674587,218674825,SRX5020211,SMARCA2,238
chr1,218674617,218674843,SRX5020214,SMARCA2,226
chr1,218686337,218686551,SRX5054309,FOSL2,214
chr1,218705859,218706611,SRX5054309,FOSL2,752
chr1,218706038,218706535,SRX5075169,SMARCA4,497
chr1,218706050,218706541,SRX5075170,SMARCA4,491
chr1,218706062,218706551,SRX5054308,FOSL2,489
chr1,218706064,218706821,SRX5716470,SMARCA4,757
chr1,218706074,218706485,SRX5716467,SMARCA2,411
chr1,218706106,218706632,SRX5075175,SMARCA4,526
chr1,218706122,218706490,SRX5716468,SMARCA2,368
chr1,218706126,218706488,SRX5075182,SMARCA2,362
chr1,218706128,218706538,SRX5716469,SMARCA4,410
chr1,218706142,218706650,SRX5020211,SMARCA2,508
chr1,218706148,218706723,SRX5075176,SMARCA4,575
chr1,218706239,218706550,SRX5020214,SMARCA2,311
chr1,218706295,218706569,SRX5075181,SMARCA2,274
chr1,218712057,218712237,SRX5075169,SMARCA4,180
chr1,218717591,218717852,SRX5075170,SMARCA4,261
chr1,218717637,218717879,SRX5075169,SMARCA4,242
chr1,218718181,218718608,SRX5075174,SMARCA4,427
chr1,218718247,218718538,SRX5075176,SMARCA4,291
chr1,218718304,218718534,SRX5716470,SMARCA4,230
chr1,218718336,218718546,SRX5075168,SMARCA4,210
chr1,218735266,218735720,SRX5020211,SMARCA2,454
chr1,218735296,218735739,SRX5054309,FOSL2,443
chr1,218735300,218735496,SRX5075175,SMARCA4,196
chr1,218735300,218735519,SRX5075169,SMARCA4,219
chr1,218735304,218735519,SRX5716469,SMARCA4,215
chr1,218735338,218735768,SRX5054308,FOSL2,430
chr1,218735349,218735555,SRX5020214,SMARCA2,206
chr1,218735349,218735629,SRX5716470,SMARCA4,280
chr1,218748109,218748460,SRX5075169,SMARCA4,351
chr1,218748137,218748475,SRX5054309,FOSL2,338
chr1,218748167,218748434,SRX5054308,FOSL2,267
chr1,218748207,218748419,SRX5716469,SMARCA4,212
chr1,218748215,218748456,SRX5075176,SMARCA4,241
chr1,218760536,218761015,SRX5716470,SMARCA4,479
chr1,218760608,218760876,SRX5716467,SMARCA2,268
chr1,218760609,218760902,SRX5075170,SMARCA4,293
chr1,218760630,218760867,SRX5075176,SMARCA4,237
chr1,218760647,218760974,SRX5716468,SMARCA2,327
chr1,218760651,218760974,SRX5075169,SMARCA4,323
chr1,218760675,218760891,SRX5020211,SMARCA2,216
chr1,218760677,218760907,SRX5054309,FOSL2,230
chr1,218760683,218760898,SRX5020214,SMARCA2,215
chr1,218772522,218772811,SRX5075169,SMARCA4,289
chr1,218772624,218772928,SRX5075176,SMARCA4,304
chr1,218772638,218772871,SRX5054308,FOSL2,233
chr1,218772647,218772888,SRX5054309,FOSL2,241
chr1,218772653,218772902,SRX5075170,SMARCA4,249
chr1,218779191,218779550,SRX5054308,FOSL2,359
chr1,218779209,218779597,SRX5054309,FOSL2,388
chr1,218779275,218779517,SRX5075170,SMARCA4,242
chr1,218779349,218779562,SRX5075169,SMARCA4,213
chr1,218785940,218786222,SRX5075169,SMARCA4,282
chr1,218785978,218786233,SRX5716469,SMARCA4,255
chr1,218785994,218786167,SRX5075170,SMARCA4,173
chr1,218813252,218813549,SRX5054309,FOSL2,297
chr1,218813344,218813606,SRX5075169,SMARCA4,262
chr1,218813367,218813565,SRX5075175,SMARCA4,198
chr1,218823261,218823785,SRX5054309,FOSL2,524
chr1,218823395,218823593,SRX5054308,FOSL2,198
chr1,218851472,218851902,SRX5054309,FOSL2,430
chr1,218851505,218851909,SRX5075170,SMARCA4,404
chr1,218851522,218851879,SRX5020214,SMARCA2,357
chr1,218851523,218851912,SRX5054308,FOSL2,389
chr1,218851525,218851890,SRX5075169,SMARCA4,365
chr1,218851527,218851820,SRX5075175,SMARCA4,293
chr1,218851587,218851837,SRX5716469,SMARCA4,250
chr1,218851594,218851811,SRX5075176,SMARCA4,217
chr1,218851722,218851933,SRX5716470,SMARCA4,211
chr1,218874178,218874733,SRX5075169,SMARCA4,555
chr1,218874193,218874740,SRX5075176,SMARCA4,547
chr1,218874217,218874720,SRX5054309,FOSL2,503
chr1,218874229,218874744,SRX5075170,SMARCA4,515
chr1,218874249,218874637,SRX5054308,FOSL2,388
chr1,218874252,218874572,SRX5716467,SMARCA2,320
chr1,218874273,218874612,SRX5075174,SMARCA4,339
chr1,218874280,218874681,SRX5716470,SMARCA4,401
chr1,218874286,218874710,SRX5075175,SMARCA4,424
chr1,218874299,218874507,SRX5020211,SMARCA2,208
chr1,218874300,218874599,SRX5716469,SMARCA4,299
chr1,218874307,218874632,SRX5075168,SMARCA4,325
chr1,218874354,218874675,SRX5075181,SMARCA2,321
chr1,218874356,218874594,SRX5716468,SMARCA2,238
chr1,218886466,218886829,SRX5075169,SMARCA4,363
chr1,218886475,218886703,SRX5716469,SMARCA4,228
chr1,218886521,218886895,SRX5075170,SMARCA4,374
chr1,218886529,218886816,SRX5075176,SMARCA4,287
chr1,218942358,218942927,SRX5075169,SMARCA4,569
chr1,218942367,218942820,SRX5075170,SMARCA4,453
chr1,218942379,218942870,SRX5075176,SMARCA4,491
chr1,218942405,218942764,SRX5716468,SMARCA2,359
chr1,218942462,218942719,SRX5716470,SMARCA4,257
chr1,218942478,218942761,SRX5716469,SMARCA4,283
chr1,218942507,218942768,SRX5075175,SMARCA4,261
chr1,218945129,218945357,SRX5054309,FOSL2,228
chr1,218967977,218968160,SRX5054309,FOSL2,183
chr1,218968981,218969376,SRX5075170,SMARCA4,395
chr1,218969061,218969363,SRX5075176,SMARCA4,302
chr1,218969063,218969275,SRX5075169,SMARCA4,212
chr1,218970425,218970681,SRX5075174,SMARCA4,256
chr1,218970482,218970780,SRX5075168,SMARCA4,298
chr1,218971153,218971548,SRX5075170,SMARCA4,395
chr1,218971162,218971578,SRX5075176,SMARCA4,416
chr1,218984004,218984251,SRX16500062,CTCF,247
chr1,218990997,218991340,SRX5075170,SMARCA4,343
chr1,218991033,218991382,SRX5075176,SMARCA4,349
chr1,219041142,219041601,SRX5716470,SMARCA4,459
chr1,219041208,219041489,SRX5075176,SMARCA4,281
chr1,219041237,219041454,SRX5716469,SMARCA4,217
chr1,219041238,219041592,SRX5054309,FOSL2,354
chr1,219041252,219041574,SRX5054308,FOSL2,322
chr1,219041261,219041512,SRX5075169,SMARCA4,251
chr1,219041278,219041596,SRX5075175,SMARCA4,318
chr1,219041298,219041486,SRX5075170,SMARCA4,188
chr1,219049651,219049843,SRX5075176,SMARCA4,192
chr1,219060943,219061189,SRX5075174,SMARCA4,246
chr1,219066733,219067239,SRX5075170,SMARCA4,506
chr1,219066786,219067269,SRX5075169,SMARCA4,483
chr1,219066939,219067361,SRX5716469,SMARCA4,422
chr1,219066960,219067437,SRX16500062,CTCF,477
chr1,219066987,219067299,SRX5075176,SMARCA4,312
chr1,219067009,219067250,SRX5075175,SMARCA4,241
chr1,219067045,219067412,SRX16500060,CTCF,367
chr1,219067056,219067401,SRX16500061,CTCF,345
chr1,219067067,219067457,SRX16500059,CTCF,390
chr1,219067076,219067351,SRX5716470,SMARCA4,275
chr1,219085057,219085451,SRX5054308,FOSL2,394
chr1,219085066,219085448,SRX5054309,FOSL2,382
chr1,219085087,219085397,SRX5075176,SMARCA4,310
chr1,219085091,219085439,SRX5075175,SMARCA4,348
chr1,219085097,219085472,SRX5075169,SMARCA4,375
chr1,219085106,219085434,SRX5075170,SMARCA4,328
chr1,219085140,219085479,SRX5716469,SMARCA4,339
chr1,219085174,219085419,SRX5020211,SMARCA2,245
chr1,219085187,219085408,SRX5716467,SMARCA2,221
chr1,219092228,219092470,SRX5075169,SMARCA4,242
chr1,219120695,219120925,SRX5075176,SMARCA4,230
chr1,219120725,219121595,SRX5075170,SMARCA4,870
chr1,219120759,219120946,SRX5075175,SMARCA4,187
chr1,219121006,219121563,SRX5716470,SMARCA4,557
chr1,219121025,219121573,SRX5075176,SMARCA4,548
chr1,219121081,219121531,SRX5075175,SMARCA4,450
chr1,219121110,219121493,SRX5075169,SMARCA4,383
chr1,219121147,219121431,SRX5716468,SMARCA2,284
chr1,219121174,219121503,SRX5716467,SMARCA2,329
chr1,219121178,219121476,SRX5054308,FOSL2,298
chr1,219121192,219121612,SRX5716469,SMARCA4,420
chr1,219121196,219121555,SRX5020211,SMARCA2,359
chr1,219121219,219121438,SRX5054309,FOSL2,219
chr1,219121800,219121991,SRX5075176,SMARCA4,191
chr1,219121867,219122045,SRX5075170,SMARCA4,178
chr1,219149067,219149341,SRX5075170,SMARCA4,274
chr1,219149075,219149263,SRX5075176,SMARCA4,188
chr1,219155043,219155449,SRX5075170,SMARCA4,406
chr1,219155093,219155312,SRX5075176,SMARCA4,219
chr1,219155138,219155340,SRX5020211,SMARCA2,202
chr1,219155141,219155321,SRX5054308,FOSL2,180
chr1,219161038,219161213,SRX5075176,SMARCA4,175
chr1,219173549,219174016,SRX5075176,SMARCA4,467
chr1,219173590,219174056,SRX5075169,SMARCA4,466
chr1,219173598,219174096,SRX5075168,SMARCA4,498
chr1,219173603,219174068,SRX5075174,SMARCA4,465
chr1,219173630,219174190,SRX20140895,INTS13,560
chr1,219173632,219174004,SRX5075170,SMARCA4,372
chr1,219173642,219174014,SRX5716464,SMARCA4,372
chr1,219173688,219174053,SRX5716463,SMARCA4,365
chr1,219173694,219173934,SRX5054309,FOSL2,240
chr1,219173711,219174011,SRX5716470,SMARCA4,300
chr1,219173747,219174083,SRX20140867,INTS10,336
chr1,219173786,219174031,SRX20140897,INTS13,245
chr1,219174651,219174970,SRX5075170,SMARCA4,319
chr1,219174669,219174969,SRX5075175,SMARCA4,300
chr1,219174746,219174927,SRX5075169,SMARCA4,181
chr1,219174759,219175018,SRX5716470,SMARCA4,259
chr1,219174829,219175038,SRX5075176,SMARCA4,209
chr1,219188988,219189368,SRX5075175,SMARCA4,380
chr1,219188999,219189446,SRX5075170,SMARCA4,447
chr1,219189005,219189347,SRX5075176,SMARCA4,342
chr1,219189017,219189366,SRX5716469,SMARCA4,349
chr1,219189024,219189287,SRX5716470,SMARCA4,263
chr1,219189024,219189336,SRX5054309,FOSL2,312
chr1,219189025,219189311,SRX5054308,FOSL2,286
chr1,219189035,219189414,SRX5075169,SMARCA4,379
chr1,219189059,219189387,SRX5716467,SMARCA2,328
chr1,219189088,219189299,SRX5716468,SMARCA2,211
chr1,219204538,219205049,SRX16500060,CTCF,511
chr1,219204543,219205027,SRX16500062,CTCF,484
chr1,219204618,219205061,SRX16500059,CTCF,443
chr1,219204692,219205042,SRX16500061,CTCF,350
chr1,219209639,219209882,SRX5075174,SMARCA4,243
chr1,219235885,219236261,SRX5075176,SMARCA4,376
chr1,219235933,219236280,SRX5075170,SMARCA4,347
chr1,219236012,219236211,SRX5075175,SMARCA4,199
chr1,219264468,219264763,SRX5716464,SMARCA4,295
chr1,219264481,219264881,SRX5716470,SMARCA4,400
chr1,219264485,219265018,SRX5075168,SMARCA4,533
chr1,219264504,219264996,SRX5075174,SMARCA4,492
chr1,219264507,219264877,SRX5075175,SMARCA4,370
chr1,219264515,219264883,SRX5716463,SMARCA4,368
chr1,219264552,219264900,SRX5075169,SMARCA4,348
chr1,219264570,219264922,SRX5075170,SMARCA4,352
chr1,219264616,219264877,SRX5716469,SMARCA4,261
chr1,219264639,219264951,SRX5075176,SMARCA4,312
chr1,219271491,219271820,SRX5054309,FOSL2,329
chr1,219271534,219271801,SRX5054308,FOSL2,267
chr1,219271567,219272093,SRX5075170,SMARCA4,526
chr1,219271614,219271921,SRX5075176,SMARCA4,307
chr1,219271648,219271859,SRX5075169,SMARCA4,211
chr1,219276087,219276306,SRX5075168,SMARCA4,219
chr1,219296361,219296692,SRX5075169,SMARCA4,331
chr1,219298645,219298997,SRX5075176,SMARCA4,352
chr1,219298702,219299056,SRX5075169,SMARCA4,354
chr1,219298778,219298975,SRX5075175,SMARCA4,197
chr1,219312917,219313412,SRX5054309,FOSL2,495
chr1,219312990,219313365,SRX5075176,SMARCA4,375
chr1,219312993,219313431,SRX5054308,FOSL2,438
chr1,219313039,219313306,SRX5716467,SMARCA2,267
chr1,219313045,219313375,SRX5075175,SMARCA4,330
chr1,219313046,219313425,SRX5075170,SMARCA4,379
chr1,219313053,219313356,SRX5075169,SMARCA4,303
chr1,219313073,219313287,SRX5716469,SMARCA4,214
chr1,219313074,219313296,SRX5716470,SMARCA4,222
chr1,219317795,219318045,SRX16500060,CTCF,250
chr1,219317860,219318087,SRX16500062,CTCF,227
chr1,219324899,219325427,SRX5075170,SMARCA4,528
chr1,219324934,219325524,SRX5075169,SMARCA4,590
chr1,219325012,219325382,SRX5716460,Epitope tags,370
chr1,219325025,219325462,SRX5075176,SMARCA4,437
chr1,219325037,219325350,SRX5716459,Epitope tags,313
chr1,219325037,219325454,SRX5075175,SMARCA4,417
chr1,219325049,219325366,SRX5716469,SMARCA4,317
chr1,219325049,219325450,SRX5054309,FOSL2,401
chr1,219325079,219325394,SRX5054308,FOSL2,315
chr1,219325087,219325359,SRX5020211,SMARCA2,272
chr1,219325128,219325343,SRX5716467,SMARCA2,215
chr1,219325150,219325355,SRX5020214,SMARCA2,205
chr1,219329676,219329993,SRX5075170,SMARCA4,317
chr1,219329767,219329956,SRX5075176,SMARCA4,189
chr1,219330077,219330277,SRX5020211,SMARCA2,200
chr1,219330143,219330331,SRX5054309,FOSL2,188
chr1,219330153,219330338,SRX5075169,SMARCA4,185
chr1,219330159,219330402,SRX5020214,SMARCA2,243
chr1,219347656,219348153,SRX5075176,SMARCA4,497
chr1,219347795,219348223,SRX5075170,SMARCA4,428
chr1,219347802,219348135,SRX5075175,SMARCA4,333
chr1,219347821,219348107,SRX5716467,SMARCA2,286
chr1,219347847,219348031,SRX5075169,SMARCA4,184
chr1,219347863,219348120,SRX5716470,SMARCA4,257
chr1,219350544,219350744,SRX5075176,SMARCA4,200
chr1,219362797,219362996,SRX5075168,SMARCA4,199
chr1,219365453,219365828,SRX5054309,FOSL2,375
chr1,219365466,219365875,SRX5075170,SMARCA4,409
chr1,219365468,219365692,SRX5075176,SMARCA4,224
chr1,219365502,219365787,SRX5054308,FOSL2,285
chr1,219365605,219365785,SRX5075169,SMARCA4,180
chr1,219374029,219374305,SRX5075170,SMARCA4,276
chr1,219374108,219374308,SRX5020211,SMARCA2,200
chr1,219374119,219374424,SRX5054309,FOSL2,305
chr1,219374164,219374353,SRX5075176,SMARCA4,189
chr1,219374238,219374476,SRX5075169,SMARCA4,238
chr1,219385772,219386162,SRX16500061,CTCF,390
chr1,219385810,219386108,SRX16500059,CTCF,298
chr1,219385812,219386187,SRX16500062,CTCF,375
chr1,219385825,219386179,SRX16500060,CTCF,354
chr1,219385899,219386083,SRX5075168,SMARCA4,184
chr1,219405436,219405647,SRX5716470,SMARCA4,211
chr1,219405505,219405911,SRX5075175,SMARCA4,406
chr1,219405506,219405869,SRX5075170,SMARCA4,363
chr1,219405535,219405784,SRX5716467,SMARCA2,249
chr1,219405552,219405849,SRX5075176,SMARCA4,297
chr1,219405584,219405889,SRX5075169,SMARCA4,305
chr1,219405596,219405779,SRX5054309,FOSL2,183
chr1,219412823,219413284,SRX5075169,SMARCA4,461
chr1,219412848,219413213,SRX5054309,FOSL2,365
chr1,219412938,219413246,SRX5075175,SMARCA4,308
chr1,219413026,219413206,SRX5054308,FOSL2,180
chr1,219416568,219417078,SRX16500059,CTCF,510
chr1,219416605,219416958,SRX5075168,SMARCA4,353
chr1,219416608,219417049,SRX16500060,CTCF,441
chr1,219416609,219417055,SRX16500062,CTCF,446
chr1,219416653,219416892,SRX5716463,SMARCA4,239
chr1,219416675,219416958,SRX5075174,SMARCA4,283
chr1,219416677,219417199,SRX16500061,CTCF,522
chr1,219416708,219416931,SRX4174629,CTCF,223
chr1,219422783,219422983,SRX5054309,FOSL2,200
chr1,219422828,219422997,SRX5075170,SMARCA4,169
chr1,219422834,219423035,SRX5075169,SMARCA4,201
chr1,219428139,219428557,SRX5075170,SMARCA4,418
chr1,219432112,219432327,SRX5075182,SMARCA2,215
chr1,219432151,219432559,SRX5054309,FOSL2,408
chr1,219432448,219432628,SRX5075169,SMARCA4,180
chr1,219442686,219442906,SRX5075170,SMARCA4,220
chr1,219442703,219442921,SRX5075175,SMARCA4,218
chr1,219442806,219442986,SRX5075169,SMARCA4,180
chr1,219467467,219467636,SRX5075170,SMARCA4,169
chr1,219496107,219496329,SRX5716467,SMARCA2,222
chr1,219518576,219518828,SRX5054308,FOSL2,252
chr1,219518591,219518870,SRX5054309,FOSL2,279
chr1,219518693,219518868,SRX5075176,SMARCA4,175
chr1,219533256,219533820,SRX5075170,SMARCA4,564
chr1,219533297,219533743,SRX5075169,SMARCA4,446
chr1,219533324,219533756,SRX5716469,SMARCA4,432
chr1,219533329,219533571,SRX5716467,SMARCA2,242
chr1,219533331,219533525,SRX5075181,SMARCA2,194
chr1,219533351,219533726,SRX5075175,SMARCA4,375
chr1,219533355,219533722,SRX5075176,SMARCA4,367
chr1,219533378,219533770,SRX5716470,SMARCA4,392
chr1,219533392,219533645,SRX5075182,SMARCA2,253
chr1,219533398,219533693,SRX5020211,SMARCA2,295
chr1,219533456,219533792,SRX5054309,FOSL2,336
chr1,219543178,219543373,SRX5054309,FOSL2,195
chr1,219549331,219549599,SRX5075170,SMARCA4,268
chr1,219549362,219549594,SRX5075176,SMARCA4,232
chr1,219555108,219555673,SRX5716463,SMARCA4,565
chr1,219555130,219555715,SRX5075168,SMARCA4,585
chr1,219555133,219555642,SRX5075174,SMARCA4,509
chr1,219555231,219556128,SRX5075170,SMARCA4,897
chr1,219555297,219555620,SRX5075176,SMARCA4,323
chr1,219555299,219555556,SRX5716464,SMARCA4,257
chr1,219555345,219555626,SRX5054309,FOSL2,281
chr1,219555362,219555544,SRX5054308,FOSL2,182
chr1,219555388,219556156,SRX5075169,SMARCA4,768
chr1,219555412,219555637,SRX5716469,SMARCA4,225
chr1,219555666,219556122,SRX5075175,SMARCA4,456
chr1,219555685,219556165,SRX5075176,SMARCA4,480
chr1,219555750,219556098,SRX5716469,SMARCA4,348
chr1,219555821,219556239,SRX5075174,SMARCA4,418
chr1,219555852,219556177,SRX5054309,FOSL2,325
chr1,219555937,219556168,SRX5716451,SOX2,231
chr1,219555979,219556288,SRX5075168,SMARCA4,309
chr1,219567336,219567712,SRX16500061,CTCF,376
chr1,219567347,219567734,SRX16500060,CTCF,387
chr1,219567357,219567749,SRX16500059,CTCF,392
chr1,219567379,219567696,SRX16500062,CTCF,317
chr1,219567432,219567612,SRX5075169,SMARCA4,180
chr1,219580060,219580282,SRX5075170,SMARCA4,222
chr1,219580097,219580390,SRX5075176,SMARCA4,293
chr1,219580130,219580354,SRX5054308,FOSL2,224
chr1,219587938,219588370,SRX5075169,SMARCA4,432
chr1,219588002,219588269,SRX5075170,SMARCA4,267
chr1,219588016,219588284,SRX5075176,SMARCA4,268
chr1,219588084,219588441,SRX5075175,SMARCA4,357
chr1,219588095,219588344,SRX5054309,FOSL2,249
chr1,219659485,219659982,SRX5075170,SMARCA4,497
chr1,219659567,219660038,SRX5075175,SMARCA4,471
chr1,219659585,219660056,SRX5075169,SMARCA4,471
chr1,219659625,219660013,SRX5716470,SMARCA4,388
chr1,219659647,219660069,SRX5075176,SMARCA4,422
chr1,219659674,219660074,SRX5054309,FOSL2,400
chr1,219659681,219659991,SRX5020214,SMARCA2,310
chr1,219659708,219659928,SRX5054308,FOSL2,220
chr1,219659724,219659991,SRX5716467,SMARCA2,267
chr1,219659742,219659972,SRX5716468,SMARCA2,230
chr1,219660973,219661460,SRX16500059,CTCF,487
chr1,219661027,219661470,SRX16500060,CTCF,443
chr1,219661034,219661331,SRX5075170,SMARCA4,297
chr1,219661037,219661458,SRX16500061,CTCF,421
chr1,219661039,219661423,SRX16500062,CTCF,384
chr1,219661058,219661413,SRX5075168,SMARCA4,355
chr1,219661077,219661424,SRX4174629,CTCF,347
chr1,219661090,219661343,SRX5075176,SMARCA4,253
chr1,219661098,219661391,SRX5075174,SMARCA4,293
chr1,219661130,219661340,SRX5075175,SMARCA4,210
chr1,219666100,219666566,SRX5054309,FOSL2,466
chr1,219666119,219666568,SRX5075170,SMARCA4,449
chr1,219666134,219666469,SRX5075169,SMARCA4,335
chr1,219666154,219666577,SRX5075176,SMARCA4,423
chr1,219666172,219666510,SRX5054308,FOSL2,338
chr1,219666182,219666501,SRX5716470,SMARCA4,319
chr1,219666226,219666553,SRX5075175,SMARCA4,327
chr1,219666289,219666535,SRX5716467,SMARCA2,246
chr1,219666315,219666534,SRX5020211,SMARCA2,219
chr1,219672464,219672690,SRX5054308,FOSL2,226
chr1,219676400,219676748,SRX5054309,FOSL2,348
chr1,219676443,219676712,SRX5075169,SMARCA4,269
chr1,219676461,219676707,SRX5075170,SMARCA4,246
chr1,219676462,219676713,SRX5075176,SMARCA4,251
chr1,219676499,219676711,SRX5716469,SMARCA4,212
chr1,219685774,219685949,SRX5075176,SMARCA4,175
chr1,219710702,219711181,SRX5054309,FOSL2,479
chr1,219710707,219711187,SRX5054308,FOSL2,480
chr1,219710721,219711055,SRX5075170,SMARCA4,334
chr1,219710733,219711170,SRX5075169,SMARCA4,437
chr1,219710746,219711141,SRX5075175,SMARCA4,395
chr1,219710808,219711188,SRX5075176,SMARCA4,380
chr1,219710831,219711238,SRX5716469,SMARCA4,407
chr1,219710834,219711081,SRX5020211,SMARCA2,247
chr1,219714146,219714475,SRX5075170,SMARCA4,329
chr1,219714208,219714423,SRX5075176,SMARCA4,215
chr1,219741409,219741921,SRX5075176,SMARCA4,512
chr1,219741471,219741940,SRX5075170,SMARCA4,469
chr1,219747432,219747657,SRX5075174,SMARCA4,225
chr1,219747449,219747704,SRX5075168,SMARCA4,255
chr1,219747514,219747694,SRX5075169,SMARCA4,180
chr1,219770967,219771535,SRX5075176,SMARCA4,568
chr1,219770973,219771491,SRX5054309,FOSL2,518
chr1,219771018,219771452,SRX5075169,SMARCA4,434
chr1,219771019,219771415,SRX5054308,FOSL2,396
chr1,219771020,219771627,SRX5075168,SMARCA4,607
chr1,219771021,219771739,SRX5075174,SMARCA4,718
chr1,219771022,219771495,SRX5075170,SMARCA4,473
chr1,219771045,219771404,SRX5020214,SMARCA2,359
chr1,219771052,219771429,SRX5075175,SMARCA4,377
chr1,219771058,219771478,SRX5716463,SMARCA4,420
chr1,219771064,219771365,SRX5020211,SMARCA2,301
chr1,219771084,219771305,SRX5054307,FOSL2,221
chr1,219771151,219771443,SRX20140895,INTS13,292
chr1,219771230,219771545,SRX5716451,SOX2,315
chr1,219784539,219785186,SRX5075170,SMARCA4,647
chr1,219784580,219784879,SRX5075176,SMARCA4,299
chr1,219784621,219784959,SRX5716470,SMARCA4,338
chr1,219784640,219784933,SRX5075169,SMARCA4,293
chr1,219792114,219792898,SRX5075170,SMARCA4,784
chr1,219792136,219792956,SRX5075176,SMARCA4,820
chr1,219792223,219792821,SRX5075169,SMARCA4,598
chr1,219792231,219792776,SRX5075175,SMARCA4,545
chr1,219792259,219792694,SRX5020211,SMARCA2,435
chr1,219792283,219792619,SRX5716470,SMARCA4,336
chr1,219792291,219792706,SRX5716469,SMARCA4,415
chr1,219792312,219792660,SRX5054309,FOSL2,348
chr1,219792320,219792653,SRX5716467,SMARCA2,333
chr1,219792324,219792717,SRX5054308,FOSL2,393
chr1,219792385,219792596,SRX5716468,SMARCA2,211
chr1,219795045,219795968,SRX20140895,INTS13,923
chr1,219795158,219795968,SRX5075168,SMARCA4,810
chr1,219795169,219795748,SRX5716463,SMARCA4,579
chr1,219795223,219795896,SRX5075174,SMARCA4,673
chr1,219795328,219795891,SRX20140867,INTS10,563
chr1,219795331,219795897,SRX20140868,INTS10,566
chr1,219795333,219795607,SRX20140860,SOX2,274
chr1,219795358,219795763,SRX20140879,CPSF3L,405
chr1,219795433,219795700,SRX5716451,SOX2,267
chr1,219795457,219795819,SRX20140880,CPSF3L,362
chr1,219795519,219795733,SRX5716454,SOX3,214
chr1,219798275,219798653,SRX5054308,FOSL2,378
chr1,219798309,219798875,SRX5075175,SMARCA4,566
chr1,219798339,219798588,SRX5075170,SMARCA4,249
chr1,219798341,219798656,SRX5075169,SMARCA4,315
chr1,219798341,219798877,SRX5054309,FOSL2,536
chr1,219798426,219798649,SRX5075176,SMARCA4,223
chr1,219801442,219801706,SRX5075170,SMARCA4,264
chr1,219801576,219801776,SRX5075176,SMARCA4,200
chr1,219812502,219813043,SRX16500062,CTCF,541
chr1,219812524,219813046,SRX16500059,CTCF,522
chr1,219812545,219813039,SRX16500060,CTCF,494
chr1,219812546,219813057,SRX16500061,CTCF,511
chr1,219812548,219812917,SRX5075168,SMARCA4,369
chr1,219812557,219812978,SRX4174629,CTCF,421
chr1,219812616,219812930,SRX5075174,SMARCA4,314
chr1,219812649,219812894,SRX5075176,SMARCA4,245
chr1,219812673,219813015,SRX5075170,SMARCA4,342
chr1,219812686,219812965,SRX5075169,SMARCA4,279
chr1,219837715,219838193,SRX16500059,CTCF,478
chr1,219837722,219838163,SRX16500060,CTCF,441
chr1,219837732,219838131,SRX16500061,CTCF,399
chr1,219837771,219838109,SRX16500062,CTCF,338
chr1,219837803,219838073,SRX5075174,SMARCA4,270
chr1,219837818,219838062,SRX5075170,SMARCA4,244
chr1,219837823,219838050,SRX5075168,SMARCA4,227
chr1,219837823,219838111,SRX5716464,SMARCA4,288
chr1,219837830,219838073,SRX5075175,SMARCA4,243
chr1,219837843,219838109,SRX5075176,SMARCA4,266
chr1,219884099,219884303,SRX5716463,SMARCA4,204
chr1,219884129,219884378,SRX5075174,SMARCA4,249
chr1,219900288,219900712,SRX5075176,SMARCA4,424
chr1,219900292,219900591,SRX5716470,SMARCA4,299
chr1,219900348,219900690,SRX5075169,SMARCA4,342
chr1,219900361,219900628,SRX5075175,SMARCA4,267
chr1,219900363,219900738,SRX5075170,SMARCA4,375
chr1,219901723,219901903,SRX5075170,SMARCA4,180
chr1,219927840,219928266,SRX20140895,INTS13,426
chr1,219927874,219928332,SRX5075168,SMARCA4,458
chr1,219927915,219928372,SRX5075174,SMARCA4,457
chr1,219928012,219928336,SRX5075170,SMARCA4,324
chr1,219928087,219928291,SRX5716463,SMARCA4,204
chr1,219928124,219928311,SRX5075169,SMARCA4,187
chr1,219990923,219991439,SRX16500059,CTCF,516
chr1,219990946,219991407,SRX16500061,CTCF,461
chr1,219990970,219991471,SRX16500062,CTCF,501
chr1,219990972,219991426,SRX16500060,CTCF,454
chr1,219991096,219991335,SRX5075174,SMARCA4,239
chr1,219991106,219991315,SRX5075170,SMARCA4,209
chr1,219991109,219991289,SRX5075168,SMARCA4,180
chr1,219991117,219991313,SRX5075176,SMARCA4,196
chr1,219991117,219991321,SRX5716463,SMARCA4,204
chr1,220001103,220001361,SRX5075175,SMARCA4,258
chr1,220014543,220014763,SRX5075170,SMARCA4,220
chr1,220046171,220046696,SRX5075175,SMARCA4,525
chr1,220046256,220046896,SRX5075174,SMARCA4,640
chr1,220046263,220047023,SRX20140895,INTS13,760
chr1,220046325,220046858,SRX5075168,SMARCA4,533
chr1,220046346,220046856,SRX16500061,CTCF,510
chr1,220046360,220046816,SRX5075170,SMARCA4,456
chr1,220046372,220046669,SRX5716464,SMARCA4,297
chr1,220046392,220046827,SRX16500060,CTCF,435
chr1,220046394,220046863,SRX16500059,CTCF,469
chr1,220046399,220046873,SRX5075176,SMARCA4,474
chr1,220046418,220046939,SRX16500062,CTCF,521
chr1,220046420,220046743,SRX5716470,SMARCA4,323
chr1,220046489,220046822,SRX20140867,INTS10,333
chr1,220046506,220046757,SRX5716463,SMARCA4,251
chr1,220046509,220046790,SRX5716451,SOX2,281
chr1,220046517,220046744,SRX5716454,SOX3,227
chr1,220046531,220046739,SRX5054309,FOSL2,208
chr1,220046556,220046736,SRX5054308,FOSL2,180
chr1,220046560,220046880,SRX5075169,SMARCA4,320
chr1,220067318,220067606,SRX5054309,FOSL2,288
chr1,220067381,220067578,SRX5054308,FOSL2,197
chr1,220089671,220089983,SRX5075168,SMARCA4,312
chr1,220089683,220090085,SRX5075174,SMARCA4,402
chr1,220089701,220089980,SRX5716463,SMARCA4,279
chr1,220089719,220090118,SRX20140895,INTS13,399
chr1,220089770,220090062,SRX5075176,SMARCA4,292
chr1,220093852,220094275,SRX5075174,SMARCA4,423
chr1,220093866,220094147,SRX5075168,SMARCA4,281
chr1,220093952,220094244,SRX5075170,SMARCA4,292
chr1,220093975,220094620,SRX20140895,INTS13,645
chr1,220094075,220094397,SRX20140868,INTS10,322
chr1,220094157,220094531,SRX5075175,SMARCA4,374
chr1,220094330,220094510,SRX5075169,SMARCA4,180
chr1,220113102,220113540,SRX16500059,CTCF,438
chr1,220113150,220113548,SRX16500060,CTCF,398
chr1,220113188,220113492,SRX16500061,CTCF,304
chr1,220113193,220113447,SRX5075174,SMARCA4,254
chr1,220113213,220113494,SRX5075168,SMARCA4,281
chr1,220113216,220113420,SRX5716463,SMARCA4,204
chr1,220113220,220113423,SRX5075176,SMARCA4,203
chr1,220113232,220113416,SRX5075170,SMARCA4,184
chr1,220113234,220113516,SRX16500062,CTCF,282
chr1,220123958,220124250,SRX16500059,CTCF,292
chr1,220123964,220124222,SRX16500062,CTCF,258
chr1,220123991,220124242,SRX16500060,CTCF,251
chr1,220137376,220137696,SRX5075174,SMARCA4,320
chr1,220137406,220137753,SRX5075168,SMARCA4,347
chr1,220151533,220151761,SRX5075168,SMARCA4,228
chr1,220157776,220158107,SRX5075174,SMARCA4,331
chr1,220157791,220158157,SRX5075168,SMARCA4,366
chr1,220189673,220190138,SRX16500060,CTCF,465
chr1,220189727,220190160,SRX16500061,CTCF,433
chr1,220189741,220190080,SRX16500062,CTCF,339
chr1,220189785,220190195,SRX16500059,CTCF,410
chr1,220198610,220198839,SRX5075169,SMARCA4,229
chr1,220218481,220219059,SRX16500060,CTCF,578
chr1,220218651,220218988,SRX16500061,CTCF,337
chr1,220218655,220219029,SRX16500062,CTCF,374
chr1,220218671,220219037,SRX16500059,CTCF,366
chr1,220272182,220272728,SRX20140897,INTS13,546
chr1,220272201,220272487,SRX20140881,CPSF3L,286
chr1,220272211,220272798,SRX20140895,INTS13,587
chr1,220272455,220272843,SRX5075174,SMARCA4,388
chr1,220272476,220272748,SRX5075168,SMARCA4,272
chr1,220272483,220272807,SRX5716469,SMARCA4,324
chr1,220272494,220272806,SRX5075176,SMARCA4,312
chr1,220272525,220272866,SRX5075170,SMARCA4,341
chr1,220272540,220272898,SRX5075169,SMARCA4,358
chr1,220278964,220279269,SRX5020211,SMARCA2,305
chr1,220279022,220279322,SRX5716469,SMARCA4,300
chr1,220279052,220279310,SRX5716470,SMARCA4,258
chr1,220281038,220281499,SRX16500059,CTCF,461
chr1,220281046,220281393,SRX16500061,CTCF,347
chr1,220281046,220281417,SRX16500060,CTCF,371
chr1,220281089,220281417,SRX16500062,CTCF,328
chr1,220281195,220281408,SRX5054309,FOSL2,213
chr1,220281216,220281495,SRX5054308,FOSL2,279
chr1,220295077,220295377,SRX5054309,FOSL2,300
chr1,220295106,220295355,SRX5054308,FOSL2,249
chr1,220296164,220296615,SRX16500061,CTCF,451
chr1,220296176,220296670,SRX16500060,CTCF,494
chr1,220296226,220296625,SRX16500059,CTCF,399
chr1,220296237,220296638,SRX16500062,CTCF,401
chr1,220298529,220298748,SRX5075174,SMARCA4,219
chr1,220298563,220298742,SRX5075168,SMARCA4,179
chr1,220300408,220300794,SRX5075168,SMARCA4,386
chr1,220300413,220300792,SRX5716463,SMARCA4,379
chr1,220300425,220300888,SRX5075176,SMARCA4,463
chr1,220300427,220300767,SRX5716469,SMARCA4,340
chr1,220300429,220301081,SRX5075170,SMARCA4,652
chr1,220300445,220300811,SRX5716470,SMARCA4,366
chr1,220300449,220300802,SRX5075174,SMARCA4,353
chr1,220300461,220301118,SRX20140869,INTS10,657
chr1,220300475,220300758,SRX5075169,SMARCA4,283
chr1,220300476,220300848,SRX20140897,INTS13,372
chr1,220300477,220300681,SRX5020211,SMARCA2,204
chr1,220300491,220300787,SRX20140895,INTS13,296
chr1,220300497,220301089,SRX5075175,SMARCA4,592
chr1,220300523,220300761,SRX5054309,FOSL2,238
chr1,220326562,220326952,SRX5075169,SMARCA4,390
chr1,220326570,220326937,SRX5716469,SMARCA4,367
chr1,220326645,220326919,SRX5075176,SMARCA4,274
chr1,220326653,220326945,SRX5075170,SMARCA4,292
chr1,220326655,220326966,SRX5075175,SMARCA4,311
chr1,220326659,220327003,SRX5054309,FOSL2,344
chr1,220326667,220326979,SRX5054308,FOSL2,312
chr1,220337447,220337618,SRX5075170,SMARCA4,171
chr1,220343745,220343926,SRX5054308,FOSL2,181
chr1,220343787,220343994,SRX5054309,FOSL2,207
chr1,220363233,220363568,SRX5054309,FOSL2,335
chr1,220363249,220363574,SRX5054308,FOSL2,325
chr1,220363257,220363524,SRX5075176,SMARCA4,267
chr1,220363277,220363547,SRX5075170,SMARCA4,270
chr1,220363280,220363494,SRX5075175,SMARCA4,214
chr1,220363283,220363482,SRX5075168,SMARCA4,199
chr1,220363317,220363504,SRX5075169,SMARCA4,187
chr1,220368579,220369012,SRX5075176,SMARCA4,433
chr1,220368619,220368932,SRX5716470,SMARCA4,313
chr1,220368690,220369064,SRX5075170,SMARCA4,374
chr1,220368816,220369034,SRX5075169,SMARCA4,218
chr1,220368829,220369043,SRX5075175,SMARCA4,214
chr1,220369996,220370717,SRX5075176,SMARCA4,721
chr1,220370085,220370658,SRX5075170,SMARCA4,573
chr1,220370157,220370357,SRX5075175,SMARCA4,200
chr1,220370160,220370742,SRX5075169,SMARCA4,582
chr1,220370175,220370560,SRX5716467,SMARCA2,385
chr1,220370176,220370454,SRX5716468,SMARCA2,278
chr1,220370179,220370647,SRX5054309,FOSL2,468
chr1,220370244,220370709,SRX5054308,FOSL2,465
chr1,220370319,220370688,SRX5716469,SMARCA4,369
chr1,220370410,220370736,SRX5075175,SMARCA4,326
chr1,220370439,220370696,SRX5716470,SMARCA4,257
chr1,220409816,220410417,SRX5075174,SMARCA4,601
chr1,220409859,220410154,SRX20140895,INTS13,295
chr1,220409906,220410340,SRX5075168,SMARCA4,434
chr1,220410411,220411028,SRX5075175,SMARCA4,617
chr1,220410465,220410998,SRX5054309,FOSL2,533
chr1,220410480,220411022,SRX5075169,SMARCA4,542
chr1,220410563,220411004,SRX5716469,SMARCA4,441
chr1,220410608,220410989,SRX5716470,SMARCA4,381
chr1,220410615,220411096,SRX5075176,SMARCA4,481
chr1,220410620,220411076,SRX5075170,SMARCA4,456
chr1,220410654,220410963,SRX5716468,SMARCA2,309
chr1,220410654,220411046,SRX5020211,SMARCA2,392
chr1,220410673,220410969,SRX5716467,SMARCA2,296
chr1,220410715,220411003,SRX5020214,SMARCA2,288
chr1,220410743,220410984,SRX5054308,FOSL2,241
chr1,220421518,220421752,SRX5075181,SMARCA2,234
chr1,220421519,220421820,SRX5020211,SMARCA2,301
chr1,220421529,220421744,SRX5716467,SMARCA2,215
chr1,220421559,220421792,SRX5075169,SMARCA4,233
chr1,220421562,220421838,SRX5075170,SMARCA4,276
chr1,220421592,220421792,SRX5075175,SMARCA4,200
chr1,220441729,220441769,SRX1424891,POU3F2,40
chr1,220451569,220451839,SRX5075168,SMARCA4,270
chr1,220451595,220451855,SRX5075174,SMARCA4,260
chr1,220454139,220454502,SRX16500059,CTCF,363
chr1,220454245,220454627,SRX16500060,CTCF,382
chr1,220454268,220454494,SRX16500062,CTCF,226
chr1,220454284,220454640,SRX16500061,CTCF,356
chr1,220487369,220487927,SRX5075168,SMARCA4,558
chr1,220487380,220487932,SRX5075174,SMARCA4,552
chr1,220487426,220487899,SRX5716463,SMARCA4,473
chr1,220487481,220487805,SRX5716464,SMARCA4,324
chr1,220487541,220487751,SRX5075170,SMARCA4,210
chr1,220487550,220487846,SRX5716454,SOX3,296
chr1,220487558,220487772,SRX5716451,SOX2,214
chr1,220493958,220494265,SRX20140867,INTS10,307
chr1,220516035,220516264,SRX5075174,SMARCA4,229
chr1,220526308,220526713,SRX16500060,CTCF,405
chr1,220526350,220526669,SRX16500062,CTCF,319
chr1,220526362,220526622,SRX16500059,CTCF,260
chr1,220526369,220526704,SRX16500061,CTCF,335
chr1,220526379,220526589,SRX4174629,CTCF,210
chr1,220528000,220528222,SRX5075174,SMARCA4,222
chr1,220528054,220528304,SRX5075170,SMARCA4,250
chr1,220528092,220528340,SRX5075169,SMARCA4,248
chr1,220528096,220529043,SRX20140895,INTS13,947
chr1,220528116,220528324,SRX5075176,SMARCA4,208
chr1,220679968,220680570,SRX16500060,CTCF,602
chr1,220679973,220680521,SRX16500059,CTCF,548
chr1,220680024,220680473,SRX16500061,CTCF,449
chr1,220680051,220680489,SRX16500062,CTCF,438
chr1,220680114,220680379,SRX5075174,SMARCA4,265
chr1,220680130,220680335,SRX5716464,SMARCA4,205
chr1,220680143,220680420,SRX5075168,SMARCA4,277
chr1,220680190,220680382,SRX5075176,SMARCA4,192
chr1,220680199,220680455,SRX4174629,CTCF,256
chr1,220689977,220690561,SRX16500059,CTCF,584
chr1,220690006,220690628,SRX16500061,CTCF,622
chr1,220690008,220690522,SRX16500062,CTCF,514
chr1,220690039,220690544,SRX16500060,CTCF,505
chr1,220690055,220690421,SRX4174629,CTCF,366
chr1,220690060,220690532,SRX5075174,SMARCA4,472
chr1,220690110,220690362,SRX5716464,SMARCA4,252
chr1,220690115,220690616,SRX5075168,SMARCA4,501
chr1,220690133,220690533,SRX5075176,SMARCA4,400
chr1,220690149,220690443,SRX5716463,SMARCA4,294
chr1,220690152,220690639,SRX20140895,INTS13,487
chr1,220690160,220690689,SRX5075170,SMARCA4,529
chr1,220690165,220690379,SRX5075175,SMARCA4,214
chr1,220690165,220690487,SRX20140868,INTS10,322
chr1,220690169,220690400,SRX5716469,SMARCA4,231
chr1,220690205,220690484,SRX5075169,SMARCA4,279
chr1,220690214,220690564,SRX20140867,INTS10,350
chr1,220690273,220690484,SRX5716470,SMARCA4,211
chr1,220700570,220700803,SRX5075176,SMARCA4,233
chr1,220700612,220700827,SRX5716467,SMARCA2,215
chr1,220700614,220700812,SRX5075170,SMARCA4,198
chr1,220732972,220733424,SRX16500061,CTCF,452
chr1,220733017,220733446,SRX16500062,CTCF,429
chr1,220733017,220733524,SRX16500059,CTCF,507
chr1,220733022,220733365,SRX5075174,SMARCA4,343
chr1,220733037,220733483,SRX16500060,CTCF,446
chr1,220733083,220733429,SRX5075168,SMARCA4,346
chr1,220733098,220733469,SRX4174629,CTCF,371
chr1,220733104,220733291,SRX5075175,SMARCA4,187
chr1,220733110,220733319,SRX5075170,SMARCA4,209
chr1,220733125,220733419,SRX5716463,SMARCA4,294
chr1,220733241,220733471,SRX5716470,SMARCA4,230
chr1,220733265,220733456,SRX5075169,SMARCA4,191
chr1,220734504,220734832,SRX5054309,FOSL2,328
chr1,220734505,220734815,SRX5054308,FOSL2,310
chr1,220734509,220734707,SRX5075175,SMARCA4,198
chr1,220734515,220734732,SRX5075169,SMARCA4,217
chr1,220734558,220734804,SRX5716470,SMARCA4,246
chr1,220734568,220734752,SRX5075176,SMARCA4,184
chr1,220747811,220748410,SRX5075169,SMARCA4,599
chr1,220747948,220748668,SRX5075176,SMARCA4,720
chr1,220747960,220748348,SRX5075170,SMARCA4,388
chr1,220747984,220748695,SRX20140895,INTS13,711
chr1,220747991,220748468,SRX5075174,SMARCA4,477
chr1,220748035,220748525,SRX5075168,SMARCA4,490
chr1,220748046,220748527,SRX20140868,INTS10,481
chr1,220748071,220748398,SRX5075175,SMARCA4,327
chr1,220748094,220748478,SRX20140867,INTS10,384
chr1,220748124,220748409,SRX20140879,CPSF3L,285
chr1,220748474,220748765,SRX5716470,SMARCA4,291
chr1,220775267,220775633,SRX16500060,CTCF,366
chr1,220775276,220775644,SRX16500062,CTCF,368
chr1,220775293,220775656,SRX16500059,CTCF,363
chr1,220775302,220775661,SRX16500061,CTCF,359
chr1,220776524,220777090,SRX4174629,CTCF,566
chr1,220776651,220777111,SRX16500061,CTCF,460
chr1,220776664,220777139,SRX16500059,CTCF,475
chr1,220776676,220777166,SRX16500062,CTCF,490
chr1,220776684,220777049,SRX5075174,SMARCA4,365
chr1,220776685,220777010,SRX5075168,SMARCA4,325
chr1,220776690,220777131,SRX16500060,CTCF,441
chr1,220776727,220777005,SRX5075170,SMARCA4,278
chr1,220776779,220777010,SRX5075176,SMARCA4,231
chr1,220776785,220776973,SRX5075169,SMARCA4,188
chr1,220786354,220787242,SRX20140868,INTS10,888
chr1,220786439,220787270,SRX20140895,INTS13,831
chr1,220786538,220787159,SRX5075168,SMARCA4,621
chr1,220786587,220787105,SRX5075174,SMARCA4,518
chr1,220786608,220787108,SRX5075170,SMARCA4,500
chr1,220786727,220786980,SRX20140867,INTS10,253
chr1,220786758,220787049,SRX5075176,SMARCA4,291
chr1,220786758,220787101,SRX5716470,SMARCA4,343
chr1,220786791,220787153,SRX5075175,SMARCA4,362
chr1,220803498,220804066,SRX16500060,CTCF,568
chr1,220803517,220804013,SRX16500061,CTCF,496
chr1,220803552,220804085,SRX16500059,CTCF,533
chr1,220803564,220804004,SRX16500062,CTCF,440
chr1,220803626,220803909,SRX5075174,SMARCA4,283
chr1,220803718,220803899,SRX5075168,SMARCA4,181
chr1,220803741,220804015,SRX4174629,CTCF,274
chr1,220808461,220808935,SRX5716470,SMARCA4,474
chr1,220808582,220808884,SRX5075170,SMARCA4,302
chr1,220808585,220808895,SRX5716469,SMARCA4,310
chr1,220808602,220808911,SRX5075169,SMARCA4,309
chr1,220808628,220808843,SRX5075175,SMARCA4,215
chr1,220808639,220808896,SRX5075176,SMARCA4,257
chr1,220810021,220810551,SRX16500059,CTCF,530
chr1,220810028,220810505,SRX16500060,CTCF,477
chr1,220810041,220810538,SRX16500061,CTCF,497
chr1,220810072,220810505,SRX16500062,CTCF,433
chr1,220810187,220810484,SRX5075174,SMARCA4,297
chr1,220810192,220810492,SRX5075168,SMARCA4,300
chr1,220810223,220810398,SRX5075176,SMARCA4,175
chr1,220810231,220810476,SRX5716463,SMARCA4,245
chr1,220810236,220810497,SRX4174629,CTCF,261
chr1,220818773,220819180,SRX5075168,SMARCA4,407
chr1,220818788,220819221,SRX5075169,SMARCA4,433
chr1,220818794,220819139,SRX5075174,SMARCA4,345
chr1,220818822,220819243,SRX5075175,SMARCA4,421
chr1,220818839,220819211,SRX5716470,SMARCA4,372
chr1,220818846,220819230,SRX5075176,SMARCA4,384
chr1,220818847,220819181,SRX5054309,FOSL2,334
chr1,220818853,220819236,SRX5054308,FOSL2,383
chr1,220818904,220819090,SRX5054307,FOSL2,186
chr1,220818905,220819221,SRX5716469,SMARCA4,316
chr1,220818928,220819139,SRX5716468,SMARCA2,211
chr1,220818933,220819131,SRX5075170,SMARCA4,198
chr1,220830240,220830487,SRX5054308,FOSL2,247
chr1,220839415,220839760,SRX5075168,SMARCA4,345
chr1,220839416,220839790,SRX5075174,SMARCA4,374
chr1,220843385,220843719,SRX5075176,SMARCA4,334
chr1,220843528,220844008,SRX5075170,SMARCA4,480
chr1,220843531,220843836,SRX5716469,SMARCA4,305
chr1,220843610,220843991,SRX5716467,SMARCA2,381
chr1,220843619,220843922,SRX5716470,SMARCA4,303
chr1,220843768,220843955,SRX5075175,SMARCA4,187
chr1,220843814,220844060,SRX5075169,SMARCA4,246
chr1,220874093,220874617,SRX16500059,CTCF,524
chr1,220874162,220874571,SRX16500062,CTCF,409
chr1,220874170,220874623,SRX16500061,CTCF,453
chr1,220874187,220874642,SRX16500060,CTCF,455
chr1,220874234,220874529,SRX5075170,SMARCA4,295
chr1,220874250,220874571,SRX4174629,CTCF,321
chr1,220874277,220874565,SRX5075174,SMARCA4,288
chr1,220879507,220879770,SRX5075169,SMARCA4,263
chr1,220908761,220909015,SRX16500062,CTCF,254
chr1,220908762,220909068,SRX16500060,CTCF,306
chr1,220908781,220909066,SRX16500059,CTCF,285
chr1,220926269,220926503,SRX5716467,SMARCA2,234
chr1,220952910,220953189,SRX5075170,SMARCA4,279
chr1,220952921,220953202,SRX5075176,SMARCA4,281
chr1,220962014,220962587,SRX5075175,SMARCA4,573
chr1,220962036,220962618,SRX5075169,SMARCA4,582
chr1,220962061,220962590,SRX5075170,SMARCA4,529
chr1,220962067,220962564,SRX5075176,SMARCA4,497
chr1,220962074,220962546,SRX5054309,FOSL2,472
chr1,220962101,220962556,SRX5054308,FOSL2,455
chr1,220962125,220962492,SRX5716469,SMARCA4,367
chr1,220962185,220962505,SRX5020211,SMARCA2,320
chr1,220962249,220962478,SRX5020214,SMARCA2,229
chr1,220967111,220967372,SRX5075170,SMARCA4,261
chr1,220982767,220982988,SRX5054309,FOSL2,221
chr1,220990453,220990782,SRX5075168,SMARCA4,329
chr1,220990453,220990845,SRX5075176,SMARCA4,392
chr1,220990459,220990764,SRX5075175,SMARCA4,305
chr1,220990476,220990789,SRX5054308,FOSL2,313
chr1,220990482,220990777,SRX5054309,FOSL2,295
chr1,220990485,220990778,SRX5075169,SMARCA4,293
chr1,220990498,220990744,SRX5075174,SMARCA4,246
chr1,220990511,220990791,SRX5075170,SMARCA4,280
chr1,221025950,221026200,SRX5054308,FOSL2,250
chr1,221035789,221036042,SRX5054308,FOSL2,253
chr1,221039644,221039913,SRX5075174,SMARCA4,269
chr1,221039672,221039918,SRX5075168,SMARCA4,246
chr1,221059296,221059587,SRX5075170,SMARCA4,291
chr1,221076441,221076845,SRX5075170,SMARCA4,404
chr1,221076458,221076767,SRX5075176,SMARCA4,309
chr1,221076481,221076668,SRX5075175,SMARCA4,187
chr1,221085584,221086339,SRX5075176,SMARCA4,755
chr1,221085586,221086173,SRX5075175,SMARCA4,587
chr1,221085603,221086160,SRX5716470,SMARCA4,557
chr1,221085634,221086358,SRX5075170,SMARCA4,724
chr1,221085664,221086033,SRX5716467,SMARCA2,369
chr1,221085684,221086091,SRX5075169,SMARCA4,407
chr1,221085695,221086007,SRX5054308,FOSL2,312
chr1,221085709,221085971,SRX5020214,SMARCA2,262
chr1,221085763,221086006,SRX5716469,SMARCA4,243
chr1,221085779,221086060,SRX5716468,SMARCA2,281
chr1,221085798,221086071,SRX5075181,SMARCA2,273
chr1,221085802,221086007,SRX5054309,FOSL2,205
chr1,221089422,221089691,SRX5054309,FOSL2,269
chr1,221098016,221098317,SRX5075169,SMARCA4,301
chr1,221098033,221098305,SRX5054309,FOSL2,272
chr1,221100599,221100856,SRX5054308,FOSL2,257
chr1,221100607,221100827,SRX5054309,FOSL2,220
chr1,221100659,221101047,SRX5075170,SMARCA4,388
chr1,221100669,221100857,SRX5075176,SMARCA4,188
chr1,221101840,221102144,SRX5054309,FOSL2,304
chr1,221101883,221102117,SRX5075169,SMARCA4,234
chr1,221101895,221102122,SRX5054308,FOSL2,227
chr1,221101907,221102171,SRX5075175,SMARCA4,264
chr1,221101941,221102113,SRX5075170,SMARCA4,172
chr1,221101943,221102118,SRX5075176,SMARCA4,175
chr1,221117464,221118064,SRX5075169,SMARCA4,600
chr1,221117484,221118065,SRX5075176,SMARCA4,581
chr1,221117490,221118028,SRX5075175,SMARCA4,538
chr1,221117501,221118020,SRX5054309,FOSL2,519
chr1,221117501,221118135,SRX5075170,SMARCA4,634
chr1,221117505,221117987,SRX5054308,FOSL2,482
chr1,221117510,221118052,SRX5716467,SMARCA2,542
chr1,221117538,221117951,SRX5075182,SMARCA2,413
chr1,221117577,221118029,SRX5716469,SMARCA4,452
chr1,221117584,221118023,SRX5716460,Epitope tags,439
chr1,221117597,221118011,SRX5020211,SMARCA2,414
chr1,221117611,221117978,SRX5716468,SMARCA2,367
chr1,221117618,221118066,SRX5716470,SMARCA4,448
chr1,221117677,221117954,SRX5020214,SMARCA2,277
chr1,221117692,221117958,SRX5075181,SMARCA2,266
chr1,221164095,221164292,SRX5054309,FOSL2,197
chr1,221165915,221166151,SRX5075170,SMARCA4,236
chr1,221169406,221169944,SRX5075174,SMARCA4,538
chr1,221169440,221169903,SRX5075168,SMARCA4,463
chr1,221169458,221169866,SRX5716463,SMARCA4,408
chr1,221169495,221169844,SRX5075170,SMARCA4,349
chr1,221169510,221169843,SRX5075169,SMARCA4,333
chr1,221169532,221169751,SRX5716470,SMARCA4,219
chr1,221169538,221169767,SRX5054309,FOSL2,229
chr1,221169544,221169881,SRX5716469,SMARCA4,337
chr1,221169547,221169860,SRX5075175,SMARCA4,313
chr1,221169551,221169767,SRX5054308,FOSL2,216
chr1,221169555,221169775,SRX5716464,SMARCA4,220
chr1,221169620,221169835,SRX5716467,SMARCA2,215
chr1,221203352,221203847,SRX16500061,CTCF,495
chr1,221203408,221203843,SRX16500062,CTCF,435
chr1,221203412,221203965,SRX16500060,CTCF,553
chr1,221203419,221203886,SRX16500059,CTCF,467
chr1,221203485,221203779,SRX5075174,SMARCA4,294
chr1,221203513,221203769,SRX5075168,SMARCA4,256
chr1,221203514,221203800,SRX5075169,SMARCA4,286
chr1,221203523,221203711,SRX5075170,SMARCA4,188
chr1,221203535,221203737,SRX5075176,SMARCA4,202
chr1,221203545,221203781,SRX4174629,CTCF,236
chr1,221216932,221217440,SRX5054308,FOSL2,508
chr1,221216997,221217506,SRX5075170,SMARCA4,509
chr1,221216999,221217501,SRX5075169,SMARCA4,502
chr1,221217001,221217492,SRX5716469,SMARCA4,491
chr1,221217003,221217492,SRX5075175,SMARCA4,489
chr1,221217024,221217432,SRX5716467,SMARCA2,408
chr1,221217035,221217445,SRX5075176,SMARCA4,410
chr1,221217035,221217504,SRX5020211,SMARCA2,469
chr1,221217038,221217509,SRX5054309,FOSL2,471
chr1,221217052,221217417,SRX5716468,SMARCA2,365
chr1,221217063,221217477,SRX5716470,SMARCA4,414
chr1,221217123,221217442,SRX5075181,SMARCA2,319
chr1,221217147,221217460,SRX5020214,SMARCA2,313
chr1,221239938,221240199,SRX5075169,SMARCA4,261
chr1,221239939,221240151,SRX5716469,SMARCA4,212
chr1,221239959,221240150,SRX5075170,SMARCA4,191
chr1,221239971,221240146,SRX5075176,SMARCA4,175
chr1,221239974,221240237,SRX5054308,FOSL2,263
chr1,221239975,221240191,SRX5054309,FOSL2,216
chr1,221240011,221240226,SRX5716467,SMARCA2,215
chr1,221250985,221251165,SRX5075169,SMARCA4,180
chr1,221263708,221264154,SRX16500060,CTCF,446
chr1,221263714,221264100,SRX16500061,CTCF,386
chr1,221263727,221264152,SRX16500059,CTCF,425
chr1,221263736,221264092,SRX16500062,CTCF,356
chr1,221263799,221264110,SRX5075174,SMARCA4,311
chr1,221263850,221264090,SRX5075168,SMARCA4,240
chr1,221263896,221264093,SRX5075170,SMARCA4,197
chr1,221263980,221264227,SRX5075169,SMARCA4,247
chr1,221264036,221264420,SRX5054308,FOSL2,384
chr1,221264088,221264275,SRX5075175,SMARCA4,187
chr1,221264398,221264583,SRX5075169,SMARCA4,185
chr1,221268218,221268664,SRX5075176,SMARCA4,446
chr1,221268306,221268633,SRX5075169,SMARCA4,327
chr1,221268314,221268653,SRX5054308,FOSL2,339
chr1,221268337,221268630,SRX5075170,SMARCA4,293
chr1,221268342,221268620,SRX5075175,SMARCA4,278
chr1,221268372,221268649,SRX5054309,FOSL2,277
chr1,221268388,221268603,SRX5716469,SMARCA4,215
chr1,221283900,221284346,SRX5075169,SMARCA4,446
chr1,221283920,221284363,SRX5054309,FOSL2,443
chr1,221283932,221284320,SRX5075175,SMARCA4,388
chr1,221283952,221284446,SRX5075170,SMARCA4,494
chr1,221283960,221284336,SRX5054308,FOSL2,376
chr1,221283975,221284348,SRX5075168,SMARCA4,373
chr1,221284024,221284385,SRX5075176,SMARCA4,361
chr1,221284027,221284389,SRX5716469,SMARCA4,362
chr1,221284041,221284366,SRX5716470,SMARCA4,325
chr1,221284054,221284310,SRX5020214,SMARCA2,256
chr1,221284064,221284309,SRX5716467,SMARCA2,245
chr1,221284086,221284320,SRX5020211,SMARCA2,234
chr1,221284097,221284336,SRX5075174,SMARCA4,239
chr1,221315226,221315645,SRX5075169,SMARCA4,419
chr1,221315268,221315598,SRX5075170,SMARCA4,330
chr1,221315293,221315619,SRX5075175,SMARCA4,326
chr1,221315295,221315603,SRX5054309,FOSL2,308
chr1,221315318,221315621,SRX5716469,SMARCA4,303
chr1,221315330,221315635,SRX5075176,SMARCA4,305
chr1,221315344,221315590,SRX5054308,FOSL2,246
chr1,221335084,221335606,SRX5075174,SMARCA4,522
chr1,221335111,221335315,SRX5716463,SMARCA4,204
chr1,221335128,221335505,SRX5075168,SMARCA4,377
chr1,221335175,221335420,SRX5075170,SMARCA4,245
chr1,221335657,221336022,SRX5075170,SMARCA4,365
chr1,221335779,221336019,SRX5716469,SMARCA4,240
chr1,221344810,221345103,SRX5054309,FOSL2,293
chr1,221344828,221345102,SRX5054308,FOSL2,274
chr1,221368467,221368695,SRX5054309,FOSL2,228
chr1,221392502,221392694,SRX5054309,FOSL2,192
chr1,221392555,221392742,SRX5075175,SMARCA4,187
chr1,221394025,221394291,SRX5075170,SMARCA4,266
chr1,221394048,221394271,SRX5054309,FOSL2,223
chr1,221394050,221394262,SRX5054308,FOSL2,212
chr1,221394107,221394319,SRX5716469,SMARCA4,212
chr1,221419655,221420038,SRX5075170,SMARCA4,383
chr1,221419670,221420048,SRX5075175,SMARCA4,378
chr1,221419673,221420020,SRX5054308,FOSL2,347
chr1,221419681,221420077,SRX5075176,SMARCA4,396
chr1,221419685,221420077,SRX5075169,SMARCA4,392
chr1,221419712,221420033,SRX5054309,FOSL2,321
chr1,221419735,221420030,SRX5716469,SMARCA4,295
chr1,221419743,221419954,SRX5716470,SMARCA4,211
chr1,221419778,221420005,SRX5716467,SMARCA2,227
chr1,221429376,221429565,SRX5054309,FOSL2,189
chr1,221435251,221435849,SRX16500060,CTCF,598
chr1,221435294,221435897,SRX16500061,CTCF,603
chr1,221435347,221435871,SRX16500059,CTCF,524
chr1,221435368,221435878,SRX16500062,CTCF,510
chr1,221435487,221435702,SRX5075168,SMARCA4,215
chr1,221435499,221435788,SRX4174629,CTCF,289
chr1,221439386,221439604,SRX5075170,SMARCA4,218
chr1,221440021,221440448,SRX5075169,SMARCA4,427
chr1,221440038,221440352,SRX5054308,FOSL2,314
chr1,221440041,221440310,SRX5716470,SMARCA4,269
chr1,221440046,221440521,SRX5075175,SMARCA4,475
chr1,221440052,221440277,SRX5054309,FOSL2,225
chr1,221440062,221440402,SRX5075176,SMARCA4,340
chr1,221440083,221440314,SRX5075170,SMARCA4,231
chr1,221440099,221440321,SRX5716469,SMARCA4,222
chr1,221440111,221440354,SRX5716467,SMARCA2,243
chr1,221442137,221442450,SRX5075168,SMARCA4,313
chr1,221442147,221442378,SRX5716463,SMARCA4,231
chr1,221442148,221442413,SRX5075174,SMARCA4,265
chr1,221458412,221458807,SRX5716469,SMARCA4,395
chr1,221458482,221458739,SRX5075175,SMARCA4,257
chr1,221458488,221458862,SRX5716467,SMARCA2,374
chr1,221458513,221458707,SRX5075170,SMARCA4,194
chr1,221458606,221458817,SRX5716470,SMARCA4,211
chr1,221478050,221478386,SRX16500059,CTCF,336
chr1,221478069,221478288,SRX16500061,CTCF,219
chr1,221478087,221478426,SRX5075175,SMARCA4,339
chr1,221478089,221478427,SRX5075170,SMARCA4,338
chr1,221478095,221478430,SRX16500060,CTCF,335
chr1,221478098,221478447,SRX5075169,SMARCA4,349
chr1,221478099,221478373,SRX5716469,SMARCA4,274
chr1,221478103,221478437,SRX5075176,SMARCA4,334
chr1,221478134,221478377,SRX4174629,CTCF,243
chr1,221478139,221478399,SRX5075168,SMARCA4,260
chr1,221478159,221478446,SRX5054308,FOSL2,287
chr1,221478174,221478428,SRX5054309,FOSL2,254
chr1,221487866,221488152,SRX5716469,SMARCA4,286
chr1,221487873,221488115,SRX5054308,FOSL2,242
chr1,221487880,221488060,SRX5075169,SMARCA4,180
chr1,221487916,221488107,SRX5075176,SMARCA4,191
chr1,221543784,221544116,SRX16500059,CTCF,332
chr1,221543796,221544058,SRX16500062,CTCF,262
chr1,221543834,221544074,SRX16500060,CTCF,240
chr1,221543879,221544114,SRX16500061,CTCF,235
chr1,221612400,221612856,SRX5075170,SMARCA4,456
chr1,221612427,221612767,SRX5054308,FOSL2,340
chr1,221612452,221612848,SRX5075169,SMARCA4,396
chr1,221612454,221612823,SRX5716469,SMARCA4,369
chr1,221612476,221612691,SRX5020211,SMARCA2,215
chr1,221612476,221612793,SRX5075175,SMARCA4,317
chr1,221612491,221612820,SRX5054309,FOSL2,329
chr1,221612492,221612732,SRX5716467,SMARCA2,240
chr1,221612501,221612794,SRX5075176,SMARCA4,293
chr1,221612509,221612776,SRX5716470,SMARCA4,267
chr1,221612518,221612783,SRX5075168,SMARCA4,265
chr1,221612550,221612788,SRX5075174,SMARCA4,238
chr1,221620666,221621015,SRX5075175,SMARCA4,349
chr1,221620760,221621121,SRX5075170,SMARCA4,361
chr1,221620780,221621005,SRX5075176,SMARCA4,225
chr1,221620998,221621181,SRX5054309,FOSL2,183
chr1,221620998,221621214,SRX5075169,SMARCA4,216
chr1,221672115,221672506,SRX5075169,SMARCA4,391
chr1,221672161,221672459,SRX5054308,FOSL2,298
chr1,221672164,221672582,SRX5075175,SMARCA4,418
chr1,221672180,221672491,SRX5075176,SMARCA4,311
chr1,221672197,221672452,SRX5054309,FOSL2,255
chr1,221672240,221672450,SRX5075170,SMARCA4,210
chr1,221708923,221709433,SRX5075168,SMARCA4,510
chr1,221708999,221709235,SRX5716451,SOX2,236
chr1,221709019,221709293,SRX5075176,SMARCA4,274
chr1,221709019,221709464,SRX5075174,SMARCA4,445
chr1,221709085,221709306,SRX5075170,SMARCA4,221
chr1,221709153,221709394,SRX5716470,SMARCA4,241
chr1,221718287,221718958,SRX5075169,SMARCA4,671
chr1,221718298,221718851,SRX5716467,SMARCA2,553
chr1,221718338,221718944,SRX5075176,SMARCA4,606
chr1,221718341,221718962,SRX5075175,SMARCA4,621
chr1,221718370,221718817,SRX5075181,SMARCA2,447
chr1,221718376,221718953,SRX5020211,SMARCA2,577
chr1,221718387,221718735,SRX5075170,SMARCA4,348
chr1,221718388,221718852,SRX5716470,SMARCA4,464
chr1,221718399,221718891,SRX5054309,FOSL2,492
chr1,221718403,221718898,SRX5716469,SMARCA4,495
chr1,221718406,221718883,SRX5054308,FOSL2,477
chr1,221718483,221718740,SRX5020214,SMARCA2,257
chr1,221718495,221718865,SRX5716468,SMARCA2,370
chr1,221741967,221742558,SRX5075176,SMARCA4,591
chr1,221741993,221742538,SRX5075170,SMARCA4,545
chr1,221742015,221742544,SRX5075168,SMARCA4,529
chr1,221742029,221742466,SRX5054309,FOSL2,437
chr1,221742038,221742607,SRX5075174,SMARCA4,569
chr1,221742075,221742358,SRX5054308,FOSL2,283
chr1,221742098,221742345,SRX5054307,FOSL2,247
chr1,221742108,221742407,SRX5716463,SMARCA4,299
chr1,221742269,221742682,SRX20140895,INTS13,413
chr1,221742378,221742641,SRX20140881,CPSF3L,263
chr1,221742686,221743057,SRX5075169,SMARCA4,371
chr1,221743077,221743449,SRX5075174,SMARCA4,372
chr1,221766239,221766517,SRX5075176,SMARCA4,278
chr1,221766242,221766551,SRX5075170,SMARCA4,309
chr1,221802245,221802456,SRX5075175,SMARCA4,211
chr1,221816988,221817232,SRX5075174,SMARCA4,244
chr1,221829654,221830012,SRX5054309,FOSL2,358
chr1,221829664,221830018,SRX5054308,FOSL2,354
chr1,221829664,221830054,SRX5075174,SMARCA4,390
chr1,221829681,221830020,SRX5075168,SMARCA4,339
chr1,221829708,221829982,SRX5075175,SMARCA4,274
chr1,221829722,221829968,SRX5075170,SMARCA4,246
chr1,221829750,221829987,SRX5075176,SMARCA4,237
chr1,221829752,221830017,SRX5075169,SMARCA4,265
chr1,221839942,221840124,SRX5075169,SMARCA4,182
chr1,221845855,221846157,SRX5075169,SMARCA4,302
chr1,221845859,221846194,SRX5716469,SMARCA4,335
chr1,221845866,221846084,SRX5075175,SMARCA4,218
chr1,221845874,221846187,SRX5075176,SMARCA4,313
chr1,221857041,221857418,SRX16500060,CTCF,377
chr1,221857063,221857436,SRX16500059,CTCF,373
chr1,221857078,221857403,SRX5075168,SMARCA4,325
chr1,221857101,221857386,SRX16500061,CTCF,285
chr1,221857116,221857446,SRX16500062,CTCF,330
chr1,221857149,221857330,SRX5075174,SMARCA4,181
chr1,221865663,221866156,SRX5075170,SMARCA4,493
chr1,221865849,221866171,SRX5075176,SMARCA4,322
chr1,221865871,221866067,SRX5054308,FOSL2,196
chr1,221868958,221869305,SRX5075169,SMARCA4,347
chr1,221868964,221869250,SRX5075170,SMARCA4,286
chr1,221868987,221869299,SRX5054309,FOSL2,312
chr1,221869061,221869291,SRX5075175,SMARCA4,230
chr1,221869070,221869347,SRX5075176,SMARCA4,277
chr1,221887056,221887408,SRX5075169,SMARCA4,352
chr1,221887219,221887407,SRX5075175,SMARCA4,188
chr1,221887225,221887408,SRX5054309,FOSL2,183
chr1,221887250,221887438,SRX5075170,SMARCA4,188
chr1,221908610,221908897,SRX20140895,INTS13,287
chr1,221961774,221962052,SRX5075174,SMARCA4,278
chr1,221961818,221962047,SRX5075168,SMARCA4,229
chr1,221979701,221979961,SRX16500060,CTCF,260
chr1,221987923,221988167,SRX5075169,SMARCA4,244
chr1,221987930,221988158,SRX5075175,SMARCA4,228
chr1,221987993,221988185,SRX5054309,FOSL2,192
chr1,221988458,221988694,SRX5075174,SMARCA4,236
chr1,222028193,222028383,SRX5075176,SMARCA4,190
chr1,222034882,222035127,SRX5075176,SMARCA4,245
chr1,222034891,222035116,SRX5075169,SMARCA4,225
chr1,222034899,222035110,SRX5716470,SMARCA4,211
chr1,222034902,222035089,SRX5075170,SMARCA4,187
chr1,222034920,222035131,SRX5716468,SMARCA2,211
chr1,222048276,222048669,SRX5075169,SMARCA4,393
chr1,222048285,222048586,SRX5716459,Epitope tags,301
chr1,222048285,222048674,SRX5075170,SMARCA4,389
chr1,222048286,222048655,SRX5716469,SMARCA4,369
chr1,222048288,222048672,SRX5075175,SMARCA4,384
chr1,222048289,222048624,SRX5020211,SMARCA2,335
chr1,222048312,222048668,SRX5075176,SMARCA4,356
chr1,222048316,222048649,SRX5716470,SMARCA4,333
chr1,222048318,222048671,SRX5054308,FOSL2,353
chr1,222048325,222048656,SRX5716467,SMARCA2,331
chr1,222048329,222048679,SRX5054309,FOSL2,350
chr1,222048343,222048596,SRX5075181,SMARCA2,253
chr1,222048369,222048621,SRX5020214,SMARCA2,252
chr1,222048379,222048632,SRX5716468,SMARCA2,253
chr1,222048406,222048585,SRX5075182,SMARCA2,179
chr1,222064917,222065209,SRX5054308,FOSL2,292
chr1,222073566,222073867,SRX5054309,FOSL2,301
chr1,222073579,222073831,SRX5054308,FOSL2,252
chr1,222079035,222079267,SRX5075169,SMARCA4,232
chr1,222079095,222079313,SRX5075170,SMARCA4,218
chr1,222079095,222079397,SRX5075175,SMARCA4,302
chr1,222096132,222096555,SRX16500060,CTCF,423
chr1,222096150,222096583,SRX16500059,CTCF,433
chr1,222096188,222096617,SRX16500062,CTCF,429
chr1,222096208,222096566,SRX16500061,CTCF,358
chr1,222124698,222124918,SRX16500062,CTCF,220
chr1,222161737,222162052,SRX5054308,FOSL2,315
chr1,222161743,222162016,SRX5075175,SMARCA4,273
chr1,222161749,222162028,SRX5075169,SMARCA4,279
chr1,222161808,222161991,SRX5054309,FOSL2,183
chr1,222165716,222165925,SRX5075170,SMARCA4,209
chr1,222167151,222167493,SRX5075169,SMARCA4,342
chr1,222171068,222171368,SRX16500060,CTCF,300
chr1,222171134,222171420,SRX16500061,CTCF,286
chr1,222171140,222171363,SRX16500062,CTCF,223
chr1,222222862,222223092,SRX20140867,INTS10,230
chr1,222233719,222234068,SRX5075174,SMARCA4,349
chr1,222233826,222234040,SRX5075168,SMARCA4,214
chr1,222370236,222370425,SRX5054308,FOSL2,189
chr1,222371279,222371650,SRX5075169,SMARCA4,371
chr1,222371301,222371666,SRX5054309,FOSL2,365
chr1,222371330,222371665,SRX5054308,FOSL2,335
chr1,222371343,222371674,SRX5075175,SMARCA4,331
chr1,222371438,222371638,SRX5075170,SMARCA4,200
chr1,222387461,222387792,SRX16500060,CTCF,331
chr1,222387472,222387790,SRX16500061,CTCF,318
chr1,222387480,222387771,SRX16500059,CTCF,291
chr1,222387582,222387792,SRX16500062,CTCF,210
chr1,222455050,222455522,SRX16500061,CTCF,472
chr1,222455052,222455552,SRX16500060,CTCF,500
chr1,222455057,222455476,SRX4174629,CTCF,419
chr1,222455077,222455529,SRX16500062,CTCF,452
chr1,222455080,222455590,SRX16500059,CTCF,510
chr1,222455103,222455465,SRX5075168,SMARCA4,362
chr1,222455115,222455456,SRX5075176,SMARCA4,341
chr1,222455120,222455464,SRX5075169,SMARCA4,344
chr1,222455157,222455402,SRX5075170,SMARCA4,245
chr1,222455159,222455459,SRX5075174,SMARCA4,300
chr1,222455165,222455644,SRX5716469,SMARCA4,479
chr1,222465152,222465753,SRX16500059,CTCF,601
chr1,222465233,222465880,SRX5716470,SMARCA4,647
chr1,222465234,222465470,SRX4174629,CTCF,236
chr1,222465237,222465758,SRX16500061,CTCF,521
chr1,222465253,222465776,SRX16500060,CTCF,523
chr1,222465260,222465982,SRX5075176,SMARCA4,722
chr1,222465281,222465795,SRX16500062,CTCF,514
chr1,222465290,222465903,SRX5075168,SMARCA4,613
chr1,222465307,222465726,SRX5716464,SMARCA4,419
chr1,222465307,222465796,SRX5075170,SMARCA4,489
chr1,222465316,222465882,SRX5075169,SMARCA4,566
chr1,222465323,222465534,SRX5716468,SMARCA2,211
chr1,222465323,222465817,SRX5075175,SMARCA4,494
chr1,222465354,222465804,SRX5075174,SMARCA4,450
chr1,222465393,222465922,SRX20140895,INTS13,529
chr1,222465399,222465639,SRX5054307,FOSL2,240
chr1,222465411,222465770,SRX5716469,SMARCA4,359
chr1,222465421,222465771,SRX5716463,SMARCA4,350
chr1,222465434,222465870,SRX5716467,SMARCA2,436
chr1,222465478,222465813,SRX5075181,SMARCA2,335
chr1,222465502,222465902,SRX20140869,INTS10,400
chr1,222465671,222465935,SRX20140897,INTS13,264
chr1,222523925,222524094,SRX5075170,SMARCA4,169
chr1,222546529,222546837,SRX5075170,SMARCA4,308
chr1,222546558,222546895,SRX5075169,SMARCA4,337
chr1,222546568,222546903,SRX5075176,SMARCA4,335
chr1,222546870,222547266,SRX5075175,SMARCA4,396
chr1,222546903,222547254,SRX5054309,FOSL2,351
chr1,222546934,222547259,SRX5075170,SMARCA4,325
chr1,222546981,222547286,SRX5075176,SMARCA4,305
chr1,222547020,222547322,SRX5075169,SMARCA4,302
chr1,222589614,222590163,SRX5075174,SMARCA4,549
chr1,222589662,222590127,SRX5075168,SMARCA4,465
chr1,222589681,222590197,SRX5075170,SMARCA4,516
chr1,222589698,222590225,SRX5075176,SMARCA4,527
chr1,222589736,222590176,SRX20140895,INTS13,440
chr1,222589783,222590150,SRX20140869,INTS10,367
chr1,222589891,222590117,SRX5716463,SMARCA4,226
chr1,222589912,222590286,SRX5716470,SMARCA4,374
chr1,222590030,222590245,SRX5075175,SMARCA4,215
chr1,222590053,222590383,SRX5075169,SMARCA4,330
chr1,222590145,222590362,SRX5716469,SMARCA4,217
chr1,222617380,222617667,SRX5716469,SMARCA4,287
chr1,222617485,222617829,SRX5075176,SMARCA4,344
chr1,222617571,222617887,SRX5075168,SMARCA4,316
chr1,222617647,222617880,SRX5075170,SMARCA4,233
chr1,222617667,222618247,SRX5054307,FOSL2,580
chr1,222617907,222618168,SRX5054308,FOSL2,261
chr1,222634305,222634808,SRX16500061,CTCF,503
chr1,222634320,222634826,SRX16500062,CTCF,506
chr1,222634350,222634818,SRX16500059,CTCF,468
chr1,222634352,222634864,SRX16500060,CTCF,512
chr1,222634436,222634759,SRX5075174,SMARCA4,323
chr1,222634444,222634740,SRX5075168,SMARCA4,296
chr1,222634446,222634642,SRX5075170,SMARCA4,196
chr1,222634479,222634730,SRX5075176,SMARCA4,251
chr1,222643778,222644521,SRX20140895,INTS13,743
chr1,222643859,222644552,SRX5075170,SMARCA4,693
chr1,222643895,222644203,SRX20140897,INTS13,308
chr1,222643900,222644400,SRX20140869,INTS10,500
chr1,222643919,222644552,SRX5075174,SMARCA4,633
chr1,222643941,222644482,SRX5075168,SMARCA4,541
chr1,222644002,222644436,SRX5075169,SMARCA4,434
chr1,222644006,222644324,SRX5716470,SMARCA4,318
chr1,222644024,222644456,SRX5075176,SMARCA4,432
chr1,222644046,222644459,SRX20140868,INTS10,413
chr1,222644053,222644354,SRX20140867,INTS10,301
chr1,222644069,222644342,SRX5054308,FOSL2,273
chr1,222644072,222644491,SRX5716463,SMARCA4,419
chr1,222644103,222644434,SRX5716469,SMARCA4,331
chr1,222644112,222644447,SRX5054309,FOSL2,335
chr1,222644123,222644507,SRX5075175,SMARCA4,384
chr1,222644128,222644405,SRX5716464,SMARCA4,277
chr1,222644171,222644415,SRX5054307,FOSL2,244
chr1,222644204,222644394,SRX5716451,SOX2,190
chr1,222668240,222668467,SRX5075176,SMARCA4,227
chr1,222668276,222668498,SRX5075170,SMARCA4,222
chr1,222669187,222669362,SRX5075176,SMARCA4,175
chr1,222712205,222713204,SRX20140895,INTS13,999
chr1,222712232,222712805,SRX20140867,INTS10,573
chr1,222712401,222712725,SRX20140868,INTS10,324
chr1,222712440,222713001,SRX20140897,INTS13,561
chr1,222712639,222712938,SRX20140879,CPSF3L,299
chr1,222713112,222713469,SRX5075174,SMARCA4,357
chr1,222713170,222713378,SRX5716463,SMARCA4,208
chr1,222713228,222713434,SRX5075168,SMARCA4,206
chr1,222713285,222713521,SRX5075176,SMARCA4,236
chr1,222713319,222713597,SRX5075170,SMARCA4,278
chr1,222738812,222739079,SRX16500059,CTCF,267
chr1,222738819,222739010,SRX5075176,SMARCA4,191
chr1,222761147,222761358,SRX5716470,SMARCA4,211
chr1,222770295,222770476,SRX5075169,SMARCA4,181
chr1,222786108,222786308,SRX5020211,SMARCA2,200
chr1,222786159,222786418,SRX5075169,SMARCA4,259
chr1,222786159,222786577,SRX5075176,SMARCA4,418
chr1,222786215,222786516,SRX5075170,SMARCA4,301
chr1,222792713,222793210,SRX16500060,CTCF,497
chr1,222792723,222793172,SRX16500059,CTCF,449
chr1,222792743,222793195,SRX16500061,CTCF,452
chr1,222792757,222793164,SRX16500062,CTCF,407
chr1,222792822,222793005,SRX5075174,SMARCA4,183
chr1,222792823,222793082,SRX5075168,SMARCA4,259
chr1,222798170,222798506,SRX5075176,SMARCA4,336
chr1,222798195,222798401,SRX5075170,SMARCA4,206
chr1,222798195,222798508,SRX5075168,SMARCA4,313
chr1,222798200,222798494,SRX5054309,FOSL2,294
chr1,222798215,222798402,SRX5075175,SMARCA4,187
chr1,222798227,222798407,SRX5075169,SMARCA4,180
chr1,222798236,222798502,SRX5054308,FOSL2,266
chr1,222798280,222798549,SRX5075174,SMARCA4,269
chr1,222805420,222805790,SRX5075168,SMARCA4,370
chr1,222805422,222805820,SRX5075174,SMARCA4,398
chr1,222805432,222805802,SRX5716463,SMARCA4,370
chr1,222814722,222815175,SRX20140868,INTS10,453
chr1,222814722,222815349,SRX20140895,INTS13,627
chr1,222814731,222815042,SRX5075176,SMARCA4,311
chr1,222814757,222815253,SRX5075174,SMARCA4,496
chr1,222814760,222815022,SRX5716470,SMARCA4,262
chr1,222814775,222815254,SRX5075169,SMARCA4,479
chr1,222814781,222815175,SRX5075168,SMARCA4,394
chr1,222814848,222815120,SRX5075170,SMARCA4,272
chr1,222814858,222815072,SRX5075175,SMARCA4,214
chr1,222814902,222815268,SRX5716464,SMARCA4,366
chr1,222815097,222815308,SRX5716470,SMARCA4,211
chr1,222817526,222817917,SRX5075169,SMARCA4,391
chr1,222817537,222817905,SRX5054308,FOSL2,368
chr1,222817545,222817903,SRX5054309,FOSL2,358
chr1,222817552,222817854,SRX5075176,SMARCA4,302
chr1,222817553,222817861,SRX5075170,SMARCA4,308
chr1,222817562,222817885,SRX5075175,SMARCA4,323
chr1,222817598,222817823,SRX5716469,SMARCA4,225
chr1,222817664,222817849,SRX5075174,SMARCA4,185
chr1,222824652,222825030,SRX5075175,SMARCA4,378
chr1,222824722,222824945,SRX5075170,SMARCA4,223
chr1,222824727,222825052,SRX5075176,SMARCA4,325
chr1,222824840,222825053,SRX5716470,SMARCA4,213
chr1,222829899,222830165,SRX5075176,SMARCA4,266
chr1,222829944,222830151,SRX5075170,SMARCA4,207
chr1,222880588,222880901,SRX5054308,FOSL2,313
chr1,222880652,222880919,SRX5054309,FOSL2,267
chr1,222889534,222889758,SRX5075170,SMARCA4,224
chr1,222892097,222892427,SRX5075168,SMARCA4,330
chr1,222892185,222892406,SRX5075170,SMARCA4,221
chr1,222892230,222892521,SRX5054309,FOSL2,291
chr1,222892258,222892603,SRX5075176,SMARCA4,345
chr1,222892279,222892524,SRX5075169,SMARCA4,245
chr1,222897494,222897785,SRX5075169,SMARCA4,291
chr1,222897511,222897765,SRX5716467,SMARCA2,254
chr1,222897520,222898071,SRX5075176,SMARCA4,551
chr1,222897525,222897860,SRX5716470,SMARCA4,335
chr1,222897561,222897834,SRX5075170,SMARCA4,273
chr1,222897610,222897811,SRX5075175,SMARCA4,201
chr1,222915269,222915518,SRX5075175,SMARCA4,249
chr1,222915304,222915473,SRX5075170,SMARCA4,169
chr1,222915353,222915565,SRX5075169,SMARCA4,212
chr1,222915356,222915542,SRX5054309,FOSL2,186
chr1,222920274,222920454,SRX5054308,FOSL2,180
chr1,222928133,222928654,SRX20140881,CPSF3L,521
chr1,222928144,222928588,SRX5075168,SMARCA4,444
chr1,222928176,222928697,SRX5075174,SMARCA4,521
chr1,222928211,222928624,SRX5716463,SMARCA4,413
chr1,222928221,222928616,SRX5075176,SMARCA4,395
chr1,222928241,222928579,SRX5075170,SMARCA4,338
chr1,222928249,222928517,SRX5716469,SMARCA4,268
chr1,222928290,222928549,SRX20140867,INTS10,259
chr1,222928292,222928505,SRX5716470,SMARCA4,213
chr1,222928297,222928632,SRX5716464,SMARCA4,335
chr1,222928362,222928608,SRX5075169,SMARCA4,246
chr1,222970259,222970458,SRX5075168,SMARCA4,199
chr1,222970538,222971073,SRX5716463,SMARCA4,535
chr1,222970669,222971014,SRX5075174,SMARCA4,345
chr1,222970671,222971042,SRX5075168,SMARCA4,371
chr1,222974583,222974793,SRX5075169,SMARCA4,210
chr1,222976509,222976780,SRX5054309,FOSL2,271
chr1,222976530,222976794,SRX5075176,SMARCA4,264
chr1,222976533,222976878,SRX5075170,SMARCA4,345
chr1,222976600,222976823,SRX5075169,SMARCA4,223
chr1,222976614,222976799,SRX5054308,FOSL2,185
chr1,222994344,222994928,SRX5020211,SMARCA2,584
chr1,222994404,222994905,SRX5054308,FOSL2,501
chr1,222994411,222994879,SRX5020214,SMARCA2,468
chr1,222994412,222994933,SRX5075175,SMARCA4,521
chr1,222994412,222994972,SRX5075176,SMARCA4,560
chr1,222994416,222994963,SRX5075169,SMARCA4,547
chr1,222994419,222994913,SRX5075170,SMARCA4,494
chr1,222994436,222994899,SRX5054309,FOSL2,463
chr1,222994472,222994807,SRX5716459,Epitope tags,335
chr1,222994481,222994728,SRX5716468,SMARCA2,247
chr1,222994503,222994794,SRX5716470,SMARCA4,291
chr1,222994552,222994876,SRX5716469,SMARCA4,324
chr1,222994552,222994886,SRX5716467,SMARCA2,334
chr1,222994586,222994812,SRX5075181,SMARCA2,226
chr1,222994624,222994820,SRX5075174,SMARCA4,196
chr1,222994628,222994807,SRX5075168,SMARCA4,179
chr1,222995196,222995415,SRX5075174,SMARCA4,219
chr1,222995268,222995461,SRX5075168,SMARCA4,193
chr1,223010544,223011158,SRX5075175,SMARCA4,614
chr1,223010574,223011217,SRX5075176,SMARCA4,643
chr1,223010603,223011153,SRX5075170,SMARCA4,550
chr1,223010608,223011047,SRX5716467,SMARCA2,439
chr1,223010647,223011158,SRX5716469,SMARCA4,511
chr1,223010656,223011219,SRX5075169,SMARCA4,563
chr1,223010668,223010946,SRX5716468,SMARCA2,278
chr1,223010677,223011092,SRX5716470,SMARCA4,415
chr1,223010681,223011098,SRX5020211,SMARCA2,417
chr1,223010757,223011022,SRX5020214,SMARCA2,265
chr1,223010771,223011001,SRX5054308,FOSL2,230
chr1,223010790,223010973,SRX5054309,FOSL2,183
chr1,223022712,223023078,SRX5075176,SMARCA4,366
chr1,223023072,223023548,SRX5075170,SMARCA4,476
chr1,223023154,223023377,SRX5075169,SMARCA4,223
chr1,223023161,223023407,SRX5716470,SMARCA4,246
chr1,223023161,223023499,SRX5075176,SMARCA4,338
chr1,223074553,223074747,SRX5075176,SMARCA4,194
chr1,223081256,223081616,SRX5716470,SMARCA4,360
chr1,223081289,223081634,SRX5075176,SMARCA4,345
chr1,223081290,223081711,SRX5075168,SMARCA4,421
chr1,223081294,223081837,SRX16500060,CTCF,543
chr1,223081298,223081705,SRX5075169,SMARCA4,407
chr1,223081304,223081848,SRX16500059,CTCF,544
chr1,223081309,223081610,SRX5075174,SMARCA4,301
chr1,223081310,223081823,SRX16500061,CTCF,513
chr1,223081315,223081626,SRX5075175,SMARCA4,311
chr1,223081333,223081683,SRX5075170,SMARCA4,350
chr1,223081339,223081610,SRX5716463,SMARCA4,271
chr1,223081339,223081810,SRX16500062,CTCF,471
chr1,223081345,223081617,SRX5716469,SMARCA4,272
chr1,223081348,223081586,SRX5716467,SMARCA2,238
chr1,223081367,223081669,SRX5716464,SMARCA4,302
chr1,223081371,223081801,SRX4174629,CTCF,430
chr1,223087378,223087756,SRX5075170,SMARCA4,378
chr1,223087422,223087881,SRX5075176,SMARCA4,459
chr1,223087498,223087696,SRX5075175,SMARCA4,198
chr1,223087500,223087715,SRX5054308,FOSL2,215
chr1,223087623,223087849,SRX5075169,SMARCA4,226
chr1,223089998,223090461,SRX16500060,CTCF,463
chr1,223090029,223090567,SRX16500059,CTCF,538
chr1,223090033,223090428,SRX16500062,CTCF,395
chr1,223090072,223090466,SRX16500061,CTCF,394
chr1,223090120,223090395,SRX5075174,SMARCA4,275
chr1,223090153,223090366,SRX5075168,SMARCA4,213
chr1,223106882,223107091,SRX5075168,SMARCA4,209
chr1,223123103,223123278,SRX5075176,SMARCA4,175
chr1,223123154,223123357,SRX5075170,SMARCA4,203
chr1,223123666,223124258,SRX16500060,CTCF,592
chr1,223123672,223124213,SRX16500059,CTCF,541
chr1,223123683,223124172,SRX16500061,CTCF,489
chr1,223123697,223124027,SRX4174629,CTCF,330
chr1,223123707,223124157,SRX16500062,CTCF,450
chr1,223123748,223123991,SRX5075168,SMARCA4,243
chr1,223123764,223123950,SRX5075176,SMARCA4,186
chr1,223123768,223123951,SRX5075170,SMARCA4,183
chr1,223123792,223123979,SRX5075175,SMARCA4,187
chr1,223123796,223124046,SRX5075174,SMARCA4,250
chr1,223129282,223129753,SRX16500059,CTCF,471
chr1,223129285,223129701,SRX16500062,CTCF,416
chr1,223129315,223129745,SRX16500060,CTCF,430
chr1,223129331,223129718,SRX16500061,CTCF,387
chr1,223129332,223129634,SRX5075176,SMARCA4,302
chr1,223129340,223129602,SRX5075168,SMARCA4,262
chr1,223129341,223129610,SRX5075170,SMARCA4,269
chr1,223129359,223129591,SRX5075174,SMARCA4,232
chr1,223129376,223129619,SRX5075169,SMARCA4,243
chr1,223129445,223129639,SRX5075175,SMARCA4,194
chr1,223133587,223134083,SRX16500059,CTCF,496
chr1,223133635,223134070,SRX16500060,CTCF,435
chr1,223133637,223134071,SRX16500061,CTCF,434
chr1,223133640,223134034,SRX16500062,CTCF,394
chr1,223133642,223133982,SRX4174629,CTCF,340
chr1,223133683,223134031,SRX5075174,SMARCA4,348
chr1,223133700,223134021,SRX5075176,SMARCA4,321
chr1,223133704,223134089,SRX5075168,SMARCA4,385
chr1,223133709,223134038,SRX5075170,SMARCA4,329
chr1,223133729,223133996,SRX5716463,SMARCA4,267
chr1,223133742,223134028,SRX5716470,SMARCA4,286
chr1,223133744,223133968,SRX5716464,SMARCA4,224
chr1,223133755,223134076,SRX5075175,SMARCA4,321
chr1,223133762,223134051,SRX5075169,SMARCA4,289
chr1,223142739,223143291,SRX16500059,CTCF,552
chr1,223142779,223143262,SRX16500060,CTCF,483
chr1,223142796,223143211,SRX16500062,CTCF,415
chr1,223142839,223143246,SRX16500061,CTCF,407
chr1,223142879,223143462,SRX5075168,SMARCA4,583
chr1,223142885,223143065,SRX5075169,SMARCA4,180
chr1,223142907,223143452,SRX5075174,SMARCA4,545
chr1,223142919,223143274,SRX5716470,SMARCA4,355
chr1,223142927,223143492,SRX20140895,INTS13,565
chr1,223142928,223143279,SRX5075176,SMARCA4,351
chr1,223142966,223143232,SRX5075175,SMARCA4,266
chr1,223142994,223143241,SRX4174629,CTCF,247
chr1,223143016,223143366,SRX5716463,SMARCA4,350
chr1,223143104,223143273,SRX5075170,SMARCA4,169
chr1,223153408,223153643,SRX5075170,SMARCA4,235
chr1,223153420,223153639,SRX5075168,SMARCA4,219
chr1,223153456,223153662,SRX5075176,SMARCA4,206
chr1,223153468,223153696,SRX5054308,FOSL2,228
chr1,223153470,223153710,SRX5054309,FOSL2,240
chr1,223190329,223190619,SRX5075175,SMARCA4,290
chr1,223190522,223190702,SRX5075169,SMARCA4,180
chr1,223207671,223207863,SRX5075170,SMARCA4,192
chr1,223207749,223207996,SRX5075176,SMARCA4,247
chr1,223208297,223208508,SRX5054309,FOSL2,211
chr1,223208307,223208513,SRX5054308,FOSL2,206
chr1,223233578,223233819,SRX5075170,SMARCA4,241
chr1,223233622,223233857,SRX5054309,FOSL2,235
chr1,223233624,223233891,SRX5054308,FOSL2,267
chr1,223233629,223233816,SRX5075175,SMARCA4,187
chr1,223233634,223233849,SRX5075169,SMARCA4,215
chr1,223258785,223258970,SRX5054309,FOSL2,185
chr1,223298760,223298939,SRX5075168,SMARCA4,179
chr1,223364149,223364346,SRX5075174,SMARCA4,197
chr1,223402523,223402788,SRX5054309,FOSL2,265
chr1,223402547,223402773,SRX5054308,FOSL2,226
chr1,223500514,223500929,SRX5075176,SMARCA4,415
chr1,223500518,223500818,SRX5075169,SMARCA4,300
chr1,223500525,223500841,SRX5054309,FOSL2,316
chr1,223500553,223500817,SRX5054308,FOSL2,264
chr1,223500558,223500819,SRX5716469,SMARCA4,261
chr1,223500561,223500937,SRX5075170,SMARCA4,376
chr1,223500571,223500841,SRX5075175,SMARCA4,270
chr1,223531662,223532176,SRX16500060,CTCF,514
chr1,223531680,223532169,SRX16500059,CTCF,489
chr1,223531683,223532141,SRX16500062,CTCF,458
chr1,223531759,223532106,SRX16500061,CTCF,347
chr1,223531828,223532102,SRX4174629,CTCF,274
chr1,223556826,223557276,SRX16500059,CTCF,450
chr1,223556832,223557289,SRX16500061,CTCF,457
chr1,223556848,223557258,SRX16500062,CTCF,410
chr1,223556871,223557284,SRX16500060,CTCF,413
chr1,223617355,223617755,SRX5075176,SMARCA4,400
chr1,223617397,223617723,SRX5075170,SMARCA4,326
chr1,223622282,223622728,SRX5075168,SMARCA4,446
chr1,223628082,223628628,SRX16500059,CTCF,546
chr1,223628175,223628618,SRX16500060,CTCF,443
chr1,223628180,223628590,SRX16500062,CTCF,410
chr1,223628212,223628577,SRX16500061,CTCF,365
chr1,223670382,223670839,SRX16500060,CTCF,457
chr1,223670444,223670911,SRX16500059,CTCF,467
chr1,223670454,223670865,SRX16500061,CTCF,411
chr1,223670471,223670860,SRX16500062,CTCF,389
chr1,223684144,223684640,SRX16500059,CTCF,496
chr1,223684147,223684605,SRX16500060,CTCF,458
chr1,223684182,223684606,SRX16500062,CTCF,424
chr1,223684183,223684650,SRX16500061,CTCF,467
chr1,223684212,223684734,SRX4174629,CTCF,522
chr1,223684254,223684481,SRX5075170,SMARCA4,227
chr1,223684279,223684506,SRX5075168,SMARCA4,227
chr1,223684287,223684562,SRX5075174,SMARCA4,275
chr1,223684298,223684518,SRX5075176,SMARCA4,220
chr1,223696436,223696765,SRX16500060,CTCF,329
chr1,223696440,223696791,SRX16500059,CTCF,351
chr1,223696459,223696780,SRX16500062,CTCF,321
chr1,223696513,223696754,SRX16500061,CTCF,241
chr1,223698137,223698627,SRX16500060,CTCF,490
chr1,223698137,223698672,SRX16500059,CTCF,535
chr1,223698176,223698600,SRX16500061,CTCF,424
chr1,223698186,223698616,SRX16500062,CTCF,430
chr1,223698213,223698585,SRX4174629,CTCF,372
chr1,223698289,223698560,SRX5075174,SMARCA4,271
chr1,223698307,223698540,SRX5075168,SMARCA4,233
chr1,223698338,223698511,SRX5075170,SMARCA4,173
chr1,223700884,223701649,SRX5075170,SMARCA4,765
chr1,223700933,223701624,SRX5075175,SMARCA4,691
chr1,223700961,223701621,SRX5054309,FOSL2,660
chr1,223700963,223701621,SRX5054308,FOSL2,658
chr1,223700971,223701567,SRX5075168,SMARCA4,596
chr1,223700987,223701643,SRX5075176,SMARCA4,656
chr1,223700992,223701672,SRX5075169,SMARCA4,680
chr1,223701003,223701445,SRX20140867,INTS10,442
chr1,223701029,223701569,SRX5075174,SMARCA4,540
chr1,223701079,223701569,SRX5716469,SMARCA4,490
chr1,223701092,223701370,SRX5716467,SMARCA2,278
chr1,223701337,223701604,SRX5716470,SMARCA4,267
chr1,223706181,223706465,SRX5075176,SMARCA4,284
chr1,223706213,223706498,SRX5075169,SMARCA4,285
chr1,223706222,223706447,SRX5075170,SMARCA4,225
chr1,223706241,223706460,SRX5716470,SMARCA4,219
chr1,223707159,223707544,SRX5054309,FOSL2,385
chr1,223707160,223707588,SRX5075176,SMARCA4,428
chr1,223707167,223707531,SRX5716469,SMARCA4,364
chr1,223707169,223707544,SRX5075175,SMARCA4,375
chr1,223707172,223707596,SRX5075170,SMARCA4,424
chr1,223707178,223707532,SRX5075169,SMARCA4,354
chr1,223707180,223707462,SRX5075174,SMARCA4,282
chr1,223707180,223707547,SRX5054308,FOSL2,367
chr1,223707213,223707510,SRX5716467,SMARCA2,297
chr1,223707218,223707519,SRX5075168,SMARCA4,301
chr1,223707226,223707533,SRX5020211,SMARCA2,307
chr1,223707247,223707480,SRX5020214,SMARCA2,233
chr1,223707302,223707522,SRX5075182,SMARCA2,220
chr1,223712139,223712648,SRX16500059,CTCF,509
chr1,223712153,223712605,SRX16500060,CTCF,452
chr1,223712172,223713053,SRX20140895,INTS13,881
chr1,223712200,223712513,SRX16500062,CTCF,313
chr1,223712200,223712657,SRX16500061,CTCF,457
chr1,223712225,223712876,SRX20140868,INTS10,651
chr1,223712234,223712595,SRX5075168,SMARCA4,361
chr1,223712284,223712639,SRX5075174,SMARCA4,355
chr1,223712294,223712545,SRX5075169,SMARCA4,251
chr1,223712308,223712645,SRX5075170,SMARCA4,337
chr1,223712310,223712732,SRX20140867,INTS10,422
chr1,223712318,223712630,SRX5075175,SMARCA4,312
chr1,223712336,223712659,SRX20140869,INTS10,323
chr1,223712347,223712688,SRX5054309,FOSL2,341
chr1,223712350,223712658,SRX5054308,FOSL2,308
chr1,223712351,223712684,SRX20140897,INTS13,333
chr1,223712358,223712611,SRX5075176,SMARCA4,253
chr1,223712377,223712641,SRX5054307,FOSL2,264
chr1,223712399,223712618,SRX5716470,SMARCA4,219
chr1,223724455,223724628,SRX5075174,SMARCA4,173
chr1,223726522,223727065,SRX5075176,SMARCA4,543
chr1,223726532,223727070,SRX5075170,SMARCA4,538
chr1,223726562,223727004,SRX5716470,SMARCA4,442
chr1,223726596,223727029,SRX5075175,SMARCA4,433
chr1,223726609,223727127,SRX5075168,SMARCA4,518
chr1,223726622,223727005,SRX5075169,SMARCA4,383
chr1,223726666,223726991,SRX5716460,Epitope tags,325
chr1,223726669,223727022,SRX5054308,FOSL2,353
chr1,223726673,223727125,SRX5075174,SMARCA4,452
chr1,223726691,223727030,SRX5054309,FOSL2,339
chr1,223726697,223727005,SRX5716469,SMARCA4,308
chr1,223726699,223726973,SRX5716467,SMARCA2,274
chr1,223726727,223727011,SRX5054307,FOSL2,284
chr1,223730956,223731219,SRX5075169,SMARCA4,263
chr1,223731026,223731285,SRX5075170,SMARCA4,259
chr1,223731044,223731277,SRX5054308,FOSL2,233
chr1,223731048,223731300,SRX5054309,FOSL2,252
chr1,223731076,223731346,SRX5075176,SMARCA4,270
chr1,223731117,223731304,SRX5075175,SMARCA4,187
chr1,223733179,223733535,SRX5075176,SMARCA4,356
chr1,223733200,223733497,SRX5075170,SMARCA4,297
chr1,223733200,223733498,SRX5075169,SMARCA4,298
chr1,223733254,223733479,SRX5054308,FOSL2,225
chr1,223742878,223743065,SRX5075176,SMARCA4,187
chr1,223749011,223749661,SRX16500061,CTCF,650
chr1,223749041,223749606,SRX16500060,CTCF,565
chr1,223749063,223749685,SRX16500059,CTCF,622
chr1,223749083,223749471,SRX5716463,SMARCA4,388
chr1,223749098,223749704,SRX16500062,CTCF,606
chr1,223749112,223749461,SRX5075174,SMARCA4,349
chr1,223749119,223749368,SRX5716470,SMARCA4,249
chr1,223749136,223749464,SRX5075168,SMARCA4,328
chr1,223749140,223749443,SRX5075169,SMARCA4,303
chr1,223749140,223749463,SRX5075176,SMARCA4,323
chr1,223749171,223749412,SRX5075170,SMARCA4,241
chr1,223749174,223749454,SRX5716464,SMARCA4,280
chr1,223749179,223749598,SRX4174629,CTCF,419
chr1,223749186,223749396,SRX5075175,SMARCA4,210
chr1,223771693,223772380,SRX5075176,SMARCA4,687
chr1,223771703,223772461,SRX5075174,SMARCA4,758
chr1,223771743,223772340,SRX5054308,FOSL2,597
chr1,223771748,223772405,SRX5054309,FOSL2,657
chr1,223771757,223772301,SRX5075170,SMARCA4,544
chr1,223771792,223772083,SRX5716467,SMARCA2,291
chr1,223771794,223772425,SRX5075168,SMARCA4,631
chr1,223771803,223772299,SRX5716469,SMARCA4,496
chr1,223771820,223772372,SRX5075175,SMARCA4,552
chr1,223771827,223772337,SRX5075169,SMARCA4,510
chr1,223771850,223772101,SRX5716470,SMARCA4,251
chr1,223771856,223772309,SRX5020211,SMARCA2,453
chr1,223771943,223772132,SRX5054307,FOSL2,189
chr1,223811664,223812006,SRX16500060,CTCF,342
chr1,223811700,223812158,SRX16500059,CTCF,458
chr1,223811713,223811999,SRX16500061,CTCF,286
chr1,223811785,223812123,SRX16500062,CTCF,338
chr1,223831767,223832184,SRX5075175,SMARCA4,417
chr1,223831806,223832248,SRX5054309,FOSL2,442
chr1,223831820,223832340,SRX5075176,SMARCA4,520
chr1,223831829,223832181,SRX5075170,SMARCA4,352
chr1,223831830,223832211,SRX5075169,SMARCA4,381
chr1,223831832,223832195,SRX5054308,FOSL2,363
chr1,223831851,223832157,SRX5716469,SMARCA4,306
chr1,223841293,223841506,SRX5054309,FOSL2,213
chr1,223845220,223845468,SRX5075176,SMARCA4,248
chr1,223845287,223845467,SRX5075169,SMARCA4,180
chr1,223845395,223845861,SRX20140881,CPSF3L,466
chr1,223845484,223846691,SRX20140895,INTS13,1207
chr1,223845489,223845899,SRX20140868,INTS10,410
chr1,223845493,223845816,SRX20140869,INTS10,323
chr1,223845572,223846530,SRX20140867,INTS10,958
chr1,223845756,223846404,SRX5075174,SMARCA4,648
chr1,223845921,223846420,SRX5075168,SMARCA4,499
chr1,223845986,223846347,SRX5716463,SMARCA4,361
chr1,223846004,223846471,SRX5075176,SMARCA4,467
chr1,223846021,223846451,SRX5075170,SMARCA4,430
chr1,223846047,223846388,SRX5075175,SMARCA4,341
chr1,223846069,223846396,SRX16500059,CTCF,327
chr1,223846076,223846392,SRX16500062,CTCF,316
chr1,223846081,223846268,SRX5075169,SMARCA4,187
chr1,223846086,223846440,SRX16500061,CTCF,354
chr1,223846088,223846421,SRX16500060,CTCF,333
chr1,223846110,223846663,SRX20140868,INTS10,553
chr1,223846138,223846421,SRX5716470,SMARCA4,283
chr1,223846142,223846508,SRX20140897,INTS13,366
chr1,223887723,223888530,SRX5716470,SMARCA4,807
chr1,223887820,223888235,SRX5716468,SMARCA2,415
chr1,223887826,223888560,SRX5075176,SMARCA4,734
chr1,223887833,223888513,SRX5075170,SMARCA4,680
chr1,223887848,223888539,SRX5075169,SMARCA4,691
chr1,223887882,223888345,SRX5716469,SMARCA4,463
chr1,223887886,223888168,SRX5716467,SMARCA2,282
chr1,223887938,223888489,SRX5075175,SMARCA4,551
chr1,223887955,223888406,SRX5075168,SMARCA4,451
chr1,223887982,223888472,SRX5054309,FOSL2,490
chr1,223888014,223888487,SRX5075174,SMARCA4,473
chr1,223888112,223888470,SRX5054308,FOSL2,358
chr1,223908056,223908295,SRX4174629,CTCF,239
chr1,223908057,223908353,SRX16500060,CTCF,296
chr1,223908064,223908286,SRX16500062,CTCF,222
chr1,223908094,223908388,SRX16500059,CTCF,294
chr1,223916335,223916529,SRX5075170,SMARCA4,194
chr1,223981730,223981905,SRX5075176,SMARCA4,175
chr1,223992398,223993201,SRX5075174,SMARCA4,803
chr1,223992401,223993237,SRX20140895,INTS13,836
chr1,223992424,223993113,SRX20140867,INTS10,689
chr1,223992426,223993012,SRX5075176,SMARCA4,586
chr1,223992441,223993083,SRX20140897,INTS13,642
chr1,223992470,223993075,SRX5075168,SMARCA4,605
chr1,223992487,223992989,SRX5075170,SMARCA4,502
chr1,223992491,223993004,SRX20140868,INTS10,513
chr1,223992515,223993138,SRX20140869,INTS10,623
chr1,223992519,223992894,SRX5716463,SMARCA4,375
chr1,223992532,223992761,SRX5716464,SMARCA4,229
chr1,223992538,223993080,SRX20140879,CPSF3L,542
chr1,223992540,223992721,SRX5054307,FOSL2,181
chr1,223992641,223993088,SRX20140881,CPSF3L,447
chr1,223992733,223992991,SRX5075169,SMARCA4,258
chr1,223992777,223993039,SRX16500060,CTCF,262
chr1,223992887,223993154,SRX5075175,SMARCA4,267
chr1,223996402,223996650,SRX5054309,FOSL2,248
chr1,223999671,224000062,SRX5075169,SMARCA4,391
chr1,223999729,224000114,SRX5075176,SMARCA4,385
chr1,223999746,224000110,SRX5075170,SMARCA4,364
chr1,223999811,224000026,SRX5716467,SMARCA2,215
chr1,223999900,224000111,SRX5716468,SMARCA2,211
chr1,223999924,224000120,SRX5075175,SMARCA4,196
chr1,224004508,224004929,SRX16500059,CTCF,421
chr1,224004550,224004858,SRX16500062,CTCF,308
chr1,224004552,224004885,SRX16500061,CTCF,333
chr1,224004578,224004908,SRX16500060,CTCF,330
chr1,224012493,224012596,SRX1424894,POU3F2,103
chr1,224012496,224012600,SRX1424892,POU3F2,104
chr1,224014828,224014874,SRX1424893,POU3F2,46
chr1,224014829,224014870,SRX1424891,POU3F2,41
chr1,224014832,224014872,SRX1424894,POU3F2,40
chr1,224014835,224014878,SRX1424892,POU3F2,43
chr1,224035773,224036178,SRX5075170,SMARCA4,405
chr1,224035785,224036221,SRX5075176,SMARCA4,436
chr1,224035873,224036115,SRX5716470,SMARCA4,242
chr1,224035886,224036066,SRX5075169,SMARCA4,180
chr1,224050733,224051190,SRX16500062,CTCF,457
chr1,224050741,224051219,SRX16500059,CTCF,478
chr1,224050743,224051233,SRX16500060,CTCF,490
chr1,224050752,224051270,SRX16500061,CTCF,518
chr1,224050830,224051094,SRX5075174,SMARCA4,264
chr1,224050841,224051045,SRX5716463,SMARCA4,204
chr1,224050850,224051070,SRX4174629,CTCF,220
chr1,224050891,224051070,SRX5075170,SMARCA4,179
chr1,224050895,224051121,SRX5075168,SMARCA4,226
chr1,224050897,224051077,SRX5075169,SMARCA4,180
chr1,224050907,224051097,SRX5075176,SMARCA4,190
chr1,224052922,224053091,SRX5075170,SMARCA4,169
chr1,224065471,224065718,SRX5716470,SMARCA4,247
chr1,224065473,224065792,SRX5075175,SMARCA4,319
chr1,224065501,224065820,SRX5075169,SMARCA4,319
chr1,224065517,224065784,SRX5075176,SMARCA4,267
chr1,224065565,224065821,SRX5716469,SMARCA4,256
chr1,224065580,224065749,SRX5075170,SMARCA4,169
chr1,224065580,224065823,SRX5054309,FOSL2,243
chr1,224065609,224065789,SRX5054308,FOSL2,180
chr1,224082159,224082498,SRX5054309,FOSL2,339
chr1,224106731,224107132,SRX16500059,CTCF,401
chr1,224106735,224106934,SRX5075168,SMARCA4,199
chr1,224106760,224107095,SRX16500060,CTCF,335
chr1,224106761,224106954,SRX5075170,SMARCA4,193
chr1,224106825,224107150,SRX16500061,CTCF,325
chr1,224106831,224107024,SRX5075174,SMARCA4,193
chr1,224106839,224107130,SRX16500062,CTCF,291
chr1,224113779,224114184,SRX5075174,SMARCA4,405
chr1,224113835,224114109,SRX5075176,SMARCA4,274
chr1,224113835,224114155,SRX5075168,SMARCA4,320
chr1,224113864,224114173,SRX5075170,SMARCA4,309
chr1,224113877,224114128,SRX5716463,SMARCA4,251
chr1,224113900,224114543,SRX20140895,INTS13,643
chr1,224113911,224114324,SRX20140868,INTS10,413
chr1,224113913,224114152,SRX5075169,SMARCA4,239
chr1,224113926,224114455,SRX20140897,INTS13,529
chr1,224113931,224114344,SRX20140879,CPSF3L,413
chr1,224113935,224114340,SRX20140869,INTS10,405
chr1,224113970,224114321,SRX20140867,INTS10,351
chr1,224114013,224114303,SRX20140896,INTS13,290
chr1,224114080,224114354,SRX20140881,CPSF3L,274
chr1,224116088,224116551,SRX16500061,CTCF,463
chr1,224116089,224116596,SRX16500059,CTCF,507
chr1,224116125,224116526,SRX16500062,CTCF,401
chr1,224116127,224116592,SRX16500060,CTCF,465
chr1,224116210,224116392,SRX5075174,SMARCA4,182
chr1,224128167,224128406,SRX5716469,SMARCA4,239
chr1,224128206,224128483,SRX5054308,FOSL2,277
chr1,224128210,224128503,SRX5054309,FOSL2,293
chr1,224152878,224153163,SRX16500061,CTCF,285
chr1,224152976,224153287,SRX16500060,CTCF,311
chr1,224168817,224169140,SRX5054309,FOSL2,323
chr1,224168822,224169296,SRX5075176,SMARCA4,474
chr1,224168826,224169158,SRX5054308,FOSL2,332
chr1,224168834,224169305,SRX5075169,SMARCA4,471
chr1,224168859,224169059,SRX5020211,SMARCA2,200
chr1,224168863,224169171,SRX5020214,SMARCA2,308
chr1,224168867,224169275,SRX5075170,SMARCA4,408
chr1,224168886,224169135,SRX5075175,SMARCA4,249
chr1,224168919,224169147,SRX5716470,SMARCA4,228
chr1,224175681,224175931,SRX5075176,SMARCA4,250
chr1,224182795,224184180,SRX20140895,INTS13,1385
chr1,224182844,224183454,SRX5075174,SMARCA4,610
chr1,224182846,224183139,SRX20140868,INTS10,293
chr1,224182869,224183561,SRX5075176,SMARCA4,692
chr1,224182902,224183323,SRX5075170,SMARCA4,421
chr1,224182903,224183327,SRX5075168,SMARCA4,424
chr1,224182918,224183180,SRX5075169,SMARCA4,262
chr1,224182935,224183403,SRX20140867,INTS10,468
chr1,224182936,224183200,SRX5075175,SMARCA4,264
chr1,224183206,224183485,SRX20140868,INTS10,279
chr1,224183274,224183457,SRX5075169,SMARCA4,183
chr1,224203374,224203566,SRX5075175,SMARCA4,192
chr1,224204706,224205066,SRX5075176,SMARCA4,360
chr1,224204780,224204989,SRX5075169,SMARCA4,209
chr1,224204823,224205060,SRX5075170,SMARCA4,237
chr1,224204829,224205042,SRX5716469,SMARCA4,213
chr1,224204856,224205082,SRX5075175,SMARCA4,226
chr1,224205463,224205723,SRX5075176,SMARCA4,260
chr1,224205472,224205731,SRX5075170,SMARCA4,259
chr1,224205485,224205695,SRX5075169,SMARCA4,210
chr1,224211442,224211879,SRX5075170,SMARCA4,437
chr1,224211490,224211857,SRX5075175,SMARCA4,367
chr1,224211506,224211921,SRX5075176,SMARCA4,415
chr1,224211537,224211872,SRX5075169,SMARCA4,335
chr1,224211543,224211813,SRX5716470,SMARCA4,270
chr1,224211609,224211850,SRX5054308,FOSL2,241
chr1,224211614,224211832,SRX5716469,SMARCA4,218
chr1,224223821,224224256,SRX5075170,SMARCA4,435
chr1,224223854,224224203,SRX5075169,SMARCA4,349
chr1,224223875,224224244,SRX5075176,SMARCA4,369
chr1,224223932,224224127,SRX5054308,FOSL2,195
chr1,224223938,224224130,SRX5075175,SMARCA4,192
chr1,224223944,224224183,SRX5716469,SMARCA4,239
chr1,224223966,224224186,SRX5716470,SMARCA4,220
chr1,224287566,224288188,SRX5075174,SMARCA4,622
chr1,224287607,224288159,SRX5716463,SMARCA4,552
chr1,224287648,224288015,SRX20140895,INTS13,367
chr1,224287686,224288244,SRX5075168,SMARCA4,558
chr1,224287707,224288079,SRX5716451,SOX2,372
chr1,224287710,224288154,SRX5716454,SOX3,444
chr1,224287711,224288105,SRX5716464,SMARCA4,394
chr1,224300350,224300763,SRX5075175,SMARCA4,413
chr1,224300381,224300687,SRX5075170,SMARCA4,306
chr1,224300384,224300694,SRX5075169,SMARCA4,310
chr1,224300401,224300727,SRX5075176,SMARCA4,326
chr1,224300403,224300637,SRX5054309,FOSL2,234
chr1,224300411,224300671,SRX5054308,FOSL2,260
chr1,224300447,224300732,SRX5716469,SMARCA4,285
chr1,224330123,224330708,SRX20140895,INTS13,585
chr1,224330124,224330462,SRX20140868,INTS10,338
chr1,224330181,224330548,SRX5075174,SMARCA4,367
chr1,224330222,224330701,SRX20140869,INTS10,479
chr1,224330251,224330590,SRX5075168,SMARCA4,339
chr1,224330258,224330600,SRX5075170,SMARCA4,342
chr1,224330287,224330620,SRX20140897,INTS13,333
chr1,224330392,224330594,SRX5075176,SMARCA4,202
chr1,224333249,224333843,SRX16500060,CTCF,594
chr1,224333277,224333779,SRX16500062,CTCF,502
chr1,224333296,224333708,SRX16500061,CTCF,412
chr1,224333296,224333746,SRX16500059,CTCF,450
chr1,224333381,224333569,SRX5075170,SMARCA4,188
chr1,224333390,224333576,SRX5075168,SMARCA4,186
chr1,224333414,224333623,SRX5075174,SMARCA4,209
chr1,224333440,224333615,SRX5075176,SMARCA4,175
chr1,224356645,224356931,SRX5075174,SMARCA4,286
chr1,224356657,224356911,SRX5716451,SOX2,254
chr1,224356687,224357234,SRX20140895,INTS13,547
chr1,224356733,224357062,SRX5075168,SMARCA4,329
chr1,224356754,224356960,SRX5075170,SMARCA4,206
chr1,224356771,224357042,SRX5075176,SMARCA4,271
chr1,224356884,224357090,SRX5075169,SMARCA4,206
chr1,224356984,224357196,SRX5716469,SMARCA4,212
chr1,224357410,224357676,SRX5075176,SMARCA4,266
chr1,224357436,224357642,SRX5075170,SMARCA4,206
chr1,224357441,224357751,SRX5075169,SMARCA4,310
chr1,224357458,224357696,SRX5054308,FOSL2,238
chr1,224357495,224357795,SRX5054309,FOSL2,300
chr1,224368470,224368679,SRX5054308,FOSL2,209
chr1,224427326,224427747,SRX5075175,SMARCA4,421
chr1,224427364,224427704,SRX5075169,SMARCA4,340
chr1,224427384,224427680,SRX5054308,FOSL2,296
chr1,224427397,224427689,SRX5054309,FOSL2,292
chr1,224427404,224427715,SRX5075170,SMARCA4,311
chr1,224427422,224427686,SRX5075176,SMARCA4,264
chr1,224430578,224430828,SRX5075176,SMARCA4,250
chr1,224430583,224430833,SRX5054309,FOSL2,250
chr1,224430602,224430816,SRX5075170,SMARCA4,214
chr1,224434704,224434918,SRX20140867,INTS10,214
chr1,224434757,224435113,SRX20140895,INTS13,356
chr1,224434830,224435015,SRX5075168,SMARCA4,185
chr1,224434859,224435083,SRX5075174,SMARCA4,224
chr1,224447332,224447568,SRX5075176,SMARCA4,236
chr1,224447347,224447606,SRX5075170,SMARCA4,259
chr1,224447377,224447566,SRX5075175,SMARCA4,189
chr1,224456084,224456378,SRX5075174,SMARCA4,294
chr1,224457414,224457811,SRX5075169,SMARCA4,397
chr1,224457423,224457670,SRX5716470,SMARCA4,247
chr1,224457424,224457839,SRX5075176,SMARCA4,415
chr1,224457435,224458015,SRX16500059,CTCF,580
chr1,224457451,224457952,SRX16500061,CTCF,501
chr1,224457455,224457816,SRX5075170,SMARCA4,361
chr1,224457478,224457730,SRX5716469,SMARCA4,252
chr1,224457478,224458003,SRX16500060,CTCF,525
chr1,224457501,224457973,SRX16500062,CTCF,472
chr1,224457518,224457773,SRX5075168,SMARCA4,255
chr1,224457534,224457792,SRX5716464,SMARCA4,258
chr1,224457538,224457840,SRX5075174,SMARCA4,302
chr1,224457544,224457780,SRX5075175,SMARCA4,236
chr1,224489167,224489383,SRX5075174,SMARCA4,216
chr1,224498095,224498615,SRX5075170,SMARCA4,520
chr1,224498124,224498572,SRX5075176,SMARCA4,448
chr1,224498153,224498851,SRX5075175,SMARCA4,698
chr1,224498169,224498548,SRX5054309,FOSL2,379
chr1,224498211,224498752,SRX5075169,SMARCA4,541
chr1,224498236,224498539,SRX5054308,FOSL2,303
chr1,224498334,224498849,SRX5716470,SMARCA4,515
chr1,224498486,224498664,SRX5075174,SMARCA4,178
chr1,224498694,224498894,SRX5075168,SMARCA4,200
chr1,224503504,224503794,SRX5075174,SMARCA4,290
chr1,224503545,224503917,SRX5075170,SMARCA4,372
chr1,224503553,224503875,SRX5075175,SMARCA4,322
chr1,224503575,224503895,SRX5075169,SMARCA4,320
chr1,224503582,224503917,SRX5075176,SMARCA4,335
chr1,224513623,224514162,SRX16500060,CTCF,539
chr1,224513639,224514154,SRX16500059,CTCF,515
chr1,224513641,224514125,SRX16500062,CTCF,484
chr1,224513672,224514128,SRX16500061,CTCF,456
chr1,224513702,224514165,SRX4174629,CTCF,463
chr1,224513739,224514039,SRX5075174,SMARCA4,300
chr1,224513750,224514074,SRX5075168,SMARCA4,324
chr1,224513793,224514074,SRX5075170,SMARCA4,281
chr1,224513797,224514002,SRX5716464,SMARCA4,205
chr1,224513824,224514040,SRX5075176,SMARCA4,216
chr1,224513828,224514060,SRX5075169,SMARCA4,232
chr1,224528914,224529353,SRX5075176,SMARCA4,439
chr1,224528924,224529334,SRX5075174,SMARCA4,410
chr1,224528927,224529273,SRX5075168,SMARCA4,346
chr1,224528928,224529254,SRX5075175,SMARCA4,326
chr1,224528930,224529307,SRX5075169,SMARCA4,377
chr1,224528956,224529365,SRX5075170,SMARCA4,409
chr1,224528968,224529283,SRX5716470,SMARCA4,315
chr1,224528975,224529220,SRX5054308,FOSL2,245
chr1,224528990,224529216,SRX5054307,FOSL2,226
chr1,224529014,224529242,SRX5716469,SMARCA4,228
chr1,224529036,224529257,SRX5054309,FOSL2,221
chr1,224542756,224543186,SRX5075176,SMARCA4,430
chr1,224542785,224543175,SRX5075168,SMARCA4,390
chr1,224542787,224543299,SRX5054309,FOSL2,512
chr1,224542789,224543181,SRX5075170,SMARCA4,392
chr1,224542801,224543198,SRX5075169,SMARCA4,397
chr1,224542807,224543202,SRX5054308,FOSL2,395
chr1,224542814,224543150,SRX5716470,SMARCA4,336
chr1,224542821,224543151,SRX5075174,SMARCA4,330
chr1,224542825,224543178,SRX5716469,SMARCA4,353
chr1,224542825,224543211,SRX5075175,SMARCA4,386
chr1,224542841,224543172,SRX5020211,SMARCA2,331
chr1,224542852,224543163,SRX5716467,SMARCA2,311
chr1,224542895,224543104,SRX5054307,FOSL2,209
chr1,224542897,224543131,SRX5075182,SMARCA2,234
chr1,224565094,224565506,SRX5075168,SMARCA4,412
chr1,224565162,224565496,SRX5075170,SMARCA4,334
chr1,224565167,224565485,SRX5075169,SMARCA4,318
chr1,224565186,224565516,SRX5075174,SMARCA4,330
chr1,224565208,224565449,SRX5075175,SMARCA4,241
chr1,224565220,224565503,SRX5075176,SMARCA4,283
chr1,224589035,224589687,SRX5075174,SMARCA4,652
chr1,224589039,224589449,SRX5075168,SMARCA4,410
chr1,224592684,224592927,SRX5075170,SMARCA4,243
chr1,224592726,224592921,SRX5075176,SMARCA4,195
chr1,224593057,224593461,SRX5075176,SMARCA4,404
chr1,224593076,224593439,SRX5075175,SMARCA4,363
chr1,224593102,224593541,SRX5716470,SMARCA4,439
chr1,224593127,224593505,SRX5075169,SMARCA4,378
chr1,224593134,224593503,SRX5716469,SMARCA4,369
chr1,224593139,224593478,SRX5075170,SMARCA4,339
chr1,224615959,224616310,SRX5075174,SMARCA4,351
chr1,224616077,224616439,SRX5075168,SMARCA4,362
chr1,224623316,224623535,SRX5075176,SMARCA4,219
chr1,224631701,224631956,SRX5075170,SMARCA4,255
chr1,224631744,224632033,SRX5075176,SMARCA4,289
chr1,224631762,224632133,SRX5716470,SMARCA4,371
chr1,224631776,224632022,SRX5075169,SMARCA4,246
chr1,224633004,224633321,SRX5075174,SMARCA4,317
chr1,224635375,224635674,SRX5075170,SMARCA4,299
chr1,224635395,224635720,SRX5075176,SMARCA4,325
chr1,224635424,224635661,SRX5054309,FOSL2,237
chr1,224644460,224644986,SRX16500061,CTCF,526
chr1,224644489,224645098,SRX16500059,CTCF,609
chr1,224644499,224644981,SRX16500060,CTCF,482
chr1,224644520,224645016,SRX16500062,CTCF,496
chr1,224644677,224644912,SRX5075168,SMARCA4,235
chr1,224644681,224644857,SRX5075174,SMARCA4,176
chr1,224644723,224644979,SRX4174629,CTCF,256
chr1,224652311,224652491,SRX5075169,SMARCA4,180
chr1,224652313,224652591,SRX5075170,SMARCA4,278
chr1,224652329,224652555,SRX5054309,FOSL2,226
chr1,224652349,224652606,SRX5075176,SMARCA4,257
chr1,224666783,224667232,SRX5075168,SMARCA4,449
chr1,224666842,224667252,SRX5075174,SMARCA4,410
chr1,224666894,224667142,SRX20140867,INTS10,248
chr1,224684765,224685525,SRX5075174,SMARCA4,760
chr1,224684837,224685575,SRX5075168,SMARCA4,738
chr1,224684934,224685302,SRX20140879,CPSF3L,368
chr1,224684937,224685205,SRX5075170,SMARCA4,268
chr1,224684950,224685365,SRX20140881,CPSF3L,415
chr1,224684956,224685319,SRX5075176,SMARCA4,363
chr1,224684966,224685219,SRX5716469,SMARCA4,253
chr1,224684990,224685245,SRX5716464,SMARCA4,255
chr1,224684998,224685316,SRX5075169,SMARCA4,318
chr1,224685057,224685338,SRX5716463,SMARCA4,281
chr1,224685064,224685308,SRX5716451,SOX2,244
chr1,224697378,224697697,SRX5075169,SMARCA4,319
chr1,224697430,224697728,SRX5075176,SMARCA4,298
chr1,224697442,224697704,SRX5075170,SMARCA4,262
chr1,224697457,224697736,SRX5054308,FOSL2,279
chr1,224697470,224697711,SRX5054309,FOSL2,241
chr1,224698125,224698559,SRX5075174,SMARCA4,434
chr1,224698151,224698490,SRX5075168,SMARCA4,339
chr1,224701022,224701245,SRX16500062,CTCF,223
chr1,224708056,224708472,SRX5054309,FOSL2,416
chr1,224708077,224708503,SRX5075175,SMARCA4,426
chr1,224708093,224708459,SRX5075176,SMARCA4,366
chr1,224708105,224708416,SRX5075170,SMARCA4,311
chr1,224708141,224708459,SRX5054308,FOSL2,318
chr1,224708201,224708444,SRX5075169,SMARCA4,243
chr1,224708227,224708485,SRX5716467,SMARCA2,258
chr1,224726712,224727123,SRX5075169,SMARCA4,411
chr1,224726755,224727127,SRX5075170,SMARCA4,372
chr1,224726773,224727083,SRX5054309,FOSL2,310
chr1,224726774,224727142,SRX5075176,SMARCA4,368
chr1,224726787,224727104,SRX5075168,SMARCA4,317
chr1,224726808,224727027,SRX5716469,SMARCA4,219
chr1,224726846,224727066,SRX5075175,SMARCA4,220
chr1,224726849,224727058,SRX5054308,FOSL2,209
chr1,224726872,224727083,SRX5716470,SMARCA4,211
chr1,224727879,224728095,SRX5716470,SMARCA4,216
chr1,224733300,224733649,SRX5075174,SMARCA4,349
chr1,224733383,224733705,SRX5075168,SMARCA4,322
chr1,224770284,224770617,SRX5075174,SMARCA4,333
chr1,224770335,224770624,SRX5075169,SMARCA4,289
chr1,224770336,224770673,SRX5075170,SMARCA4,337
chr1,224770374,224770646,SRX5054309,FOSL2,272
chr1,224770377,224770697,SRX5054308,FOSL2,320
chr1,224770391,224770600,SRX5075176,SMARCA4,209
chr1,224770426,224770614,SRX5075175,SMARCA4,188
chr1,224784661,224784942,SRX5075170,SMARCA4,281
chr1,224784662,224784952,SRX5075176,SMARCA4,290
chr1,224784682,224784999,SRX5075169,SMARCA4,317
chr1,224784684,224785012,SRX5075175,SMARCA4,328
chr1,224784691,224784925,SRX5054308,FOSL2,234
chr1,224784691,224784935,SRX5054309,FOSL2,244
chr1,224784738,224785086,SRX5716469,SMARCA4,348
chr1,224786884,224787067,SRX5054309,FOSL2,183
chr1,224851476,224851810,SRX16500059,CTCF,334
chr1,224851482,224851805,SRX16500062,CTCF,323
chr1,224851482,224851862,SRX16500060,CTCF,380
chr1,224851522,224851835,SRX16500061,CTCF,313
chr1,224852877,224853353,SRX16500061,CTCF,476
chr1,224852903,224853369,SRX16500059,CTCF,466
chr1,224852926,224853369,SRX16500062,CTCF,443
chr1,224852937,224853336,SRX16500060,CTCF,399
chr1,224852999,224853277,SRX5075174,SMARCA4,278
chr1,224853001,224853249,SRX5075168,SMARCA4,248
chr1,224860772,224861267,SRX5075174,SMARCA4,495
chr1,224860802,224861216,SRX5075168,SMARCA4,414
chr1,224879368,224879778,SRX5075176,SMARCA4,410
chr1,224879372,224879753,SRX5075169,SMARCA4,381
chr1,224879388,224879771,SRX5075175,SMARCA4,383
chr1,224879405,224879796,SRX5075170,SMARCA4,391
chr1,224879421,224879781,SRX5075174,SMARCA4,360
chr1,224879435,224879758,SRX5716470,SMARCA4,323
chr1,224879461,224879735,SRX5075168,SMARCA4,274
chr1,224879463,224879755,SRX5054308,FOSL2,292
chr1,224879475,224879769,SRX5716469,SMARCA4,294
chr1,224879499,224879747,SRX5054309,FOSL2,248
chr1,224880598,224880956,SRX5075174,SMARCA4,358
chr1,224880599,224880907,SRX5075168,SMARCA4,308
chr1,224880646,224880898,SRX5716464,SMARCA4,252
chr1,224880648,224880938,SRX5716463,SMARCA4,290
chr1,224894925,224895235,SRX16500060,CTCF,310
chr1,224894999,224895263,SRX16500059,CTCF,264
chr1,224895002,224895273,SRX16500062,CTCF,271
chr1,224922478,224922961,SRX16500059,CTCF,483
chr1,224922488,224922974,SRX16500060,CTCF,486
chr1,224922509,224922947,SRX16500061,CTCF,438
chr1,224922517,224922791,SRX4174629,CTCF,274
chr1,224922527,224922935,SRX16500062,CTCF,408
chr1,224922624,224922884,SRX5075168,SMARCA4,260
chr1,224929411,224929600,SRX5075168,SMARCA4,189
chr1,224929464,224930149,SRX5075174,SMARCA4,685
chr1,224929490,224930074,SRX20140895,INTS13,584
chr1,224929502,224930192,SRX5075176,SMARCA4,690
chr1,224929506,224930143,SRX5716470,SMARCA4,637
chr1,224929518,224930124,SRX5716469,SMARCA4,606
chr1,224929553,224930093,SRX5075170,SMARCA4,540
chr1,224929597,224929952,SRX20140867,INTS10,355
chr1,224929661,224929961,SRX20140869,INTS10,300
chr1,224929668,224929954,SRX20140897,INTS13,286
chr1,224929688,224930049,SRX5075175,SMARCA4,361
chr1,224929737,224930105,SRX5075168,SMARCA4,368
chr1,224929768,224930100,SRX5075169,SMARCA4,332
chr1,224929865,224930083,SRX5716467,SMARCA2,218
chr1,225044233,225044640,SRX5075176,SMARCA4,407
chr1,225044265,225044685,SRX5075170,SMARCA4,420
chr1,225044322,225044565,SRX5716470,SMARCA4,243
chr1,225044337,225044563,SRX5075175,SMARCA4,226
chr1,225044376,225044675,SRX5716469,SMARCA4,299
chr1,225264758,225264996,SRX5020211,SMARCA2,238
chr1,225318842,225319407,SRX16500061,CTCF,565
chr1,225318857,225319421,SRX16500059,CTCF,564
chr1,225318907,225319378,SRX16500060,CTCF,471
chr1,225318984,225319338,SRX5075174,SMARCA4,354
chr1,225318995,225319419,SRX16500062,CTCF,424
chr1,225319005,225319330,SRX5075168,SMARCA4,325
chr1,225319092,225319261,SRX5075170,SMARCA4,169
chr1,225319111,225319286,SRX5075176,SMARCA4,175
chr1,225347204,225347700,SRX5075168,SMARCA4,496
chr1,225347209,225347748,SRX5075174,SMARCA4,539
chr1,225378951,225379313,SRX5716469,SMARCA4,362
chr1,225378968,225379330,SRX5716470,SMARCA4,362
chr1,225378992,225379205,SRX5716468,SMARCA2,213
chr1,225379022,225379212,SRX5075176,SMARCA4,190
chr1,225379037,225379286,SRX5075175,SMARCA4,249
chr1,225379052,225379252,SRX5075170,SMARCA4,200
chr1,225379164,225379350,SRX5075168,SMARCA4,186
chr1,225427614,225428797,SRX20140895,INTS13,1183
chr1,225427951,225428300,SRX5075174,SMARCA4,349
chr1,225427959,225428495,SRX5075168,SMARCA4,536
chr1,225428019,225428637,SRX20140868,INTS10,618
chr1,225428083,225428321,SRX5075176,SMARCA4,238
chr1,225428093,225428288,SRX5054307,FOSL2,195
chr1,225428146,225428607,SRX20140867,INTS10,461
chr1,225428147,225428405,SRX5075170,SMARCA4,258
chr1,225428235,225428568,SRX20140897,INTS13,333
chr1,225428242,225428582,SRX20140879,CPSF3L,340
chr1,225428436,225428710,SRX20140881,CPSF3L,274
chr1,225428463,225428808,SRX5075174,SMARCA4,345
chr1,225438012,225438318,SRX16500060,CTCF,306
chr1,225438094,225438348,SRX16500062,CTCF,254
chr1,225438114,225438335,SRX16500061,CTCF,221
chr1,225438139,225438466,SRX16500059,CTCF,327
chr1,225438183,225438372,SRX5075174,SMARCA4,189
chr1,225454720,225455150,SRX5075168,SMARCA4,430
chr1,225454741,225455094,SRX5075174,SMARCA4,353
chr1,225454802,225455019,SRX5075175,SMARCA4,217
chr1,225454803,225455044,SRX5075169,SMARCA4,241
chr1,225454815,225455063,SRX5075170,SMARCA4,248
chr1,225454823,225455074,SRX5075176,SMARCA4,251
chr1,225454845,225455078,SRX5054309,FOSL2,233
chr1,225463054,225463223,SRX5075170,SMARCA4,169
chr1,225464734,225465227,SRX5075168,SMARCA4,493
chr1,225464735,225465061,SRX5075174,SMARCA4,326
chr1,225474782,225475452,SRX4174629,CTCF,670
chr1,225474839,225475452,SRX16500059,CTCF,613
chr1,225474846,225475293,SRX5075174,SMARCA4,447
chr1,225474846,225475427,SRX16500060,CTCF,581
chr1,225474854,225475382,SRX16500061,CTCF,528
chr1,225474857,225475412,SRX16500062,CTCF,555
chr1,225474909,225475304,SRX5075170,SMARCA4,395
chr1,225474921,225475335,SRX5075168,SMARCA4,414
chr1,225474932,225475344,SRX5075176,SMARCA4,412
chr1,225474950,225475313,SRX5075175,SMARCA4,363
chr1,225474953,225475247,SRX5075169,SMARCA4,294
chr1,225475003,225475344,SRX5716470,SMARCA4,341
chr1,225475058,225475428,SRX20140895,INTS13,370
chr1,225480879,225481302,SRX16500061,CTCF,423
chr1,225480903,225481291,SRX16500062,CTCF,388
chr1,225480915,225481340,SRX16500060,CTCF,425
chr1,225480927,225481302,SRX16500059,CTCF,375
chr1,225482806,225482989,SRX5075176,SMARCA4,183
chr1,225498437,225499081,SRX5075170,SMARCA4,644
chr1,225498468,225499070,SRX5075176,SMARCA4,602
chr1,225498499,225498931,SRX5054309,FOSL2,432
chr1,225498519,225498795,SRX5020211,SMARCA2,276
chr1,225498533,225498948,SRX5054308,FOSL2,415
chr1,225498548,225498905,SRX5075175,SMARCA4,357
chr1,225498549,225499108,SRX5075169,SMARCA4,559
chr1,225498556,225499060,SRX5716470,SMARCA4,504
chr1,225498557,225498970,SRX5716469,SMARCA4,413
chr1,225498639,225498902,SRX5716467,SMARCA2,263
chr1,225508439,225509041,SRX5075168,SMARCA4,602
chr1,225508468,225508873,SRX5716467,SMARCA2,405
chr1,225508469,225508922,SRX5054308,FOSL2,453
chr1,225508473,225509012,SRX5075170,SMARCA4,539
chr1,225508475,225508983,SRX5075174,SMARCA4,508
chr1,225508476,225508953,SRX5075169,SMARCA4,477
chr1,225508478,225508947,SRX5716470,SMARCA4,469
chr1,225508480,225508955,SRX5075176,SMARCA4,475
chr1,225508489,225508925,SRX5054309,FOSL2,436
chr1,225508493,225509004,SRX5716469,SMARCA4,511
chr1,225508513,225508939,SRX5075175,SMARCA4,426
chr1,225508519,225508887,SRX5020211,SMARCA2,368
chr1,225508524,225508892,SRX5716460,Epitope tags,368
chr1,225508526,225508779,SRX5716454,SOX3,253
chr1,225508526,225508850,SRX5716463,SMARCA4,324
chr1,225508548,225508850,SRX5054307,FOSL2,302
chr1,225508554,225508823,SRX5020214,SMARCA2,269
chr1,225508565,225508862,SRX5716451,SOX2,297
chr1,225508575,225508835,SRX5075182,SMARCA2,260
chr1,225508618,225508976,SRX5716459,Epitope tags,358
chr1,225532847,225533028,SRX5075168,SMARCA4,181
chr1,225548155,225548390,SRX5054308,FOSL2,235
chr1,225548180,225548467,SRX5075176,SMARCA4,287
chr1,225548202,225548403,SRX5054309,FOSL2,201
chr1,225548224,225548421,SRX5075170,SMARCA4,197
chr1,225554162,225554593,SRX16500059,CTCF,431
chr1,225554211,225554599,SRX16500061,CTCF,388
chr1,225554222,225554587,SRX16500060,CTCF,365
chr1,225554271,225554540,SRX16500062,CTCF,269
chr1,225554284,225554496,SRX5075174,SMARCA4,212
chr1,225572528,225572720,SRX5075176,SMARCA4,192
chr1,225578334,225578740,SRX5075174,SMARCA4,406
chr1,225578450,225578654,SRX5716463,SMARCA4,204
chr1,225578521,225578820,SRX5075168,SMARCA4,299
chr1,225578572,225578762,SRX5716451,SOX2,190
chr1,225593386,225593432,SRX1424891,POU3F2,46
chr1,225593387,225593430,SRX1424892,POU3F2,43
chr1,225593389,225593429,SRX1424894,POU3F2,40
chr1,225598045,225598260,SRX5054308,FOSL2,215
chr1,225603481,225603839,SRX5075176,SMARCA4,358
chr1,225603494,225603788,SRX5075170,SMARCA4,294
chr1,225603499,225603824,SRX5075175,SMARCA4,325
chr1,225603507,225603942,SRX5054309,FOSL2,435
chr1,225603513,225603801,SRX5075169,SMARCA4,288
chr1,225603513,225603809,SRX5716469,SMARCA4,296
chr1,225603516,225603850,SRX5054308,FOSL2,334
chr1,225603527,225603966,SRX5716467,SMARCA2,439
chr1,225603530,225603885,SRX5716460,Epitope tags,355
chr1,225603534,225603839,SRX5075174,SMARCA4,305
chr1,225603549,225603787,SRX5716470,SMARCA4,238
chr1,225603590,225603892,SRX5020211,SMARCA2,302
chr1,225603603,225603856,SRX5075168,SMARCA4,253
chr1,225609042,225609217,SRX5075176,SMARCA4,175
chr1,225631080,225631294,SRX5075176,SMARCA4,214
chr1,225652514,225653930,SRX20140895,INTS13,1416
chr1,225652671,225653839,SRX20140868,INTS10,1168
chr1,225652848,225653924,SRX20140867,INTS10,1076
chr1,225653054,225653367,SRX20140896,INTS13,313
chr1,225653056,225653439,SRX5075168,SMARCA4,383
chr1,225653062,225653411,SRX5075174,SMARCA4,349
chr1,225653268,225653664,SRX20140879,CPSF3L,396
chr1,225653450,225653716,SRX20140869,INTS10,266
chr1,225653832,225654058,SRX5075174,SMARCA4,226
chr1,225655424,225655956,SRX5075176,SMARCA4,532
chr1,225655431,225655904,SRX5075170,SMARCA4,473
chr1,225655445,225655907,SRX5054309,FOSL2,462
chr1,225655447,225655810,SRX5054308,FOSL2,363
chr1,225655457,225655926,SRX5075175,SMARCA4,469
chr1,225655488,225655862,SRX5716468,SMARCA2,374
chr1,225655522,225655894,SRX5716467,SMARCA2,372
chr1,225655529,225656047,SRX5075169,SMARCA4,518
chr1,225655549,225655932,SRX5716470,SMARCA4,383
chr1,225655550,225655949,SRX5716469,SMARCA4,399
chr1,225655580,225655856,SRX5020211,SMARCA2,276
chr1,225657692,225657926,SRX5054309,FOSL2,234
chr1,225657716,225657911,SRX5054308,FOSL2,195
chr1,225657776,225658313,SRX5075170,SMARCA4,537
chr1,225657821,225658328,SRX5075169,SMARCA4,507
chr1,225666442,225666962,SRX5075170,SMARCA4,520
chr1,225666521,225666952,SRX5716470,SMARCA4,431
chr1,225666537,225666786,SRX5075176,SMARCA4,249
chr1,225666556,225666755,SRX5075169,SMARCA4,199
chr1,225666565,225666957,SRX5716469,SMARCA4,392
chr1,225666624,225666885,SRX5075175,SMARCA4,261
chr1,225670791,225671217,SRX5075176,SMARCA4,426
chr1,225670809,225671235,SRX5075170,SMARCA4,426
chr1,225670944,225671252,SRX5054309,FOSL2,308
chr1,225670956,225671183,SRX5075169,SMARCA4,227
chr1,225671042,225671239,SRX5054308,FOSL2,197
chr1,225671053,225671311,SRX5075175,SMARCA4,258
chr1,225691892,225692111,SRX5020211,SMARCA2,219
chr1,225691896,225692179,SRX5716470,SMARCA4,283
chr1,225691900,225692212,SRX5054308,FOSL2,312
chr1,225691909,225692191,SRX5054309,FOSL2,282
chr1,225691918,225692206,SRX5075175,SMARCA4,288
chr1,225691944,225692210,SRX5075181,SMARCA2,266
chr1,225691984,225692217,SRX5716469,SMARCA4,233
chr1,225691991,225692170,SRX5075182,SMARCA2,179
chr1,225692001,225692207,SRX5020214,SMARCA2,206
chr1,225692018,225692237,SRX5075169,SMARCA4,219
chr1,225696107,225696325,SRX5075170,SMARCA4,218
chr1,225699410,225699592,SRX5075176,SMARCA4,182
chr1,225700012,225700933,SRX5075169,SMARCA4,921
chr1,225700029,225700669,SRX5075168,SMARCA4,640
chr1,225700058,225700879,SRX5075176,SMARCA4,821
chr1,225700102,225700857,SRX5075170,SMARCA4,755
chr1,225700111,225700865,SRX5075175,SMARCA4,754
chr1,225700161,225700887,SRX5075174,SMARCA4,726
chr1,225700180,225700729,SRX5716467,SMARCA2,549
chr1,225700220,225700715,SRX5716470,SMARCA4,495
chr1,225700227,225700801,SRX5716469,SMARCA4,574
chr1,225700239,225700652,SRX5020211,SMARCA2,413
chr1,225700249,225700524,SRX5075182,SMARCA2,275
chr1,225700252,225700710,SRX5054309,FOSL2,458
chr1,225700266,225700602,SRX5716468,SMARCA2,336
chr1,225700269,225700720,SRX5054308,FOSL2,451
chr1,225700359,225700646,SRX5020214,SMARCA2,287
chr1,225700362,225700567,SRX5075181,SMARCA2,205
chr1,225700439,225700693,SRX5054307,FOSL2,254
chr1,225700528,225700799,SRX20140867,INTS10,271
chr1,225710853,225711216,SRX5075176,SMARCA4,363
chr1,225710928,225711181,SRX5075170,SMARCA4,253
chr1,225710968,225711148,SRX5075169,SMARCA4,180
chr1,225710970,225711167,SRX5075175,SMARCA4,197
chr1,225710971,225711154,SRX5054309,FOSL2,183
chr1,225710986,225711169,SRX5054308,FOSL2,183
chr1,225723733,225724105,SRX5075176,SMARCA4,372
chr1,225723809,225724033,SRX5075170,SMARCA4,224
chr1,225735457,225736075,SRX5075169,SMARCA4,618
chr1,225735530,225736140,SRX5075176,SMARCA4,610
chr1,225735537,225736091,SRX5716470,SMARCA4,554
chr1,225735586,225736202,SRX5075175,SMARCA4,616
chr1,225735603,225736139,SRX5075170,SMARCA4,536
chr1,225735660,225736157,SRX5054309,FOSL2,497
chr1,225735685,225735942,SRX5716467,SMARCA2,257
chr1,225735702,225736091,SRX5716469,SMARCA4,389
chr1,225735799,225736108,SRX5075168,SMARCA4,309
chr1,225735811,225736066,SRX5075174,SMARCA4,255
chr1,225735885,225736086,SRX5054308,FOSL2,201
chr1,225746619,225747204,SRX5075176,SMARCA4,585
chr1,225746631,225747177,SRX5075170,SMARCA4,546
chr1,225746650,225747112,SRX5075169,SMARCA4,462
chr1,225746665,225746913,SRX5716459,Epitope tags,248
chr1,225746681,225747211,SRX5075175,SMARCA4,530
chr1,225746698,225747161,SRX5716469,SMARCA4,463
chr1,225746705,225747107,SRX5075168,SMARCA4,402
chr1,225746725,225747127,SRX5716467,SMARCA2,402
chr1,225746729,225747201,SRX5716470,SMARCA4,472
chr1,225746740,225747050,SRX5716468,SMARCA2,310
chr1,225746749,225747174,SRX5075174,SMARCA4,425
chr1,225746754,225747071,SRX5075181,SMARCA2,317
chr1,225746772,225747179,SRX5054308,FOSL2,407
chr1,225746776,225747117,SRX5020211,SMARCA2,341
chr1,225746806,225747156,SRX5054309,FOSL2,350
chr1,225746812,225747091,SRX5020214,SMARCA2,279
chr1,225755306,225755560,SRX5020211,SMARCA2,254
chr1,225755310,225755781,SRX5075176,SMARCA4,471
chr1,225755313,225755745,SRX5716469,SMARCA4,432
chr1,225755314,225755677,SRX5075170,SMARCA4,363
chr1,225755322,225755728,SRX5075169,SMARCA4,406
chr1,225755339,225755873,SRX5716470,SMARCA4,534
chr1,225755342,225755676,SRX5075175,SMARCA4,334
chr1,225755346,225755582,SRX5020214,SMARCA2,236
chr1,225755353,225755592,SRX5075181,SMARCA2,239
chr1,225755356,225755702,SRX5054309,FOSL2,346
chr1,225755362,225755636,SRX5054308,FOSL2,274
chr1,225755397,225755626,SRX5716468,SMARCA2,229
chr1,225755438,225755654,SRX5716467,SMARCA2,216
chr1,225762396,225762714,SRX5075168,SMARCA4,318
chr1,225762451,225762645,SRX5075181,SMARCA2,194
chr1,225762487,225762714,SRX5054309,FOSL2,227
chr1,225762519,225762764,SRX5075170,SMARCA4,245
chr1,225762535,225762734,SRX5054308,FOSL2,199
chr1,225762544,225762764,SRX5075176,SMARCA4,220
chr1,225762549,225762750,SRX5075169,SMARCA4,201
chr1,225763843,225764030,SRX5075169,SMARCA4,187
chr1,225763846,225764028,SRX5075176,SMARCA4,182
chr1,225766951,225767271,SRX5075176,SMARCA4,320
chr1,225767034,225767266,SRX5075170,SMARCA4,232
chr1,225767053,225767321,SRX5054309,FOSL2,268
chr1,225767074,225767254,SRX5054308,FOSL2,180
chr1,225767107,225767301,SRX5075169,SMARCA4,194
chr1,225772230,225772695,SRX16500059,CTCF,465
chr1,225772245,225772658,SRX16500062,CTCF,413
chr1,225772246,225772635,SRX16500061,CTCF,389
chr1,225772249,225772701,SRX16500060,CTCF,452
chr1,225772258,225772685,SRX4174629,CTCF,427
chr1,225772316,225772572,SRX5075168,SMARCA4,256
chr1,225772319,225772580,SRX5075174,SMARCA4,261
chr1,225772372,225772562,SRX5075176,SMARCA4,190
chr1,225772373,225772622,SRX5075170,SMARCA4,249
chr1,225777412,225777894,SRX16500059,CTCF,482
chr1,225777434,225777843,SRX16500060,CTCF,409
chr1,225777439,225777855,SRX16500062,CTCF,416
chr1,225777465,225777856,SRX16500061,CTCF,391
chr1,225777474,225777790,SRX5075168,SMARCA4,316
chr1,225777495,225777829,SRX5075174,SMARCA4,334
chr1,225777509,225778345,SRX20140895,INTS13,836
chr1,225777518,225777767,SRX5075169,SMARCA4,249
chr1,225777533,225777783,SRX5075176,SMARCA4,250
chr1,225777546,225777799,SRX5075170,SMARCA4,253
chr1,225777554,225777799,SRX4174629,CTCF,245
chr1,225777606,225778242,SRX20140897,INTS13,636
chr1,225777608,225777815,SRX5716463,SMARCA4,207
chr1,225777637,225777825,SRX5054307,FOSL2,188
chr1,225777654,225778290,SRX20140868,INTS10,636
chr1,225777690,225778387,SRX20140867,INTS10,697
chr1,225777706,225778141,SRX20140881,CPSF3L,435
chr1,225777888,225778210,SRX20140869,INTS10,322
chr1,225778201,225778415,SRX5075174,SMARCA4,214
chr1,225789059,225789519,SRX5075174,SMARCA4,460
chr1,225789134,225789517,SRX5075168,SMARCA4,383
chr1,225789215,225789485,SRX5716464,SMARCA4,270
chr1,225809828,225810171,SRX5075174,SMARCA4,343
chr1,225809839,225810510,SRX20140895,INTS13,671
chr1,225809858,225810255,SRX5075168,SMARCA4,397
chr1,225809883,225810233,SRX5075176,SMARCA4,350
chr1,225809898,225810171,SRX20140897,INTS13,273
chr1,225809912,225810166,SRX5075170,SMARCA4,254
chr1,225809918,225810373,SRX20140868,INTS10,455
chr1,225809985,225810438,SRX20140867,INTS10,453
chr1,225809989,225810489,SRX5075169,SMARCA4,500
chr1,225810019,225810292,SRX20140869,INTS10,273
chr1,225810067,225810450,SRX5075175,SMARCA4,383
chr1,225810095,225810505,SRX5716470,SMARCA4,410
chr1,225810309,225810522,SRX5075174,SMARCA4,213
chr1,225810352,225810531,SRX5075176,SMARCA4,179
chr1,225811621,225811966,SRX16500060,CTCF,345
chr1,225811666,225811917,SRX16500062,CTCF,251
chr1,225811711,225811964,SRX16500061,CTCF,253
chr1,225815806,225816058,SRX5075170,SMARCA4,252
chr1,225817652,225817940,SRX5075169,SMARCA4,288
chr1,225817681,225817956,SRX5075176,SMARCA4,275
chr1,225817722,225817921,SRX5075170,SMARCA4,199
chr1,225817732,225817985,SRX5075175,SMARCA4,253
chr1,225834392,225834887,SRX5075176,SMARCA4,495
chr1,225834400,225834863,SRX5075169,SMARCA4,463
chr1,225834410,225834950,SRX5075170,SMARCA4,540
chr1,225834411,225834804,SRX5716469,SMARCA4,393
chr1,225834419,225834813,SRX5716470,SMARCA4,394
chr1,225834434,225834758,SRX5075175,SMARCA4,324
chr1,225834446,225834873,SRX5716467,SMARCA2,427
chr1,225834474,225834806,SRX5716468,SMARCA2,332
chr1,225834560,225834771,SRX5075181,SMARCA2,211
chr1,225835865,225836062,SRX5075176,SMARCA4,197
chr1,225845548,225845782,SRX5075170,SMARCA4,234
chr1,225845689,225846162,SRX16500060,CTCF,473
chr1,225845707,225846163,SRX16500061,CTCF,456
chr1,225845755,225846236,SRX16500059,CTCF,481
chr1,225845794,225846163,SRX16500062,CTCF,369
chr1,225845845,225846041,SRX5075174,SMARCA4,196
chr1,225845849,225846078,SRX5075176,SMARCA4,229
chr1,225845850,225846119,SRX5075175,SMARCA4,269
chr1,225845871,225846075,SRX5075168,SMARCA4,204
chr1,225864179,225864648,SRX5075169,SMARCA4,469
chr1,225864195,225864502,SRX5716459,Epitope tags,307
chr1,225864199,225864685,SRX5075176,SMARCA4,486
chr1,225864219,225864654,SRX5716470,SMARCA4,435
chr1,225864219,225864700,SRX5075170,SMARCA4,481
chr1,225864239,225864655,SRX5075175,SMARCA4,416
chr1,225864242,225864605,SRX5075174,SMARCA4,363
chr1,225864245,225864614,SRX5075168,SMARCA4,369
chr1,225864257,225864637,SRX5716467,SMARCA2,380
chr1,225864274,225864584,SRX5716460,Epitope tags,310
chr1,225864283,225864671,SRX5054308,FOSL2,388
chr1,225864293,225864654,SRX5054309,FOSL2,361
chr1,225864301,225864657,SRX5716469,SMARCA4,356
chr1,225864303,225864628,SRX5020211,SMARCA2,325
chr1,225864328,225864674,SRX5716468,SMARCA2,346
chr1,225864330,225864582,SRX5075181,SMARCA2,252
chr1,225864386,225864615,SRX5054307,FOSL2,229
chr1,225866081,225866453,SRX5075170,SMARCA4,372
chr1,225866107,225866358,SRX5075169,SMARCA4,251
chr1,225866124,225866449,SRX5075176,SMARCA4,325
chr1,225866158,225866443,SRX5075175,SMARCA4,285
chr1,225877664,225877993,SRX16500060,CTCF,329
chr1,225877687,225878082,SRX16500059,CTCF,395
chr1,225877708,225878009,SRX16500061,CTCF,301
chr1,225877718,225877999,SRX16500062,CTCF,281
chr1,225877747,225877926,SRX5075168,SMARCA4,179
chr1,225877760,225877976,SRX5075169,SMARCA4,216
chr1,225882168,225882651,SRX5075168,SMARCA4,483
chr1,225882180,225882567,SRX5075176,SMARCA4,387
chr1,225882200,225882833,SRX20140895,INTS13,633
chr1,225882213,225882607,SRX5075174,SMARCA4,394
chr1,225882214,225882694,SRX20140868,INTS10,480
chr1,225882279,225882607,SRX5075170,SMARCA4,328
chr1,225882474,225882675,SRX5075169,SMARCA4,201
chr1,225889315,225889497,SRX5075170,SMARCA4,182
chr1,225911204,225911754,SRX16500059,CTCF,550
chr1,225911207,225911726,SRX16500061,CTCF,519
chr1,225911252,225911720,SRX16500060,CTCF,468
chr1,225911297,225911703,SRX16500062,CTCF,406
chr1,225915052,225915257,SRX5075174,SMARCA4,205
chr1,225915602,225915804,SRX5075168,SMARCA4,202
chr1,225915649,225915838,SRX5075174,SMARCA4,189
chr1,225919902,225920151,SRX5716470,SMARCA4,249
chr1,225919907,225920224,SRX5075176,SMARCA4,317
chr1,225919933,225920201,SRX5075170,SMARCA4,268
chr1,225919968,225920160,SRX5075175,SMARCA4,192
chr1,225920001,225920183,SRX5075169,SMARCA4,182
chr1,225923851,225924118,SRX5716470,SMARCA4,267
chr1,225923915,225924470,SRX5075168,SMARCA4,555
chr1,225923934,225924204,SRX20140869,INTS10,270
chr1,225923939,225924646,SRX20140895,INTS13,707
chr1,225923951,225924264,SRX5716469,SMARCA4,313
chr1,225923962,225924614,SRX20140897,INTS13,652
chr1,225923963,225924345,SRX5716463,SMARCA4,382
chr1,225923983,225924497,SRX20140868,INTS10,514
chr1,225924005,225924428,SRX5075176,SMARCA4,423
chr1,225924012,225924383,SRX20140867,INTS10,371
chr1,225924042,225924263,SRX5075169,SMARCA4,221
chr1,225924042,225924473,SRX5075174,SMARCA4,431
chr1,225924094,225924501,SRX5075170,SMARCA4,407
chr1,225924108,225924375,SRX20140879,CPSF3L,267
chr1,225933171,225933414,SRX5075169,SMARCA4,243
chr1,225933177,225933416,SRX5054309,FOSL2,239
chr1,225941343,225941678,SRX5075176,SMARCA4,335
chr1,225945791,225946064,SRX20140895,INTS13,273
chr1,225962324,225962716,SRX16500059,CTCF,392
chr1,225962339,225962832,SRX16500060,CTCF,493
chr1,225962340,225962711,SRX16500062,CTCF,371
chr1,225962354,225962742,SRX16500061,CTCF,388
chr1,225962466,225962711,SRX5716464,SMARCA4,245
chr1,225962476,225962700,SRX5075176,SMARCA4,224
chr1,225962502,225962734,SRX5075168,SMARCA4,232
chr1,225975913,225976361,SRX16500061,CTCF,448
chr1,225975914,225976377,SRX16500059,CTCF,463
chr1,225975919,225976399,SRX16500060,CTCF,480
chr1,225975945,225976257,SRX4174629,CTCF,312
chr1,225975948,225976385,SRX16500062,CTCF,437
chr1,225975980,225976222,SRX5716463,SMARCA4,242
chr1,225975982,225976262,SRX5075176,SMARCA4,280
chr1,225975982,225976265,SRX5075170,SMARCA4,283
chr1,225975990,225976251,SRX5716470,SMARCA4,261
chr1,225975992,225976285,SRX5075174,SMARCA4,293
chr1,225975996,225976239,SRX5075169,SMARCA4,243
chr1,225976021,225976304,SRX5075168,SMARCA4,283
chr1,225976040,225976239,SRX5075175,SMARCA4,199
chr1,225987319,225987995,SRX16500060,CTCF,676
chr1,225987373,225987915,SRX16500059,CTCF,542
chr1,225987380,225987975,SRX16500062,CTCF,595
chr1,225987452,225987976,SRX16500061,CTCF,524
chr1,225987548,225987802,SRX5075174,SMARCA4,254
chr1,225987563,225987743,SRX5075168,SMARCA4,180
chr1,225999088,225999836,SRX20140895,INTS13,748
chr1,225999150,225999676,SRX20140868,INTS10,526
chr1,225999158,225999944,SRX20140869,INTS10,786
chr1,225999164,225999800,SRX20140897,INTS13,636
chr1,225999179,225999899,SRX20140879,CPSF3L,720
chr1,225999213,225999773,SRX5075175,SMARCA4,560
chr1,225999235,225999891,SRX20140867,INTS10,656
chr1,225999237,225999741,SRX5075174,SMARCA4,504
chr1,225999245,225999809,SRX20140896,INTS13,564
chr1,225999249,225999698,SRX5716469,SMARCA4,449
chr1,225999284,225999695,SRX5075168,SMARCA4,411
chr1,225999285,225999468,SRX5054309,FOSL2,183
chr1,225999301,225999644,SRX5716464,SMARCA4,343
chr1,225999311,225999556,SRX5054307,FOSL2,245
chr1,225999319,225999726,SRX5716463,SMARCA4,407
chr1,225999327,225999672,SRX5075169,SMARCA4,345
chr1,225999327,225999737,SRX5075170,SMARCA4,410
chr1,225999341,225999778,SRX5075176,SMARCA4,437
chr1,225999363,225999585,SRX5054308,FOSL2,222
chr1,225999369,225999570,SRX5716451,SOX2,201
chr1,225999385,225999838,SRX20140881,CPSF3L,453
chr1,225999390,225999766,SRX20140894,INTS13,376
chr1,226018620,226018664,SRX1424894,POU3F2,44
chr1,226018621,226018664,SRX1424891,POU3F2,43
chr1,226018621,226018664,SRX1424893,POU3F2,43
chr1,226027818,226028065,SRX5075168,SMARCA4,247
chr1,226027934,226028165,SRX5075174,SMARCA4,231
chr1,226034527,226034889,SRX5075176,SMARCA4,362
chr1,226034558,226034929,SRX5075170,SMARCA4,371
chr1,226034616,226034843,SRX5075169,SMARCA4,227
chr1,226034626,226034838,SRX5716469,SMARCA4,212
chr1,226034644,226034899,SRX5075175,SMARCA4,255
chr1,226048962,226049140,SRX5075174,SMARCA4,178
chr1,226061705,226063228,SRX20140895,INTS13,1523
chr1,226061823,226062139,SRX20140879,CPSF3L,316
chr1,226061840,226062936,SRX20140868,INTS10,1096
chr1,226061859,226062972,SRX20140867,INTS10,1113
chr1,226062276,226063041,SRX20140896,INTS13,765
chr1,226062287,226062477,SRX5075176,SMARCA4,190
chr1,226062329,226062755,SRX5075170,SMARCA4,426
chr1,226062487,226062737,SRX5075168,SMARCA4,250
chr1,226062493,226062721,SRX5054307,FOSL2,228
chr1,226062503,226062760,SRX5716454,SOX3,257
chr1,226062536,226062717,SRX5075174,SMARCA4,181
chr1,226062608,226063095,SRX20140897,INTS13,487
chr1,226062634,226062913,SRX20140881,CPSF3L,279
chr1,226062784,226063086,SRX20140869,INTS10,302
chr1,226064193,226065189,SRX16500062,CTCF,996
chr1,226064199,226064611,SRX4174629,CTCF,412
chr1,226064217,226065234,SRX16500059,CTCF,1017
chr1,226064224,226065192,SRX16500060,CTCF,968
chr1,226064230,226065181,SRX16500061,CTCF,951
chr1,226064903,226065117,SRX5075175,SMARCA4,214
chr1,226064903,226065125,SRX5075176,SMARCA4,222
chr1,226064922,226065114,SRX5075169,SMARCA4,192
chr1,226064925,226065114,SRX5075174,SMARCA4,189
chr1,226082969,226083174,SRX5075170,SMARCA4,205
chr1,226083113,226083883,SRX20140895,INTS13,770
chr1,226083308,226083730,SRX20140897,INTS13,422
chr1,226083373,226083668,SRX5075168,SMARCA4,295
chr1,226083376,226083761,SRX5075174,SMARCA4,385
chr1,226083404,226083683,SRX5075176,SMARCA4,279
chr1,226083429,226083633,SRX5716463,SMARCA4,204
chr1,226083463,226083773,SRX5075170,SMARCA4,310
chr1,226100523,226100750,SRX5075174,SMARCA4,227
chr1,226100670,226100849,SRX5075168,SMARCA4,179
chr1,226109628,226109885,SRX16500060,CTCF,257
chr1,226109719,226109996,SRX5075174,SMARCA4,277
chr1,226109757,226110043,SRX5075168,SMARCA4,286
chr1,226109854,226110278,SRX5075176,SMARCA4,424
chr1,226109993,226110239,SRX20140867,INTS10,246
chr1,226110069,226110302,SRX5075170,SMARCA4,233
chr1,226110108,226110874,SRX20140895,INTS13,766
chr1,226110144,226110325,SRX5075168,SMARCA4,181
chr1,226110153,226110352,SRX5075174,SMARCA4,199
chr1,226110183,226110519,SRX5075169,SMARCA4,336
chr1,226110480,226110858,SRX5075176,SMARCA4,378
chr1,226110493,226110877,SRX20140868,INTS10,384
chr1,226110557,226110837,SRX5075170,SMARCA4,280
chr1,226110631,226110884,SRX5075174,SMARCA4,253
chr1,226110688,226110989,SRX5075168,SMARCA4,301
chr1,226121421,226121887,SRX16500059,CTCF,466
chr1,226121436,226121860,SRX16500062,CTCF,424
chr1,226121443,226121920,SRX16500060,CTCF,477
chr1,226121446,226121963,SRX5075168,SMARCA4,517
chr1,226121449,226121901,SRX16500061,CTCF,452
chr1,226121473,226121773,SRX5075176,SMARCA4,300
chr1,226121475,226121901,SRX5075174,SMARCA4,426
chr1,226121476,226121836,SRX5716470,SMARCA4,360
chr1,226121480,226121764,SRX5075170,SMARCA4,284
chr1,226121499,226121723,SRX5075169,SMARCA4,224
chr1,226121510,226121796,SRX5075175,SMARCA4,286
chr1,226121633,226122666,SRX20140895,INTS13,1033
chr1,226121652,226122561,SRX20140868,INTS10,909
chr1,226121729,226122420,SRX20140867,INTS10,691
chr1,226125128,226125554,SRX16500059,CTCF,426
chr1,226125130,226125575,SRX16500060,CTCF,445
chr1,226125141,226125527,SRX16500061,CTCF,386
chr1,226125147,226125519,SRX16500062,CTCF,372
chr1,226125148,226125549,SRX4174629,CTCF,401
chr1,226125209,226125537,SRX5075174,SMARCA4,328
chr1,226125216,226125502,SRX5716463,SMARCA4,286
chr1,226125238,226125505,SRX5075168,SMARCA4,267
chr1,226125246,226125455,SRX5075170,SMARCA4,209
chr1,226125247,226125434,SRX5075175,SMARCA4,187
chr1,226125249,226125511,SRX5075176,SMARCA4,262
chr1,226125265,226125455,SRX5075169,SMARCA4,190
chr1,226186438,226186829,SRX20140867,INTS10,391
chr1,226186442,226187091,SRX20140895,INTS13,649
chr1,226186451,226186894,SRX20140896,INTS13,443
chr1,226186478,226186825,SRX20140869,INTS10,347
chr1,226186517,226186967,SRX5075174,SMARCA4,450
chr1,226186526,226186873,SRX20140868,INTS10,347
chr1,226186531,226187011,SRX5075168,SMARCA4,480
chr1,226186545,226186769,SRX5716469,SMARCA4,224
chr1,226186598,226186870,SRX20140897,INTS13,272
chr1,226186645,226186890,SRX5075175,SMARCA4,245
chr1,226186712,226187103,SRX5075170,SMARCA4,391
chr1,226186820,226187168,SRX5075176,SMARCA4,348
chr1,226187020,226187193,SRX5075174,SMARCA4,173
chr1,226196871,226197458,SRX16500060,CTCF,587
chr1,226196903,226197435,SRX16500059,CTCF,532
chr1,226196913,226197395,SRX16500061,CTCF,482
chr1,226196967,226197409,SRX16500062,CTCF,442
chr1,226196980,226197376,SRX5075168,SMARCA4,396
chr1,226196987,226197365,SRX5075174,SMARCA4,378
chr1,226197013,226197296,SRX5716470,SMARCA4,283
chr1,226197014,226197245,SRX5075170,SMARCA4,231
chr1,226197027,226197315,SRX4174629,CTCF,288
chr1,226197029,226197238,SRX5075176,SMARCA4,209
chr1,226197034,226197220,SRX5075169,SMARCA4,186
chr1,226217427,226217622,SRX5075170,SMARCA4,195
chr1,226223677,226224061,SRX5075174,SMARCA4,384
chr1,226223810,226224087,SRX5075170,SMARCA4,277
chr1,226223825,226224012,SRX5075175,SMARCA4,187
chr1,226308731,226309818,SRX20140895,INTS13,1087
chr1,226308948,226309559,SRX20140867,INTS10,611
chr1,226308971,226309819,SRX20140868,INTS10,848
chr1,226308990,226309542,SRX5075168,SMARCA4,552
chr1,226309181,226309381,SRX5075170,SMARCA4,200
chr1,226309213,226309538,SRX5075169,SMARCA4,325
chr1,226309334,226309638,SRX5075174,SMARCA4,304
chr1,226309395,226309589,SRX5075176,SMARCA4,194
chr1,226309401,226309667,SRX5716470,SMARCA4,266
chr1,226309407,226309721,SRX20140879,CPSF3L,314
chr1,226327797,226328001,SRX5716463,SMARCA4,204
chr1,226333344,226333784,SRX16500060,CTCF,440
chr1,226333393,226333833,SRX16500059,CTCF,440
chr1,226333424,226333822,SRX16500062,CTCF,398
chr1,226333431,226333803,SRX16500061,CTCF,372
chr1,226333432,226333756,SRX5075174,SMARCA4,324
chr1,226333435,226333615,SRX5075169,SMARCA4,180
chr1,226333438,226333758,SRX5075168,SMARCA4,320
chr1,226333443,226333745,SRX5716463,SMARCA4,302
chr1,226333448,226333726,SRX4174629,CTCF,278
chr1,226333456,226333631,SRX5075176,SMARCA4,175
chr1,226333462,226333668,SRX5075170,SMARCA4,206
chr1,226350092,226350359,SRX5075176,SMARCA4,267
chr1,226356214,226356408,SRX5075176,SMARCA4,194
chr1,226365914,226366089,SRX5075176,SMARCA4,175
chr1,226403528,226403798,SRX16500062,CTCF,270
chr1,226407589,226408413,SRX20140895,INTS13,824
chr1,226407641,226408202,SRX20140897,INTS13,561
chr1,226407731,226408283,SRX20140868,INTS10,552
chr1,226407779,226408028,SRX20140879,CPSF3L,249
chr1,226407794,226408005,SRX5716470,SMARCA4,211
chr1,226407875,226408265,SRX20140867,INTS10,390
chr1,226407917,226408410,SRX16500060,CTCF,493
chr1,226407918,226408371,SRX16500059,CTCF,453
chr1,226407929,226408352,SRX5075174,SMARCA4,423
chr1,226407934,226408347,SRX16500062,CTCF,413
chr1,226407942,226408367,SRX16500061,CTCF,425
chr1,226407952,226408387,SRX5075176,SMARCA4,435
chr1,226407954,226408408,SRX5075168,SMARCA4,454
chr1,226407990,226408393,SRX5075170,SMARCA4,403
chr1,226407992,226408278,SRX5075175,SMARCA4,286
chr1,226408015,226408343,SRX5075169,SMARCA4,328
chr1,226408095,226408300,SRX5716464,SMARCA4,205
chr1,226424418,226424901,SRX16500059,CTCF,483
chr1,226424432,226424882,SRX16500062,CTCF,450
chr1,226424450,226424870,SRX16500060,CTCF,420
chr1,226424504,226424896,SRX16500061,CTCF,392
chr1,226424585,226424826,SRX5075170,SMARCA4,241
chr1,226424648,226424823,SRX5075176,SMARCA4,175
chr1,226424652,226424825,SRX5075174,SMARCA4,173
chr1,226429230,226429418,SRX5075168,SMARCA4,188
chr1,226438054,226438300,SRX16500062,CTCF,246
chr1,226438076,226438310,SRX16500061,CTCF,234
chr1,226443516,226443727,SRX5075175,SMARCA4,211
chr1,226443547,226443955,SRX5075169,SMARCA4,408
chr1,226443565,226443802,SRX5054309,FOSL2,237
chr1,226532585,226532825,SRX5716464,SMARCA4,240
chr1,226532717,226532910,SRX5075168,SMARCA4,193
chr1,226547599,226548019,SRX4174629,CTCF,420
chr1,226547605,226548069,SRX16500059,CTCF,464
chr1,226547647,226548011,SRX16500061,CTCF,364
chr1,226547664,226548064,SRX16500060,CTCF,400
chr1,226547692,226548056,SRX16500062,CTCF,364
chr1,226547717,226548115,SRX5075174,SMARCA4,398
chr1,226547721,226548059,SRX5075168,SMARCA4,338
chr1,226547742,226548035,SRX5075175,SMARCA4,293
chr1,226547745,226548078,SRX5075176,SMARCA4,333
chr1,226547751,226548041,SRX5075169,SMARCA4,290
chr1,226547753,226548046,SRX5716463,SMARCA4,293
chr1,226547754,226548049,SRX5716469,SMARCA4,295
chr1,226547758,226548050,SRX5716470,SMARCA4,292
chr1,226547768,226548050,SRX5020214,SMARCA2,282
chr1,226547772,226548034,SRX5075170,SMARCA4,262
chr1,226547781,226547979,SRX5075181,SMARCA2,198
chr1,226548543,226548961,SRX20140895,INTS13,418
chr1,226548604,226548873,SRX5075168,SMARCA4,269
chr1,226568375,226568582,SRX5075176,SMARCA4,207
chr1,226569933,226570152,SRX16500061,CTCF,219
chr1,226570016,226570272,SRX16500059,CTCF,256
chr1,226602488,226602948,SRX5075176,SMARCA4,460
chr1,226602520,226603063,SRX5075170,SMARCA4,543
chr1,226602547,226602893,SRX5716470,SMARCA4,346
chr1,226602600,226602865,SRX5075169,SMARCA4,265
chr1,226602644,226602908,SRX5716468,SMARCA2,264
chr1,226602699,226602917,SRX5716469,SMARCA4,218
chr1,226602747,226602982,SRX5075175,SMARCA4,235
chr1,226603134,226603507,SRX5075170,SMARCA4,373
chr1,226603161,226603599,SRX5075176,SMARCA4,438
chr1,226608676,226609174,SRX16500060,CTCF,498
chr1,226608690,226609003,SRX5075174,SMARCA4,313
chr1,226608702,226609147,SRX16500061,CTCF,445
chr1,226608704,226609204,SRX16500059,CTCF,500
chr1,226608714,226609130,SRX16500062,CTCF,416
chr1,226608787,226609039,SRX5075168,SMARCA4,252
chr1,226626382,226626874,SRX16500061,CTCF,492
chr1,226626396,226626863,SRX16500062,CTCF,467
chr1,226626407,226626896,SRX16500059,CTCF,489
chr1,226626411,226626880,SRX16500060,CTCF,469
chr1,226626478,226626775,SRX5075175,SMARCA4,297
chr1,226626478,226626843,SRX5075168,SMARCA4,365
chr1,226626489,226626744,SRX4174629,CTCF,255
chr1,226626534,226626835,SRX5075174,SMARCA4,301
chr1,226626540,226626839,SRX5075176,SMARCA4,299
chr1,226626553,226626819,SRX5716470,SMARCA4,266
chr1,226626563,226626866,SRX20140895,INTS13,303
chr1,226626576,226626804,SRX5075169,SMARCA4,228
chr1,226626594,226626850,SRX5075170,SMARCA4,256
chr1,226634031,226634539,SRX16500061,CTCF,508
chr1,226634064,226634541,SRX16500062,CTCF,477
chr1,226634076,226634626,SRX16500060,CTCF,550
chr1,226634085,226634549,SRX16500059,CTCF,464
chr1,226634137,226634491,SRX4174629,CTCF,354
chr1,226634188,226634448,SRX5075174,SMARCA4,260
chr1,226634222,226634411,SRX5075175,SMARCA4,189
chr1,226634239,226634459,SRX5075168,SMARCA4,220
chr1,226634272,226634447,SRX5075176,SMARCA4,175
chr1,226643200,226643467,SRX5075170,SMARCA4,267
chr1,226643202,226643502,SRX5075169,SMARCA4,300
chr1,226643209,226643436,SRX5075175,SMARCA4,227
chr1,226643218,226643462,SRX5054309,FOSL2,244
chr1,226643303,226643497,SRX5075176,SMARCA4,194
chr1,226653941,226654442,SRX5075168,SMARCA4,501
chr1,226653947,226654515,SRX5075174,SMARCA4,568
chr1,226654001,226654308,SRX5716470,SMARCA4,307
chr1,226654025,226654285,SRX5054309,FOSL2,260
chr1,226654047,226654329,SRX5020211,SMARCA2,282
chr1,226654049,226654328,SRX5716463,SMARCA4,279
chr1,226654126,226654326,SRX5075175,SMARCA4,200
chr1,226656909,226657138,SRX5716470,SMARCA4,229
chr1,226656947,226657394,SRX5075176,SMARCA4,447
chr1,226656955,226657279,SRX5716467,SMARCA2,324
chr1,226656967,226657342,SRX5075170,SMARCA4,375
chr1,226656978,226657312,SRX5075169,SMARCA4,334
chr1,226657009,226657308,SRX5075175,SMARCA4,299
chr1,226662654,226663251,SRX5075176,SMARCA4,597
chr1,226662688,226662996,SRX5716469,SMARCA4,308
chr1,226662703,226663188,SRX5075169,SMARCA4,485
chr1,226662714,226663174,SRX5075170,SMARCA4,460
chr1,226662718,226663178,SRX5054309,FOSL2,460
chr1,226662719,226663086,SRX5075174,SMARCA4,367
chr1,226662722,226662988,SRX5020211,SMARCA2,266
chr1,226662723,226663214,SRX5054308,FOSL2,491
chr1,226662750,226663186,SRX5075175,SMARCA4,436
chr1,226662751,226663135,SRX5075168,SMARCA4,384
chr1,226662802,226663046,SRX5054307,FOSL2,244
chr1,226662809,226663035,SRX5020214,SMARCA2,226
chr1,226662843,226663185,SRX5716470,SMARCA4,342
chr1,226664403,226665020,SRX5075176,SMARCA4,617
chr1,226664451,226664977,SRX5075170,SMARCA4,526
chr1,226664470,226664890,SRX5716470,SMARCA4,420
chr1,226664495,226664945,SRX5075169,SMARCA4,450
chr1,226664497,226664975,SRX5075175,SMARCA4,478
chr1,226664510,226664857,SRX5716469,SMARCA4,347
chr1,226664581,226664955,SRX5716467,SMARCA2,374
chr1,226664589,226664896,SRX5716468,SMARCA2,307
chr1,226664620,226664851,SRX5075181,SMARCA2,231
chr1,226677047,226677352,SRX5075170,SMARCA4,305
chr1,226677121,226677348,SRX5075169,SMARCA4,227
chr1,226677175,226677389,SRX5075176,SMARCA4,214
chr1,226679942,226680504,SRX5075168,SMARCA4,562
chr1,226679984,226680621,SRX5716463,SMARCA4,637
chr1,226679995,226680448,SRX20140895,INTS13,453
chr1,226680012,226680559,SRX5075174,SMARCA4,547
chr1,226680035,226680403,SRX20140897,INTS13,368
chr1,226680045,226680546,SRX5716470,SMARCA4,501
chr1,226680051,226680578,SRX5075169,SMARCA4,527
chr1,226680054,226680554,SRX5716464,SMARCA4,500
chr1,226680071,226680574,SRX5075170,SMARCA4,503
chr1,226680085,226680629,SRX5075176,SMARCA4,544
chr1,226680143,226680570,SRX20140867,INTS10,427
chr1,226680152,226680557,SRX5716469,SMARCA4,405
chr1,226680153,226680404,SRX5716468,SMARCA2,251
chr1,226680182,226680509,SRX5075175,SMARCA4,327
chr1,226680190,226680424,SRX5054309,FOSL2,234
chr1,226680192,226680502,SRX20140881,CPSF3L,310
chr1,226680229,226680503,SRX5075182,SMARCA2,274
chr1,226680235,226680450,SRX5716467,SMARCA2,215
chr1,226688913,226689290,SRX5075176,SMARCA4,377
chr1,226688916,226689191,SRX5075170,SMARCA4,275
chr1,226688927,226689143,SRX5716467,SMARCA2,216
chr1,226697106,226697435,SRX5075169,SMARCA4,329
chr1,226697143,226697531,SRX5075170,SMARCA4,388
chr1,226697153,226697393,SRX5716470,SMARCA4,240
chr1,226697155,226697375,SRX5075175,SMARCA4,220
chr1,226697160,226697634,SRX5075176,SMARCA4,474
chr1,226697165,226697448,SRX5054309,FOSL2,283
chr1,226697204,226697385,SRX5054308,FOSL2,181
chr1,226703161,226703718,SRX5075176,SMARCA4,557
chr1,226703215,226703800,SRX5716470,SMARCA4,585
chr1,226703278,226703696,SRX5075170,SMARCA4,418
chr1,226703303,226703904,SRX20140895,INTS13,601
chr1,226703317,226703754,SRX5075174,SMARCA4,437
chr1,226703323,226703759,SRX5075168,SMARCA4,436
chr1,226703330,226703789,SRX5075169,SMARCA4,459
chr1,226703357,226703826,SRX20140868,INTS10,469
chr1,226703366,226703745,SRX5075175,SMARCA4,379
chr1,226703425,226703754,SRX20140897,INTS13,329
chr1,226703500,226703729,SRX5716469,SMARCA4,229
chr1,226708407,226708755,SRX5075176,SMARCA4,348
chr1,226708544,226708772,SRX5054308,FOSL2,228
chr1,226711205,226711642,SRX16500061,CTCF,437
chr1,226711232,226711655,SRX16500059,CTCF,423
chr1,226711268,226711652,SRX16500060,CTCF,384
chr1,226711269,226711590,SRX16500062,CTCF,321
chr1,226723553,226724033,SRX5075174,SMARCA4,480
chr1,226723576,226724057,SRX5075170,SMARCA4,481
chr1,226723584,226724070,SRX5075176,SMARCA4,486
chr1,226723604,226724038,SRX5716469,SMARCA4,434
chr1,226723611,226723980,SRX5075168,SMARCA4,369
chr1,226723631,226724039,SRX5716470,SMARCA4,408
chr1,226723637,226724030,SRX5075169,SMARCA4,393
chr1,226723666,226723996,SRX5716467,SMARCA2,330
chr1,226723676,226724086,SRX5075175,SMARCA4,410
chr1,226723685,226724002,SRX5716468,SMARCA2,317
chr1,226723691,226723916,SRX5020211,SMARCA2,225
chr1,226737271,226737444,SRX5075174,SMARCA4,173
chr1,226739390,226739606,SRX5075176,SMARCA4,216
chr1,226739395,226739630,SRX5716470,SMARCA4,235
chr1,226739397,226739689,SRX5075170,SMARCA4,292
chr1,226739510,226739701,SRX5075175,SMARCA4,191
chr1,226763886,226764279,SRX5075169,SMARCA4,393
chr1,226763912,226764340,SRX5075176,SMARCA4,428
chr1,226763917,226764323,SRX5075168,SMARCA4,406
chr1,226763918,226764328,SRX5054309,FOSL2,410
chr1,226763952,226764298,SRX5075175,SMARCA4,346
chr1,226763965,226764178,SRX5716469,SMARCA4,213
chr1,226763977,226764291,SRX5075174,SMARCA4,314
chr1,226763998,226764341,SRX5054308,FOSL2,343
chr1,226764006,226764300,SRX5075170,SMARCA4,294
chr1,226778584,226778868,SRX5716469,SMARCA4,284
chr1,226778599,226779046,SRX5075168,SMARCA4,447
chr1,226778612,226779057,SRX5075169,SMARCA4,445
chr1,226778622,226779014,SRX5054309,FOSL2,392
chr1,226778627,226779046,SRX5075174,SMARCA4,419
chr1,226778631,226779009,SRX5075170,SMARCA4,378
chr1,226778633,226779019,SRX5075176,SMARCA4,386
chr1,226778674,226779081,SRX5716470,SMARCA4,407
chr1,226778689,226779002,SRX5075175,SMARCA4,313
chr1,226778749,226779082,SRX5716463,SMARCA4,333
chr1,226778857,226779137,SRX5716459,Epitope tags,280
chr1,226784040,226784428,SRX5075174,SMARCA4,388
chr1,226784084,226784423,SRX5075168,SMARCA4,339
chr1,226784123,226784429,SRX5075170,SMARCA4,306
chr1,226784129,226784370,SRX5075176,SMARCA4,241
chr1,226784277,226784493,SRX5075175,SMARCA4,216
chr1,226810156,226810547,SRX20140867,INTS10,391
chr1,226810257,226810463,SRX5075170,SMARCA4,206
chr1,226810266,226810536,SRX5716470,SMARCA4,270
chr1,226810344,226810680,SRX5075168,SMARCA4,336
chr1,226810497,226810670,SRX5075174,SMARCA4,173
chr1,226814863,226815414,SRX5075176,SMARCA4,551
chr1,226814903,226815433,SRX5075170,SMARCA4,530
chr1,226814971,226815414,SRX5075169,SMARCA4,443
chr1,226814980,226815253,SRX5716469,SMARCA4,273
chr1,226815003,226815415,SRX5075175,SMARCA4,412
chr1,226815043,226815327,SRX5054308,FOSL2,284
chr1,226815086,226815301,SRX5054309,FOSL2,215
chr1,226815151,226815362,SRX5716470,SMARCA4,211
chr1,226821152,226822065,SRX5075170,SMARCA4,913
chr1,226821169,226821720,SRX5075169,SMARCA4,551
chr1,226821207,226822086,SRX5075176,SMARCA4,879
chr1,226821228,226821735,SRX5716469,SMARCA4,507
chr1,226821258,226821628,SRX5054308,FOSL2,370
chr1,226821261,226821626,SRX5716468,SMARCA2,365
chr1,226821292,226821628,SRX5020211,SMARCA2,336
chr1,226821292,226821634,SRX5054309,FOSL2,342
chr1,226821293,226821602,SRX5716467,SMARCA2,309
chr1,226821315,226821647,SRX5075175,SMARCA4,332
chr1,226821317,226821634,SRX5716470,SMARCA4,317
chr1,226821407,226821608,SRX5075168,SMARCA4,201
chr1,226821815,226822028,SRX5075175,SMARCA4,213
chr1,226821822,226822048,SRX5075169,SMARCA4,226
chr1,226827973,226828535,SRX16500059,CTCF,562
chr1,226827974,226828542,SRX16500062,CTCF,568
chr1,226827976,226828495,SRX16500061,CTCF,519
chr1,226827981,226828469,SRX5075176,SMARCA4,488
chr1,226827982,226828418,SRX5075169,SMARCA4,436
chr1,226827983,226828544,SRX16500060,CTCF,561
chr1,226827987,226828460,SRX4174629,CTCF,473
chr1,226827995,226828321,SRX5716469,SMARCA4,326
chr1,226828011,226828205,SRX5075181,SMARCA2,194
chr1,226828014,226828440,SRX5075168,SMARCA4,426
chr1,226828015,226828429,SRX5075175,SMARCA4,414
chr1,226828016,226828361,SRX5716470,SMARCA4,345
chr1,226828023,226828442,SRX5075170,SMARCA4,419
chr1,226828033,226828216,SRX5054309,FOSL2,183
chr1,226828071,226828353,SRX5716467,SMARCA2,282
chr1,226828079,226828374,SRX5075174,SMARCA4,295
chr1,226862959,226863256,SRX5054308,FOSL2,297
chr1,226862970,226863210,SRX5054309,FOSL2,240
chr1,226863012,226863183,SRX5075170,SMARCA4,171
chr1,226863019,226863228,SRX5075176,SMARCA4,209
chr1,226863561,226863765,SRX5075174,SMARCA4,204
chr1,226870399,226870579,SRX5075168,SMARCA4,180
chr1,226870424,226871084,SRX5075176,SMARCA4,660
chr1,226870425,226870613,SRX5075170,SMARCA4,188
chr1,226870433,226871158,SRX5075175,SMARCA4,725
chr1,226870435,226871215,SRX20140895,INTS13,780
chr1,226870524,226871024,SRX5075174,SMARCA4,500
chr1,226870579,226871030,SRX5075169,SMARCA4,451
chr1,226870663,226870931,SRX5075168,SMARCA4,268
chr1,226870667,226871035,SRX5075170,SMARCA4,368
chr1,226870706,226871048,SRX5716470,SMARCA4,342
chr1,226904039,226904335,SRX5075170,SMARCA4,296
chr1,226912721,226913002,SRX16500060,CTCF,281
chr1,226939021,226939249,SRX5075169,SMARCA4,228
chr1,226939030,226939290,SRX5075170,SMARCA4,260
chr1,226939073,226939266,SRX5054308,FOSL2,193
chr1,226939279,226939498,SRX5716469,SMARCA4,219
chr1,226939392,226939805,SRX5075169,SMARCA4,413
chr1,226939443,226939735,SRX5075176,SMARCA4,292
chr1,226939453,226940371,SRX20140895,INTS13,918
chr1,226939593,226939976,SRX5075175,SMARCA4,383
chr1,226939598,226940206,SRX20140868,INTS10,608
chr1,226939607,226940426,SRX5075168,SMARCA4,819
chr1,226939636,226939984,SRX20140869,INTS10,348
chr1,226939658,226940216,SRX20140897,INTS13,558
chr1,226939713,226940030,SRX20140896,INTS13,317
chr1,226939725,226940224,SRX20140867,INTS10,499
chr1,226939744,226939998,SRX20140879,CPSF3L,254
chr1,226939744,226940445,SRX5075174,SMARCA4,701
chr1,226940014,226940289,SRX5054307,FOSL2,275
chr1,226940037,226940330,SRX5716464,SMARCA4,293
chr1,226940073,226940265,SRX5054309,FOSL2,192
chr1,226940081,226940343,SRX5716463,SMARCA4,262
chr1,226940212,226940485,SRX5075176,SMARCA4,273
chr1,226975445,226975922,SRX20140895,INTS13,477
chr1,226975476,226975892,SRX5075174,SMARCA4,416
chr1,226975512,226975746,SRX5716451,SOX2,234
chr1,226975523,226975817,SRX5716454,SOX3,294
chr1,226975526,226975898,SRX5075168,SMARCA4,372
chr1,226975562,226975807,SRX5716463,SMARCA4,245
chr1,227058197,227058696,SRX5075169,SMARCA4,499
chr1,227058222,227058675,SRX5716470,SMARCA4,453
chr1,227058255,227058604,SRX5075175,SMARCA4,349
chr1,227058285,227058730,SRX5716469,SMARCA4,445
chr1,227058328,227058616,SRX5716467,SMARCA2,288
chr1,227058504,227058764,SRX5054308,FOSL2,260
chr1,227131327,227131562,SRX16500059,CTCF,235
chr1,227131342,227131563,SRX16500060,CTCF,221
chr1,227131354,227131597,SRX16500061,CTCF,243
chr1,227174177,227174390,SRX5054309,FOSL2,213
chr1,227174257,227174451,SRX5075175,SMARCA4,194
chr1,227174286,227174518,SRX5075169,SMARCA4,232
chr1,227192222,227192515,SRX5075176,SMARCA4,293
chr1,227192226,227192440,SRX5716469,SMARCA4,214
chr1,227192235,227192594,SRX5075170,SMARCA4,359
chr1,227192236,227192563,SRX5075169,SMARCA4,327
chr1,227192279,227192546,SRX5075175,SMARCA4,267
chr1,227192304,227192484,SRX5054308,FOSL2,180
chr1,227192329,227192512,SRX5054309,FOSL2,183
chr1,227225618,227225997,SRX5054309,FOSL2,379
chr1,227225690,227225987,SRX5075175,SMARCA4,297
chr1,227225718,227226088,SRX5075169,SMARCA4,370
chr1,227225734,227225983,SRX5075170,SMARCA4,249
chr1,227225745,227225927,SRX5054308,FOSL2,182
chr1,227225849,227226062,SRX5075176,SMARCA4,213
chr1,227234997,227235207,SRX16500062,CTCF,210
chr1,227235027,227235248,SRX16500060,CTCF,221
chr1,227235060,227235359,SRX16500061,CTCF,299
chr1,227299145,227299470,SRX5716470,SMARCA4,325
chr1,227299161,227299491,SRX5075176,SMARCA4,330
chr1,227299210,227299464,SRX5075170,SMARCA4,254
chr1,227299223,227299470,SRX5716469,SMARCA4,247
chr1,227299241,227299463,SRX5075169,SMARCA4,222
chr1,227317641,227317853,SRX16500062,CTCF,212
chr1,227317726,227317987,SRX20140895,INTS13,261
chr1,227318048,227318965,SRX20140895,INTS13,917
chr1,227318214,227318802,SRX20140867,INTS10,588
chr1,227318315,227318769,SRX5075170,SMARCA4,454
chr1,227318317,227318577,SRX20140897,INTS13,260
chr1,227318328,227318817,SRX20140868,INTS10,489
chr1,227318430,227318812,SRX5075174,SMARCA4,382
chr1,227318469,227318774,SRX5075175,SMARCA4,305
chr1,227318565,227318783,SRX5075169,SMARCA4,218
chr1,227318568,227318876,SRX5075176,SMARCA4,308
chr1,227318614,227318825,SRX5075168,SMARCA4,211
chr1,227319135,227319413,SRX5075174,SMARCA4,278
chr1,227343985,227344547,SRX5075170,SMARCA4,562
chr1,227344053,227344511,SRX5075169,SMARCA4,458
chr1,227344061,227344348,SRX5716469,SMARCA4,287
chr1,227344069,227344569,SRX5075176,SMARCA4,500
chr1,227344090,227344305,SRX5716467,SMARCA2,215
chr1,227344107,227344528,SRX5716470,SMARCA4,421
chr1,227344117,227344502,SRX5075174,SMARCA4,385
chr1,227344128,227344525,SRX5075175,SMARCA4,397
chr1,227344143,227344543,SRX5054309,FOSL2,400
chr1,227344204,227344533,SRX5054308,FOSL2,329
chr1,227351409,227351759,SRX5075170,SMARCA4,350
chr1,227351413,227351780,SRX5075176,SMARCA4,367
chr1,227351420,227351785,SRX5075169,SMARCA4,365
chr1,227351435,227351716,SRX5075175,SMARCA4,281
chr1,227351480,227351739,SRX5054308,FOSL2,259
chr1,227357120,227357830,SRX5075170,SMARCA4,710
chr1,227357122,227357804,SRX5054309,FOSL2,682
chr1,227357127,227357939,SRX5075176,SMARCA4,812
chr1,227357179,227357798,SRX5075169,SMARCA4,619
chr1,227357188,227357851,SRX5716469,SMARCA4,663
chr1,227357218,227357732,SRX5054308,FOSL2,514
chr1,227357242,227357817,SRX5075175,SMARCA4,575
chr1,227357296,227357739,SRX5716470,SMARCA4,443
chr1,227357324,227357692,SRX5075168,SMARCA4,368
chr1,227357354,227357739,SRX5075174,SMARCA4,385
chr1,227357439,227357705,SRX5716460,Epitope tags,266
chr1,227357450,227357805,SRX5716467,SMARCA2,355
chr1,227357504,227357750,SRX5020211,SMARCA2,246
chr1,227367297,227367629,SRX5075176,SMARCA4,332
chr1,227370486,227370778,SRX5075169,SMARCA4,292
chr1,227372685,227372892,SRX5075169,SMARCA4,207
chr1,227372704,227372919,SRX5075170,SMARCA4,215
chr1,227378839,227379279,SRX5075175,SMARCA4,440
chr1,227378844,227379367,SRX5075170,SMARCA4,523
chr1,227378862,227379267,SRX5075169,SMARCA4,405
chr1,227378880,227379297,SRX5054309,FOSL2,417
chr1,227378881,227379305,SRX5075176,SMARCA4,424
chr1,227378904,227379119,SRX5020214,SMARCA2,215
chr1,227378953,227379255,SRX5716469,SMARCA4,302
chr1,227378955,227379234,SRX5054308,FOSL2,279
chr1,227395462,227395769,SRX5054309,FOSL2,307
chr1,227395490,227395683,SRX5054308,FOSL2,193
chr1,227416177,227416450,SRX5054309,FOSL2,273
chr1,227416208,227416429,SRX5075175,SMARCA4,221
chr1,227428786,227429013,SRX5075175,SMARCA4,227
chr1,227428805,227428995,SRX5075176,SMARCA4,190
chr1,227428810,227429107,SRX5716470,SMARCA4,297
chr1,227428888,227429057,SRX5075170,SMARCA4,169
chr1,227429698,227429945,SRX5075169,SMARCA4,247
chr1,227429711,227430035,SRX5075170,SMARCA4,324
chr1,227429742,227430006,SRX5075176,SMARCA4,264
chr1,227431683,227432228,SRX5075174,SMARCA4,545
chr1,227431703,227432212,SRX5075168,SMARCA4,509
chr1,227431766,227432224,SRX5075170,SMARCA4,458
chr1,227431809,227432206,SRX5075175,SMARCA4,397
chr1,227431822,227432240,SRX5075176,SMARCA4,418
chr1,227431859,227432194,SRX5075169,SMARCA4,335
chr1,227431875,227432167,SRX5054308,FOSL2,292
chr1,227431905,227432158,SRX5054309,FOSL2,253
chr1,227437641,227437877,SRX4174629,CTCF,236
chr1,227437691,227438061,SRX16500059,CTCF,370
chr1,227437700,227438029,SRX16500060,CTCF,329
chr1,227437760,227438152,SRX16500061,CTCF,392
chr1,227449132,227449379,SRX16500062,CTCF,247
chr1,227481489,227481943,SRX16500059,CTCF,454
chr1,227481502,227481951,SRX16500060,CTCF,449
chr1,227481512,227481919,SRX16500061,CTCF,407
chr1,227481531,227481900,SRX16500062,CTCF,369
chr1,227481616,227481883,SRX5075168,SMARCA4,267
chr1,227481623,227481859,SRX4174629,CTCF,236
chr1,227481626,227481832,SRX5075170,SMARCA4,206
chr1,227481677,227481858,SRX5075174,SMARCA4,181
chr1,227542404,227542897,SRX20140895,INTS13,493
chr1,227542438,227542935,SRX5075168,SMARCA4,497
chr1,227542461,227542983,SRX16500059,CTCF,522
chr1,227542462,227542923,SRX16500062,CTCF,461
chr1,227542468,227542871,SRX5075175,SMARCA4,403
chr1,227542469,227542818,SRX5716470,SMARCA4,349
chr1,227542500,227542974,SRX5075174,SMARCA4,474
chr1,227542510,227542953,SRX16500060,CTCF,443
chr1,227542511,227542938,SRX16500061,CTCF,427
chr1,227542515,227542875,SRX5716469,SMARCA4,360
chr1,227542531,227542895,SRX5716463,SMARCA4,364
chr1,227542539,227542879,SRX5716464,SMARCA4,340
chr1,227542564,227542839,SRX5075169,SMARCA4,275
chr1,227542566,227542897,SRX5075170,SMARCA4,331
chr1,227542568,227542868,SRX5075176,SMARCA4,300
chr1,227542710,227542943,SRX4174629,CTCF,233
chr1,227563372,227564089,SRX5075168,SMARCA4,717
chr1,227563453,227563674,SRX5716463,SMARCA4,221
chr1,227563456,227564173,SRX20140895,INTS13,717
chr1,227563505,227564095,SRX20140868,INTS10,590
chr1,227563539,227564007,SRX20140867,INTS10,468
chr1,227563559,227564128,SRX20140897,INTS13,569
chr1,227563562,227564090,SRX5075174,SMARCA4,528
chr1,227563578,227564111,SRX5075170,SMARCA4,533
chr1,227563591,227564082,SRX20140869,INTS10,491
chr1,227563602,227564092,SRX5716470,SMARCA4,490
chr1,227563684,227564091,SRX5075175,SMARCA4,407
chr1,227563730,227563973,SRX5716469,SMARCA4,243
chr1,227563743,227564010,SRX20140879,CPSF3L,267
chr1,227563781,227564171,SRX5075176,SMARCA4,390
chr1,227728137,227728353,SRX5075176,SMARCA4,216
chr1,227730261,227730765,SRX16500060,CTCF,504
chr1,227730315,227730734,SRX16500059,CTCF,419
chr1,227730347,227730818,SRX16500061,CTCF,471
chr1,227730349,227730695,SRX16500062,CTCF,346
chr1,227730455,227730628,SRX5075174,SMARCA4,173
chr1,227734946,227735145,SRX5075169,SMARCA4,199
chr1,227734980,227735634,SRX20140895,INTS13,654
chr1,227734990,227735661,SRX5075174,SMARCA4,671
chr1,227735050,227735492,SRX20140867,INTS10,442
chr1,227735051,227735395,SRX20140897,INTS13,344
chr1,227735070,227735452,SRX20140868,INTS10,382
chr1,227735079,227735601,SRX5075170,SMARCA4,522
chr1,227735143,227735436,SRX20140869,INTS10,293
chr1,227735149,227735678,SRX5075176,SMARCA4,529
chr1,227735153,227735611,SRX5075168,SMARCA4,458
chr1,227735232,227735601,SRX5075169,SMARCA4,369
chr1,227759325,227759889,SRX5075176,SMARCA4,564
chr1,227759330,227759779,SRX5716459,Epitope tags,449
chr1,227759333,227759791,SRX5075170,SMARCA4,458
chr1,227759352,227759780,SRX5075169,SMARCA4,428
chr1,227759355,227759807,SRX5716470,SMARCA4,452
chr1,227759366,227759858,SRX5716469,SMARCA4,492
chr1,227759382,227759770,SRX5075175,SMARCA4,388
chr1,227759383,227759788,SRX5054309,FOSL2,405
chr1,227759396,227759759,SRX5054308,FOSL2,363
chr1,227759434,227759742,SRX5020211,SMARCA2,308
chr1,227759444,227759839,SRX5716467,SMARCA2,395
chr1,227759463,227759738,SRX5716468,SMARCA2,275
chr1,227759470,227759664,SRX5075181,SMARCA2,194
chr1,227759471,227759696,SRX5020214,SMARCA2,225
chr1,227759503,227759713,SRX5054307,FOSL2,210
chr1,227762308,227762862,SRX16500061,CTCF,554
chr1,227762320,227762880,SRX16500060,CTCF,560
chr1,227762363,227762931,SRX16500059,CTCF,568
chr1,227762398,227762827,SRX4174629,CTCF,429
chr1,227762398,227762881,SRX16500062,CTCF,483
chr1,227762512,227762795,SRX5075174,SMARCA4,283
chr1,227762518,227762797,SRX5075168,SMARCA4,279
chr1,227762541,227762778,SRX5716463,SMARCA4,237
chr1,227762602,227762821,SRX5075175,SMARCA4,219
chr1,227774952,227775500,SRX5075175,SMARCA4,548
chr1,227774967,227775569,SRX5075169,SMARCA4,602
chr1,227774989,227775484,SRX5075176,SMARCA4,495
chr1,227775025,227775467,SRX5075170,SMARCA4,442
chr1,227775030,227775496,SRX5716469,SMARCA4,466
chr1,227775036,227775449,SRX5716470,SMARCA4,413
chr1,227775089,227775284,SRX5075181,SMARCA2,195
chr1,227775103,227775433,SRX5054308,FOSL2,330
chr1,227775121,227775393,SRX5716467,SMARCA2,272
chr1,227775142,227775393,SRX5716468,SMARCA2,251
chr1,227775181,227775484,SRX5054309,FOSL2,303
chr1,227776268,227776912,SRX5075168,SMARCA4,644
chr1,227776326,227776688,SRX5054308,FOSL2,362
chr1,227776346,227777001,SRX5075174,SMARCA4,655
chr1,227776349,227776609,SRX5054309,FOSL2,260
chr1,227776373,227776872,SRX5075170,SMARCA4,499
chr1,227776402,227776813,SRX5075175,SMARCA4,411
chr1,227776423,227776856,SRX5075176,SMARCA4,433
chr1,227776453,227776920,SRX5075169,SMARCA4,467
chr1,227776488,227776839,SRX20140867,INTS10,351
chr1,227776496,227776781,SRX20140897,INTS13,285
chr1,227776503,227776908,SRX20140869,INTS10,405
chr1,227776516,227776787,SRX20140896,INTS13,271
chr1,227776520,227776925,SRX20140881,CPSF3L,405
chr1,227776527,227776835,SRX5716470,SMARCA4,308
chr1,227776546,227776820,SRX5020214,SMARCA2,274
chr1,227776546,227776951,SRX5716463,SMARCA4,405
chr1,227776596,227776839,SRX5716469,SMARCA4,243
chr1,227776632,227776837,SRX5716464,SMARCA4,205
chr1,227787814,227788108,SRX20140895,INTS13,294
chr1,227787833,227788146,SRX5075168,SMARCA4,313
chr1,227787855,227788050,SRX5075174,SMARCA4,195
chr1,227788023,227788283,SRX5054307,FOSL2,260
chr1,227793839,227794322,SRX5075176,SMARCA4,483
chr1,227793858,227794265,SRX5075175,SMARCA4,407
chr1,227793868,227794316,SRX5075169,SMARCA4,448
chr1,227793879,227794266,SRX5075170,SMARCA4,387
chr1,227793911,227794204,SRX5716470,SMARCA4,293
chr1,227793923,227794188,SRX5716469,SMARCA4,265
chr1,227793952,227794194,SRX5716467,SMARCA2,242
chr1,227793965,227794145,SRX5054308,FOSL2,180
chr1,227793969,227794195,SRX5054309,FOSL2,226
chr1,227793985,227794191,SRX5020211,SMARCA2,206
chr1,227805704,227805948,SRX5075170,SMARCA4,244
chr1,227805719,227806084,SRX5075169,SMARCA4,365
chr1,227805720,227806142,SRX5075176,SMARCA4,422
chr1,227805727,227805969,SRX5716469,SMARCA4,242
chr1,227885820,227886047,SRX5054309,FOSL2,227
chr1,227886812,227887383,SRX5075170,SMARCA4,571
chr1,227886862,227887340,SRX5075176,SMARCA4,478
chr1,227886885,227887200,SRX5716469,SMARCA4,315
chr1,227886894,227887233,SRX5716468,SMARCA2,339
chr1,227886896,227887333,SRX5075169,SMARCA4,437
chr1,227886903,227887362,SRX5716470,SMARCA4,459
chr1,227886930,227887336,SRX5075175,SMARCA4,406
chr1,227886990,227887192,SRX5020211,SMARCA2,202
chr1,227886995,227887282,SRX5716467,SMARCA2,287
chr1,227887030,227887210,SRX5054308,FOSL2,180
chr1,227887118,227887309,SRX5075174,SMARCA4,191
chr1,227896015,227896416,SRX5075176,SMARCA4,401
chr1,227910675,227910890,SRX5075176,SMARCA4,215
chr1,227914283,227914717,SRX5075170,SMARCA4,434
chr1,227914447,227914759,SRX16500059,CTCF,312
chr1,227914464,227914687,SRX5716469,SMARCA4,223
chr1,227914492,227914667,SRX5075176,SMARCA4,175
chr1,227914552,227914830,SRX16500061,CTCF,278
chr1,227934422,227934591,SRX5075170,SMARCA4,169
chr1,227934698,227935283,SRX5054309,FOSL2,585
chr1,227934708,227935191,SRX5054308,FOSL2,483
chr1,227934890,227935190,SRX5075175,SMARCA4,300
chr1,227934945,227935152,SRX5075169,SMARCA4,207
chr1,227946343,227946535,SRX5054308,FOSL2,192
chr1,227946502,227947104,SRX16500059,CTCF,602
chr1,227946521,227947083,SRX16500060,CTCF,562
chr1,227946542,227947024,SRX16500061,CTCF,482
chr1,227946563,227946983,SRX16500062,CTCF,420
chr1,227946623,227946803,SRX5075170,SMARCA4,180
chr1,227946649,227946931,SRX5075174,SMARCA4,282
chr1,227947632,227948278,SRX20140895,INTS13,646
chr1,227947767,227948096,SRX20140896,INTS13,329
chr1,227947767,227948156,SRX20140867,INTS10,389
chr1,227948018,227948187,SRX5075170,SMARCA4,169
chr1,227953631,227953849,SRX5075175,SMARCA4,218
chr1,227953631,227953908,SRX5716469,SMARCA4,277
chr1,227953674,227953885,SRX5716470,SMARCA4,211
chr1,227953690,227953874,SRX5054309,FOSL2,184
chr1,227953954,227954275,SRX16500060,CTCF,321
chr1,227953960,227954191,SRX5075174,SMARCA4,231
chr1,227953996,227954221,SRX16500062,CTCF,225
chr1,227999281,227999761,SRX16500060,CTCF,480
chr1,227999298,227999766,SRX16500061,CTCF,468
chr1,227999316,227999748,SRX16500059,CTCF,432
chr1,227999329,227999751,SRX16500062,CTCF,422
chr1,227999351,227999735,SRX4174629,CTCF,384
chr1,227999422,227999667,SRX5075168,SMARCA4,245
chr1,227999461,227999677,SRX5075174,SMARCA4,216
chr1,228004287,228004592,SRX16500060,CTCF,305
chr1,228004290,228004689,SRX16500059,CTCF,399
chr1,228004327,228004718,SRX16500062,CTCF,391
chr1,228037427,228038365,SRX20140895,INTS13,938
chr1,228037530,228038315,SRX5075174,SMARCA4,785
chr1,228037575,228038267,SRX20140868,INTS10,692
chr1,228037609,228038082,SRX20140879,CPSF3L,473
chr1,228037632,228038330,SRX20140867,INTS10,698
chr1,228037644,228038089,SRX5716463,SMARCA4,445
chr1,228037653,228038180,SRX20140881,CPSF3L,527
chr1,228037684,228038056,SRX20140880,CPSF3L,372
chr1,228037690,228038247,SRX5075168,SMARCA4,557
chr1,228037719,228038014,SRX5716464,SMARCA4,295
chr1,228037791,228038122,SRX20140861,SOX2,331
chr1,228038107,228038359,SRX16500060,CTCF,252
chr1,228060922,228061138,SRX5054309,FOSL2,216
chr1,228073786,228074122,SRX20140881,CPSF3L,336
chr1,228073870,228074152,SRX4174629,CTCF,282
chr1,228082317,228082688,SRX16500060,CTCF,371
chr1,228082335,228082818,SRX5075174,SMARCA4,483
chr1,228082345,228082652,SRX16500062,CTCF,307
chr1,228082405,228082810,SRX5075168,SMARCA4,405
chr1,228082502,228082758,SRX5716463,SMARCA4,256
chr1,228082511,228082702,SRX5054307,FOSL2,191
chr1,228082514,228082784,SRX5054309,FOSL2,270
chr1,228082521,228082930,SRX20140895,INTS13,409
chr1,228082527,228082713,SRX5075176,SMARCA4,186
chr1,228082532,228082739,SRX5716464,SMARCA4,207
chr1,228082539,228082776,SRX5075170,SMARCA4,237
chr1,228082552,228082741,SRX5054308,FOSL2,189
chr1,228082681,228082938,SRX20140867,INTS10,257
chr1,228082785,228083130,SRX20140869,INTS10,345
chr1,228087874,228088049,SRX5075176,SMARCA4,175
chr1,228087915,228088097,SRX5075170,SMARCA4,182
chr1,228102343,228102567,SRX16500060,CTCF,224
chr1,228102942,228103637,SRX20140895,INTS13,695
chr1,228103019,228103638,SRX20140868,INTS10,619
chr1,228103036,228103438,SRX20140869,INTS10,402
chr1,228103088,228103478,SRX20140867,INTS10,390
chr1,228103134,228103626,SRX5075168,SMARCA4,492
chr1,228103219,228103593,SRX5716463,SMARCA4,374
chr1,228103273,228103620,SRX5075174,SMARCA4,347
chr1,228103279,228103546,SRX5075170,SMARCA4,267
chr1,228103550,228103785,SRX20140879,CPSF3L,235
chr1,228109101,228109777,SRX20140895,INTS13,676
chr1,228109109,228109649,SRX5075174,SMARCA4,540
chr1,228109125,228109521,SRX20140867,INTS10,396
chr1,228109175,228109603,SRX5075176,SMARCA4,428
chr1,228109185,228109680,SRX5075168,SMARCA4,495
chr1,228109208,228109562,SRX20140869,INTS10,354
chr1,228109227,228109822,SRX5075170,SMARCA4,595
chr1,228109229,228109583,SRX5716463,SMARCA4,354
chr1,228109240,228109513,SRX20140868,INTS10,273
chr1,228109241,228109479,SRX5075175,SMARCA4,238
chr1,228109246,228109499,SRX5054307,FOSL2,253
chr1,228109253,228109477,SRX5054308,FOSL2,224
chr1,228109261,228109834,SRX5075169,SMARCA4,573
chr1,228109262,228109701,SRX20140879,CPSF3L,439
chr1,228109388,228109593,SRX5716464,SMARCA4,205
chr1,228109394,228109682,SRX20140897,INTS13,288
chr1,228130869,228131416,SRX16500059,CTCF,547
chr1,228130910,228131391,SRX16500060,CTCF,481
chr1,228130917,228131363,SRX16500062,CTCF,446
chr1,228130955,228131378,SRX16500061,CTCF,423
chr1,228130984,228131290,SRX5716470,SMARCA4,306
chr1,228130989,228131359,SRX5075168,SMARCA4,370
chr1,228131003,228131328,SRX4174629,CTCF,325
chr1,228131004,228131354,SRX5075174,SMARCA4,350
chr1,228131014,228131312,SRX5075175,SMARCA4,298
chr1,228131034,228131272,SRX5075169,SMARCA4,238
chr1,228131044,228131296,SRX5075176,SMARCA4,252
chr1,228131073,228131297,SRX5075170,SMARCA4,224
chr1,228131080,228131284,SRX5716463,SMARCA4,204
chr1,228131120,228131387,SRX5716469,SMARCA4,267
chr1,228139642,228139872,SRX5716469,SMARCA4,230
chr1,228139725,228140562,SRX5075174,SMARCA4,837
chr1,228139761,228140467,SRX5075170,SMARCA4,706
chr1,228139792,228140464,SRX5075168,SMARCA4,672
chr1,228139824,228140205,SRX5716463,SMARCA4,381
chr1,228139838,228140156,SRX5716451,SOX2,318
chr1,228139840,228140224,SRX5054309,FOSL2,384
chr1,228139874,228140239,SRX16500061,CTCF,365
chr1,228139897,228140171,SRX16500059,CTCF,274
chr1,228139908,228140587,SRX20140895,INTS13,679
chr1,228139916,228140135,SRX5716464,SMARCA4,219
chr1,228139940,228140254,SRX5054307,FOSL2,314
chr1,228139942,228140473,SRX5075176,SMARCA4,531
chr1,228139946,228140225,SRX16500060,CTCF,279
chr1,228139947,228140492,SRX20140867,INTS10,545
chr1,228139954,228140274,SRX5054308,FOSL2,320
chr1,228139961,228140198,SRX5716470,SMARCA4,237
chr1,228139965,228140467,SRX20140868,INTS10,502
chr1,228140029,228140512,SRX20140881,CPSF3L,483
chr1,228140065,228140538,SRX20140869,INTS10,473
chr1,228140099,228140511,SRX20140897,INTS13,412
chr1,228140108,228140409,SRX5075169,SMARCA4,301
chr1,228150635,228151064,SRX5075170,SMARCA4,429
chr1,228150689,228151057,SRX5075176,SMARCA4,368
chr1,228165205,228165951,SRX5075168,SMARCA4,746
chr1,228165314,228165900,SRX5075170,SMARCA4,586
chr1,228165337,228166291,SRX5075174,SMARCA4,954
chr1,228165406,228165937,SRX5716464,SMARCA4,531
chr1,228165485,228165702,SRX5054307,FOSL2,217
chr1,228165522,228166006,SRX16500059,CTCF,484
chr1,228165534,228165936,SRX5716470,SMARCA4,402
chr1,228165534,228166009,SRX5716463,SMARCA4,475
chr1,228165543,228166241,SRX5075176,SMARCA4,698
chr1,228165549,228166046,SRX16500062,CTCF,497
chr1,228165555,228165944,SRX5716469,SMARCA4,389
chr1,228165556,228166095,SRX16500060,CTCF,539
chr1,228165565,228166226,SRX20140895,INTS13,661
chr1,228165574,228165843,SRX4174629,CTCF,269
chr1,228165586,228165994,SRX16500061,CTCF,408
chr1,228165597,228165912,SRX5075175,SMARCA4,315
chr1,228165608,228165822,SRX5716454,SOX3,214
chr1,228165625,228165953,SRX5075169,SMARCA4,328
chr1,228165625,228166187,SRX20140867,INTS10,562
chr1,228165635,228166184,SRX20140868,INTS10,549
chr1,228165655,228166077,SRX20140896,INTS13,422
chr1,228165705,228166289,SRX20140897,INTS13,584
chr1,228165717,228166095,SRX20140879,CPSF3L,378
chr1,228165729,228166004,SRX20140882,CPSF3L,275
chr1,228165738,228166125,SRX20140869,INTS10,387
chr1,228165755,228166220,SRX20140881,CPSF3L,465
chr1,228165793,228166065,SRX20140894,INTS13,272
chr1,228166025,228166298,SRX5075168,SMARCA4,273
chr1,228166034,228166279,SRX5075170,SMARCA4,245
chr1,228166140,228166350,SRX5075169,SMARCA4,210
chr1,228180333,228180554,SRX16500061,CTCF,221
chr1,228180340,228180554,SRX16500062,CTCF,214
chr1,228180358,228180649,SRX16500060,CTCF,291
chr1,228194431,228194723,SRX5075168,SMARCA4,292
chr1,228194474,228194748,SRX5716464,SMARCA4,274
chr1,228194486,228194743,SRX5716463,SMARCA4,257
chr1,228194507,228194715,SRX5075174,SMARCA4,208
chr1,228213315,228213769,SRX16500061,CTCF,454
chr1,228213328,228213784,SRX16500059,CTCF,456
chr1,228213399,228213793,SRX16500062,CTCF,394
chr1,228213466,228213776,SRX5075174,SMARCA4,310
chr1,228213469,228213779,SRX16500060,CTCF,310
chr1,228213472,228213702,SRX4174629,CTCF,230
chr1,228213484,228213705,SRX5075168,SMARCA4,221
chr1,228218042,228218222,SRX5075176,SMARCA4,180
chr1,228228785,228229079,SRX5054309,FOSL2,294
chr1,228236855,228237098,SRX16500060,CTCF,243
chr1,228275541,228275884,SRX20140895,INTS13,343
chr1,228275544,228275719,SRX5075176,SMARCA4,175
chr1,228275546,228275723,SRX5075174,SMARCA4,177
chr1,228275678,228276114,SRX5075168,SMARCA4,436
chr1,228275831,228276075,SRX5075169,SMARCA4,244
chr1,228275870,228276116,SRX5075176,SMARCA4,246
chr1,228275878,228276268,SRX5075170,SMARCA4,390
chr1,228275924,228276280,SRX5075174,SMARCA4,356
chr1,228378537,228378915,SRX20140895,INTS13,378
chr1,228378568,228379052,SRX16500059,CTCF,484
chr1,228378571,228379060,SRX16500060,CTCF,489
chr1,228378589,228378998,SRX5075174,SMARCA4,409
chr1,228378589,228379182,SRX16500062,CTCF,593
chr1,228378611,228378907,SRX4174629,CTCF,296
chr1,228378611,228379068,SRX16500061,CTCF,457
chr1,228378638,228378866,SRX5075176,SMARCA4,228
chr1,228378702,228378927,SRX5075169,SMARCA4,225
chr1,228378710,228379113,SRX5075168,SMARCA4,403
chr1,228392222,228392435,SRX5054308,FOSL2,213
chr1,228406614,228407404,SRX20140895,INTS13,790
chr1,228406694,228406939,SRX5075176,SMARCA4,245
chr1,228406749,228407061,SRX20140897,INTS13,312
chr1,228406845,228407076,SRX5075168,SMARCA4,231
chr1,228407213,228407402,SRX5075174,SMARCA4,189
chr1,228416164,228416674,SRX16500059,CTCF,510
chr1,228416181,228416591,SRX16500060,CTCF,410
chr1,228416185,228416606,SRX16500061,CTCF,421
chr1,228416216,228416395,SRX5075168,SMARCA4,179
chr1,228416238,228416602,SRX16500062,CTCF,364
chr1,228416267,228416480,SRX5075175,SMARCA4,213
chr1,228416368,228416579,SRX5716470,SMARCA4,211
chr1,228445651,228446128,SRX5075174,SMARCA4,477
chr1,228445671,228446334,SRX5075168,SMARCA4,663
chr1,228445686,228446376,SRX20140895,INTS13,690
chr1,228457280,228458353,SRX20140895,INTS13,1073
chr1,228457332,228458281,SRX20140868,INTS10,949
chr1,228457394,228458467,SRX20140867,INTS10,1073
chr1,228457426,228457912,SRX5075174,SMARCA4,486
chr1,228457434,228458237,SRX20140897,INTS13,803
chr1,228457460,228457883,SRX5075168,SMARCA4,423
chr1,228457477,228458049,SRX20140879,CPSF3L,572
chr1,228457495,228458322,SRX20140881,CPSF3L,827
chr1,228457615,228457907,SRX20140894,INTS13,292
chr1,228457615,228457916,SRX20140869,INTS10,301
chr1,228457650,228457853,SRX5075176,SMARCA4,203
chr1,228457653,228458032,SRX20140896,INTS13,379
chr1,228457671,228457880,SRX5075175,SMARCA4,209
chr1,228459078,228459572,SRX16500060,CTCF,494
chr1,228459106,228459554,SRX16500059,CTCF,448
chr1,228459132,228459577,SRX16500061,CTCF,445
chr1,228459162,228459591,SRX16500062,CTCF,429
chr1,228459309,228459537,SRX5075176,SMARCA4,228
chr1,228459322,228459496,SRX5075174,SMARCA4,174
chr1,228464398,228464712,SRX20140895,INTS13,314
chr1,228464564,228464767,SRX5075168,SMARCA4,203
chr1,228471807,228472120,SRX16500060,CTCF,313
chr1,228472679,228473047,SRX5075169,SMARCA4,368
chr1,228472683,228473041,SRX5075175,SMARCA4,358
chr1,228472702,228473037,SRX5075176,SMARCA4,335
chr1,228472724,228473016,SRX5054309,FOSL2,292
chr1,228472738,228473067,SRX5075170,SMARCA4,329
chr1,228472756,228473041,SRX5054308,FOSL2,285
chr1,228483013,228483059,SRX1424891,POU3F2,46
chr1,228483014,228483060,SRX1424892,POU3F2,46
chr1,228483016,228483057,SRX1424893,POU3F2,41
chr1,228485078,228485258,SRX5054308,FOSL2,180
chr1,228485114,228485331,SRX5054309,FOSL2,217
chr1,228486528,228487648,SRX20140895,INTS13,1120
chr1,228486587,228486798,SRX5075176,SMARCA4,211
chr1,228486599,228486770,SRX5075170,SMARCA4,171
chr1,228486657,228486855,SRX5075174,SMARCA4,198
chr1,228486687,228487162,SRX20140868,INTS10,475
chr1,228486841,228487074,SRX5075170,SMARCA4,233
chr1,228487000,228487559,SRX5075168,SMARCA4,559
chr1,228487149,228487337,SRX5075174,SMARCA4,188
chr1,228500845,228501364,SRX16500059,CTCF,519
chr1,228500849,228501313,SRX16500061,CTCF,464
chr1,228500889,228501380,SRX16500060,CTCF,491
chr1,228500891,228501368,SRX16500062,CTCF,477
chr1,228500927,228501314,SRX5075168,SMARCA4,387
chr1,228500940,228501303,SRX5075174,SMARCA4,363
chr1,228500962,228501352,SRX5075170,SMARCA4,390
chr1,228500965,228501302,SRX5075176,SMARCA4,337
chr1,228500978,228501313,SRX5716469,SMARCA4,335
chr1,228500980,228501306,SRX5075169,SMARCA4,326
chr1,228501004,228501220,SRX5054308,FOSL2,216
chr1,228501019,228501385,SRX5075175,SMARCA4,366
chr1,228501060,228501303,SRX5716470,SMARCA4,243
chr1,228515153,228515656,SRX16500060,CTCF,503
chr1,228515161,228515637,SRX16500061,CTCF,476
chr1,228515187,228515719,SRX16500059,CTCF,532
chr1,228515198,228515650,SRX16500062,CTCF,452
chr1,228515353,228515785,SRX4174629,CTCF,432
chr1,228556647,228556817,SRX5075170,SMARCA4,170
chr1,228557136,228557311,SRX5075176,SMARCA4,175
chr1,228557722,228558011,SRX16500059,CTCF,289
chr1,228557724,228557992,SRX16500060,CTCF,268
chr1,228557736,228558148,SRX16500061,CTCF,412
chr1,228610325,228610649,SRX20140870,INTS10,324
chr1,228612563,228612828,SRX20140868,INTS10,265
chr1,228646002,228646246,SRX20140867,INTS10,244
chr1,228646007,228646419,SRX20140870,INTS10,412
chr1,228664288,228664814,SRX16500061,CTCF,526
chr1,228664319,228664843,SRX16500059,CTCF,524
chr1,228664323,228664835,SRX16500060,CTCF,512
chr1,228664378,228664771,SRX16500062,CTCF,393
chr1,228664409,228664673,SRX5075174,SMARCA4,264
chr1,228664500,228664791,SRX4174629,CTCF,291
chr1,228664501,228664680,SRX5075168,SMARCA4,179
chr1,228664504,228664673,SRX5075170,SMARCA4,169
chr1,228692008,228692283,SRX16500059,CTCF,275
chr1,228692024,228692329,SRX16500060,CTCF,305
chr1,228692031,228692251,SRX16500062,CTCF,220
chr1,228697409,228697603,SRX5075170,SMARCA4,194
chr1,228734970,228735646,SRX16500062,CTCF,676
chr1,228734988,228735561,SRX16500061,CTCF,573
chr1,228734996,228735656,SRX16500060,CTCF,660
chr1,228735003,228735565,SRX5075174,SMARCA4,562
chr1,228735060,228735598,SRX16500059,CTCF,538
chr1,228735064,228735539,SRX5075169,SMARCA4,475
chr1,228735079,228735564,SRX5075170,SMARCA4,485
chr1,228735099,228735819,SRX20140895,INTS13,720
chr1,228735103,228735675,SRX20140868,INTS10,572
chr1,228735123,228735521,SRX5716469,SMARCA4,398
chr1,228735135,228735599,SRX5075168,SMARCA4,464
chr1,228735139,228735699,SRX5075175,SMARCA4,560
chr1,228735163,228735338,SRX5075176,SMARCA4,175
chr1,228735218,228735483,SRX5716463,SMARCA4,265
chr1,228753904,228754291,SRX5075170,SMARCA4,387
chr1,228754139,228754323,SRX5075176,SMARCA4,184
chr1,228782893,228783166,SRX5054309,FOSL2,273
chr1,228782955,228783135,SRX5054308,FOSL2,180
chr1,228794095,228794551,SRX5075176,SMARCA4,456
chr1,228794110,228794577,SRX5075170,SMARCA4,467
chr1,228794138,228794540,SRX5054309,FOSL2,402
chr1,228794159,228794398,SRX5020214,SMARCA2,239
chr1,228794165,228794499,SRX5075175,SMARCA4,334
chr1,228794174,228794490,SRX5054308,FOSL2,316
chr1,228794201,228794515,SRX5020211,SMARCA2,314
chr1,228794205,228794481,SRX5075169,SMARCA4,276
chr1,228804862,228805499,SRX5075170,SMARCA4,637
chr1,228804896,228805485,SRX5075176,SMARCA4,589
chr1,228804959,228805285,SRX5075181,SMARCA2,326
chr1,228804967,228805383,SRX5075169,SMARCA4,416
chr1,228804977,228805474,SRX5716469,SMARCA4,497
chr1,228804980,228805434,SRX5716470,SMARCA4,454
chr1,228804983,228805371,SRX5054309,FOSL2,388
chr1,228804996,228805323,SRX5054308,FOSL2,327
chr1,228805003,228805356,SRX5075175,SMARCA4,353
chr1,228805004,228805406,SRX5716467,SMARCA2,402
chr1,228805015,228805287,SRX5020211,SMARCA2,272
chr1,228811270,228811490,SRX5075176,SMARCA4,220
chr1,228811271,228811514,SRX5716468,SMARCA2,243
chr1,228811306,228811593,SRX5075170,SMARCA4,287
chr1,228811321,228811577,SRX5716467,SMARCA2,256
chr1,228818462,228818717,SRX9989504,GFP,255
chr1,228831083,228831456,SRX5054309,FOSL2,373
chr1,228831090,228831384,SRX5716469,SMARCA4,294
chr1,228831107,228831460,SRX5075170,SMARCA4,353
chr1,228831117,228831457,SRX5075176,SMARCA4,340
chr1,228831118,228831462,SRX5075169,SMARCA4,344
chr1,228831144,228831464,SRX5054308,FOSL2,320
chr1,228831156,228831457,SRX5075175,SMARCA4,301
chr1,228834139,228834501,SRX5075176,SMARCA4,362
chr1,228834183,228834519,SRX5075175,SMARCA4,336
chr1,228834262,228834503,SRX5075169,SMARCA4,241
chr1,228834283,228834562,SRX5075170,SMARCA4,279
chr1,228838298,228838764,SRX5075174,SMARCA4,466
chr1,228838432,228838809,SRX5075168,SMARCA4,377
chr1,228838439,228838758,SRX5054309,FOSL2,319
chr1,228838453,228838752,SRX5054308,FOSL2,299
chr1,228838473,228838726,SRX5075169,SMARCA4,253
chr1,228838477,228838795,SRX5075170,SMARCA4,318
chr1,228838551,228838742,SRX5075176,SMARCA4,191
chr1,228838568,228838779,SRX5716470,SMARCA4,211
chr1,228842210,228842619,SRX5075174,SMARCA4,409
chr1,228842267,228842555,SRX5075176,SMARCA4,288
chr1,228842267,228842566,SRX5054309,FOSL2,299
chr1,228842273,228842603,SRX5075168,SMARCA4,330
chr1,228842275,228842514,SRX5054308,FOSL2,239
chr1,228842278,228842555,SRX5075170,SMARCA4,277
chr1,228842292,228842508,SRX5075169,SMARCA4,216
chr1,228842301,228842526,SRX5054307,FOSL2,225
chr1,228842307,228842572,SRX5075175,SMARCA4,265
chr1,228861101,228861513,SRX5075175,SMARCA4,412
chr1,228861172,228861522,SRX5075169,SMARCA4,350
chr1,228861184,228861579,SRX5054309,FOSL2,395
chr1,228861193,228861524,SRX5075170,SMARCA4,331
chr1,228861214,228861531,SRX5054308,FOSL2,317
chr1,228861229,228861541,SRX5075176,SMARCA4,312
chr1,228861254,228861553,SRX5020214,SMARCA2,299
chr1,228861267,228861519,SRX5075174,SMARCA4,252
chr1,228861280,228861514,SRX5716469,SMARCA4,234
chr1,228864659,228864837,SRX5075170,SMARCA4,178
chr1,228882253,228882761,SRX20140868,INTS10,508
chr1,228882286,228882820,SRX20140895,INTS13,534
chr1,228882291,228882925,SRX5075174,SMARCA4,634
chr1,228882342,228882849,SRX5075168,SMARCA4,507
chr1,228882373,228882754,SRX5716463,SMARCA4,381
chr1,228882377,228882821,SRX20140867,INTS10,444
chr1,228882489,228882727,SRX5716464,SMARCA4,238
chr1,228882497,228882777,SRX5716451,SOX2,280
chr1,228900484,228900699,SRX5075170,SMARCA4,215
chr1,228902938,228903437,SRX5075176,SMARCA4,499
chr1,228902945,228903460,SRX5075170,SMARCA4,515
chr1,228902953,228903468,SRX5075175,SMARCA4,515
chr1,228902976,228903478,SRX5075169,SMARCA4,502
chr1,228903023,228903439,SRX5716467,SMARCA2,416
chr1,228903027,228903515,SRX5716469,SMARCA4,488
chr1,228903034,228903440,SRX5054308,FOSL2,406
chr1,228903039,228903434,SRX5054309,FOSL2,395
chr1,228903061,228903408,SRX5020214,SMARCA2,347
chr1,228903086,228903422,SRX5716470,SMARCA4,336
chr1,228903098,228903453,SRX5020211,SMARCA2,355
chr1,228903110,228903378,SRX5716468,SMARCA2,268
chr1,228903138,228903332,SRX5075181,SMARCA2,194
chr1,228911175,228911532,SRX5075174,SMARCA4,357
chr1,228911281,228911486,SRX5075168,SMARCA4,205
chr1,228913769,228914153,SRX20140895,INTS13,384
chr1,228917759,228918054,SRX5054309,FOSL2,295
chr1,228917769,228918061,SRX5075170,SMARCA4,292
chr1,228917792,228918074,SRX5075169,SMARCA4,282
chr1,228917795,228918073,SRX5054308,FOSL2,278
chr1,228917810,228918024,SRX5716469,SMARCA4,214
chr1,228917829,228918146,SRX5075175,SMARCA4,317
chr1,228917832,228918056,SRX5075176,SMARCA4,224
chr1,228920906,228921142,SRX5075176,SMARCA4,236
chr1,228938243,228938430,SRX5075176,SMARCA4,187
chr1,228944921,228945218,SRX5054308,FOSL2,297
chr1,228944938,228945201,SRX5054309,FOSL2,263
chr1,228963930,228964558,SRX5075169,SMARCA4,628
chr1,228964111,228964519,SRX5716470,SMARCA4,408
chr1,228964125,228964422,SRX5716469,SMARCA4,297
chr1,228964149,228964374,SRX5020214,SMARCA2,225
chr1,228964170,228964481,SRX5054308,FOSL2,311
chr1,228964177,228964439,SRX5075175,SMARCA4,262
chr1,228964181,228964436,SRX5075170,SMARCA4,255
chr1,228964196,228964444,SRX5075176,SMARCA4,248
chr1,228964211,228964481,SRX20140897,INTS13,270
chr1,228964220,228964461,SRX5020211,SMARCA2,241
chr1,228964225,228964483,SRX5054309,FOSL2,258
chr1,228968820,228969325,SRX5075174,SMARCA4,505
chr1,228968840,228969263,SRX20140895,INTS13,423
chr1,228968934,228969372,SRX5075168,SMARCA4,438
chr1,228968983,228969159,SRX5075176,SMARCA4,176
chr1,229003317,229003533,SRX20140867,INTS10,216
chr1,229003576,229003794,SRX20140867,INTS10,218
chr1,229022654,229022969,SRX5075176,SMARCA4,315
chr1,229022677,229022915,SRX5075170,SMARCA4,238
chr1,229024650,229025016,SRX5054309,FOSL2,366
chr1,229024658,229024943,SRX5075169,SMARCA4,285
chr1,229024672,229024972,SRX5054308,FOSL2,300
chr1,229024692,229024971,SRX5075170,SMARCA4,279
chr1,229024693,229024944,SRX5075176,SMARCA4,251
chr1,229024693,229024959,SRX5075175,SMARCA4,266
chr1,229031137,229031341,SRX5075174,SMARCA4,204
chr1,229032302,229032778,SRX5075176,SMARCA4,476
chr1,229032369,229032600,SRX5716467,SMARCA2,231
chr1,229032392,229032626,SRX5075169,SMARCA4,234
chr1,229032427,229032631,SRX5075175,SMARCA4,204
chr1,229032452,229032748,SRX5075170,SMARCA4,296
chr1,229058674,229058985,SRX5075170,SMARCA4,311
chr1,229058788,229059065,SRX5075176,SMARCA4,277
chr1,229059636,229060066,SRX5075176,SMARCA4,430
chr1,229059668,229060046,SRX5075170,SMARCA4,378
chr1,229059718,229059979,SRX5075169,SMARCA4,261
chr1,229059766,229060034,SRX5716470,SMARCA4,268
chr1,229059793,229060048,SRX5075175,SMARCA4,255
chr1,229064440,229064644,SRX5054309,FOSL2,204
chr1,229070214,229070451,SRX5075170,SMARCA4,237
chr1,229070288,229070540,SRX5075169,SMARCA4,252
chr1,229085965,229086497,SRX5075169,SMARCA4,532
chr1,229086250,229086554,SRX5075170,SMARCA4,304
chr1,229095022,229095344,SRX5054309,FOSL2,322
chr1,229095040,229095356,SRX5054308,FOSL2,316
chr1,229095042,229095347,SRX5075169,SMARCA4,305
chr1,229095057,229095325,SRX5020214,SMARCA2,268
chr1,229095079,229095293,SRX5075174,SMARCA4,214
chr1,229095095,229095339,SRX5075170,SMARCA4,244
chr1,229095102,229095346,SRX5075175,SMARCA4,244
chr1,229127409,229127618,SRX5020211,SMARCA2,209
chr1,229146615,229146876,SRX5075176,SMARCA4,261
chr1,229155446,229155856,SRX5075170,SMARCA4,410
chr1,229156845,229157080,SRX16500059,CTCF,235
chr1,229156901,229157152,SRX16500060,CTCF,251
chr1,229158199,229158387,SRX5075170,SMARCA4,188
chr1,229205388,229205673,SRX5075176,SMARCA4,285
chr1,229205457,229205645,SRX5075170,SMARCA4,188
chr1,229221619,229221912,SRX5075170,SMARCA4,293
chr1,229224509,229224797,SRX5054309,FOSL2,288
chr1,229224543,229224747,SRX5054308,FOSL2,204
chr1,229227319,229227913,SRX16500059,CTCF,594
chr1,229227364,229227856,SRX16500061,CTCF,492
chr1,229227384,229227862,SRX16500062,CTCF,478
chr1,229227397,229227873,SRX16500060,CTCF,476
chr1,229227454,229227785,SRX4174629,CTCF,331
chr1,229227583,229227761,SRX5075174,SMARCA4,178
chr1,229230613,229230865,SRX5054309,FOSL2,252
chr1,229230641,229230890,SRX5054308,FOSL2,249
chr1,229230702,229230908,SRX5075176,SMARCA4,206
chr1,229231454,229231648,SRX5075174,SMARCA4,194
chr1,229231481,229231709,SRX5075168,SMARCA4,228
chr1,229231498,229231723,SRX5075170,SMARCA4,225
chr1,229231547,229231756,SRX5075176,SMARCA4,209
chr1,229253232,229253675,SRX5075176,SMARCA4,443
chr1,229253248,229253629,SRX5075168,SMARCA4,381
chr1,229253273,229253667,SRX5075170,SMARCA4,394
chr1,229253307,229253664,SRX5054308,FOSL2,357
chr1,229253313,229253519,SRX5075174,SMARCA4,206
chr1,229253317,229253611,SRX5075169,SMARCA4,294
chr1,229253323,229253607,SRX5054309,FOSL2,284
chr1,229253324,229253615,SRX5075175,SMARCA4,291
chr1,229257993,229258461,SRX16500059,CTCF,468
chr1,229258014,229258422,SRX16500062,CTCF,408
chr1,229258035,229258479,SRX16500061,CTCF,444
chr1,229258041,229258488,SRX16500060,CTCF,447
chr1,229258060,229258486,SRX4174629,CTCF,426
chr1,229258089,229258336,SRX5075174,SMARCA4,247
chr1,229258168,229258342,SRX5075170,SMARCA4,174
chr1,229270909,229271401,SRX5075174,SMARCA4,492
chr1,229270921,229271554,SRX20140895,INTS13,633
chr1,229270930,229271409,SRX20140868,INTS10,479
chr1,229271014,229271228,SRX5716463,SMARCA4,214
chr1,229271037,229271469,SRX5075168,SMARCA4,432
chr1,229271070,229271360,SRX20140867,INTS10,290
chr1,229271165,229271412,SRX5075169,SMARCA4,247
chr1,229271225,229271466,SRX5075176,SMARCA4,241
chr1,229271228,229271712,SRX5075175,SMARCA4,484
chr1,229271336,229271906,SRX5716470,SMARCA4,570
chr1,229271483,229271787,SRX5075170,SMARCA4,304
chr1,229271510,229271747,SRX5075169,SMARCA4,237
chr1,229271574,229271817,SRX5075176,SMARCA4,243
chr1,229318064,229318453,SRX5075174,SMARCA4,389
chr1,229318081,229318425,SRX5075168,SMARCA4,344
chr1,229341365,229341636,SRX5075170,SMARCA4,271
chr1,229341426,229341601,SRX5075176,SMARCA4,175
chr1,229342124,229343127,SRX20140895,INTS13,1003
chr1,229342399,229343168,SRX20140868,INTS10,769
chr1,229342406,229342725,SRX5075174,SMARCA4,319
chr1,229342518,229342707,SRX5075176,SMARCA4,189
chr1,229342723,229343006,SRX20140879,CPSF3L,283
chr1,229343000,229343218,SRX5075175,SMARCA4,218
chr1,229389221,229389447,SRX5054309,FOSL2,226
chr1,229411081,229411278,SRX5075169,SMARCA4,197
chr1,229411083,229411292,SRX5075168,SMARCA4,209
chr1,229411098,229411407,SRX5075176,SMARCA4,309
chr1,229411207,229411387,SRX5075170,SMARCA4,180
chr1,229430796,229431044,SRX5716470,SMARCA4,248
chr1,229430829,229431076,SRX5075169,SMARCA4,247
chr1,229430839,229431069,SRX5075175,SMARCA4,230
chr1,229430849,229431071,SRX5075170,SMARCA4,222
chr1,229430866,229431091,SRX5075174,SMARCA4,225
chr1,229439077,229439281,SRX5075176,SMARCA4,204
chr1,229440883,229441422,SRX5075169,SMARCA4,539
chr1,229440964,229441335,SRX5075176,SMARCA4,371
chr1,229440964,229441514,SRX5075175,SMARCA4,550
chr1,229440974,229441192,SRX5716469,SMARCA4,218
chr1,229441010,229441221,SRX5716470,SMARCA4,211
chr1,229441023,229441369,SRX5054308,FOSL2,346
chr1,229441024,229441337,SRX5054309,FOSL2,313
chr1,229441036,229441311,SRX5075170,SMARCA4,275
chr1,229441100,229441332,SRX5020211,SMARCA2,232
chr1,229441214,229441462,SRX5716459,Epitope tags,248
chr1,229453178,229453551,SRX16500062,CTCF,373
chr1,229453250,229453554,SRX16500060,CTCF,304
chr1,229453250,229453611,SRX16500059,CTCF,361
chr1,229453258,229453490,SRX4174629,CTCF,232
chr1,229453310,229453543,SRX16500061,CTCF,233
chr1,229481836,229482307,SRX16500060,CTCF,471
chr1,229481844,229482390,SRX16500059,CTCF,546
chr1,229481937,229482362,SRX16500062,CTCF,425
chr1,229481948,229482371,SRX16500061,CTCF,423
chr1,229482071,229482293,SRX5075168,SMARCA4,222
chr1,229482088,229482268,SRX5075170,SMARCA4,180
chr1,229507968,229508620,SRX5075168,SMARCA4,652
chr1,229508011,229508728,SRX20140895,INTS13,717
chr1,229508021,229508676,SRX20140868,INTS10,655
chr1,229508038,229508734,SRX20140869,INTS10,696
chr1,229508041,229508696,SRX20140897,INTS13,655
chr1,229508067,229508670,SRX5075174,SMARCA4,603
chr1,229508087,229508677,SRX20140867,INTS10,590
chr1,229508304,229508647,SRX5075176,SMARCA4,343
chr1,229508339,229508641,SRX5075170,SMARCA4,302
chr1,229508376,229508640,SRX5716464,SMARCA4,264
chr1,229508401,229508672,SRX20140879,CPSF3L,271
chr1,229508498,229508783,SRX5075169,SMARCA4,285
chr1,229514639,229515109,SRX16500061,CTCF,470
chr1,229514640,229515012,SRX5075174,SMARCA4,372
chr1,229514649,229515134,SRX16500059,CTCF,485
chr1,229514657,229515113,SRX16500060,CTCF,456
chr1,229514668,229514904,SRX4174629,CTCF,236
chr1,229514668,229514966,SRX5075176,SMARCA4,298
chr1,229514675,229515122,SRX16500062,CTCF,447
chr1,229514683,229514994,SRX5075168,SMARCA4,311
chr1,229514692,229514961,SRX5075170,SMARCA4,269
chr1,229514803,229515005,SRX5075169,SMARCA4,202
chr1,229558383,229559353,SRX20140895,INTS13,970
chr1,229558603,229559204,SRX16500060,CTCF,601
chr1,229558618,229559305,SRX20140868,INTS10,687
chr1,229558620,229559087,SRX5716470,SMARCA4,467
chr1,229558650,229559192,SRX16500059,CTCF,542
chr1,229558655,229559271,SRX5075170,SMARCA4,616
chr1,229558688,229559115,SRX16500061,CTCF,427
chr1,229558691,229559142,SRX16500062,CTCF,451
chr1,229558704,229559285,SRX5075174,SMARCA4,581
chr1,229558713,229559003,SRX20140867,INTS10,290
chr1,229558734,229559127,SRX5075169,SMARCA4,393
chr1,229558739,229559286,SRX5075176,SMARCA4,547
chr1,229558758,229559141,SRX5716464,SMARCA4,383
chr1,229558771,229559041,SRX5075175,SMARCA4,270
chr1,229558771,229559368,SRX5075168,SMARCA4,597
chr1,229558851,229559187,SRX5716469,SMARCA4,336
chr1,229558865,229559181,SRX20140879,CPSF3L,316
chr1,229558928,229559295,SRX5716463,SMARCA4,367
chr1,229558969,229559180,SRX5716451,SOX2,211
chr1,229578943,229579682,SRX5075170,SMARCA4,739
chr1,229578965,229579691,SRX5075176,SMARCA4,726
chr1,229579178,229579410,SRX5716469,SMARCA4,232
chr1,229579203,229579501,SRX5075169,SMARCA4,298
chr1,229579246,229579517,SRX5716468,SMARCA2,271
chr1,229579265,229579619,SRX20140895,INTS13,354
chr1,229579328,229579611,SRX5075174,SMARCA4,283
chr1,229579366,229579681,SRX5075168,SMARCA4,315
chr1,229596909,229597475,SRX5075175,SMARCA4,566
chr1,229596925,229597256,SRX5054309,FOSL2,331
chr1,229596927,229597301,SRX5075170,SMARCA4,374
chr1,229596930,229597214,SRX5020211,SMARCA2,284
chr1,229596937,229597399,SRX5716469,SMARCA4,462
chr1,229596937,229597415,SRX5075169,SMARCA4,478
chr1,229596943,229597301,SRX5075176,SMARCA4,358
chr1,229596958,229597283,SRX5054308,FOSL2,325
chr1,229621775,229621955,SRX5054308,FOSL2,180
chr1,229625823,229626488,SRX20140895,INTS13,665
chr1,229625884,229626456,SRX20140868,INTS10,572
chr1,229625890,229626311,SRX5075174,SMARCA4,421
chr1,229625894,229626306,SRX20140867,INTS10,412
chr1,229625935,229626167,SRX5075176,SMARCA4,232
chr1,229625935,229626302,SRX5075168,SMARCA4,367
chr1,229626030,229626357,SRX5075170,SMARCA4,327
chr1,229626055,229626393,SRX20140897,INTS13,338
chr1,229626270,229626491,SRX16500060,CTCF,221
chr1,229661124,229661684,SRX16500060,CTCF,560
chr1,229661189,229661647,SRX16500061,CTCF,458
chr1,229661189,229661707,SRX16500059,CTCF,518
chr1,229661204,229661672,SRX16500062,CTCF,468
chr1,229661230,229661657,SRX4174629,CTCF,427
chr1,229661333,229661623,SRX5075170,SMARCA4,290
chr1,229661338,229661564,SRX5075174,SMARCA4,226
chr1,229661351,229661580,SRX5075175,SMARCA4,229
chr1,229661351,229661590,SRX5075168,SMARCA4,239
chr1,229661362,229661576,SRX5075176,SMARCA4,214
chr1,229661362,229661587,SRX5716470,SMARCA4,225
chr1,229661389,229661629,SRX5075169,SMARCA4,240
chr1,229693185,229693616,SRX5075176,SMARCA4,431
chr1,229693195,229693412,SRX5020211,SMARCA2,217
chr1,229693239,229693627,SRX5075170,SMARCA4,388
chr1,229693261,229693480,SRX5075169,SMARCA4,219
chr1,229694164,229694741,SRX5075170,SMARCA4,577
chr1,229694219,229694739,SRX5075176,SMARCA4,520
chr1,229694244,229694664,SRX5075169,SMARCA4,420
chr1,229694297,229694711,SRX5716470,SMARCA4,414
chr1,229694306,229694569,SRX5054308,FOSL2,263
chr1,229694311,229694539,SRX5054309,FOSL2,228
chr1,229694333,229694676,SRX5075175,SMARCA4,343
chr1,229694368,229694675,SRX5716467,SMARCA2,307
chr1,229694369,229694555,SRX5075168,SMARCA4,186
chr1,229694402,229694601,SRX5075174,SMARCA4,199
chr1,229699877,229700302,SRX5075176,SMARCA4,425
chr1,229699950,229700222,SRX5716470,SMARCA4,272
chr1,229699967,229700371,SRX5075170,SMARCA4,404
chr1,229699996,229700287,SRX5075169,SMARCA4,291
chr1,229700047,229700242,SRX5075175,SMARCA4,195
chr1,229710722,229711090,SRX5075169,SMARCA4,368
chr1,229710741,229711150,SRX5075175,SMARCA4,409
chr1,229710746,229711162,SRX5054308,FOSL2,416
chr1,229710755,229711062,SRX5075181,SMARCA2,307
chr1,229710770,229711205,SRX5075170,SMARCA4,435
chr1,229710782,229711089,SRX5020214,SMARCA2,307
chr1,229710782,229711167,SRX5054309,FOSL2,385
chr1,229710783,229711143,SRX5075176,SMARCA4,360
chr1,229710783,229711157,SRX5716469,SMARCA4,374
chr1,229710790,229711129,SRX5716467,SMARCA2,339
chr1,229710837,229711122,SRX5020211,SMARCA2,285
chr1,229710864,229711102,SRX5716468,SMARCA2,238
chr1,229710885,229711124,SRX5716470,SMARCA4,239
chr1,229716046,229716813,SRX5075176,SMARCA4,767
chr1,229716049,229716392,SRX20140869,INTS10,343
chr1,229716107,229716739,SRX5075170,SMARCA4,632
chr1,229716121,229716817,SRX5716469,SMARCA4,696
chr1,229716124,229716596,SRX5075175,SMARCA4,472
chr1,229716142,229716540,SRX5716468,SMARCA2,398
chr1,229716142,229716755,SRX5075169,SMARCA4,613
chr1,229716172,229716614,SRX5716467,SMARCA2,442
chr1,229716180,229716624,SRX5716470,SMARCA4,444
chr1,229716204,229716537,SRX5020211,SMARCA2,333
chr1,229716210,229716632,SRX5075181,SMARCA2,422
chr1,229716213,229716616,SRX5054309,FOSL2,403
chr1,229716252,229716614,SRX5054308,FOSL2,362
chr1,229716279,229716555,SRX5020214,SMARCA2,276
chr1,229716306,229716592,SRX5075182,SMARCA2,286
chr1,229726268,229726657,SRX20140869,INTS10,389
chr1,229751631,229751911,SRX5075174,SMARCA4,280
chr1,229751637,229751905,SRX5075168,SMARCA4,268
chr1,229751686,229751897,SRX5716463,SMARCA4,211
chr1,229756711,229756938,SRX5075169,SMARCA4,227
chr1,229756725,229757003,SRX5054309,FOSL2,278
chr1,229792117,229792379,SRX5716470,SMARCA4,262
chr1,229792161,229792371,SRX5075181,SMARCA2,210
chr1,229792165,229792882,SRX5075176,SMARCA4,717
chr1,229792171,229792375,SRX5075170,SMARCA4,204
chr1,229792181,229792354,SRX5075174,SMARCA4,173
chr1,229792211,229792398,SRX5075175,SMARCA4,187
chr1,229792463,229792922,SRX5075170,SMARCA4,459
chr1,229819190,229819422,SRX5054308,FOSL2,232
chr1,229819223,229819427,SRX5054309,FOSL2,204
chr1,229822450,229822668,SRX5075169,SMARCA4,218
chr1,229822489,229822667,SRX5075176,SMARCA4,178
chr1,229843857,229844048,SRX5075170,SMARCA4,191
chr1,229843916,229844206,SRX5054308,FOSL2,290
chr1,229849041,229849420,SRX16500061,CTCF,379
chr1,229849049,229849361,SRX16500060,CTCF,312
chr1,229849092,229849422,SRX16500062,CTCF,330
chr1,229849097,229849445,SRX16500059,CTCF,348
chr1,229849117,229849328,SRX5075174,SMARCA4,211
chr1,229857636,229857895,SRX5054308,FOSL2,259
chr1,229857662,229857847,SRX5054309,FOSL2,185
chr1,229862035,229862419,SRX5075168,SMARCA4,384
chr1,229862066,229862477,SRX5075176,SMARCA4,411
chr1,229862079,229862446,SRX5075174,SMARCA4,367
chr1,229869236,229869467,SRX5075169,SMARCA4,231
chr1,229869356,229869562,SRX5054309,FOSL2,206
chr1,229869361,229869606,SRX5075170,SMARCA4,245
chr1,229874235,229874426,SRX5075170,SMARCA4,191
chr1,229874239,229874419,SRX5075169,SMARCA4,180
chr1,229879845,229880142,SRX5716470,SMARCA4,297
chr1,229879869,229880126,SRX5075176,SMARCA4,257
chr1,229879872,229880052,SRX5075169,SMARCA4,180
chr1,229894508,229894852,SRX5075176,SMARCA4,344
chr1,229894620,229894825,SRX5054308,FOSL2,205
chr1,229921242,229921701,SRX5075168,SMARCA4,459
chr1,229921418,229921843,SRX5075174,SMARCA4,425
chr1,229933317,229933533,SRX5716470,SMARCA4,216
chr1,229933399,229933574,SRX5075176,SMARCA4,175
chr1,229933399,229933601,SRX5075170,SMARCA4,202
chr1,229940659,229941229,SRX5716470,SMARCA4,570
chr1,229940665,229941078,SRX5075176,SMARCA4,413
chr1,229940681,229941137,SRX5075169,SMARCA4,456
chr1,229940684,229941051,SRX5075170,SMARCA4,367
chr1,229940687,229941085,SRX5716469,SMARCA4,398
chr1,229940698,229940903,SRX5020211,SMARCA2,205
chr1,229940700,229941024,SRX5075175,SMARCA4,324
chr1,229940723,229941044,SRX5716467,SMARCA2,321
chr1,229940733,229941059,SRX5075181,SMARCA2,326
chr1,229940751,229941068,SRX5054309,FOSL2,317
chr1,229940768,229940986,SRX5075182,SMARCA2,218
chr1,229940785,229941018,SRX5716468,SMARCA2,233
chr1,229940807,229941032,SRX5020214,SMARCA2,225
chr1,229940816,229941026,SRX5054308,FOSL2,210
chr1,229947988,229948357,SRX5054309,FOSL2,369
chr1,229948045,229948283,SRX5054308,FOSL2,238
chr1,229948093,229948319,SRX5075169,SMARCA4,226
chr1,229981848,229982059,SRX5075170,SMARCA4,211
chr1,230002456,230002784,SRX5075176,SMARCA4,328
chr1,230002566,230002795,SRX5075170,SMARCA4,229
chr1,230011062,230011250,SRX5054309,FOSL2,188
chr1,230066633,230067010,SRX20140895,INTS13,377
chr1,230066670,230067444,SRX5075168,SMARCA4,774
chr1,230066689,230067357,SRX5075174,SMARCA4,668
chr1,230066812,230067106,SRX5716463,SMARCA4,294
chr1,230066835,230067101,SRX5075169,SMARCA4,266
chr1,230066842,230067247,SRX5716464,SMARCA4,405
chr1,230066847,230067349,SRX5075176,SMARCA4,502
chr1,230066883,230067358,SRX5075170,SMARCA4,475
chr1,230066966,230067309,SRX20140867,INTS10,343
chr1,230066979,230067203,SRX5054307,FOSL2,224
chr1,230066986,230067277,SRX5716470,SMARCA4,291
chr1,230067053,230067493,SRX20140895,INTS13,440
chr1,230073456,230073683,SRX5075169,SMARCA4,227
chr1,230084422,230084998,SRX5075175,SMARCA4,576
chr1,230084461,230085002,SRX5075176,SMARCA4,541
chr1,230084525,230085051,SRX5075169,SMARCA4,526
chr1,230084529,230084967,SRX5716469,SMARCA4,438
chr1,230084534,230084958,SRX5716470,SMARCA4,424
chr1,230084541,230085031,SRX5075170,SMARCA4,490
chr1,230084569,230084965,SRX5054309,FOSL2,396
chr1,230084584,230084849,SRX5716467,SMARCA2,265
chr1,230084607,230084891,SRX5054308,FOSL2,284
chr1,230084644,230084961,SRX5020214,SMARCA2,317
chr1,230084711,230084970,SRX5075182,SMARCA2,259
chr1,230090326,230090630,SRX5054309,FOSL2,304
chr1,230104610,230105334,SRX5075170,SMARCA4,724
chr1,230104641,230105190,SRX5075175,SMARCA4,549
chr1,230104642,230105269,SRX5075169,SMARCA4,627
chr1,230104682,230105117,SRX5054309,FOSL2,435
chr1,230104687,230105227,SRX5716470,SMARCA4,540
chr1,230104693,230105333,SRX5075176,SMARCA4,640
chr1,230104708,230105082,SRX5054308,FOSL2,374
chr1,230104709,230105129,SRX5716469,SMARCA4,420
chr1,230104732,230105108,SRX5716467,SMARCA2,376
chr1,230104748,230105106,SRX5020214,SMARCA2,358
chr1,230104819,230105063,SRX5075174,SMARCA4,244
chr1,230104850,230105124,SRX5716468,SMARCA2,274
chr1,230112529,230112712,SRX5075174,SMARCA4,183
chr1,230113753,230114033,SRX5054309,FOSL2,280
chr1,230113762,230114083,SRX5075176,SMARCA4,321
chr1,230113762,230114185,SRX5075169,SMARCA4,423
chr1,230113832,230114208,SRX5075170,SMARCA4,376
chr1,230113837,230114024,SRX5054308,FOSL2,187
chr1,230120713,230121273,SRX16500061,CTCF,560
chr1,230120753,230121247,SRX16500060,CTCF,494
chr1,230120791,230121224,SRX16500062,CTCF,433
chr1,230120820,230121251,SRX16500059,CTCF,431
chr1,230123747,230124113,SRX5054308,FOSL2,366
chr1,230123842,230124069,SRX5054309,FOSL2,227
chr1,230137393,230137697,SRX5075176,SMARCA4,304
chr1,230137449,230137706,SRX5075170,SMARCA4,257
chr1,230140640,230140823,SRX5075170,SMARCA4,183
chr1,230140910,230141192,SRX5054309,FOSL2,282
chr1,230140963,230141182,SRX5075175,SMARCA4,219
chr1,230140975,230141173,SRX5075169,SMARCA4,198
chr1,230142784,230143062,SRX5075170,SMARCA4,278
chr1,230153353,230154202,SRX5075168,SMARCA4,849
chr1,230153475,230154260,SRX5075174,SMARCA4,785
chr1,230153599,230154271,SRX20140895,INTS13,672
chr1,230153648,230153838,SRX5716451,SOX2,190
chr1,230153767,230154053,SRX20140868,INTS10,286
chr1,230153889,230154121,SRX5716454,SOX3,232
chr1,230153925,230154177,SRX5716451,SOX2,252
chr1,230157448,230157647,SRX5054308,FOSL2,199
chr1,230167369,230167935,SRX16500059,CTCF,566
chr1,230167375,230167788,SRX16500061,CTCF,413
chr1,230167377,230167764,SRX16500062,CTCF,387
chr1,230167382,230167779,SRX16500060,CTCF,397
chr1,230171301,230172090,SRX5716469,SMARCA4,789
chr1,230171350,230171692,SRX5075176,SMARCA4,342
chr1,230171383,230172077,SRX5075169,SMARCA4,694
chr1,230171401,230172124,SRX5054309,FOSL2,723
chr1,230171508,230172017,SRX5075175,SMARCA4,509
chr1,230171680,230171934,SRX5054308,FOSL2,254
chr1,230186153,230186575,SRX5075170,SMARCA4,422
chr1,230186171,230186562,SRX5075168,SMARCA4,391
chr1,230186184,230186556,SRX5075176,SMARCA4,372
chr1,230186193,230186523,SRX5716470,SMARCA4,330
chr1,230186200,230186580,SRX5716469,SMARCA4,380
chr1,230186214,230186598,SRX5075174,SMARCA4,384
chr1,230186217,230186596,SRX5054309,FOSL2,379
chr1,230186247,230186594,SRX5054308,FOSL2,347
chr1,230186292,230186543,SRX5075175,SMARCA4,251
chr1,230186304,230186567,SRX5075169,SMARCA4,263
chr1,230215132,230215301,SRX5075170,SMARCA4,169
chr1,230222760,230222932,SRX5075170,SMARCA4,172
chr1,230244044,230244245,SRX5054308,FOSL2,201
chr1,230244074,230244266,SRX5054309,FOSL2,192
chr1,230268813,230269317,SRX16500059,CTCF,504
chr1,230268819,230269310,SRX16500060,CTCF,491
chr1,230268887,230269256,SRX16500061,CTCF,369
chr1,230268906,230269205,SRX5716470,SMARCA4,299
chr1,230268919,230269305,SRX16500062,CTCF,386
chr1,230268922,230269146,SRX5716464,SMARCA4,224
chr1,230268928,230269298,SRX4174629,CTCF,370
chr1,230268930,230269218,SRX5075175,SMARCA4,288
chr1,230268942,230269179,SRX5075169,SMARCA4,237
chr1,230268944,230269250,SRX5075176,SMARCA4,306
chr1,230268958,230269194,SRX5075174,SMARCA4,236
chr1,230268963,230269185,SRX5075168,SMARCA4,222
chr1,230268977,230269202,SRX5075170,SMARCA4,225
chr1,230269003,230269246,SRX5716463,SMARCA4,243
chr1,230277159,230277862,SRX5075174,SMARCA4,703
chr1,230277174,230277827,SRX5075168,SMARCA4,653
chr1,230277175,230277680,SRX5716463,SMARCA4,505
chr1,230277181,230277551,SRX16500060,CTCF,370
chr1,230277198,230277582,SRX16500062,CTCF,384
chr1,230277202,230277506,SRX16500061,CTCF,304
chr1,230277267,230277757,SRX5716464,SMARCA4,490
chr1,230277275,230277646,SRX5716451,SOX2,371
chr1,230277278,230277616,SRX16500059,CTCF,338
chr1,230277287,230277619,SRX5716454,SOX3,332
chr1,230308098,230308445,SRX5075170,SMARCA4,347
chr1,230308101,230308388,SRX5075176,SMARCA4,287
chr1,230308130,230308398,SRX5054308,FOSL2,268
chr1,230308137,230308394,SRX5054309,FOSL2,257
chr1,230310509,230311077,SRX16500059,CTCF,568
chr1,230310514,230310895,SRX5075168,SMARCA4,381
chr1,230310514,230311102,SRX16500062,CTCF,588
chr1,230310515,230311023,SRX16500060,CTCF,508
chr1,230310533,230310945,SRX4174629,CTCF,412
chr1,230310537,230311030,SRX16500061,CTCF,493
chr1,230310565,230310955,SRX5075174,SMARCA4,390
chr1,230310589,230310824,SRX5716470,SMARCA4,235
chr1,230310591,230310879,SRX5716463,SMARCA4,288
chr1,230310623,230310859,SRX5075176,SMARCA4,236
chr1,230310625,230310831,SRX5075170,SMARCA4,206
chr1,230310630,230310871,SRX5075175,SMARCA4,241
chr1,230310656,230310843,SRX5075169,SMARCA4,187
chr1,230332139,230332490,SRX5075168,SMARCA4,351
chr1,230332342,230333059,SRX20140895,INTS13,717
chr1,230336128,230336529,SRX5075170,SMARCA4,401
chr1,230336150,230336575,SRX5075176,SMARCA4,425
chr1,230336210,230336424,SRX5054308,FOSL2,214
chr1,230359956,230360430,SRX5075176,SMARCA4,474
chr1,230359988,230360374,SRX5075170,SMARCA4,386
chr1,230360013,230360294,SRX5054309,FOSL2,281
chr1,230360061,230360358,SRX5075175,SMARCA4,297
chr1,230360063,230360274,SRX5716470,SMARCA4,211
chr1,230360076,230360319,SRX5054308,FOSL2,243
chr1,230381975,230382180,SRX5075176,SMARCA4,205
chr1,230382013,230382382,SRX5075174,SMARCA4,369
chr1,230401891,230402374,SRX5075176,SMARCA4,483
chr1,230401919,230402332,SRX5075170,SMARCA4,413
chr1,230401940,230402316,SRX5716470,SMARCA4,376
chr1,230401959,230402294,SRX5075169,SMARCA4,335
chr1,230401997,230402293,SRX5075175,SMARCA4,296
chr1,230402022,230402312,SRX5020214,SMARCA2,290
chr1,230402086,230402396,SRX5054309,FOSL2,310
chr1,230426318,230426846,SRX5075170,SMARCA4,528
chr1,230426321,230426870,SRX5075176,SMARCA4,549
chr1,230426335,230426807,SRX5075175,SMARCA4,472
chr1,230426368,230426834,SRX5075174,SMARCA4,466
chr1,230426376,230426790,SRX5075168,SMARCA4,414
chr1,230426425,230426830,SRX5716470,SMARCA4,405
chr1,230426434,230426641,SRX5716464,SMARCA4,207
chr1,230426469,230426773,SRX5716469,SMARCA4,304
chr1,230426478,230426885,SRX5075169,SMARCA4,407
chr1,230427960,230428180,SRX5075174,SMARCA4,220
chr1,230428069,230428314,SRX5716451,SOX2,245
chr1,230428075,230428297,SRX5075168,SMARCA4,222
chr1,230459455,230459790,SRX5075174,SMARCA4,335
chr1,230459477,230459772,SRX5075168,SMARCA4,295
chr1,230459531,230459750,SRX5054309,FOSL2,219
chr1,230509622,230510120,SRX5054309,FOSL2,498
chr1,230509633,230510094,SRX5075175,SMARCA4,461
chr1,230509674,230510016,SRX5075170,SMARCA4,342
chr1,230509686,230510001,SRX5054308,FOSL2,315
chr1,230509721,230510053,SRX5020214,SMARCA2,332
chr1,230509737,230510029,SRX5075169,SMARCA4,292
chr1,230509749,230510025,SRX5075176,SMARCA4,276
chr1,230510498,230510839,SRX5075168,SMARCA4,341
chr1,230510602,230510876,SRX5075174,SMARCA4,274
chr1,230542078,230542352,SRX5054309,FOSL2,274
chr1,230563547,230563982,SRX5075174,SMARCA4,435
chr1,230563549,230563990,SRX5075168,SMARCA4,441
chr1,230563725,230563994,SRX20140895,INTS13,269
chr1,230588229,230588878,SRX20140895,INTS13,649
chr1,230611165,230611346,SRX5075170,SMARCA4,181
chr1,230611426,230611817,SRX5075170,SMARCA4,391
chr1,230611562,230611797,SRX5075176,SMARCA4,235
chr1,230632238,230632699,SRX16500060,CTCF,461
chr1,230632253,230632651,SRX16500059,CTCF,398
chr1,230632293,230632635,SRX16500062,CTCF,342
chr1,230632317,230632655,SRX16500061,CTCF,338
chr1,230632434,230632607,SRX5075174,SMARCA4,173
chr1,230641974,230642581,SRX16500062,CTCF,607
chr1,230641975,230642615,SRX16500059,CTCF,640
chr1,230641976,230642478,SRX4174629,CTCF,502
chr1,230641991,230642607,SRX16500060,CTCF,616
chr1,230642058,230642585,SRX16500061,CTCF,527
chr1,230642093,230642605,SRX5716463,SMARCA4,512
chr1,230642145,230642676,SRX5075168,SMARCA4,531
chr1,230642155,230642697,SRX5075170,SMARCA4,542
chr1,230642175,230642501,SRX5716464,SMARCA4,326
chr1,230642191,230642710,SRX5075174,SMARCA4,519
chr1,230642195,230642693,SRX5075176,SMARCA4,498
chr1,230642224,230642837,SRX5075169,SMARCA4,613
chr1,230642233,230642885,SRX20140895,INTS13,652
chr1,230642290,230642759,SRX20140868,INTS10,469
chr1,230642355,230642542,SRX5075175,SMARCA4,187
chr1,230642359,230642873,SRX5716470,SMARCA4,514
chr1,230642361,230642695,SRX20140869,INTS10,334
chr1,230642388,230642674,SRX20140897,INTS13,286
chr1,230642442,230642746,SRX20140867,INTS10,304
chr1,230642455,230642698,SRX20140879,CPSF3L,243
chr1,230666780,230666980,SRX5075174,SMARCA4,200
chr1,230666916,230667186,SRX5075168,SMARCA4,270
chr1,230681622,230681907,SRX5716469,SMARCA4,285
chr1,230681641,230681939,SRX5075170,SMARCA4,298
chr1,230681660,230681970,SRX5075169,SMARCA4,310
chr1,230681677,230681952,SRX5075176,SMARCA4,275
chr1,230681686,230681866,SRX5054308,FOSL2,180
chr1,230681687,230681967,SRX5054309,FOSL2,280
chr1,230690195,230690382,SRX5054309,FOSL2,187
chr1,230713999,230714303,SRX5716470,SMARCA4,304
chr1,230714072,230714382,SRX5075176,SMARCA4,310
chr1,230714076,230714397,SRX5075170,SMARCA4,321
chr1,230714118,230714305,SRX5075175,SMARCA4,187
chr1,230744442,230744684,SRX5716470,SMARCA4,242
chr1,230753536,230754200,SRX20140895,INTS13,664
chr1,230753682,230754209,SRX20140868,INTS10,527
chr1,230753927,230754290,SRX5075168,SMARCA4,363
chr1,230773152,230773484,SRX16500060,CTCF,332
chr1,230773240,230773459,SRX16500061,CTCF,219
chr1,230780542,230780857,SRX5054308,FOSL2,315
chr1,230780555,230780847,SRX5075176,SMARCA4,292
chr1,230780575,230780764,SRX5075169,SMARCA4,189
chr1,230780601,230780822,SRX5075170,SMARCA4,221
chr1,230780610,230780852,SRX5054309,FOSL2,242
chr1,230781559,230781913,SRX5075169,SMARCA4,354
chr1,230781647,230781934,SRX5075176,SMARCA4,287
chr1,230781659,230781903,SRX5075175,SMARCA4,244
chr1,230781680,230781886,SRX5054309,FOSL2,206
chr1,230781688,230781888,SRX5075170,SMARCA4,200
chr1,230785600,230785910,SRX5075168,SMARCA4,310
chr1,230785618,230785997,SRX5075174,SMARCA4,379
chr1,230785647,230785924,SRX5716451,SOX2,277
chr1,230785647,230785980,SRX20140895,INTS13,333
chr1,230786365,230786875,SRX5075174,SMARCA4,510
chr1,230786371,230786853,SRX5075168,SMARCA4,482
chr1,230786476,230786795,SRX5716463,SMARCA4,319
chr1,230797894,230798370,SRX4174629,CTCF,476
chr1,230797900,230798381,SRX16500061,CTCF,481
chr1,230797903,230798403,SRX16500059,CTCF,500
chr1,230797905,230798353,SRX16500062,CTCF,448
chr1,230797905,230798404,SRX16500060,CTCF,499
chr1,230797997,230798320,SRX5075170,SMARCA4,323
chr1,230798000,230798369,SRX5075174,SMARCA4,369
chr1,230798022,230798272,SRX5075169,SMARCA4,250
chr1,230798044,230798356,SRX5075168,SMARCA4,312
chr1,230798061,230798402,SRX5075176,SMARCA4,341
chr1,230815427,230815634,SRX5075176,SMARCA4,207
chr1,230818306,230818693,SRX5075170,SMARCA4,387
chr1,230818364,230818744,SRX5075176,SMARCA4,380
chr1,230818402,230818720,SRX5075175,SMARCA4,318
chr1,230818467,230818682,SRX5716467,SMARCA2,215
chr1,230818509,230818733,SRX5075169,SMARCA4,224
chr1,230818533,230818744,SRX5716470,SMARCA4,211
chr1,230821964,230822435,SRX5075170,SMARCA4,471
chr1,230821982,230822462,SRX5075176,SMARCA4,480
chr1,230822036,230822440,SRX5716470,SMARCA4,404
chr1,230822050,230822429,SRX5716469,SMARCA4,379
chr1,230822066,230822460,SRX5075169,SMARCA4,394
chr1,230822097,230822371,SRX5075175,SMARCA4,274
chr1,230822126,230822341,SRX5716467,SMARCA2,215
chr1,230822144,230822355,SRX5716468,SMARCA2,211
chr1,230824973,230825250,SRX5054309,FOSL2,277
chr1,230824985,230825243,SRX5054308,FOSL2,258
chr1,230827501,230827731,SRX5075170,SMARCA4,230
chr1,230849400,230850022,SRX5075176,SMARCA4,622
chr1,230849413,230849926,SRX5716469,SMARCA4,513
chr1,230849417,230850012,SRX5075175,SMARCA4,595
chr1,230849417,230850174,SRX5075170,SMARCA4,757
chr1,230849435,230849959,SRX5075169,SMARCA4,524
chr1,230849436,230849955,SRX5716470,SMARCA4,519
chr1,230849454,230849862,SRX5054308,FOSL2,408
chr1,230849455,230849846,SRX5020211,SMARCA2,391
chr1,230849455,230849864,SRX5054309,FOSL2,409
chr1,230849457,230849953,SRX5716467,SMARCA2,496
chr1,230849467,230849837,SRX5075181,SMARCA2,370
chr1,230849489,230849824,SRX5020214,SMARCA2,335
chr1,230849496,230849850,SRX5716468,SMARCA2,354
chr1,230849501,230849738,SRX5075182,SMARCA2,237
chr1,230851277,230851639,SRX5075175,SMARCA4,362
chr1,230851315,230851652,SRX5075169,SMARCA4,337
chr1,230851315,230851673,SRX5716470,SMARCA4,358
chr1,230851337,230851667,SRX5054309,FOSL2,330
chr1,230851340,230851509,SRX5075170,SMARCA4,169
chr1,230851364,230851701,SRX5716468,SMARCA2,337
chr1,230851395,230851684,SRX5075181,SMARCA2,289
chr1,230851399,230851586,SRX5054308,FOSL2,187
chr1,230858854,230859652,SRX5075174,SMARCA4,798
chr1,230858941,230859531,SRX5075168,SMARCA4,590
chr1,230859177,230859612,SRX5716451,SOX2,435
chr1,230859320,230859530,SRX5716463,SMARCA4,210
chr1,230868253,230869252,SRX20140895,INTS13,999
chr1,230868312,230869222,SRX20140867,INTS10,910
chr1,230868491,230868801,SRX5075168,SMARCA4,310
chr1,230868605,230869292,SRX20140868,INTS10,687
chr1,230868801,230869081,SRX20140897,INTS13,280
chr1,230869632,230869801,SRX5075170,SMARCA4,169
chr1,230870126,230870336,SRX5020211,SMARCA2,210
chr1,230872038,230872095,SRX1424892,POU3F2,57
chr1,230872038,230872096,SRX1424894,POU3F2,58
chr1,230872039,230872097,SRX1424893,POU3F2,58
chr1,230872039,230872098,SRX1424891,POU3F2,59
chr1,230878363,230879294,SRX5075176,SMARCA4,931
chr1,230878412,230879079,SRX5075170,SMARCA4,667
chr1,230878461,230879039,SRX5716470,SMARCA4,578
chr1,230878465,230879037,SRX5075175,SMARCA4,572
chr1,230878472,230879039,SRX5075169,SMARCA4,567
chr1,230878539,230879000,SRX5020214,SMARCA2,461
chr1,230878556,230878979,SRX5716467,SMARCA2,423
chr1,230878587,230878951,SRX5020211,SMARCA2,364
chr1,230878594,230878998,SRX5716469,SMARCA4,404
chr1,230878594,230879017,SRX5716468,SMARCA2,423
chr1,230878633,230878916,SRX5054309,FOSL2,283
chr1,230878659,230878948,SRX5075181,SMARCA2,289
chr1,230878692,230878970,SRX5075182,SMARCA2,278
chr1,230891399,230891770,SRX5075170,SMARCA4,371
chr1,230891417,230891813,SRX5075174,SMARCA4,396
chr1,230891421,230891833,SRX5075168,SMARCA4,412
chr1,230891433,230891862,SRX5075176,SMARCA4,429
chr1,230891461,230891674,SRX5054309,FOSL2,213
chr1,230891483,230891803,SRX5075169,SMARCA4,320
chr1,230905693,230906189,SRX5075174,SMARCA4,496
chr1,230905716,230906151,SRX5075168,SMARCA4,435
chr1,230905748,230905959,SRX5716470,SMARCA4,211
chr1,230905830,230906173,SRX5075170,SMARCA4,343
chr1,230917210,230917679,SRX16500059,CTCF,469
chr1,230917222,230917847,SRX16500061,CTCF,625
chr1,230917223,230917652,SRX16500062,CTCF,429
chr1,230917235,230917689,SRX16500060,CTCF,454
chr1,230917256,230917645,SRX4174629,CTCF,389
chr1,230917316,230917544,SRX5075174,SMARCA4,228
chr1,230917394,230917574,SRX5075168,SMARCA4,180
chr1,230940994,230941188,SRX5054308,FOSL2,194
chr1,230978588,230979357,SRX20140895,INTS13,769
chr1,230978644,230978982,SRX5075176,SMARCA4,338
chr1,230978706,230979288,SRX5075174,SMARCA4,582
chr1,230978708,230979310,SRX5075170,SMARCA4,602
chr1,230978737,230978974,SRX5716463,SMARCA4,237
chr1,230978752,230979069,SRX5075168,SMARCA4,317
chr1,230978764,230978994,SRX5716464,SMARCA4,230
chr1,230978833,230979342,SRX16500059,CTCF,509
chr1,230978888,230979309,SRX20140868,INTS10,421
chr1,230978896,230979308,SRX16500060,CTCF,412
chr1,230978906,230979237,SRX20140867,INTS10,331
chr1,230978930,230979259,SRX20140897,INTS13,329
chr1,230978933,230979231,SRX20140879,CPSF3L,298
chr1,230978946,230979166,SRX4174629,CTCF,220
chr1,230979021,230979302,SRX16500062,CTCF,281
chr1,230979038,230979323,SRX20140881,CPSF3L,285
chr1,230987029,230987364,SRX5075170,SMARCA4,335
chr1,230987077,230987324,SRX5054309,FOSL2,247
chr1,230987105,230987285,SRX5054308,FOSL2,180
chr1,230987126,230987363,SRX5075176,SMARCA4,237
chr1,231039200,231039408,SRX5075176,SMARCA4,208
chr1,231039209,231039424,SRX5075168,SMARCA4,215
chr1,231039423,231040021,SRX5075170,SMARCA4,598
chr1,231039661,231040080,SRX5075175,SMARCA4,419
chr1,231039702,231039944,SRX5716470,SMARCA4,242
chr1,231039740,231040159,SRX5075169,SMARCA4,419
chr1,231040005,231040440,SRX20140895,INTS13,435
chr1,231040124,231040389,SRX5075174,SMARCA4,265
chr1,231040202,231040438,SRX5075168,SMARCA4,236
chr1,231053587,231053825,SRX5075174,SMARCA4,238
chr1,231053641,231054013,SRX5716470,SMARCA4,372
chr1,231053710,231054002,SRX5075169,SMARCA4,292
chr1,231053745,231054186,SRX5075170,SMARCA4,441
chr1,231053778,231054215,SRX5075176,SMARCA4,437
chr1,231053862,231054126,SRX5075175,SMARCA4,264
chr1,231053882,231054131,SRX5075174,SMARCA4,249
chr1,231053931,231054175,SRX5716469,SMARCA4,244
chr1,231059858,231060155,SRX5054308,FOSL2,297
chr1,231059860,231060203,SRX5054309,FOSL2,343
chr1,231059880,231060109,SRX5075170,SMARCA4,229
chr1,231059893,231060126,SRX5075176,SMARCA4,233
chr1,231059920,231060101,SRX5075169,SMARCA4,181
chr1,231062583,231062816,SRX5075175,SMARCA4,233
chr1,231062585,231062873,SRX5716469,SMARCA4,288
chr1,231062607,231062917,SRX5020211,SMARCA2,310
chr1,231062617,231062856,SRX5075169,SMARCA4,239
chr1,231062634,231062874,SRX5020214,SMARCA2,240
chr1,231091904,231092310,SRX16500062,CTCF,406
chr1,231091907,231092323,SRX16500060,CTCF,416
chr1,231091924,231092373,SRX16500059,CTCF,449
chr1,231091961,231092316,SRX16500061,CTCF,355
chr1,231093301,231094181,SRX5075168,SMARCA4,880
chr1,231093304,231093499,SRX5054309,FOSL2,195
chr1,231093337,231093697,SRX5075176,SMARCA4,360
chr1,231093377,231094098,SRX20140895,INTS13,721
chr1,231093423,231094167,SRX5075174,SMARCA4,744
chr1,231093504,231094036,SRX20140868,INTS10,532
chr1,231093568,231093942,SRX5716451,SOX2,374
chr1,231093575,231093756,SRX5075170,SMARCA4,181
chr1,231093585,231094078,SRX5716463,SMARCA4,493
chr1,231093597,231094011,SRX5716464,SMARCA4,414
chr1,231093632,231093938,SRX20140867,INTS10,306
chr1,231093656,231094010,SRX5716454,SOX3,354
chr1,231093677,231093951,SRX20140879,CPSF3L,274
chr1,231093714,231093965,SRX20140894,INTS13,251
chr1,231106222,231106667,SRX5075176,SMARCA4,445
chr1,231106241,231106667,SRX5075170,SMARCA4,426
chr1,231106266,231106656,SRX5054309,FOSL2,390
chr1,231106271,231106709,SRX5075169,SMARCA4,438
chr1,231106285,231106569,SRX5054308,FOSL2,284
chr1,231106298,231106676,SRX5716469,SMARCA4,378
chr1,231106309,231106713,SRX5716470,SMARCA4,404
chr1,231106312,231106742,SRX5075175,SMARCA4,430
chr1,231106332,231106574,SRX5020211,SMARCA2,242
chr1,231139183,231139509,SRX5075176,SMARCA4,326
chr1,231139185,231139594,SRX5075170,SMARCA4,409
chr1,231139207,231139387,SRX5075169,SMARCA4,180
chr1,231139220,231139551,SRX5054308,FOSL2,331
chr1,231139239,231139487,SRX5054309,FOSL2,248
chr1,231139269,231139468,SRX5075175,SMARCA4,199
chr1,231139281,231139497,SRX5716470,SMARCA4,216
chr1,231139282,231139483,SRX5020211,SMARCA2,201
chr1,231139872,231140649,SRX5075175,SMARCA4,777
chr1,231139937,231140643,SRX5075169,SMARCA4,706
chr1,231139962,231140621,SRX5716470,SMARCA4,659
chr1,231139970,231140644,SRX5075176,SMARCA4,674
chr1,231139979,231140512,SRX5716468,SMARCA2,533
chr1,231140008,231140269,SRX5075170,SMARCA4,261
chr1,231140023,231140391,SRX5075181,SMARCA2,368
chr1,231140025,231140296,SRX5716469,SMARCA4,271
chr1,231140034,231140319,SRX5054309,FOSL2,285
chr1,231140342,231140611,SRX5075170,SMARCA4,269
chr1,231140418,231140730,SRX5054309,FOSL2,312
chr1,231140422,231140676,SRX5054308,FOSL2,254
chr1,231162018,231162637,SRX5075168,SMARCA4,619
chr1,231162045,231162573,SRX5075170,SMARCA4,528
chr1,231162053,231162515,SRX5075174,SMARCA4,462
chr1,231162137,231162651,SRX5075169,SMARCA4,514
chr1,231162177,231162587,SRX5075176,SMARCA4,410
chr1,231162249,231162612,SRX5716470,SMARCA4,363
chr1,231162279,231162654,SRX5075175,SMARCA4,375
chr1,231183785,231184319,SRX5075168,SMARCA4,534
chr1,231183823,231184260,SRX5075174,SMARCA4,437
chr1,231211178,231211776,SRX4174629,CTCF,598
chr1,231211245,231211777,SRX16500059,CTCF,532
chr1,231211250,231211777,SRX16500060,CTCF,527
chr1,231211263,231211754,SRX16500061,CTCF,491
chr1,231211292,231211728,SRX5075176,SMARCA4,436
chr1,231211298,231211745,SRX16500062,CTCF,447
chr1,231211314,231211602,SRX5075174,SMARCA4,288
chr1,231211317,231211567,SRX5075169,SMARCA4,250
chr1,231211342,231211632,SRX5075168,SMARCA4,290
chr1,231211381,231211713,SRX5075170,SMARCA4,332
chr1,231211396,231211645,SRX5716464,SMARCA4,249
chr1,231240925,231241469,SRX20140895,INTS13,544
chr1,231240942,231241420,SRX5075169,SMARCA4,478
chr1,231240959,231241177,SRX5075175,SMARCA4,218
chr1,231241011,231241386,SRX5075174,SMARCA4,375
chr1,231241047,231241516,SRX5075176,SMARCA4,469
chr1,231241088,231241331,SRX20140867,INTS10,243
chr1,231241112,231241316,SRX5716463,SMARCA4,204
chr1,231241158,231241395,SRX5075168,SMARCA4,237
chr1,231241251,231241462,SRX5716470,SMARCA4,211
chr1,231274317,231274612,SRX5075175,SMARCA4,295
chr1,231274379,231274607,SRX5075169,SMARCA4,228
chr1,231274432,231274647,SRX5075176,SMARCA4,215
chr1,231279133,231279308,SRX5075176,SMARCA4,175
chr1,231279140,231279355,SRX5075170,SMARCA4,215
chr1,231279175,231279384,SRX5054309,FOSL2,209
chr1,231315722,231316146,SRX16500060,CTCF,424
chr1,231315846,231316125,SRX16500059,CTCF,279
chr1,231315851,231316109,SRX16500061,CTCF,258
chr1,231337620,231337903,SRX20140897,INTS13,283
chr1,231338049,231338590,SRX20140895,INTS13,541
chr1,231338068,231338404,SRX5075168,SMARCA4,336
chr1,231338093,231338346,SRX5075170,SMARCA4,253
chr1,231338115,231338349,SRX20140867,INTS10,234
chr1,231338218,231338438,SRX5075176,SMARCA4,220
chr1,231338276,231338488,SRX5075174,SMARCA4,212
chr1,231357741,231358245,SRX16500060,CTCF,504
chr1,231357752,231358234,SRX16500059,CTCF,482
chr1,231357786,231358217,SRX16500062,CTCF,431
chr1,231357794,231358265,SRX16500061,CTCF,471
chr1,231357864,231358200,SRX5075174,SMARCA4,336
chr1,231357869,231358191,SRX5716463,SMARCA4,322
chr1,231357881,231358260,SRX4174629,CTCF,379
chr1,231357910,231358226,SRX5075168,SMARCA4,316
chr1,231357911,231358199,SRX5075176,SMARCA4,288
chr1,231357924,231358135,SRX5075169,SMARCA4,211
chr1,231357946,231358179,SRX5075175,SMARCA4,233
chr1,231357957,231358225,SRX5075170,SMARCA4,268
chr1,231368554,231368920,SRX5075170,SMARCA4,366
chr1,231368555,231368840,SRX5075176,SMARCA4,285
chr1,231368587,231368876,SRX5054308,FOSL2,289
chr1,231368704,231368956,SRX5054309,FOSL2,252
chr1,231388022,231388293,SRX5075169,SMARCA4,271
chr1,231388029,231388333,SRX5054309,FOSL2,304
chr1,231388043,231388329,SRX5075176,SMARCA4,286
chr1,231388044,231388323,SRX5075175,SMARCA4,279
chr1,231388048,231388274,SRX5054308,FOSL2,226
chr1,231388053,231388250,SRX5075170,SMARCA4,197
chr1,231390087,231390389,SRX5054309,FOSL2,302
chr1,231390112,231390368,SRX5075170,SMARCA4,256
chr1,231390122,231390353,SRX5075169,SMARCA4,231
chr1,231390147,231390333,SRX5054308,FOSL2,186
chr1,231390199,231390387,SRX5075176,SMARCA4,188
chr1,231395302,231395996,SRX5075175,SMARCA4,694
chr1,231395307,231395540,SRX5075168,SMARCA4,233
chr1,231395321,231396088,SRX5075169,SMARCA4,767
chr1,231395333,231396057,SRX5075176,SMARCA4,724
chr1,231395335,231396067,SRX5075170,SMARCA4,732
chr1,231395343,231395948,SRX5716469,SMARCA4,605
chr1,231395375,231395828,SRX5075174,SMARCA4,453
chr1,231395375,231396028,SRX5716470,SMARCA4,653
chr1,231395395,231396050,SRX5054309,FOSL2,655
chr1,231395417,231395875,SRX5020214,SMARCA2,458
chr1,231395460,231395889,SRX5716467,SMARCA2,429
chr1,231395468,231395919,SRX5716460,Epitope tags,451
chr1,231395472,231395976,SRX5054308,FOSL2,504
chr1,231395511,231395778,SRX5075181,SMARCA2,267
chr1,231395631,231395906,SRX5075168,SMARCA4,275
chr1,231422018,231422857,SRX20140895,INTS13,839
chr1,231422083,231422263,SRX5075169,SMARCA4,180
chr1,231422212,231422724,SRX20140867,INTS10,512
chr1,231422214,231422797,SRX20140868,INTS10,583
chr1,231422338,231422616,SRX5075169,SMARCA4,278
chr1,231422372,231422936,SRX5075176,SMARCA4,564
chr1,231422383,231422825,SRX5075170,SMARCA4,442
chr1,231422400,231422824,SRX5075174,SMARCA4,424
chr1,231422402,231422724,SRX5075168,SMARCA4,322
chr1,231422424,231422715,SRX20140879,CPSF3L,291
chr1,231422450,231422779,SRX20140897,INTS13,329
chr1,231422489,231422760,SRX16500060,CTCF,271
chr1,231487058,231487278,SRX5054309,FOSL2,220
chr1,231487221,231487390,SRX5075170,SMARCA4,169
chr1,231493501,231493790,SRX5075169,SMARCA4,289
chr1,231493534,231493757,SRX5054308,FOSL2,223
chr1,231493549,231493871,SRX5054309,FOSL2,322
chr1,231493558,231493883,SRX5075170,SMARCA4,325
chr1,231493571,231493920,SRX5075176,SMARCA4,349
chr1,231512330,231512802,SRX5054309,FOSL2,472
chr1,231512399,231512754,SRX5054308,FOSL2,355
chr1,231512431,231512672,SRX5075169,SMARCA4,241
chr1,231528090,231528901,SRX5075174,SMARCA4,811
chr1,231528163,231528892,SRX5075170,SMARCA4,729
chr1,231528226,231528787,SRX5075168,SMARCA4,561
chr1,231528244,231528546,SRX20140879,CPSF3L,302
chr1,231528265,231528555,SRX20140894,INTS13,290
chr1,231528272,231528917,SRX20140895,INTS13,645
chr1,231528293,231528543,SRX20140867,INTS10,250
chr1,231528299,231528561,SRX5716470,SMARCA4,262
chr1,231528330,231528767,SRX5716463,SMARCA4,437
chr1,231528334,231528669,SRX20140868,INTS10,335
chr1,231528336,231528597,SRX20140881,CPSF3L,261
chr1,231528384,231528925,SRX5075176,SMARCA4,541
chr1,231528396,231528618,SRX5716464,SMARCA4,222
chr1,231528416,231528700,SRX20140869,INTS10,284
chr1,231528434,231528641,SRX5075175,SMARCA4,207
chr1,231528498,231528700,SRX5075169,SMARCA4,202
chr1,231528736,231528947,SRX5716470,SMARCA4,211
chr1,231550403,231550663,SRX16500060,CTCF,260
chr1,231550422,231550746,SRX16500061,CTCF,324
chr1,231550487,231550745,SRX16500059,CTCF,258
chr1,231584147,231584472,SRX5075176,SMARCA4,325
chr1,231590552,231590986,SRX16500060,CTCF,434
chr1,231590560,231590967,SRX16500059,CTCF,407
chr1,231590568,231590988,SRX16500062,CTCF,420
chr1,231590570,231591013,SRX16500061,CTCF,443
chr1,231590572,231590798,SRX5716470,SMARCA4,226
chr1,231590589,231590863,SRX5075175,SMARCA4,274
chr1,231590608,231590883,SRX4174629,CTCF,275
chr1,231590610,231590893,SRX5075176,SMARCA4,283
chr1,231590615,231590924,SRX5075170,SMARCA4,309
chr1,231590679,231590859,SRX5075169,SMARCA4,180
chr1,231590718,231590901,SRX5054309,FOSL2,183
chr1,231590721,231590925,SRX5075174,SMARCA4,204
chr1,231600364,231600620,SRX5075176,SMARCA4,256
chr1,231600406,231600582,SRX5075170,SMARCA4,176
chr1,231600722,231601029,SRX5075170,SMARCA4,307
chr1,231601871,231602055,SRX5075176,SMARCA4,184
chr1,231603959,231604482,SRX16500060,CTCF,523
chr1,231603964,231604310,SRX5075168,SMARCA4,346
chr1,231603970,231604499,SRX16500059,CTCF,529
chr1,231603976,231604232,SRX5075169,SMARCA4,256
chr1,231603984,231604244,SRX4174629,CTCF,260
chr1,231603990,231604440,SRX16500062,CTCF,450
chr1,231604000,231604447,SRX16500061,CTCF,447
chr1,231604008,231604258,SRX5716464,SMARCA4,250
chr1,231604024,231604292,SRX5716469,SMARCA4,268
chr1,231604038,231604237,SRX5075175,SMARCA4,199
chr1,231604051,231604269,SRX5075176,SMARCA4,218
chr1,231604060,231604265,SRX5075170,SMARCA4,205
chr1,231604069,231604301,SRX5075174,SMARCA4,232
chr1,231618737,231619080,SRX5716470,SMARCA4,343
chr1,231626379,231626933,SRX5075175,SMARCA4,554
chr1,231626410,231626902,SRX5075174,SMARCA4,492
chr1,231626412,231626968,SRX5075168,SMARCA4,556
chr1,231626417,231626752,SRX5054309,FOSL2,335
chr1,231626427,231626688,SRX5054308,FOSL2,261
chr1,231626441,231626852,SRX5075176,SMARCA4,411
chr1,231626452,231626843,SRX5075169,SMARCA4,391
chr1,231626479,231626895,SRX5075170,SMARCA4,416
chr1,231626491,231626780,SRX5716470,SMARCA4,289
chr1,231626517,231626808,SRX5020214,SMARCA2,291
chr1,231626539,231626880,SRX5716463,SMARCA4,341
chr1,231626571,231626776,SRX5716464,SMARCA4,205
chr1,231626573,231627226,SRX20140895,INTS13,653
chr1,231630506,231630871,SRX5075169,SMARCA4,365
chr1,231630512,231630820,SRX5716470,SMARCA4,308
chr1,231630572,231630827,SRX5716469,SMARCA4,255
chr1,231630572,231630854,SRX5716468,SMARCA2,282
chr1,231630573,231630818,SRX5075176,SMARCA4,245
chr1,231630576,231630863,SRX5716467,SMARCA2,287
chr1,231630589,231630776,SRX5075175,SMARCA4,187
chr1,231630594,231630882,SRX5020211,SMARCA2,288
chr1,231630596,231630830,SRX5054308,FOSL2,234
chr1,231630609,231630858,SRX5075170,SMARCA4,249
chr1,231630670,231630853,SRX5054309,FOSL2,183
chr1,231634371,231634673,SRX5075170,SMARCA4,302
chr1,231634379,231634727,SRX5075176,SMARCA4,348
chr1,231634415,231634630,SRX5716467,SMARCA2,215
chr1,231634422,231634602,SRX5075169,SMARCA4,180
chr1,231636150,231636536,SRX5075169,SMARCA4,386
chr1,231636167,231636521,SRX5075170,SMARCA4,354
chr1,231636174,231636554,SRX5075176,SMARCA4,380
chr1,231636182,231636516,SRX5075175,SMARCA4,334
chr1,231636194,231636497,SRX5075168,SMARCA4,303
chr1,231636196,231636520,SRX5054308,FOSL2,324
chr1,231636225,231636550,SRX5075174,SMARCA4,325
chr1,231636245,231636509,SRX5054309,FOSL2,264
chr1,231636247,231636494,SRX5716469,SMARCA4,247
chr1,231677919,231678177,SRX5054308,FOSL2,258
chr1,231677922,231678196,SRX5054309,FOSL2,274
chr1,231677964,231678152,SRX5075170,SMARCA4,188
chr1,231677981,231678175,SRX5075169,SMARCA4,194
chr1,231678026,231678218,SRX5075176,SMARCA4,192
chr1,231683858,231684121,SRX5075170,SMARCA4,263
chr1,231683861,231684099,SRX5075176,SMARCA4,238
chr1,231684437,231684648,SRX5075170,SMARCA4,211
chr1,231691602,231692034,SRX16500059,CTCF,432
chr1,231691607,231692008,SRX16500060,CTCF,401
chr1,231691609,231691993,SRX16500061,CTCF,384
chr1,231691684,231692048,SRX16500062,CTCF,364
chr1,231691690,231691987,SRX5075170,SMARCA4,297
chr1,231691725,231692006,SRX5075176,SMARCA4,281
chr1,231691736,231691931,SRX5075175,SMARCA4,195
chr1,231705800,231706180,SRX5075176,SMARCA4,380
chr1,231705824,231706174,SRX5075170,SMARCA4,350
chr1,231715875,231716079,SRX5075168,SMARCA4,204
chr1,231715941,231716159,SRX5075174,SMARCA4,218
chr1,231725085,231725520,SRX16500059,CTCF,435
chr1,231725134,231725588,SRX16500061,CTCF,454
chr1,231725190,231725586,SRX16500060,CTCF,396
chr1,231725191,231725460,SRX5716463,SMARCA4,269
chr1,231725195,231725532,SRX16500062,CTCF,337
chr1,231725229,231725568,SRX5075174,SMARCA4,339
chr1,231725267,231725574,SRX5075168,SMARCA4,307
chr1,231729456,231729934,SRX5075170,SMARCA4,478
chr1,231729475,231729938,SRX5716467,SMARCA2,463
chr1,231729494,231729968,SRX5075176,SMARCA4,474
chr1,231729499,231729826,SRX5716468,SMARCA2,327
chr1,231729508,231729834,SRX5075175,SMARCA4,326
chr1,231729549,231729824,SRX5075181,SMARCA2,275
chr1,231729549,231729870,SRX5716470,SMARCA4,321
chr1,231729550,231729889,SRX5020211,SMARCA2,339
chr1,231729559,231730140,SRX5075169,SMARCA4,581
chr1,231729565,231729941,SRX5716469,SMARCA4,376
chr1,231729647,231729827,SRX5054308,FOSL2,180
chr1,231756681,231757241,SRX16500061,CTCF,560
chr1,231756704,231757255,SRX16500059,CTCF,551
chr1,231756710,231757218,SRX16500062,CTCF,508
chr1,231756731,231757211,SRX16500060,CTCF,480
chr1,231756838,231757157,SRX5075168,SMARCA4,319
chr1,231756850,231757129,SRX5075174,SMARCA4,279
chr1,231756857,231757082,SRX5075170,SMARCA4,225
chr1,231756858,231757148,SRX4174629,CTCF,290
chr1,231756862,231757078,SRX5075176,SMARCA4,216
chr1,231756916,231757099,SRX5075169,SMARCA4,183
chr1,231776011,231776458,SRX5716470,SMARCA4,447
chr1,231776040,231776302,SRX5075169,SMARCA4,262
chr1,231776059,231776385,SRX5075170,SMARCA4,326
chr1,231776064,231776454,SRX5716469,SMARCA4,390
chr1,231776089,231776383,SRX5075176,SMARCA4,294
chr1,231776099,231776356,SRX5716467,SMARCA2,257
chr1,231776132,231776354,SRX5075175,SMARCA4,222
chr1,231782088,231782268,SRX5054308,FOSL2,180
chr1,231796241,231796427,SRX5075169,SMARCA4,186
chr1,231806649,231807047,SRX16500062,CTCF,398
chr1,231806671,231806998,SRX16500061,CTCF,327
chr1,231806685,231807075,SRX16500059,CTCF,390
chr1,231806690,231807049,SRX16500060,CTCF,359
chr1,231809115,231809302,SRX5075175,SMARCA4,187
chr1,231809126,231809360,SRX5075169,SMARCA4,234
chr1,231814697,231814872,SRX5075176,SMARCA4,175
chr1,231814697,231814929,SRX5075170,SMARCA4,232
chr1,231827288,231827740,SRX5075169,SMARCA4,452
chr1,231827303,231827660,SRX5054309,FOSL2,357
chr1,231827330,231827644,SRX5054308,FOSL2,314
chr1,231827333,231827730,SRX5075175,SMARCA4,397
chr1,231827362,231827582,SRX5075176,SMARCA4,220
chr1,231827372,231827587,SRX5716467,SMARCA2,215
chr1,231827390,231827667,SRX5716470,SMARCA4,277
chr1,231827395,231827624,SRX5075170,SMARCA4,229
chr1,231828163,231828607,SRX5075169,SMARCA4,444
chr1,231828164,231828544,SRX5075176,SMARCA4,380
chr1,231828214,231828494,SRX5716470,SMARCA4,280
chr1,231828220,231828536,SRX5075170,SMARCA4,316
chr1,231828225,231828563,SRX5716469,SMARCA4,338
chr1,231828235,231828504,SRX5054309,FOSL2,269
chr1,231828241,231828582,SRX5075175,SMARCA4,341
chr1,231841930,231842121,SRX5054309,FOSL2,191
chr1,231841964,231842167,SRX5075170,SMARCA4,203
chr1,231862019,231862495,SRX5075174,SMARCA4,476
chr1,231862078,231862348,SRX20140867,INTS10,270
chr1,231862095,231862519,SRX5075168,SMARCA4,424
chr1,231862110,231862416,SRX5716464,SMARCA4,306
chr1,231862114,231862531,SRX5716463,SMARCA4,417
chr1,231866538,231867093,SRX16500061,CTCF,555
chr1,231866584,231867082,SRX16500060,CTCF,498
chr1,231866604,231867125,SRX16500059,CTCF,521
chr1,231866607,231867088,SRX16500062,CTCF,481
chr1,231866702,231867143,SRX5075174,SMARCA4,441
chr1,231866722,231867028,SRX5075175,SMARCA4,306
chr1,231866727,231867088,SRX5075169,SMARCA4,361
chr1,231866728,231866992,SRX5716470,SMARCA4,264
chr1,231866728,231867042,SRX5075176,SMARCA4,314
chr1,231866729,231867041,SRX5075170,SMARCA4,312
chr1,231866730,231867049,SRX5075168,SMARCA4,319
chr1,231866758,231867030,SRX5716463,SMARCA4,272
chr1,231866779,231867166,SRX4174629,CTCF,387
chr1,231866837,231867049,SRX5716469,SMARCA4,212
chr1,231866867,231867072,SRX5716464,SMARCA4,205
chr1,231872414,231872594,SRX5054308,FOSL2,180
chr1,231872417,231872805,SRX5075175,SMARCA4,388
chr1,231872687,231872897,SRX5075176,SMARCA4,210
chr1,231872729,231872925,SRX5054309,FOSL2,196
chr1,231885194,231885450,SRX5054309,FOSL2,256
chr1,231885229,231885440,SRX5054308,FOSL2,211
chr1,231887890,231888141,SRX5716470,SMARCA4,251
chr1,231899950,231900485,SRX5075168,SMARCA4,535
chr1,231900006,231900500,SRX5075174,SMARCA4,494
chr1,231900116,231900433,SRX5075170,SMARCA4,317
chr1,231900138,231900465,SRX5716463,SMARCA4,327
chr1,231923665,231924596,SRX5075174,SMARCA4,931
chr1,231924056,231924607,SRX5075168,SMARCA4,551
chr1,231924130,231924526,SRX5716454,SOX3,396
chr1,231924195,231924553,SRX5716451,SOX2,358
chr1,231924220,231924505,SRX5716463,SMARCA4,285
chr1,231924223,231924481,SRX20140895,INTS13,258
chr1,231929256,231929645,SRX5075170,SMARCA4,389
chr1,231929265,231929598,SRX5075168,SMARCA4,333
chr1,231929285,231929691,SRX5075176,SMARCA4,406
chr1,231929299,231929614,SRX5716469,SMARCA4,315
chr1,231929310,231929645,SRX5054308,FOSL2,335
chr1,231929316,231929649,SRX5716470,SMARCA4,333
chr1,231929319,231929723,SRX5075169,SMARCA4,404
chr1,231929324,231929577,SRX5716467,SMARCA2,253
chr1,231929325,231929564,SRX5075181,SMARCA2,239
chr1,231929335,231929726,SRX5075174,SMARCA4,391
chr1,231929337,231929630,SRX5054309,FOSL2,293
chr1,231929345,231929570,SRX5020214,SMARCA2,225
chr1,231929361,231929586,SRX5020211,SMARCA2,225
chr1,231929363,231929679,SRX5075175,SMARCA4,316
chr1,231931863,231932293,SRX16500060,CTCF,430
chr1,231931877,231932220,SRX16500062,CTCF,343
chr1,231931879,231932261,SRX16500061,CTCF,382
chr1,231931911,231932263,SRX16500059,CTCF,352
chr1,231937073,231937448,SRX5054308,FOSL2,375
chr1,231937163,231937346,SRX5054309,FOSL2,183
chr1,231937229,231937545,SRX5075169,SMARCA4,316
chr1,231937233,231937616,SRX5075176,SMARCA4,383
chr1,231937264,231937706,SRX5075170,SMARCA4,442
chr1,231937313,231937594,SRX5716470,SMARCA4,281
chr1,231937346,231937808,SRX5075174,SMARCA4,462
chr1,231937361,231937593,SRX5075175,SMARCA4,232
chr1,231937396,231937798,SRX5075168,SMARCA4,402
chr1,231937435,231937649,SRX5716464,SMARCA4,214
chr1,231937438,231937675,SRX5716463,SMARCA4,237
chr1,231949485,231949789,SRX16500059,CTCF,304
chr1,231949498,231949776,SRX16500060,CTCF,278
chr1,231951397,231951651,SRX5075170,SMARCA4,254
chr1,231951448,231951773,SRX5054309,FOSL2,325
chr1,231951497,231951687,SRX5075169,SMARCA4,190
chr1,231951539,231951753,SRX5054308,FOSL2,214
chr1,231959327,231959514,SRX5075176,SMARCA4,187
chr1,231959330,231959499,SRX5075170,SMARCA4,169
chr1,231971362,231971742,SRX5075170,SMARCA4,380
chr1,231971400,231971773,SRX5075169,SMARCA4,373
chr1,231971404,231971692,SRX5054309,FOSL2,288
chr1,231971408,231971730,SRX5054308,FOSL2,322
chr1,231971415,231971622,SRX5020211,SMARCA2,207
chr1,231971420,231971729,SRX5075176,SMARCA4,309
chr1,231971426,231971775,SRX5075175,SMARCA4,349
chr1,231991372,231991555,SRX5075176,SMARCA4,183
chr1,232012794,232013441,SRX5075170,SMARCA4,647
chr1,232012839,232013470,SRX5075176,SMARCA4,631
chr1,232013050,232013285,SRX5716470,SMARCA4,235
chr1,232013081,232013392,SRX5075169,SMARCA4,311
chr1,232013111,232013464,SRX5054308,FOSL2,353
chr1,232013130,232013419,SRX5075175,SMARCA4,289
chr1,232013165,232013377,SRX5716469,SMARCA4,212
chr1,232013188,232013386,SRX5054309,FOSL2,198
chr1,232013191,232013426,SRX5716467,SMARCA2,235
chr1,232029435,232029650,SRX5075168,SMARCA4,215
chr1,232029548,232029746,SRX5075174,SMARCA4,198
chr1,232110142,232110510,SRX5716470,SMARCA4,368
chr1,232110147,232110388,SRX5020211,SMARCA2,241
chr1,232110183,232110511,SRX5075176,SMARCA4,328
chr1,232110200,232110393,SRX5075169,SMARCA4,193
chr1,232110220,232110435,SRX5716467,SMARCA2,215
chr1,232110247,232110434,SRX5054308,FOSL2,187
chr1,232110594,232111082,SRX5075175,SMARCA4,488
chr1,232110644,232111107,SRX5075176,SMARCA4,463
chr1,232110650,232110923,SRX5075174,SMARCA4,273
chr1,232110679,232111103,SRX5075169,SMARCA4,424
chr1,232110737,232110981,SRX5075168,SMARCA4,244
chr1,232110830,232111172,SRX5075170,SMARCA4,342
chr1,232111724,232111980,SRX5075169,SMARCA4,256
chr1,232111792,232111995,SRX5075175,SMARCA4,203
chr1,232124320,232124515,SRX5075170,SMARCA4,195
chr1,232124330,232124785,SRX5075174,SMARCA4,455
chr1,232124353,232124888,SRX5075168,SMARCA4,535
chr1,232124354,232124544,SRX5075169,SMARCA4,190
chr1,232124366,232124573,SRX5716451,SOX2,207
chr1,232127262,232127502,SRX5054309,FOSL2,240
chr1,232127289,232127477,SRX5075176,SMARCA4,188
chr1,232127308,232127521,SRX5075175,SMARCA4,213
chr1,232127362,232127535,SRX5075174,SMARCA4,173
chr1,232127396,232127565,SRX5075170,SMARCA4,169
chr1,232142438,232142930,SRX5075169,SMARCA4,492
chr1,232142439,232142835,SRX5075175,SMARCA4,396
chr1,232142489,232142741,SRX5716469,SMARCA4,252
chr1,232142492,232142748,SRX5716470,SMARCA4,256
chr1,232142515,232142760,SRX5075176,SMARCA4,245
chr1,232142533,232142782,SRX5075170,SMARCA4,249
chr1,232142547,232142749,SRX5054309,FOSL2,202
chr1,232142547,232142818,SRX5716467,SMARCA2,271
chr1,232149840,232150079,SRX5054308,FOSL2,239
chr1,232149970,232150235,SRX5054309,FOSL2,265
chr1,232150006,232150295,SRX5075175,SMARCA4,289
chr1,232150016,232150235,SRX5075169,SMARCA4,219
chr1,232160725,232160966,SRX5716469,SMARCA4,241
chr1,232160764,232160990,SRX5075169,SMARCA4,226
chr1,232160840,232161010,SRX5075170,SMARCA4,170
chr1,232186729,232187270,SRX5075169,SMARCA4,541
chr1,232186746,232187145,SRX5054309,FOSL2,399
chr1,232186802,232187215,SRX5075170,SMARCA4,413
chr1,232186871,232187291,SRX5075175,SMARCA4,420
chr1,232186884,232187185,SRX5075176,SMARCA4,301
chr1,232186984,232187170,SRX5054308,FOSL2,186
chr1,232211176,232211434,SRX16500060,CTCF,258
chr1,232211247,232211478,SRX16500061,CTCF,231
chr1,232226041,232226466,SRX5075176,SMARCA4,425
chr1,232226102,232226409,SRX5075169,SMARCA4,307
chr1,232226122,232226483,SRX5075170,SMARCA4,361
chr1,232226145,232226494,SRX5075175,SMARCA4,349
chr1,232226222,232226427,SRX5075168,SMARCA4,205
chr1,232227203,232227602,SRX5075168,SMARCA4,399
chr1,232227249,232227588,SRX5075174,SMARCA4,339
chr1,232281049,232281376,SRX5075174,SMARCA4,327
chr1,232300541,232300873,SRX5020211,SMARCA2,332
chr1,232300580,232300767,SRX5075175,SMARCA4,187
chr1,232300585,232300851,SRX5716470,SMARCA4,266
chr1,232300638,232300832,SRX5075181,SMARCA2,194
chr1,232306483,232306731,SRX5075170,SMARCA4,248
chr1,232307567,232307781,SRX5075169,SMARCA4,214
chr1,232307617,232307815,SRX5054308,FOSL2,198
chr1,232327223,232327936,SRX5075170,SMARCA4,713
chr1,232327240,232327503,SRX5054308,FOSL2,263
chr1,232327243,232327836,SRX5075176,SMARCA4,593
chr1,232327244,232327719,SRX5716468,SMARCA2,475
chr1,232327258,232327724,SRX5075169,SMARCA4,466
chr1,232327266,232327785,SRX5716469,SMARCA4,519
chr1,232327272,232327735,SRX5716470,SMARCA4,463
chr1,232327273,232327692,SRX5716467,SMARCA2,419
chr1,232327275,232327645,SRX5075181,SMARCA2,370
chr1,232327285,232327556,SRX5020214,SMARCA2,271
chr1,232327299,232327648,SRX5020211,SMARCA2,349
chr1,232327321,232327740,SRX5075175,SMARCA4,419
chr1,232327416,232327625,SRX5054309,FOSL2,209
chr1,232353018,232353344,SRX5054309,FOSL2,326
chr1,232353026,232353282,SRX5075170,SMARCA4,256
chr1,232353050,232353313,SRX5054308,FOSL2,263
chr1,232353105,232353281,SRX5075176,SMARCA4,176
chr1,232369652,232369893,SRX5075170,SMARCA4,241
chr1,232377367,232377729,SRX5075174,SMARCA4,362
chr1,232377380,232377713,SRX5075169,SMARCA4,333
chr1,232377397,232377754,SRX5054309,FOSL2,357
chr1,232377402,232377707,SRX5054308,FOSL2,305
chr1,232377429,232377722,SRX5075168,SMARCA4,293
chr1,232377449,232377711,SRX5075176,SMARCA4,262
chr1,232377467,232377727,SRX5075170,SMARCA4,260
chr1,232377480,232377723,SRX5075175,SMARCA4,243
chr1,232385198,232385506,SRX5075169,SMARCA4,308
chr1,232385254,232385529,SRX5054308,FOSL2,275
chr1,232385259,232385604,SRX5075175,SMARCA4,345
chr1,232385270,232385540,SRX5075170,SMARCA4,270
chr1,232385270,232385562,SRX5075176,SMARCA4,292
chr1,232385279,232385462,SRX5054309,FOSL2,183
chr1,232393131,232393300,SRX5075170,SMARCA4,169
chr1,232405870,232406056,SRX5075176,SMARCA4,186
chr1,232426879,232427131,SRX5075174,SMARCA4,252
chr1,232426889,232427182,SRX5075168,SMARCA4,293
chr1,232438362,232438814,SRX5075170,SMARCA4,452
chr1,232438397,232438791,SRX5716470,SMARCA4,394
chr1,232438408,232438809,SRX5075169,SMARCA4,401
chr1,232438437,232438831,SRX5075176,SMARCA4,394
chr1,232438443,232438803,SRX5075174,SMARCA4,360
chr1,232438471,232438771,SRX5716469,SMARCA4,300
chr1,232438500,232438793,SRX5075175,SMARCA4,293
chr1,232438500,232438848,SRX5716468,SMARCA2,348
chr1,232438520,232438760,SRX5716467,SMARCA2,240
chr1,232438530,232438788,SRX5075168,SMARCA4,258
chr1,232450660,232450978,SRX5075176,SMARCA4,318
chr1,232450684,232450991,SRX5075170,SMARCA4,307
chr1,232450685,232450908,SRX5716469,SMARCA4,223
chr1,232450708,232450919,SRX5075169,SMARCA4,211
chr1,232450722,232450946,SRX5054308,FOSL2,224
chr1,232450740,232451007,SRX5075175,SMARCA4,267
chr1,232450747,232450949,SRX5054309,FOSL2,202
chr1,232454358,232454899,SRX5075168,SMARCA4,541
chr1,232454385,232454992,SRX5075174,SMARCA4,607
chr1,232454395,232454895,SRX5716463,SMARCA4,500
chr1,232454488,232454812,SRX5716451,SOX2,324
chr1,232454523,232454801,SRX5716454,SOX3,278
chr1,232454570,232454858,SRX5716464,SMARCA4,288
chr1,232462372,232462668,SRX5075174,SMARCA4,296
chr1,232472595,232473018,SRX5075174,SMARCA4,423
chr1,232472652,232473069,SRX5075175,SMARCA4,417
chr1,232472657,232473055,SRX5075168,SMARCA4,398
chr1,232472675,232473039,SRX5075169,SMARCA4,364
chr1,232472727,232473052,SRX5075170,SMARCA4,325
chr1,232472737,232473081,SRX5075176,SMARCA4,344
chr1,232472750,232473078,SRX5054308,FOSL2,328
chr1,232472752,232473062,SRX5054309,FOSL2,310
chr1,232472755,232473068,SRX5020211,SMARCA2,313
chr1,232472799,232473103,SRX5716467,SMARCA2,304
chr1,232473273,232473563,SRX5075174,SMARCA4,290
chr1,232473314,232473662,SRX5075168,SMARCA4,348
chr1,232477628,232478212,SRX5075176,SMARCA4,584
chr1,232477646,232478148,SRX5716470,SMARCA4,502
chr1,232477654,232478222,SRX5075170,SMARCA4,568
chr1,232477658,232478215,SRX5075169,SMARCA4,557
chr1,232477672,232478188,SRX5075175,SMARCA4,516
chr1,232477716,232478158,SRX5054309,FOSL2,442
chr1,232477721,232478119,SRX5716469,SMARCA4,398
chr1,232477734,232478118,SRX5716467,SMARCA2,384
chr1,232477739,232478042,SRX5716468,SMARCA2,303
chr1,232477769,232478161,SRX5054308,FOSL2,392
chr1,232477793,232478066,SRX5075174,SMARCA4,273
chr1,232477822,232478109,SRX5075168,SMARCA4,287
chr1,232477854,232478105,SRX5075181,SMARCA2,251
chr1,232477909,232478132,SRX5020214,SMARCA2,223
chr1,232483986,232484279,SRX5075176,SMARCA4,293
chr1,232483986,232484303,SRX5075170,SMARCA4,317
chr1,232484482,232484699,SRX5075176,SMARCA4,217
chr1,232538232,232538658,SRX5075168,SMARCA4,426
chr1,232538256,232538687,SRX5075174,SMARCA4,431
chr1,232538259,232538582,SRX5075169,SMARCA4,323
chr1,232538267,232538474,SRX5054309,FOSL2,207
chr1,232538268,232538488,SRX5054307,FOSL2,220
chr1,232538273,232538569,SRX5716463,SMARCA4,296
chr1,232538289,232538530,SRX5075175,SMARCA4,241
chr1,232538295,232538516,SRX5054308,FOSL2,221
chr1,232538572,232538861,SRX5075170,SMARCA4,289
chr1,232538656,232538900,SRX5054309,FOSL2,244
chr1,232538690,232538945,SRX5075169,SMARCA4,255
chr1,232538786,232538988,SRX5054308,FOSL2,202
chr1,232538824,232539004,SRX5075176,SMARCA4,180
chr1,232551451,232551712,SRX5075169,SMARCA4,261
chr1,232551464,232551698,SRX5716468,SMARCA2,234
chr1,232551510,232551721,SRX5716470,SMARCA4,211
chr1,232551527,232551747,SRX5020211,SMARCA2,220
chr1,232551534,232551786,SRX5054309,FOSL2,252
chr1,232551536,232551777,SRX5054308,FOSL2,241
chr1,232551555,232551724,SRX5075170,SMARCA4,169
chr1,232555483,232556030,SRX5075174,SMARCA4,547
chr1,232555663,232556075,SRX5075168,SMARCA4,412
chr1,232574905,232575120,SRX5075170,SMARCA4,215
chr1,232574908,232575273,SRX5075176,SMARCA4,365
chr1,232575271,232575741,SRX5075175,SMARCA4,470
chr1,232575480,232575837,SRX5075176,SMARCA4,357
chr1,232575541,232575732,SRX5075169,SMARCA4,191
chr1,232575644,232575840,SRX5075170,SMARCA4,196
chr1,232578631,232579051,SRX5075174,SMARCA4,420
chr1,232578652,232578952,SRX5075168,SMARCA4,300
chr1,232594332,232594513,SRX5075170,SMARCA4,181
chr1,232595120,232595777,SRX5075174,SMARCA4,657
chr1,232595161,232595758,SRX5075168,SMARCA4,597
chr1,232595232,232595538,SRX20140868,INTS10,306
chr1,232595246,232595575,SRX20140895,INTS13,329
chr1,232595303,232595578,SRX5716463,SMARCA4,275
chr1,232595309,232595588,SRX5716451,SOX2,279
chr1,232613738,232614178,SRX5075169,SMARCA4,440
chr1,232613767,232614166,SRX5075170,SMARCA4,399
chr1,232613772,232614109,SRX5075176,SMARCA4,337
chr1,232613777,232614288,SRX5716470,SMARCA4,511
chr1,232613778,232614220,SRX5075175,SMARCA4,442
chr1,232613796,232614076,SRX5020214,SMARCA2,280
chr1,232613798,232614208,SRX5716469,SMARCA4,410
chr1,232613811,232614033,SRX5054308,FOSL2,222
chr1,232613823,232614111,SRX5054309,FOSL2,288
chr1,232613830,232614176,SRX5716467,SMARCA2,346
chr1,232613855,232614092,SRX5716468,SMARCA2,237
chr1,232613863,232614084,SRX5020211,SMARCA2,221
chr1,232613864,232614058,SRX5075181,SMARCA2,194
chr1,232614461,232614630,SRX5075170,SMARCA4,169
chr1,232615366,232615732,SRX5075168,SMARCA4,366
chr1,232615452,232615685,SRX5075174,SMARCA4,233
chr1,232620409,232620815,SRX5075169,SMARCA4,406
chr1,232620442,232620923,SRX5075170,SMARCA4,481
chr1,232620508,232620823,SRX5716467,SMARCA2,315
chr1,232620530,232620928,SRX5075176,SMARCA4,398
chr1,232620560,232620805,SRX5716470,SMARCA4,245
chr1,232627650,232627978,SRX16500061,CTCF,328
chr1,232627654,232628057,SRX16500060,CTCF,403
chr1,232627675,232628039,SRX16500059,CTCF,364
chr1,232627681,232628011,SRX16500062,CTCF,330
chr1,232630042,232630865,SRX20140895,INTS13,823
chr1,232630131,232630410,SRX5075174,SMARCA4,279
chr1,232630314,232630740,SRX20140868,INTS10,426
chr1,232630448,232630878,SRX16500060,CTCF,430
chr1,232630518,232630933,SRX16500061,CTCF,415
chr1,232630527,232631034,SRX5075174,SMARCA4,507
chr1,232630601,232631010,SRX5075168,SMARCA4,409
chr1,232630633,232630894,SRX16500059,CTCF,261
chr1,232630641,232630908,SRX16500062,CTCF,267
chr1,232630660,232630919,SRX5075176,SMARCA4,259
chr1,232630680,232630969,SRX5075175,SMARCA4,289
chr1,232630694,232630943,SRX5075170,SMARCA4,249
chr1,232630753,232630951,SRX5075169,SMARCA4,198
chr1,232635646,232636162,SRX16500061,CTCF,516
chr1,232635655,232636233,SRX16500059,CTCF,578
chr1,232635690,232636227,SRX16500060,CTCF,537
chr1,232635719,232636177,SRX16500062,CTCF,458
chr1,232635853,232636114,SRX5075176,SMARCA4,261
chr1,232635861,232636063,SRX5075168,SMARCA4,202
chr1,232635873,232636112,SRX5075174,SMARCA4,239
chr1,232635878,232636084,SRX5075170,SMARCA4,206
chr1,232635895,232636095,SRX5075169,SMARCA4,200
chr1,232641734,232641914,SRX5075169,SMARCA4,180
chr1,232641957,232642541,SRX5716469,SMARCA4,584
chr1,232641986,232642419,SRX5075170,SMARCA4,433
chr1,232641989,232642287,SRX5716467,SMARCA2,298
chr1,232641992,232642219,SRX5075181,SMARCA2,227
chr1,232642007,232642336,SRX5075169,SMARCA4,329
chr1,232642026,232642392,SRX5075176,SMARCA4,366
chr1,232642053,232642294,SRX5716470,SMARCA4,241
chr1,232642065,232642264,SRX5075175,SMARCA4,199
chr1,232642077,232642257,SRX5054308,FOSL2,180
chr1,232642089,232642351,SRX5020211,SMARCA2,262
chr1,232655540,232655740,SRX5054309,FOSL2,200
chr1,232667526,232668023,SRX5075170,SMARCA4,497
chr1,232667638,232667979,SRX5075176,SMARCA4,341
chr1,232670383,232670653,SRX5075169,SMARCA4,270
chr1,232670385,232670711,SRX5075170,SMARCA4,326
chr1,232670393,232670766,SRX5075175,SMARCA4,373
chr1,232670407,232670670,SRX5054308,FOSL2,263
chr1,232670425,232670637,SRX5020211,SMARCA2,212
chr1,232670435,232670709,SRX5075176,SMARCA4,274
chr1,232670450,232670665,SRX5716469,SMARCA4,215
chr1,232670483,232670742,SRX5054309,FOSL2,259
chr1,232684682,232684916,SRX5075169,SMARCA4,234
chr1,232684723,232685022,SRX5054309,FOSL2,299
chr1,232684738,232684926,SRX5075176,SMARCA4,188
chr1,232684761,232685050,SRX5054308,FOSL2,289
chr1,232684770,232685026,SRX5075175,SMARCA4,256
chr1,232704706,232705198,SRX5075168,SMARCA4,492
chr1,232704719,232705148,SRX5075176,SMARCA4,429
chr1,232704730,232705136,SRX5075169,SMARCA4,406
chr1,232704741,232705135,SRX5075175,SMARCA4,394
chr1,232704754,232705169,SRX5075170,SMARCA4,415
chr1,232704769,232705174,SRX5716469,SMARCA4,405
chr1,232704777,232705147,SRX5075174,SMARCA4,370
chr1,232704780,232705164,SRX5054309,FOSL2,384
chr1,232704803,232705145,SRX5054308,FOSL2,342
chr1,232704813,232705049,SRX5020214,SMARCA2,236
chr1,232704815,232705052,SRX5716467,SMARCA2,237
chr1,232704834,232705073,SRX5716470,SMARCA4,239
chr1,232709313,232709739,SRX5075176,SMARCA4,426
chr1,232709349,232709782,SRX5075170,SMARCA4,433
chr1,232709413,232709643,SRX5075175,SMARCA4,230
chr1,232709420,232709663,SRX5054308,FOSL2,243
chr1,232709422,232709784,SRX5075169,SMARCA4,362
chr1,232719102,232719294,SRX5075174,SMARCA4,192
chr1,232726515,232726799,SRX5020211,SMARCA2,284
chr1,232726525,232726769,SRX5054308,FOSL2,244
chr1,232728483,232728844,SRX5075170,SMARCA4,361
chr1,232728502,232728884,SRX5075176,SMARCA4,382
chr1,232728533,232728825,SRX5075175,SMARCA4,292
chr1,232728594,232728857,SRX5716469,SMARCA4,263
chr1,232728610,232728838,SRX5075169,SMARCA4,228
chr1,232751762,232752227,SRX5075170,SMARCA4,465
chr1,232751780,232752144,SRX5075176,SMARCA4,364
chr1,232767419,232767675,SRX5075176,SMARCA4,256
chr1,232767431,232767675,SRX5075175,SMARCA4,244
chr1,232767436,232767752,SRX5054309,FOSL2,316
chr1,232767443,232767731,SRX5075169,SMARCA4,288
chr1,232767474,232767741,SRX5075170,SMARCA4,267
chr1,232767515,232767703,SRX5054308,FOSL2,188
chr1,232769865,232770186,SRX5075170,SMARCA4,321
chr1,232769868,232770131,SRX5075176,SMARCA4,263
chr1,232793836,232794044,SRX5075168,SMARCA4,208
chr1,232793874,232794286,SRX5075176,SMARCA4,412
chr1,232793879,232794378,SRX5075175,SMARCA4,499
chr1,232793893,232794168,SRX5054309,FOSL2,275
chr1,232793907,232794272,SRX5075170,SMARCA4,365
chr1,232793912,232794129,SRX5716469,SMARCA4,217
chr1,232793914,232794242,SRX5075169,SMARCA4,328
chr1,232793935,232794150,SRX5716467,SMARCA2,215
chr1,232793955,232794161,SRX5054308,FOSL2,206
chr1,232794005,232794223,SRX5716470,SMARCA4,218
chr1,232805236,232805596,SRX20140869,INTS10,360
chr1,232805356,232805570,SRX20140867,INTS10,214
chr1,232805365,232805692,SRX20140895,INTS13,327
chr1,232822453,232822885,SRX5075169,SMARCA4,432
chr1,232822529,232822952,SRX5075170,SMARCA4,423
chr1,232822544,232823000,SRX5075176,SMARCA4,456
chr1,232822578,232822839,SRX5075175,SMARCA4,261
chr1,232837019,232837391,SRX5075176,SMARCA4,372
chr1,232837038,232837373,SRX5054308,FOSL2,335
chr1,232837052,232837429,SRX5054309,FOSL2,377
chr1,232837113,232837376,SRX5075170,SMARCA4,263
chr1,232837146,232837391,SRX5075169,SMARCA4,245
chr1,232837147,232837391,SRX5075175,SMARCA4,244
chr1,232845380,232845948,SRX5075168,SMARCA4,568
chr1,232845406,232845905,SRX5075174,SMARCA4,499
chr1,232845414,232845811,SRX5075170,SMARCA4,397
chr1,232845486,232845798,SRX5716464,SMARCA4,312
chr1,232845498,232845901,SRX5075176,SMARCA4,403
chr1,232845503,232845874,SRX5716463,SMARCA4,371
chr1,232854068,232854407,SRX5075169,SMARCA4,339
chr1,232854162,232854558,SRX5075175,SMARCA4,396
chr1,232854192,232854387,SRX5054309,FOSL2,195
chr1,232854204,232854436,SRX5075170,SMARCA4,232
chr1,232854270,232854494,SRX5075176,SMARCA4,224
chr1,232868842,232869514,SRX5075170,SMARCA4,672
chr1,232868855,232869570,SRX5075176,SMARCA4,715
chr1,232868889,232869534,SRX5716470,SMARCA4,645
chr1,232868907,232869507,SRX5075175,SMARCA4,600
chr1,232868922,232869499,SRX5716469,SMARCA4,577
chr1,232868927,232869298,SRX5020211,SMARCA2,371
chr1,232868943,232869487,SRX5075169,SMARCA4,544
chr1,232868966,232869297,SRX5716467,SMARCA2,331
chr1,232868974,232869499,SRX5054309,FOSL2,525
chr1,232868979,232869400,SRX5020214,SMARCA2,421
chr1,232868992,232869420,SRX5716468,SMARCA2,428
chr1,232868999,232869285,SRX5075182,SMARCA2,286
chr1,232869006,232869249,SRX5075181,SMARCA2,243
chr1,232869059,232869415,SRX5054308,FOSL2,356
chr1,232875589,232875814,SRX5075170,SMARCA4,225
chr1,232875619,232875879,SRX5075176,SMARCA4,260
chr1,232880282,232880663,SRX16500059,CTCF,381
chr1,232880354,232880755,SRX16500060,CTCF,401
chr1,232880365,232880735,SRX16500061,CTCF,370
chr1,232880385,232880661,SRX5075174,SMARCA4,276
chr1,232880399,232880611,SRX4174629,CTCF,212
chr1,232880399,232880681,SRX16500062,CTCF,282
chr1,232880402,232880713,SRX5075168,SMARCA4,311
chr1,232880429,232880634,SRX5716464,SMARCA4,205
chr1,232880494,232880663,SRX5075170,SMARCA4,169
chr1,232890453,232890661,SRX5075174,SMARCA4,208
chr1,232890933,232891558,SRX5075169,SMARCA4,625
chr1,232890950,232891517,SRX5716469,SMARCA4,567
chr1,232890955,232891487,SRX5075176,SMARCA4,532
chr1,232890955,232891557,SRX5054309,FOSL2,602
chr1,232890964,232891538,SRX5075170,SMARCA4,574
chr1,232890982,232891566,SRX5716459,Epitope tags,584
chr1,232890983,232891536,SRX5716467,SMARCA2,553
chr1,232890986,232891561,SRX5075175,SMARCA4,575
chr1,232891135,232891511,SRX5716470,SMARCA4,376
chr1,232891164,232891524,SRX5054308,FOSL2,360
chr1,232891177,232891446,SRX5075181,SMARCA2,269
chr1,232891189,232891443,SRX5716468,SMARCA2,254
chr1,232891239,232891445,SRX5020211,SMARCA2,206
chr1,232891240,232891449,SRX5020214,SMARCA2,209
chr1,232891393,232891697,SRX5716460,Epitope tags,304
chr1,232904594,232904869,SRX5075169,SMARCA4,275
chr1,232904598,232904881,SRX5075176,SMARCA4,283
chr1,232904600,232904828,SRX5075175,SMARCA4,228
chr1,232904648,232904873,SRX5075170,SMARCA4,225
chr1,232904661,232904873,SRX5716469,SMARCA4,212
chr1,232904670,232904863,SRX5054309,FOSL2,193
chr1,232921349,232921634,SRX5075170,SMARCA4,285
chr1,232921359,232921756,SRX5716470,SMARCA4,397
chr1,232921369,232921608,SRX5075169,SMARCA4,239
chr1,232921379,232921674,SRX5716469,SMARCA4,295
chr1,232922529,232922835,SRX5075169,SMARCA4,306
chr1,232922596,232922828,SRX5054309,FOSL2,232
chr1,232922598,232922851,SRX5054308,FOSL2,253
chr1,232922600,232922823,SRX5075176,SMARCA4,223
chr1,232922642,232922828,SRX5075170,SMARCA4,186
chr1,232922652,232922845,SRX5075175,SMARCA4,193
chr1,232950079,232950524,SRX5075170,SMARCA4,445
chr1,232950089,232950446,SRX5716463,SMARCA4,357
chr1,232950107,232950366,SRX5075169,SMARCA4,259
chr1,232950107,232950590,SRX5075174,SMARCA4,483
chr1,232950117,232950486,SRX20140895,INTS13,369
chr1,232950119,232950309,SRX5716451,SOX2,190
chr1,232950129,232950510,SRX5075168,SMARCA4,381
chr1,232950143,232950473,SRX5075176,SMARCA4,330
chr1,232950146,232950478,SRX5716470,SMARCA4,332
chr1,232950161,232950378,SRX5716469,SMARCA4,217
chr1,232950622,232950887,SRX20140895,INTS13,265
chr1,232952889,232953298,SRX16500060,CTCF,409
chr1,232952911,232953257,SRX16500059,CTCF,346
chr1,232952930,232953112,SRX5075168,SMARCA4,182
chr1,232952931,232953295,SRX16500061,CTCF,364
chr1,232952932,232953306,SRX16500062,CTCF,374
chr1,232952955,232953159,SRX5075174,SMARCA4,204
chr1,232962926,232963190,SRX5075168,SMARCA4,264
chr1,233005654,233005941,SRX5075170,SMARCA4,287
chr1,233005685,233006060,SRX5075176,SMARCA4,375
chr1,233005734,233006024,SRX5075175,SMARCA4,290
chr1,233005774,233005989,SRX5075169,SMARCA4,215
chr1,233018389,233018583,SRX5054308,FOSL2,194
chr1,233019914,233020185,SRX5075174,SMARCA4,271
chr1,233020026,233020205,SRX5075176,SMARCA4,179
chr1,233020509,233020682,SRX5075174,SMARCA4,173
chr1,233020618,233020867,SRX5075170,SMARCA4,249
chr1,233020680,233020879,SRX5075176,SMARCA4,199
chr1,233025097,233025628,SRX16500059,CTCF,531
chr1,233025193,233025591,SRX16500060,CTCF,398
chr1,233025220,233025589,SRX16500062,CTCF,369
chr1,233025256,233025529,SRX16500061,CTCF,273
chr1,233037852,233038129,SRX5075168,SMARCA4,277
chr1,233037913,233038177,SRX5075174,SMARCA4,264
chr1,233045532,233045827,SRX5075176,SMARCA4,295
chr1,233045536,233045839,SRX5075174,SMARCA4,303
chr1,233045581,233045840,SRX5075168,SMARCA4,259
chr1,233045626,233046029,SRX5075170,SMARCA4,403
chr1,233045658,233045842,SRX5075169,SMARCA4,184
chr1,233045691,233045892,SRX5075175,SMARCA4,201
chr1,233075014,233075506,SRX5075169,SMARCA4,492
chr1,233075061,233075366,SRX5075175,SMARCA4,305
chr1,233075066,233075368,SRX5054309,FOSL2,302
chr1,233075103,233075419,SRX5716469,SMARCA4,316
chr1,233075110,233075362,SRX5054308,FOSL2,252
chr1,233075131,233075422,SRX5075170,SMARCA4,291
chr1,233075182,233075396,SRX5075176,SMARCA4,214
chr1,233081526,233082312,SRX5075176,SMARCA4,786
chr1,233081527,233082230,SRX5075170,SMARCA4,703
chr1,233081646,233081879,SRX5716470,SMARCA4,233
chr1,233081649,233082015,SRX5054308,FOSL2,366
chr1,233081684,233082095,SRX5075175,SMARCA4,411
chr1,233081705,233081989,SRX5075169,SMARCA4,284
chr1,233081769,233081970,SRX5075168,SMARCA4,201
chr1,233094875,233095048,SRX5075174,SMARCA4,173
chr1,233097917,233098224,SRX5054309,FOSL2,307
chr1,233097959,233098264,SRX5075169,SMARCA4,305
chr1,233097979,233098247,SRX5054308,FOSL2,268
chr1,233098018,233098219,SRX5075176,SMARCA4,201
chr1,233098041,233098331,SRX5075175,SMARCA4,290
chr1,233098089,233098296,SRX5075170,SMARCA4,207
chr1,233112792,233113731,SRX5075176,SMARCA4,939
chr1,233112803,233113835,SRX5075169,SMARCA4,1032
chr1,233112838,233113807,SRX5075170,SMARCA4,969
chr1,233112842,233113794,SRX5716470,SMARCA4,952
chr1,233112854,233113947,SRX5075174,SMARCA4,1093
chr1,233112856,233113887,SRX5075168,SMARCA4,1031
chr1,233112890,233113764,SRX5075175,SMARCA4,874
chr1,233112898,233113750,SRX5054309,FOSL2,852
chr1,233112898,233113766,SRX5716469,SMARCA4,868
chr1,233112944,233113736,SRX5054308,FOSL2,792
chr1,233112949,233113750,SRX5716468,SMARCA2,801
chr1,233112955,233113513,SRX5020211,SMARCA2,558
chr1,233112969,233113338,SRX5716467,SMARCA2,369
chr1,233113012,233113260,SRX5075182,SMARCA2,248
chr1,233113047,233113296,SRX5020214,SMARCA2,249
chr1,233113067,233113345,SRX5075181,SMARCA2,278
chr1,233113338,233113707,SRX20140869,INTS10,369
chr1,233113433,233113631,SRX5075181,SMARCA2,198
chr1,233113472,233113755,SRX5716463,SMARCA4,283
chr1,233113485,233113703,SRX5054307,FOSL2,218
chr1,233113516,233113811,SRX5716460,Epitope tags,295
chr1,233113557,233113792,SRX5716464,SMARCA4,235
chr1,233122186,233122485,SRX5075169,SMARCA4,299
chr1,233122230,233122531,SRX5075175,SMARCA4,301
chr1,233122278,233122582,SRX5054309,FOSL2,304
chr1,233122339,233122567,SRX5054308,FOSL2,228
chr1,233139166,233139512,SRX5075170,SMARCA4,346
chr1,233139242,233139505,SRX5075176,SMARCA4,263
chr1,233139245,233139501,SRX5054309,FOSL2,256
chr1,233139269,233139473,SRX5075169,SMARCA4,204
chr1,233183639,233183978,SRX5075174,SMARCA4,339
chr1,233183645,233184039,SRX5075168,SMARCA4,394
chr1,233183696,233183900,SRX5054309,FOSL2,204
chr1,233224430,233224637,SRX5075169,SMARCA4,207
chr1,233240418,233240654,SRX5075170,SMARCA4,236
chr1,233240943,233241466,SRX4174629,CTCF,523
chr1,233241049,233241471,SRX16500059,CTCF,422
chr1,233241051,233241440,SRX16500062,CTCF,389
chr1,233241054,233241439,SRX16500061,CTCF,385
chr1,233241074,233241456,SRX16500060,CTCF,382
chr1,233241126,233241420,SRX5075174,SMARCA4,294
chr1,233241140,233241341,SRX5075168,SMARCA4,201
chr1,233244306,233244486,SRX5054308,FOSL2,180
chr1,233253778,233254050,SRX5075168,SMARCA4,272
chr1,233253827,233254182,SRX5075174,SMARCA4,355
chr1,233261200,233261572,SRX5075174,SMARCA4,372
chr1,233261286,233261548,SRX5075168,SMARCA4,262
chr1,233281708,233281895,SRX5075175,SMARCA4,187
chr1,233292190,233292512,SRX5075170,SMARCA4,322
chr1,233292260,233292554,SRX5075176,SMARCA4,294
chr1,233292268,233292534,SRX5075169,SMARCA4,266
chr1,233293686,233293967,SRX5075169,SMARCA4,281
chr1,233293744,233293959,SRX5075176,SMARCA4,215
chr1,233293778,233293951,SRX5075170,SMARCA4,173
chr1,233294879,233295205,SRX5075168,SMARCA4,326
chr1,233294897,233295200,SRX5075176,SMARCA4,303
chr1,233294900,233295290,SRX5075174,SMARCA4,390
chr1,233294909,233295200,SRX5054308,FOSL2,291
chr1,233294932,233295190,SRX5054309,FOSL2,258
chr1,233294942,233295197,SRX5075169,SMARCA4,255
chr1,233294944,233295198,SRX5075170,SMARCA4,254
chr1,233294960,233295166,SRX5054307,FOSL2,206
chr1,233294973,233295176,SRX5075175,SMARCA4,203
chr1,233295499,233295858,SRX20140895,INTS13,359
chr1,233295678,233295857,SRX5075168,SMARCA4,179
chr1,233304434,233304961,SRX16500059,CTCF,527
chr1,233304485,233304915,SRX16500060,CTCF,430
chr1,233304487,233304923,SRX16500061,CTCF,436
chr1,233304499,233304897,SRX16500062,CTCF,398
chr1,233304516,233304844,SRX5075174,SMARCA4,328
chr1,233304561,233304847,SRX5075168,SMARCA4,286
chr1,233304576,233304830,SRX5075170,SMARCA4,254
chr1,233304585,233304839,SRX5075176,SMARCA4,254
chr1,233304612,233304816,SRX5716463,SMARCA4,204
chr1,233304628,233304815,SRX5075175,SMARCA4,187
chr1,233327919,233328187,SRX5075175,SMARCA4,268
chr1,233328033,233328376,SRX5716470,SMARCA4,343
chr1,233328343,233328737,SRX5075168,SMARCA4,394
chr1,233340946,233341533,SRX5075174,SMARCA4,587
chr1,233340977,233341314,SRX5075168,SMARCA4,337
chr1,233341020,233341439,SRX5716463,SMARCA4,419
chr1,233341022,233341236,SRX5716464,SMARCA4,214
chr1,233364630,233365129,SRX16500059,CTCF,499
chr1,233364662,233365206,SRX16500061,CTCF,544
chr1,233364696,233365153,SRX16500060,CTCF,457
chr1,233364712,233365109,SRX16500062,CTCF,397
chr1,233364804,233364979,SRX5075174,SMARCA4,175
chr1,233364820,233365014,SRX5075170,SMARCA4,194
chr1,233364822,233365047,SRX5075168,SMARCA4,225
chr1,233364834,233365017,SRX5075176,SMARCA4,183
chr1,233372815,233373166,SRX5716469,SMARCA4,351
chr1,233394781,233395246,SRX16500059,CTCF,465
chr1,233394830,233395256,SRX16500060,CTCF,426
chr1,233394860,233395307,SRX16500061,CTCF,447
chr1,233394884,233395259,SRX16500062,CTCF,375
chr1,233394904,233395143,SRX5075174,SMARCA4,239
chr1,233394907,233395197,SRX5075168,SMARCA4,290
chr1,233394957,233395147,SRX5075176,SMARCA4,190
chr1,233394983,233395183,SRX5075170,SMARCA4,200
chr1,233406909,233407274,SRX5075176,SMARCA4,365
chr1,233407054,233407250,SRX5075174,SMARCA4,196
chr1,233407074,233407319,SRX5075168,SMARCA4,245
chr1,233433036,233433360,SRX5075170,SMARCA4,324
chr1,233439700,233439978,SRX5054309,FOSL2,278
chr1,233439730,233439908,SRX5075176,SMARCA4,178
chr1,233440756,233441265,SRX16500059,CTCF,509
chr1,233440776,233441320,SRX16500061,CTCF,544
chr1,233440808,233441261,SRX16500060,CTCF,453
chr1,233440829,233441226,SRX16500062,CTCF,397
chr1,233440889,233441304,SRX5075168,SMARCA4,415
chr1,233440908,233441257,SRX5075174,SMARCA4,349
chr1,233440916,233441184,SRX5075169,SMARCA4,268
chr1,233440922,233441177,SRX5075176,SMARCA4,255
chr1,233440932,233441213,SRX5075170,SMARCA4,281
chr1,233440936,233441202,SRX5716464,SMARCA4,266
chr1,233440943,233441154,SRX5716470,SMARCA4,211
chr1,233440943,233441301,SRX4174629,CTCF,358
chr1,233440944,233441223,SRX5716463,SMARCA4,279
chr1,233440949,233441185,SRX5075175,SMARCA4,236
chr1,233460005,233460326,SRX5716463,SMARCA4,321
chr1,233460034,233460403,SRX5075168,SMARCA4,369
chr1,233460059,233460319,SRX5075174,SMARCA4,260
chr1,233509498,233509927,SRX5716463,SMARCA4,429
chr1,233509523,233510071,SRX5075168,SMARCA4,548
chr1,233509564,233510019,SRX5075174,SMARCA4,455
chr1,233509689,233509934,SRX5716451,SOX2,245
chr1,233509692,233509962,SRX20140895,INTS13,270
chr1,233518263,233518708,SRX16500060,CTCF,445
chr1,233518334,233518677,SRX16500059,CTCF,343
chr1,233518347,233518670,SRX16500062,CTCF,323
chr1,233518380,233518710,SRX16500061,CTCF,330
chr1,233522954,233523438,SRX5075168,SMARCA4,484
chr1,233523096,233523500,SRX5075174,SMARCA4,404
chr1,233523101,233523399,SRX5716463,SMARCA4,298
chr1,233523732,233523908,SRX5075174,SMARCA4,176
chr1,233543592,233544022,SRX5075174,SMARCA4,430
chr1,233543618,233544005,SRX5075170,SMARCA4,387
chr1,233543639,233543969,SRX5075175,SMARCA4,330
chr1,233543643,233544026,SRX5075176,SMARCA4,383
chr1,233543658,233543993,SRX5075168,SMARCA4,335
chr1,233543660,233544029,SRX5075169,SMARCA4,369
chr1,233543667,233544050,SRX5054309,FOSL2,383
chr1,233543702,233543913,SRX5716470,SMARCA4,211
chr1,233543710,233544056,SRX5716469,SMARCA4,346
chr1,233543712,233543984,SRX5054308,FOSL2,272
chr1,233597651,233597845,SRX5075170,SMARCA4,194
chr1,233597689,233597869,SRX5054308,FOSL2,180
chr1,233599016,233599276,SRX5075174,SMARCA4,260
chr1,233613562,233613968,SRX5075170,SMARCA4,406
chr1,233613571,233613751,SRX5075169,SMARCA4,180
chr1,233613719,233613931,SRX5716469,SMARCA4,212
chr1,233613724,233614018,SRX5075174,SMARCA4,294
chr1,233613776,233613951,SRX5075176,SMARCA4,175
chr1,233614246,233614433,SRX5075175,SMARCA4,187
chr1,233647085,233647289,SRX5075170,SMARCA4,204
chr1,233647099,233647330,SRX5075176,SMARCA4,231
chr1,233655250,233655453,SRX5075174,SMARCA4,203
chr1,233662606,233663049,SRX5054308,FOSL2,443
chr1,233662622,233662819,SRX5075169,SMARCA4,197
chr1,233662664,233662982,SRX5054309,FOSL2,318
chr1,233707472,233707909,SRX5075170,SMARCA4,437
chr1,233707534,233707838,SRX5054308,FOSL2,304
chr1,233707534,233707938,SRX5054309,FOSL2,404
chr1,233707539,233707730,SRX5075176,SMARCA4,191
chr1,233707555,233707884,SRX5075169,SMARCA4,329
chr1,233708124,233708320,SRX5075174,SMARCA4,196
chr1,233791041,233791409,SRX4174629,CTCF,368
chr1,233791045,233791537,SRX16500060,CTCF,492
chr1,233791048,233791522,SRX16500059,CTCF,474
chr1,233791049,233791603,SRX16500061,CTCF,554
chr1,233791077,233791561,SRX16500062,CTCF,484
chr1,233791132,233791382,SRX5075174,SMARCA4,250
chr1,233791147,233791397,SRX5075168,SMARCA4,250
chr1,233796445,233796698,SRX5716464,SMARCA4,253
chr1,233807365,233807655,SRX5075168,SMARCA4,290
chr1,233843613,233843900,SRX5054309,FOSL2,287
chr1,233843665,233843845,SRX5075168,SMARCA4,180
chr1,233844842,233845021,SRX5075168,SMARCA4,179
chr1,233879815,233880084,SRX5075176,SMARCA4,269
chr1,233879829,233880041,SRX5716469,SMARCA4,212
chr1,233879918,233880107,SRX5054309,FOSL2,189
chr1,233880409,233880680,SRX5075168,SMARCA4,271
chr1,233880443,233880639,SRX5075174,SMARCA4,196
chr1,233885285,233885807,SRX5054309,FOSL2,522
chr1,233885302,233885551,SRX5075175,SMARCA4,249
chr1,233885437,233886010,SRX5075176,SMARCA4,573
chr1,233885477,233885998,SRX5075168,SMARCA4,521
chr1,233885512,233885898,SRX5075170,SMARCA4,386
chr1,233885582,233885871,SRX5020214,SMARCA2,289
chr1,233885640,233885881,SRX5716464,SMARCA4,241
chr1,233885650,233885990,SRX5075174,SMARCA4,340
chr1,233885721,233885901,SRX5075169,SMARCA4,180
chr1,233904465,233904943,SRX5075174,SMARCA4,478
chr1,233904471,233904779,SRX5075176,SMARCA4,308
chr1,233904474,233904870,SRX16500059,CTCF,396
chr1,233904475,233904814,SRX16500062,CTCF,339
chr1,233904475,233904858,SRX5075168,SMARCA4,383
chr1,233904476,233904690,SRX5075175,SMARCA4,214
chr1,233904478,233904729,SRX5075170,SMARCA4,251
chr1,233904487,233904812,SRX16500061,CTCF,325
chr1,233904491,233904870,SRX16500060,CTCF,379
chr1,233904511,233904725,SRX5075169,SMARCA4,214
chr1,233904518,233904828,SRX5716463,SMARCA4,310
chr1,233904520,233904732,SRX5716469,SMARCA4,212
chr1,233909257,233909596,SRX5054309,FOSL2,339
chr1,233909343,233909545,SRX5054308,FOSL2,202
chr1,233916768,233917101,SRX5054309,FOSL2,333
chr1,233928209,233928436,SRX5054309,FOSL2,227
chr1,233955774,233956005,SRX16500060,CTCF,231
chr1,233993874,233994143,SRX5075174,SMARCA4,269
chr1,234000615,234001025,SRX5075174,SMARCA4,410
chr1,234000626,234001221,SRX5075168,SMARCA4,595
chr1,234047116,234047481,SRX5054309,FOSL2,365
chr1,234047163,234047429,SRX5075170,SMARCA4,266
chr1,234065731,234066267,SRX16500059,CTCF,536
chr1,234065790,234066228,SRX16500061,CTCF,438
chr1,234065790,234066255,SRX16500060,CTCF,465
chr1,234065818,234066147,SRX4174629,CTCF,329
chr1,234065850,234066220,SRX16500062,CTCF,370
chr1,234065905,234066144,SRX5075174,SMARCA4,239
chr1,234065955,234066124,SRX5075170,SMARCA4,169
chr1,234089477,234089714,SRX16500060,CTCF,237
chr1,234096320,234096625,SRX5075168,SMARCA4,305
chr1,234096386,234096739,SRX5075174,SMARCA4,353
chr1,234108963,234109198,SRX5075174,SMARCA4,235
chr1,234111486,234111826,SRX16500060,CTCF,340
chr1,234111517,234111811,SRX16500061,CTCF,294
chr1,234111524,234111823,SRX16500059,CTCF,299
chr1,234111534,234111815,SRX16500062,CTCF,281
chr1,234114532,234114948,SRX16500060,CTCF,416
chr1,234114546,234115006,SRX16500059,CTCF,460
chr1,234114552,234114928,SRX16500061,CTCF,376
chr1,234114579,234114942,SRX16500062,CTCF,363
chr1,234114628,234114946,SRX5075174,SMARCA4,318
chr1,234114634,234114860,SRX5716469,SMARCA4,226
chr1,234114637,234114919,SRX5075170,SMARCA4,282
chr1,234114638,234114911,SRX5075168,SMARCA4,273
chr1,234114638,234114922,SRX5716470,SMARCA4,284
chr1,234114643,234114939,SRX5075176,SMARCA4,296
chr1,234114681,234114932,SRX5075169,SMARCA4,251
chr1,234114688,234114887,SRX5075175,SMARCA4,199
chr1,234125286,234125687,SRX16500059,CTCF,401
chr1,234125295,234125621,SRX16500061,CTCF,326
chr1,234125317,234125633,SRX16500060,CTCF,316
chr1,234125349,234125641,SRX16500062,CTCF,292
chr1,234154618,234155139,SRX16500059,CTCF,521
chr1,234154625,234155137,SRX16500060,CTCF,512
chr1,234154633,234155092,SRX16500062,CTCF,459
chr1,234154640,234155104,SRX16500061,CTCF,464
chr1,234154722,234155008,SRX5075168,SMARCA4,286
chr1,234154775,234154997,SRX5075174,SMARCA4,222
chr1,234154815,234155002,SRX5075176,SMARCA4,187
chr1,234188579,234188856,SRX16500059,CTCF,277
chr1,234188639,234188866,SRX16500060,CTCF,227
chr1,234188686,234188896,SRX16500062,CTCF,210
chr1,234206945,234207218,SRX5075170,SMARCA4,273
chr1,234206945,234207244,SRX5075176,SMARCA4,299
chr1,234206971,234207227,SRX5054309,FOSL2,256
chr1,234206982,234207236,SRX5054308,FOSL2,254
chr1,234206985,234207171,SRX5075169,SMARCA4,186
chr1,234212715,234213132,SRX16500060,CTCF,417
chr1,234212718,234213172,SRX16500059,CTCF,454
chr1,234212739,234213148,SRX16500061,CTCF,409
chr1,234212756,234213119,SRX16500062,CTCF,363
chr1,234212825,234213164,SRX4174629,CTCF,339
chr1,234214173,234214352,SRX5075168,SMARCA4,179
chr1,234214275,234214459,SRX5075174,SMARCA4,184
chr1,234226195,234226702,SRX5075168,SMARCA4,507
chr1,234226203,234226641,SRX5075174,SMARCA4,438
chr1,234231771,234231998,SRX16500060,CTCF,227
chr1,234237334,234237738,SRX5716463,SMARCA4,404
chr1,234237389,234237756,SRX5075168,SMARCA4,367
chr1,234237405,234237844,SRX5075174,SMARCA4,439
chr1,234237443,234237710,SRX5716464,SMARCA4,267
chr1,234271045,234271262,SRX5054309,FOSL2,217
chr1,234281877,234282257,SRX5075174,SMARCA4,380
chr1,234281889,234282228,SRX5075168,SMARCA4,339
chr1,234282040,234282246,SRX5075170,SMARCA4,206
chr1,234289018,234289247,SRX5075174,SMARCA4,229
chr1,234309795,234310420,SRX16500060,CTCF,625
chr1,234309838,234310373,SRX16500059,CTCF,535
chr1,234309880,234310439,SRX16500061,CTCF,559
chr1,234309925,234310387,SRX16500062,CTCF,462
chr1,234309959,234310330,SRX4174629,CTCF,371
chr1,234310043,234310274,SRX5716470,SMARCA4,231
chr1,234310043,234310371,SRX5075170,SMARCA4,328
chr1,234310047,234310416,SRX5075168,SMARCA4,369
chr1,234310051,234310419,SRX5075174,SMARCA4,368
chr1,234315299,234315489,SRX5075169,SMARCA4,190
chr1,234315314,234315506,SRX5054309,FOSL2,192
chr1,234315324,234315502,SRX5075170,SMARCA4,178
chr1,234315359,234315536,SRX5075176,SMARCA4,177
chr1,234326532,234326984,SRX16500060,CTCF,452
chr1,234326558,234327017,SRX16500061,CTCF,459
chr1,234326583,234327035,SRX16500059,CTCF,452
chr1,234326595,234326916,SRX5075174,SMARCA4,321
chr1,234326609,234327007,SRX16500062,CTCF,398
chr1,234326614,234326901,SRX5075175,SMARCA4,287
chr1,234326617,234326829,SRX5716469,SMARCA4,212
chr1,234326621,234326875,SRX5075170,SMARCA4,254
chr1,234326627,234326879,SRX5716470,SMARCA4,252
chr1,234326630,234326845,SRX4174629,CTCF,215
chr1,234326641,234326981,SRX5075168,SMARCA4,340
chr1,234326664,234326881,SRX5075169,SMARCA4,217
chr1,234326673,234326887,SRX5075176,SMARCA4,214
chr1,234326711,234326970,SRX5716463,SMARCA4,259
chr1,234372957,234373262,SRX5716470,SMARCA4,305
chr1,234372991,234373510,SRX5075176,SMARCA4,519
chr1,234373008,234373410,SRX5075168,SMARCA4,402
chr1,234373059,234373546,SRX5075170,SMARCA4,487
chr1,234373066,234373463,SRX5716469,SMARCA4,397
chr1,234373113,234373559,SRX20140869,INTS10,446
chr1,234373187,234373743,SRX20140897,INTS13,556
chr1,234373188,234373742,SRX5075174,SMARCA4,554
chr1,234373237,234373893,SRX20140895,INTS13,656
chr1,234373280,234373612,SRX20140879,CPSF3L,332
chr1,234373351,234373690,SRX20140867,INTS10,339
chr1,234373365,234373691,SRX20140868,INTS10,326
chr1,234373466,234373832,SRX5075168,SMARCA4,366
chr1,234373482,234373741,SRX5716470,SMARCA4,259
chr1,234373500,234373757,SRX5716463,SMARCA4,257
chr1,234409433,234409675,SRX16500060,CTCF,242
chr1,234409542,234409765,SRX16500061,CTCF,223
chr1,234433652,234433829,SRX5075176,SMARCA4,177
chr1,234433653,234433867,SRX5075175,SMARCA4,214
chr1,234433668,234433884,SRX5075169,SMARCA4,216
chr1,234478102,234478360,SRX5075174,SMARCA4,258
chr1,234478180,234478364,SRX5075169,SMARCA4,184
chr1,234478195,234478426,SRX5075175,SMARCA4,231
chr1,234478196,234478413,SRX5075170,SMARCA4,217
chr1,234478304,234479300,SRX20140895,INTS13,996
chr1,234478394,234478664,SRX20140881,CPSF3L,270
chr1,234478451,234478877,SRX5075169,SMARCA4,426
chr1,234478460,234479181,SRX20140868,INTS10,721
chr1,234478555,234479384,SRX5075174,SMARCA4,829
chr1,234478609,234478813,SRX5075170,SMARCA4,204
chr1,234478618,234479298,SRX5075168,SMARCA4,680
chr1,234478654,234479031,SRX20140880,CPSF3L,377
chr1,234478689,234478962,SRX5075176,SMARCA4,273
chr1,234478702,234479164,SRX5075175,SMARCA4,462
chr1,234478855,234479111,SRX20140867,INTS10,256
chr1,234478986,234479296,SRX5075170,SMARCA4,310
chr1,234486967,234487320,SRX16500060,CTCF,353
chr1,234486970,234487322,SRX16500061,CTCF,352
chr1,234486981,234487341,SRX16500059,CTCF,360
chr1,234486990,234487326,SRX16500062,CTCF,336
chr1,234487019,234487367,SRX5075176,SMARCA4,348
chr1,234487030,234487321,SRX5075170,SMARCA4,291
chr1,234487046,234487266,SRX5075169,SMARCA4,220
chr1,234487049,234487346,SRX5716470,SMARCA4,297
chr1,234487050,234487323,SRX5075174,SMARCA4,273
chr1,234487058,234487320,SRX5716469,SMARCA4,262
chr1,234487069,234487264,SRX5075175,SMARCA4,195
chr1,234495190,234495735,SRX5075170,SMARCA4,545
chr1,234495270,234495710,SRX5075176,SMARCA4,440
chr1,234495286,234495781,SRX5075169,SMARCA4,495
chr1,234495288,234495694,SRX5075175,SMARCA4,406
chr1,234495308,234495551,SRX5075174,SMARCA4,243
chr1,234495348,234495736,SRX5054309,FOSL2,388
chr1,234495382,234495600,SRX5716470,SMARCA4,218
chr1,234495400,234495670,SRX5716469,SMARCA4,270
chr1,234495429,234495681,SRX5054308,FOSL2,252
chr1,234495447,234495707,SRX5716467,SMARCA2,260
chr1,234499015,234499505,SRX16500059,CTCF,490
chr1,234499017,234499601,SRX16500061,CTCF,584
chr1,234499023,234499510,SRX16500060,CTCF,487
chr1,234499052,234499504,SRX16500062,CTCF,452
chr1,234499073,234499450,SRX4174629,CTCF,377
chr1,234499200,234499452,SRX5075176,SMARCA4,252
chr1,234499200,234499571,SRX5075174,SMARCA4,371
chr1,234499201,234499415,SRX5075170,SMARCA4,214
chr1,234499223,234499459,SRX5075168,SMARCA4,236
chr1,234499275,234499486,SRX5716470,SMARCA4,211
chr1,234499997,234500280,SRX5075168,SMARCA4,283
chr1,234500039,234500278,SRX5075174,SMARCA4,239
chr1,234501161,234501427,SRX5054309,FOSL2,266
chr1,234501197,234501445,SRX5054308,FOSL2,248
chr1,234501230,234501422,SRX5075169,SMARCA4,192
chr1,234509743,234510041,SRX5075170,SMARCA4,298
chr1,234509777,234510145,SRX5075176,SMARCA4,368
chr1,234515393,234516142,SRX5075174,SMARCA4,749
chr1,234515425,234516213,SRX5075176,SMARCA4,788
chr1,234515459,234516176,SRX5075169,SMARCA4,717
chr1,234515469,234516165,SRX5075170,SMARCA4,696
chr1,234515489,234516133,SRX5716469,SMARCA4,644
chr1,234515541,234516152,SRX5075175,SMARCA4,611
chr1,234515596,234516089,SRX5716470,SMARCA4,493
chr1,234515605,234516044,SRX5075168,SMARCA4,439
chr1,234515645,234516183,SRX5716460,Epitope tags,538
chr1,234515688,234515966,SRX5020211,SMARCA2,278
chr1,234515715,234516052,SRX5020214,SMARCA2,337
chr1,234515734,234516125,SRX5716467,SMARCA2,391
chr1,234515770,234516094,SRX5716468,SMARCA2,324
chr1,234515772,234516087,SRX5054308,FOSL2,315
chr1,234515788,234516204,SRX5054309,FOSL2,416
chr1,234522938,234523941,SRX5075174,SMARCA4,1003
chr1,234522946,234523918,SRX5075168,SMARCA4,972
chr1,234523041,234523889,SRX5716463,SMARCA4,848
chr1,234523115,234523850,SRX5716464,SMARCA4,735
chr1,234523262,234523473,SRX5716454,SOX3,211
chr1,234523420,234523852,SRX5716467,SMARCA2,432
chr1,234523451,234523787,SRX5020214,SMARCA2,336
chr1,234523452,234523848,SRX5075175,SMARCA4,396
chr1,234523474,234523908,SRX5716470,SMARCA4,434
chr1,234523478,234523882,SRX5075169,SMARCA4,404
chr1,234523484,234523875,SRX5716469,SMARCA4,391
chr1,234523509,234523828,SRX5054308,FOSL2,319
chr1,234523509,234523891,SRX5075170,SMARCA4,382
chr1,234523526,234523852,SRX5716454,SOX3,326
chr1,234523526,234523880,SRX5075176,SMARCA4,354
chr1,234523560,234523848,SRX5020211,SMARCA2,288
chr1,234523563,234523811,SRX5075181,SMARCA2,248
chr1,234523563,234523869,SRX5054309,FOSL2,306
chr1,234523564,234523800,SRX5075182,SMARCA2,236
chr1,234523584,234523859,SRX5716468,SMARCA2,275
chr1,234523654,234523865,SRX5716451,SOX2,211
chr1,234531494,234531764,SRX20140895,INTS13,270
chr1,234531575,234531842,SRX5075168,SMARCA4,267
chr1,234531702,234532008,SRX5075176,SMARCA4,306
chr1,234531756,234531967,SRX5716470,SMARCA4,211
chr1,234531805,234531974,SRX5075170,SMARCA4,169
chr1,234531811,234532032,SRX5716467,SMARCA2,221
chr1,234533098,234533389,SRX5075169,SMARCA4,291
chr1,234533101,234533446,SRX5054309,FOSL2,345
chr1,234533110,234533457,SRX5075170,SMARCA4,347
chr1,234533130,234533399,SRX5075176,SMARCA4,269
chr1,234533169,234533383,SRX5075175,SMARCA4,214
chr1,234533861,234534349,SRX5075170,SMARCA4,488
chr1,234533905,234534599,SRX5075176,SMARCA4,694
chr1,234533914,234534626,SRX5716470,SMARCA4,712
chr1,234533917,234534274,SRX5075169,SMARCA4,357
chr1,234533940,234534172,SRX5075181,SMARCA2,232
chr1,234533951,234534310,SRX5716469,SMARCA4,359
chr1,234533972,234534337,SRX5075175,SMARCA4,365
chr1,234533993,234534217,SRX5020211,SMARCA2,224
chr1,234534013,234534271,SRX5716468,SMARCA2,258
chr1,234534487,234534665,SRX5075170,SMARCA4,178
chr1,234544130,234544865,SRX5075176,SMARCA4,735
chr1,234544159,234544519,SRX5054309,FOSL2,360
chr1,234544159,234544838,SRX5075170,SMARCA4,679
chr1,234544161,234544859,SRX5075175,SMARCA4,698
chr1,234544217,234544590,SRX5054308,FOSL2,373
chr1,234544232,234544749,SRX5716470,SMARCA4,517
chr1,234544256,234544800,SRX5716469,SMARCA4,544
chr1,234544263,234544587,SRX5716467,SMARCA2,324
chr1,234544274,234544715,SRX5716468,SMARCA2,441
chr1,234544294,234544855,SRX5075169,SMARCA4,561
chr1,234544439,234544692,SRX5020214,SMARCA2,253
chr1,234545448,234545982,SRX5075168,SMARCA4,534
chr1,234545535,234545889,SRX5075174,SMARCA4,354
chr1,234553515,234553835,SRX5020211,SMARCA2,320
chr1,234553547,234553904,SRX5075169,SMARCA4,357
chr1,234553551,234553961,SRX5716470,SMARCA4,410
chr1,234553563,234553843,SRX5075175,SMARCA4,280
chr1,234553566,234553925,SRX5075181,SMARCA2,359
chr1,234553592,234553811,SRX5075182,SMARCA2,219
chr1,234553606,234553850,SRX5075170,SMARCA4,244
chr1,234553614,234553902,SRX5075176,SMARCA4,288
chr1,234553625,234553868,SRX5020214,SMARCA2,243
chr1,234553627,234553823,SRX5054309,FOSL2,196
chr1,234553627,234553952,SRX5716469,SMARCA4,325
chr1,234553641,234553863,SRX5716467,SMARCA2,222
chr1,234553647,234553907,SRX5716468,SMARCA2,260
chr1,234553682,234553956,SRX5716459,Epitope tags,274
chr1,234554969,234555273,SRX5075174,SMARCA4,304
chr1,234564551,234565027,SRX5075169,SMARCA4,476
chr1,234564608,234564988,SRX5054309,FOSL2,380
chr1,234564664,234564961,SRX5075170,SMARCA4,297
chr1,234564686,234565027,SRX5075176,SMARCA4,341
chr1,234564690,234565029,SRX5075175,SMARCA4,339
chr1,234564719,234565012,SRX5075174,SMARCA4,293
chr1,234564732,234565025,SRX5054308,FOSL2,293
chr1,234564741,234565023,SRX5716469,SMARCA4,282
chr1,234564757,234564991,SRX5075168,SMARCA4,234
chr1,234597877,234598323,SRX16500059,CTCF,446
chr1,234597914,234598331,SRX16500061,CTCF,417
chr1,234597916,234598303,SRX16500060,CTCF,387
chr1,234597952,234598310,SRX16500062,CTCF,358
chr1,234599698,234600314,SRX20140868,INTS10,616
chr1,234599751,234600479,SRX20140895,INTS13,728
chr1,234599803,234600124,SRX20140867,INTS10,321
chr1,234599812,234600379,SRX5075174,SMARCA4,567
chr1,234599824,234600059,SRX20140879,CPSF3L,235
chr1,234599844,234600167,SRX20140881,CPSF3L,323
chr1,234599879,234600146,SRX5075175,SMARCA4,267
chr1,234599879,234600422,SRX5075168,SMARCA4,543
chr1,234599899,234600445,SRX5075170,SMARCA4,546
chr1,234599919,234600270,SRX5075176,SMARCA4,351
chr1,234599954,234600247,SRX5716464,SMARCA4,293
chr1,234602749,234603215,SRX5075176,SMARCA4,466
chr1,234602786,234603131,SRX5054309,FOSL2,345
chr1,234602799,234603175,SRX5054308,FOSL2,376
chr1,234602854,234603060,SRX5075169,SMARCA4,206
chr1,234602875,234603238,SRX5075170,SMARCA4,363
chr1,234602926,234603228,SRX5075175,SMARCA4,302
chr1,234608122,234608335,SRX5054309,FOSL2,213
chr1,234608124,234608306,SRX5054308,FOSL2,182
chr1,234610091,234610364,SRX20140867,INTS10,273
chr1,234610133,234611420,SRX20140895,INTS13,1287
chr1,234610170,234610355,SRX5075168,SMARCA4,185
chr1,234610223,234610396,SRX5075174,SMARCA4,173
chr1,234610589,234611051,SRX20140897,INTS13,462
chr1,234610718,234611387,SRX20140868,INTS10,669
chr1,234610757,234611395,SRX20140867,INTS10,638
chr1,234612589,234612869,SRX5075168,SMARCA4,280
chr1,234612597,234612922,SRX5054309,FOSL2,325
chr1,234612613,234613184,SRX5075176,SMARCA4,571
chr1,234612626,234613105,SRX5075170,SMARCA4,479
chr1,234612643,234612977,SRX5075169,SMARCA4,334
chr1,234612648,234612909,SRX5075174,SMARCA4,261
chr1,234612665,234612923,SRX5075175,SMARCA4,258
chr1,234612821,234613051,SRX5716469,SMARCA4,230
chr1,234612887,234613098,SRX5716470,SMARCA4,211
chr1,234618416,234618921,SRX5075174,SMARCA4,505
chr1,234618430,234618891,SRX5075168,SMARCA4,461
chr1,234618467,234618732,SRX5716463,SMARCA4,265
chr1,234618491,234618719,SRX5075176,SMARCA4,228
chr1,234618495,234618724,SRX5075170,SMARCA4,229
chr1,234621578,234622283,SRX5075176,SMARCA4,705
chr1,234621591,234622279,SRX5054309,FOSL2,688
chr1,234621601,234622267,SRX5075175,SMARCA4,666
chr1,234621606,234622311,SRX5075170,SMARCA4,705
chr1,234621618,234622167,SRX5054308,FOSL2,549
chr1,234621636,234622278,SRX5020211,SMARCA2,642
chr1,234621646,234622225,SRX5075169,SMARCA4,579
chr1,234621660,234622137,SRX5075181,SMARCA2,477
chr1,234621691,234622218,SRX5716469,SMARCA4,527
chr1,234621736,234622210,SRX5716467,SMARCA2,474
chr1,234621772,234622283,SRX5716470,SMARCA4,511
chr1,234621839,234622275,SRX5716468,SMARCA2,436
chr1,234628158,234628440,SRX5075170,SMARCA4,282
chr1,234628165,234628450,SRX5075175,SMARCA4,285
chr1,234628188,234628454,SRX5075169,SMARCA4,266
chr1,234628200,234628471,SRX5075176,SMARCA4,271
chr1,234631582,234632139,SRX5716469,SMARCA4,557
chr1,234631636,234632049,SRX5716470,SMARCA4,413
chr1,234631645,234632015,SRX5020214,SMARCA2,370
chr1,234631646,234632054,SRX5020211,SMARCA2,408
chr1,234631665,234632048,SRX5075168,SMARCA4,383
chr1,234631668,234632144,SRX5075170,SMARCA4,476
chr1,234631688,234632161,SRX5075169,SMARCA4,473
chr1,234631689,234631900,SRX5716468,SMARCA2,211
chr1,234631690,234632019,SRX5054308,FOSL2,329
chr1,234631691,234632170,SRX5075176,SMARCA4,479
chr1,234631703,234632164,SRX5075175,SMARCA4,461
chr1,234631717,234632139,SRX5075182,SMARCA2,422
chr1,234631721,234632227,SRX5054309,FOSL2,506
chr1,234631789,234632222,SRX5075174,SMARCA4,433
chr1,234657278,234657465,SRX5075175,SMARCA4,187
chr1,234657295,234657557,SRX5075169,SMARCA4,262
chr1,234657301,234657493,SRX5054309,FOSL2,192
chr1,234659577,234659841,SRX5075176,SMARCA4,264
chr1,234659578,234659827,SRX5075170,SMARCA4,249
chr1,234659591,234659821,SRX5075169,SMARCA4,230
chr1,234659593,234659828,SRX5054308,FOSL2,235
chr1,234659598,234659918,SRX5054309,FOSL2,320
chr1,234659641,234659830,SRX5075175,SMARCA4,189
chr1,234666205,234666416,SRX5716470,SMARCA4,211
chr1,234666227,234666489,SRX5716469,SMARCA4,262
chr1,234676187,234676564,SRX5075174,SMARCA4,377
chr1,234676228,234676587,SRX5075168,SMARCA4,359
chr1,234676244,234676506,SRX5716464,SMARCA4,262
chr1,234676292,234676496,SRX5716463,SMARCA4,204
chr1,234676330,234676561,SRX5075176,SMARCA4,231
chr1,234676365,234676577,SRX5075170,SMARCA4,212
chr1,234684283,234684608,SRX5075176,SMARCA4,325
chr1,234684285,234684550,SRX5075170,SMARCA4,265
chr1,234684331,234684532,SRX5075174,SMARCA4,201
chr1,234684336,234684523,SRX5075175,SMARCA4,187
chr1,234684348,234684553,SRX5075169,SMARCA4,205
chr1,234700235,234700612,SRX5075175,SMARCA4,377
chr1,234700257,234700668,SRX5075169,SMARCA4,411
chr1,234700277,234700593,SRX5075170,SMARCA4,316
chr1,234700315,234700553,SRX5054308,FOSL2,238
chr1,234700358,234700570,SRX5716469,SMARCA4,212
chr1,234700362,234700636,SRX5054309,FOSL2,274
chr1,234700363,234700611,SRX5075176,SMARCA4,248
chr1,234707826,234708006,SRX5075169,SMARCA4,180
chr1,234711473,234711714,SRX5054308,FOSL2,241
chr1,234711494,234711732,SRX5054309,FOSL2,238
chr1,234723193,234723524,SRX5054309,FOSL2,331
chr1,234723200,234723446,SRX5075170,SMARCA4,246
chr1,234723230,234723415,SRX5054308,FOSL2,185
chr1,234723236,234723671,SRX5075176,SMARCA4,435
chr1,234723242,234723425,SRX5075169,SMARCA4,183
chr1,234723851,234724732,SRX5716469,SMARCA4,881
chr1,234723858,234724725,SRX5075176,SMARCA4,867
chr1,234723880,234724852,SRX5075170,SMARCA4,972
chr1,234723891,234724534,SRX20140869,INTS10,643
chr1,234723933,234724626,SRX5716467,SMARCA2,693
chr1,234723941,234724748,SRX5716470,SMARCA4,807
chr1,234724027,234724652,SRX5075175,SMARCA4,625
chr1,234724038,234724643,SRX5075174,SMARCA4,605
chr1,234724044,234724893,SRX5075169,SMARCA4,849
chr1,234724059,234724659,SRX5716468,SMARCA2,600
chr1,234724093,234724699,SRX5075168,SMARCA4,606
chr1,234724145,234724525,SRX5054308,FOSL2,380
chr1,234724146,234724366,SRX5054307,FOSL2,220
chr1,234724171,234724486,SRX5054309,FOSL2,315
chr1,234724190,234724508,SRX20140868,INTS10,318
chr1,234724203,234724470,SRX5716463,SMARCA4,267
chr1,234724211,234724532,SRX20140881,CPSF3L,321
chr1,234724216,234725042,SRX20140895,INTS13,826
chr1,234724223,234724681,SRX5020211,SMARCA2,458
chr1,234724257,234724717,SRX20140867,INTS10,460
chr1,234724464,234724687,SRX5716451,SOX2,223
chr1,234731388,234731665,SRX5075169,SMARCA4,277
chr1,234731405,234731693,SRX5075176,SMARCA4,288
chr1,234731408,234731697,SRX5054309,FOSL2,289
chr1,234731413,234731709,SRX5075168,SMARCA4,296
chr1,234731415,234731721,SRX5075175,SMARCA4,306
chr1,234731416,234731650,SRX5716469,SMARCA4,234
chr1,234731433,234731721,SRX5075170,SMARCA4,288
chr1,234731443,234731675,SRX5075174,SMARCA4,232
chr1,234737935,234738294,SRX5075174,SMARCA4,359
chr1,234737941,234738300,SRX5075176,SMARCA4,359
chr1,234737981,234738420,SRX5075168,SMARCA4,439
chr1,234737993,234738267,SRX5716469,SMARCA4,274
chr1,234738009,234738300,SRX5716464,SMARCA4,291
chr1,234738032,234738290,SRX5075170,SMARCA4,258
chr1,234738098,234738309,SRX5716470,SMARCA4,211
chr1,234743801,234744381,SRX5075176,SMARCA4,580
chr1,234743863,234744344,SRX5075169,SMARCA4,481
chr1,234743870,234744336,SRX5716469,SMARCA4,466
chr1,234743900,234744226,SRX5716467,SMARCA2,326
chr1,234743902,234744436,SRX5075170,SMARCA4,534
chr1,234743955,234744462,SRX5075175,SMARCA4,507
chr1,234744010,234744404,SRX5716470,SMARCA4,394
chr1,234744024,234744296,SRX5716468,SMARCA2,272
chr1,234744034,234744298,SRX5054309,FOSL2,264
chr1,234744049,234744287,SRX5020214,SMARCA2,238
chr1,234745727,234746187,SRX5075174,SMARCA4,460
chr1,234745767,234746123,SRX5075170,SMARCA4,356
chr1,234745786,234746079,SRX5075169,SMARCA4,293
chr1,234745789,234746131,SRX5075168,SMARCA4,342
chr1,234745810,234746117,SRX5054308,FOSL2,307
chr1,234745812,234746103,SRX5075175,SMARCA4,291
chr1,234745813,234746092,SRX5054309,FOSL2,279
chr1,234745825,234746167,SRX5075176,SMARCA4,342
chr1,234745830,234746041,SRX5716470,SMARCA4,211
chr1,234745839,234746075,SRX5054307,FOSL2,236
chr1,234745889,234746131,SRX5716469,SMARCA4,242
chr1,234770268,234770452,SRX5075176,SMARCA4,184
chr1,234772221,234772750,SRX5716470,SMARCA4,529
chr1,234772254,234772771,SRX5075170,SMARCA4,517
chr1,234772255,234772769,SRX5075174,SMARCA4,514
chr1,234772257,234772751,SRX5716469,SMARCA4,494
chr1,234772300,234772776,SRX5075169,SMARCA4,476
chr1,234772307,234772749,SRX5075175,SMARCA4,442
chr1,234772324,234772808,SRX5075176,SMARCA4,484
chr1,234772328,234772773,SRX5054309,FOSL2,445
chr1,234772357,234772638,SRX5020211,SMARCA2,281
chr1,234772357,234772727,SRX5054308,FOSL2,370
chr1,234772365,234772742,SRX5020214,SMARCA2,377
chr1,234772367,234772723,SRX5716467,SMARCA2,356
chr1,234772370,234772673,SRX5075182,SMARCA2,303
chr1,234772371,234772582,SRX5075181,SMARCA2,211
chr1,234772377,234772745,SRX5075168,SMARCA4,368
chr1,234772412,234772718,SRX5716468,SMARCA2,306
chr1,234772421,234772661,SRX5054307,FOSL2,240
chr1,234772429,234772689,SRX5716460,Epitope tags,260
chr1,234785681,234785893,SRX5716469,SMARCA4,212
chr1,234785687,234786021,SRX5716470,SMARCA4,334
chr1,234795964,234796139,SRX5075176,SMARCA4,175
chr1,234795971,234796228,SRX5716469,SMARCA4,257
chr1,234795980,234796272,SRX5075170,SMARCA4,292
chr1,234795982,234796253,SRX5075169,SMARCA4,271
chr1,234796013,234796243,SRX5716470,SMARCA4,230
chr1,234796045,234796258,SRX5075175,SMARCA4,213
chr1,234811815,234812258,SRX5075176,SMARCA4,443
chr1,234811834,234812236,SRX5075170,SMARCA4,402
chr1,234811854,234812267,SRX5075175,SMARCA4,413
chr1,234811856,234812261,SRX5075169,SMARCA4,405
chr1,234811881,234812240,SRX5716469,SMARCA4,359
chr1,234811888,234812219,SRX5716470,SMARCA4,331
chr1,234811894,234812147,SRX5020214,SMARCA2,253
chr1,234811909,234812184,SRX5716467,SMARCA2,275
chr1,234811914,234812213,SRX5054308,FOSL2,299
chr1,234811916,234812224,SRX5054309,FOSL2,308
chr1,234849480,234849712,SRX5716469,SMARCA4,232
chr1,234851461,234851707,SRX5075170,SMARCA4,246
chr1,234851496,234851714,SRX5075175,SMARCA4,218
chr1,234862868,234863455,SRX5075170,SMARCA4,587
chr1,234862900,234863157,SRX5716470,SMARCA4,257
chr1,234862917,234863181,SRX5716467,SMARCA2,264
chr1,234862919,234863412,SRX5075176,SMARCA4,493
chr1,234863013,234863333,SRX5075169,SMARCA4,320
chr1,234866483,234866739,SRX5054308,FOSL2,256
chr1,234866516,234866717,SRX5054309,FOSL2,201
chr1,234871652,234872034,SRX5075169,SMARCA4,382
chr1,234871671,234872065,SRX5075170,SMARCA4,394
chr1,234871695,234871985,SRX5075176,SMARCA4,290
chr1,234871723,234871995,SRX5075175,SMARCA4,272
chr1,234871739,234871950,SRX5716470,SMARCA4,211
chr1,234871784,234872092,SRX5054309,FOSL2,308
chr1,234871814,234872068,SRX5020211,SMARCA2,254
chr1,234871870,234872083,SRX5054308,FOSL2,213
chr1,234886964,234887390,SRX5075170,SMARCA4,426
chr1,234887034,234887405,SRX5075176,SMARCA4,371
chr1,234887046,234887318,SRX5075169,SMARCA4,272
chr1,234887121,234887308,SRX5054309,FOSL2,187
chr1,234893772,234894091,SRX5075170,SMARCA4,319
chr1,234893774,234894025,SRX5075175,SMARCA4,251
chr1,234893798,234894051,SRX5075169,SMARCA4,253
chr1,234893816,234894075,SRX5054309,FOSL2,259
chr1,234893879,234894141,SRX5054308,FOSL2,262
chr1,234894241,234894580,SRX5075169,SMARCA4,339
chr1,234894280,234894776,SRX5075170,SMARCA4,496
chr1,234894379,234894676,SRX5716470,SMARCA4,297
chr1,234894383,234894658,SRX5020211,SMARCA2,275
chr1,234894383,234894789,SRX5075176,SMARCA4,406
chr1,234894427,234894720,SRX5054308,FOSL2,293
chr1,234907893,234908524,SRX5075176,SMARCA4,631
chr1,234907926,234908370,SRX5054308,FOSL2,444
chr1,234907940,234908493,SRX5075170,SMARCA4,553
chr1,234907951,234908478,SRX5716469,SMARCA4,527
chr1,234907965,234908481,SRX5716470,SMARCA4,516
chr1,234908009,234908464,SRX5716467,SMARCA2,455
chr1,234908015,234908488,SRX5075175,SMARCA4,473
chr1,234908018,234908444,SRX5075169,SMARCA4,426
chr1,234908031,234908296,SRX5020211,SMARCA2,265
chr1,234908049,234908315,SRX5075181,SMARCA2,266
chr1,234908061,234908348,SRX5054309,FOSL2,287
chr1,234908087,234908395,SRX5716468,SMARCA2,308
chr1,234908140,234908355,SRX5020214,SMARCA2,215
chr1,234911802,234912082,SRX5075168,SMARCA4,280
chr1,234911812,234912035,SRX5075174,SMARCA4,223
chr1,234916065,234916273,SRX5075170,SMARCA4,208
chr1,234918167,234918434,SRX5075176,SMARCA4,267
chr1,234918183,234918398,SRX5716467,SMARCA2,215
chr1,234918236,234918405,SRX5075170,SMARCA4,169
chr1,234918516,234918908,SRX5075174,SMARCA4,392
chr1,234918615,234919007,SRX5075168,SMARCA4,392
chr1,234925721,234926289,SRX5054309,FOSL2,568
chr1,234925737,234926550,SRX5075168,SMARCA4,813
chr1,234925750,234926503,SRX5075176,SMARCA4,753
chr1,234925761,234926361,SRX5075175,SMARCA4,600
chr1,234925765,234926255,SRX5075174,SMARCA4,490
chr1,234925773,234926363,SRX5075170,SMARCA4,590
chr1,234925780,234926341,SRX5075169,SMARCA4,561
chr1,234925789,234926230,SRX5716469,SMARCA4,441
chr1,234925817,234926243,SRX5075181,SMARCA2,426
chr1,234925831,234926251,SRX5054308,FOSL2,420
chr1,234925851,234926211,SRX5020214,SMARCA2,360
chr1,234925859,234926298,SRX5716467,SMARCA2,439
chr1,234925877,234926348,SRX5716470,SMARCA4,471
chr1,234925901,234926205,SRX5054307,FOSL2,304
chr1,234925910,234926251,SRX5020211,SMARCA2,341
chr1,234926004,234926316,SRX5716460,Epitope tags,312
chr1,234933433,234933761,SRX5075176,SMARCA4,328
chr1,234933442,234933737,SRX5075169,SMARCA4,295
chr1,234933455,234933794,SRX5075175,SMARCA4,339
chr1,234933477,234933742,SRX5054309,FOSL2,265
chr1,234933541,234933763,SRX5075170,SMARCA4,222
chr1,234955545,234955747,SRX5075174,SMARCA4,202
chr1,234955571,234955835,SRX5075168,SMARCA4,264
chr1,234957106,234957787,SRX5075176,SMARCA4,681
chr1,234957118,234957730,SRX5716470,SMARCA4,612
chr1,234957131,234957610,SRX5716468,SMARCA2,479
chr1,234957167,234957618,SRX5075181,SMARCA2,451
chr1,234957229,234957488,SRX5020211,SMARCA2,259
chr1,234957253,234957548,SRX20140895,INTS13,295
chr1,234957283,234957800,SRX5075174,SMARCA4,517
chr1,234957305,234957731,SRX5075170,SMARCA4,426
chr1,234957315,234957714,SRX5054308,FOSL2,399
chr1,234957321,234957649,SRX20140879,CPSF3L,328
chr1,234957325,234957708,SRX5075168,SMARCA4,383
chr1,234957328,234957716,SRX5054309,FOSL2,388
chr1,234957337,234957797,SRX20140869,INTS10,460
chr1,234957354,234957722,SRX5075175,SMARCA4,368
chr1,234957359,234957625,SRX5075169,SMARCA4,266
chr1,234957366,234957715,SRX20140881,CPSF3L,349
chr1,234957409,234957650,SRX5716469,SMARCA4,241
chr1,234957477,234957690,SRX5054307,FOSL2,213
chr1,234962557,234963064,SRX5716469,SMARCA4,507
chr1,234962603,234963033,SRX5075169,SMARCA4,430
chr1,234962644,234963035,SRX5075170,SMARCA4,391
chr1,234962653,234963053,SRX5075176,SMARCA4,400
chr1,234962663,234963052,SRX5716470,SMARCA4,389
chr1,234962664,234963011,SRX5075175,SMARCA4,347
chr1,234962672,234962899,SRX5075182,SMARCA2,227
chr1,234962706,234963006,SRX5054309,FOSL2,300
chr1,234962726,234963023,SRX5054308,FOSL2,297
chr1,234962751,234962988,SRX5020214,SMARCA2,237
chr1,234962769,234962990,SRX5716468,SMARCA2,221
chr1,234962775,234963051,SRX5716467,SMARCA2,276
chr1,234962801,234963023,SRX5075181,SMARCA2,222
chr1,234963271,234963901,SRX5075169,SMARCA4,630
chr1,234963587,234963985,SRX5075176,SMARCA4,398
chr1,234963590,234963773,SRX5054309,FOSL2,183
chr1,234963635,234963874,SRX5075175,SMARCA4,239
chr1,234963635,234964000,SRX5075170,SMARCA4,365
chr1,234963659,234963900,SRX5716470,SMARCA4,241
chr1,234969880,234971030,SRX5716470,SMARCA4,1150
chr1,234969935,234970302,SRX5075174,SMARCA4,367
chr1,234969972,234970351,SRX5075169,SMARCA4,379
chr1,234969972,234970391,SRX5075176,SMARCA4,419
chr1,234969983,234970256,SRX20140895,INTS13,273
chr1,234970021,234970368,SRX5075170,SMARCA4,347
chr1,234970022,234970326,SRX5075168,SMARCA4,304
chr1,234970028,234970477,SRX5075175,SMARCA4,449
chr1,234970060,234970309,SRX5716468,SMARCA2,249
chr1,234970104,234970317,SRX5054308,FOSL2,213
chr1,234970126,234971172,SRX5716469,SMARCA4,1046
chr1,234970273,234970550,SRX5020211,SMARCA2,277
chr1,234970407,234971067,SRX5075169,SMARCA4,660
chr1,234970496,234971023,SRX5716467,SMARCA2,527
chr1,234970509,234970874,SRX5075181,SMARCA2,365
chr1,234970520,234971321,SRX5075176,SMARCA4,801
chr1,234970538,234971280,SRX5075170,SMARCA4,742
chr1,234970568,234970762,SRX5054308,FOSL2,194
chr1,234970575,234971225,SRX5075175,SMARCA4,650
chr1,234970585,234970888,SRX5020214,SMARCA2,303
chr1,234970602,234970915,SRX5054309,FOSL2,313
chr1,234970626,234971035,SRX5716468,SMARCA2,409
chr1,234975056,234975477,SRX5054309,FOSL2,421
chr1,234975139,234975509,SRX5054308,FOSL2,370
chr1,234978624,234978975,SRX5075169,SMARCA4,351
chr1,234978703,234979033,SRX5075170,SMARCA4,330
chr1,234978756,234979079,SRX5075174,SMARCA4,323
chr1,234978760,234979182,SRX5075176,SMARCA4,422
chr1,234978776,234979082,SRX20140881,CPSF3L,306
chr1,234978785,234979022,SRX5075168,SMARCA4,237
chr1,234978852,234979128,SRX5716469,SMARCA4,276
chr1,234980643,234980955,SRX5075175,SMARCA4,312
chr1,234980682,234981279,SRX5075170,SMARCA4,597
chr1,234980757,234981289,SRX5054309,FOSL2,532
chr1,234980778,234981260,SRX5075169,SMARCA4,482
chr1,234980814,234981319,SRX5075176,SMARCA4,505
chr1,234980969,234981216,SRX5716470,SMARCA4,247
chr1,234980999,234981295,SRX5054308,FOSL2,296
chr1,234984321,234984755,SRX5075174,SMARCA4,434
chr1,234984383,234984682,SRX5054309,FOSL2,299
chr1,234984383,234984691,SRX5075168,SMARCA4,308
chr1,234984385,234984724,SRX5075170,SMARCA4,339
chr1,234984389,234984686,SRX5075175,SMARCA4,297
chr1,234984390,234984618,SRX5716464,SMARCA4,228
chr1,234984390,234984717,SRX5716467,SMARCA2,327
chr1,234984396,234984714,SRX5716469,SMARCA4,318
chr1,234984410,234984762,SRX5075169,SMARCA4,352
chr1,234984411,234984665,SRX5075176,SMARCA4,254
chr1,234984483,234984705,SRX5716470,SMARCA4,222
chr1,234984484,234984739,SRX5716468,SMARCA2,255
chr1,234986978,234987713,SRX5075168,SMARCA4,735
chr1,234987379,234987770,SRX5716470,SMARCA4,391
chr1,234987419,234987726,SRX5075176,SMARCA4,307
chr1,234987426,234987806,SRX5075170,SMARCA4,380
chr1,234987434,234987747,SRX5075174,SMARCA4,313
chr1,234987440,234987681,SRX5716469,SMARCA4,241
chr1,234987456,234987684,SRX5716464,SMARCA4,228
chr1,234987464,234987727,SRX5716467,SMARCA2,263
chr1,234987472,234987784,SRX5075169,SMARCA4,312
chr1,234987519,234987802,SRX5075175,SMARCA4,283
chr1,234987554,234987781,SRX5716468,SMARCA2,227
chr1,234997110,234997755,SRX5075170,SMARCA4,645
chr1,234997144,234997820,SRX5075175,SMARCA4,676
chr1,234997148,234997759,SRX5075169,SMARCA4,611
chr1,234997154,234997754,SRX5075176,SMARCA4,600
chr1,234997178,234997699,SRX5716469,SMARCA4,521
chr1,234997215,234997812,SRX5716470,SMARCA4,597
chr1,234997222,234997702,SRX5716467,SMARCA2,480
chr1,234997266,234997622,SRX5716468,SMARCA2,356
chr1,234997267,234997721,SRX5054309,FOSL2,454
chr1,234997301,234997608,SRX5075182,SMARCA2,307
chr1,234997308,234997681,SRX5054308,FOSL2,373
chr1,234997391,234997655,SRX5020211,SMARCA2,264
chr1,235011646,235012215,SRX5075175,SMARCA4,569
chr1,235011661,235012174,SRX5075170,SMARCA4,513
chr1,235011663,235011911,SRX5716459,Epitope tags,248
chr1,235011666,235012142,SRX5075176,SMARCA4,476
chr1,235011688,235012120,SRX5054308,FOSL2,432
chr1,235011692,235012078,SRX5054309,FOSL2,386
chr1,235011692,235012138,SRX5075169,SMARCA4,446
chr1,235011718,235012139,SRX5716469,SMARCA4,421
chr1,235011743,235011971,SRX5020214,SMARCA2,228
chr1,235011793,235012142,SRX5716470,SMARCA4,349
chr1,235011799,235012105,SRX5020211,SMARCA2,306
chr1,235018155,235018423,SRX5075169,SMARCA4,268
chr1,235018172,235018483,SRX5054309,FOSL2,311
chr1,235018191,235018460,SRX5020214,SMARCA2,269
chr1,235018198,235018457,SRX5054308,FOSL2,259
chr1,235018210,235018468,SRX5075170,SMARCA4,258
chr1,235018215,235018404,SRX5075175,SMARCA4,189
chr1,235018278,235018476,SRX5075176,SMARCA4,198
chr1,235019984,235020250,SRX5075174,SMARCA4,266
chr1,235020068,235020319,SRX5075168,SMARCA4,251
chr1,235022341,235022696,SRX5075176,SMARCA4,355
chr1,235022366,235022594,SRX5075174,SMARCA4,228
chr1,235022386,235022722,SRX5075170,SMARCA4,336
chr1,235022451,235022700,SRX5075169,SMARCA4,249
chr1,235022498,235022758,SRX5716470,SMARCA4,260
chr1,235022556,235022772,SRX5075175,SMARCA4,216
chr1,235048037,235048454,SRX5075169,SMARCA4,417
chr1,235048077,235048494,SRX5075170,SMARCA4,417
chr1,235048098,235048399,SRX5716469,SMARCA4,301
chr1,235048104,235048481,SRX5075176,SMARCA4,377
chr1,235048111,235048436,SRX5075175,SMARCA4,325
chr1,235048186,235048400,SRX5054308,FOSL2,214
chr1,235048187,235048424,SRX5054309,FOSL2,237
chr1,235048249,235048496,SRX5075168,SMARCA4,247
chr1,235067635,235067965,SRX5075175,SMARCA4,330
chr1,235067649,235067939,SRX5075176,SMARCA4,290
chr1,235067715,235067981,SRX5716470,SMARCA4,266
chr1,235067728,235067986,SRX5075169,SMARCA4,258
chr1,235068093,235068527,SRX5075174,SMARCA4,434
chr1,235070062,235070404,SRX5075175,SMARCA4,342
chr1,235070097,235070542,SRX5075176,SMARCA4,445
chr1,235070176,235070399,SRX5075170,SMARCA4,223
chr1,235074605,235074809,SRX5075176,SMARCA4,204
chr1,235074615,235074813,SRX5054308,FOSL2,198
chr1,235074628,235074846,SRX5075170,SMARCA4,218
chr1,235074664,235075043,SRX5075168,SMARCA4,379
chr1,235074667,235075114,SRX5075174,SMARCA4,447
chr1,235075220,235075633,SRX5075169,SMARCA4,413
chr1,235075376,235075591,SRX5716467,SMARCA2,215
chr1,235075385,235075615,SRX5716469,SMARCA4,230
chr1,235075415,235075586,SRX5075170,SMARCA4,171
chr1,235075444,235075627,SRX5054309,FOSL2,183
chr1,235075451,235075667,SRX5075176,SMARCA4,216
chr1,235075451,235075784,SRX5075175,SMARCA4,333
chr1,235083145,235084024,SRX5716469,SMARCA4,879
chr1,235083154,235083974,SRX5075170,SMARCA4,820
chr1,235083182,235083988,SRX5075176,SMARCA4,806
chr1,235083203,235083865,SRX5075169,SMARCA4,662
chr1,235083204,235084094,SRX5075168,SMARCA4,890
chr1,235083215,235083881,SRX5075175,SMARCA4,666
chr1,235083225,235083504,SRX5716467,SMARCA2,279
chr1,235083232,235084037,SRX5075174,SMARCA4,805
chr1,235083234,235083998,SRX5716470,SMARCA4,764
chr1,235083256,235083504,SRX5020214,SMARCA2,248
chr1,235083260,235083481,SRX5054308,FOSL2,221
chr1,235083262,235083594,SRX5716468,SMARCA2,332
chr1,235083277,235083471,SRX5075181,SMARCA2,194
chr1,235083325,235083528,SRX5054309,FOSL2,203
chr1,235083418,235083719,SRX20140897,INTS13,301
chr1,235083539,235083805,SRX20140869,INTS10,266
chr1,235083577,235084096,SRX16500062,CTCF,519
chr1,235083601,235084094,SRX16500060,CTCF,493
chr1,235083650,235084116,SRX16500061,CTCF,466
chr1,235083654,235084170,SRX16500059,CTCF,516
chr1,235083675,235084091,SRX4174629,CTCF,416
chr1,235090337,235090938,SRX5075168,SMARCA4,601
chr1,235090358,235090991,SRX5075174,SMARCA4,633
chr1,235090377,235090729,SRX5075175,SMARCA4,352
chr1,235090382,235090838,SRX5716464,SMARCA4,456
chr1,235090441,235090848,SRX5716463,SMARCA4,407
chr1,235090443,235090745,SRX5075169,SMARCA4,302
chr1,235090450,235090880,SRX5075170,SMARCA4,430
chr1,235090457,235090813,SRX5716470,SMARCA4,356
chr1,235090468,235090952,SRX20140895,INTS13,484
chr1,235090492,235090882,SRX5716469,SMARCA4,390
chr1,235090497,235090786,SRX5716451,SOX2,289
chr1,235090503,235090884,SRX5075176,SMARCA4,381
chr1,235093340,235094227,SRX16500060,CTCF,887
chr1,235093354,235094190,SRX16500062,CTCF,836
chr1,235093368,235094257,SRX16500059,CTCF,889
chr1,235093389,235094221,SRX16500061,CTCF,832
chr1,235093733,235094146,SRX4174629,CTCF,413
chr1,235093849,235094192,SRX5075169,SMARCA4,343
chr1,235093864,235094172,SRX5716463,SMARCA4,308
chr1,235093864,235094173,SRX5075176,SMARCA4,309
chr1,235093867,235094169,SRX5075170,SMARCA4,302
chr1,235093875,235094188,SRX5075168,SMARCA4,313
chr1,235093882,235094163,SRX5075175,SMARCA4,281
chr1,235093884,235094201,SRX5075174,SMARCA4,317
chr1,235093902,235094194,SRX5716470,SMARCA4,292
chr1,235093908,235094130,SRX5716469,SMARCA4,222
chr1,235100164,235100428,SRX5075170,SMARCA4,264
chr1,235100227,235100563,SRX5075176,SMARCA4,336
chr1,235100260,235100614,SRX5075174,SMARCA4,354
chr1,235100276,235100678,SRX20140895,INTS13,402
chr1,235100278,235100528,SRX5075168,SMARCA4,250
chr1,235104061,235104622,SRX16500059,CTCF,561
chr1,235104068,235104601,SRX16500060,CTCF,533
chr1,235104072,235104587,SRX16500061,CTCF,515
chr1,235104107,235104610,SRX16500062,CTCF,503
chr1,235104155,235104588,SRX5075176,SMARCA4,433
chr1,235104168,235104580,SRX5075168,SMARCA4,412
chr1,235104178,235104550,SRX5075175,SMARCA4,372
chr1,235104197,235104577,SRX5075170,SMARCA4,380
chr1,235104199,235104574,SRX5075174,SMARCA4,375
chr1,235104199,235104591,SRX5716469,SMARCA4,392
chr1,235104201,235104603,SRX4174629,CTCF,402
chr1,235104202,235104565,SRX5716463,SMARCA4,363
chr1,235104214,235104555,SRX5075169,SMARCA4,341
chr1,235104226,235104631,SRX5716470,SMARCA4,405
chr1,235104235,235104552,SRX5716464,SMARCA4,317
chr1,235104241,235104550,SRX5075182,SMARCA2,309
chr1,235104280,235104518,SRX5716468,SMARCA2,238
chr1,235128459,235129289,SRX20140895,INTS13,830
chr1,235128475,235129024,SRX20140868,INTS10,549
chr1,235128555,235128940,SRX20140881,CPSF3L,385
chr1,235128578,235129169,SRX20140897,INTS13,591
chr1,235128591,235128876,SRX20140879,CPSF3L,285
chr1,235128671,235129200,SRX5075174,SMARCA4,529
chr1,235128676,235128935,SRX20140867,INTS10,259
chr1,235128696,235129181,SRX5075168,SMARCA4,485
chr1,235128696,235129211,SRX5075170,SMARCA4,515
chr1,235128800,235129175,SRX5075176,SMARCA4,375
chr1,235128812,235129011,SRX5054309,FOSL2,199
chr1,235128856,235129165,SRX5716464,SMARCA4,309
chr1,235128865,235129150,SRX5716463,SMARCA4,285
chr1,235128954,235129169,SRX5716469,SMARCA4,215
chr1,235160907,235161575,SRX20140869,INTS10,668
chr1,235160962,235161546,SRX20140895,INTS13,584
chr1,235160964,235161649,SRX5075175,SMARCA4,685
chr1,235161049,235161547,SRX5075174,SMARCA4,498
chr1,235161056,235161536,SRX20140897,INTS13,480
chr1,235161058,235161543,SRX5075176,SMARCA4,485
chr1,235161070,235161440,SRX5075170,SMARCA4,370
chr1,235161071,235161528,SRX20140881,CPSF3L,457
chr1,235161079,235161531,SRX5075168,SMARCA4,452
chr1,235161085,235161548,SRX20140867,INTS10,463
chr1,235161187,235161453,SRX20140879,CPSF3L,266
chr1,235161246,235161525,SRX5716463,SMARCA4,279
chr1,235161262,235161584,SRX5716469,SMARCA4,322
chr1,235161288,235161492,SRX5075169,SMARCA4,204
chr1,235161299,235161624,SRX5716470,SMARCA4,325
chr1,235199377,235199662,SRX5716470,SMARCA4,285
chr1,235199403,235199787,SRX5075174,SMARCA4,384
chr1,235199405,235199725,SRX5075169,SMARCA4,320
chr1,235199407,235199785,SRX5075176,SMARCA4,378
chr1,235199411,235199781,SRX5075170,SMARCA4,370
chr1,235199434,235199788,SRX16500060,CTCF,354
chr1,235199438,235199838,SRX16500061,CTCF,400
chr1,235199439,235199700,SRX5075175,SMARCA4,261
chr1,235199442,235199752,SRX5075168,SMARCA4,310
chr1,235199447,235199788,SRX16500059,CTCF,341
chr1,235199493,235199747,SRX5716464,SMARCA4,254
chr1,235199494,235199890,SRX16500062,CTCF,396
chr1,235199506,235199718,SRX5716469,SMARCA4,212
chr1,235199522,235199773,SRX5716463,SMARCA4,251
chr1,235252996,235253601,SRX16500059,CTCF,605
chr1,235253011,235253586,SRX16500060,CTCF,575
chr1,235253081,235253566,SRX16500061,CTCF,485
chr1,235253147,235253608,SRX16500062,CTCF,461
chr1,235253208,235253535,SRX5075168,SMARCA4,327
chr1,235253215,235253546,SRX5075174,SMARCA4,331
chr1,235253227,235253509,SRX5716463,SMARCA4,282
chr1,235253257,235253542,SRX5075170,SMARCA4,285
chr1,235253276,235253507,SRX5075176,SMARCA4,231
chr1,235253325,235253535,SRX4174629,CTCF,210
chr1,235253335,235253555,SRX5075169,SMARCA4,220
chr1,235256353,235256598,SRX5075169,SMARCA4,245
chr1,235256377,235256609,SRX5075175,SMARCA4,232
chr1,235256425,235256612,SRX5054309,FOSL2,187
chr1,235266292,235266649,SRX5075174,SMARCA4,357
chr1,235266316,235266535,SRX5716467,SMARCA2,219
chr1,235266371,235266634,SRX5716463,SMARCA4,263
chr1,235266395,235266621,SRX5716470,SMARCA4,226
chr1,235266450,235266644,SRX5075170,SMARCA4,194
chr1,235270544,235270903,SRX5075168,SMARCA4,359
chr1,235270546,235270969,SRX5075174,SMARCA4,423
chr1,235270605,235271045,SRX5075176,SMARCA4,440
chr1,235270654,235271013,SRX5075170,SMARCA4,359
chr1,235270664,235270844,SRX5075169,SMARCA4,180
chr1,235270688,235270966,SRX5716469,SMARCA4,278
chr1,235277777,235278015,SRX5054309,FOSL2,238
chr1,235327865,235328307,SRX20140895,INTS13,442
chr1,235327902,235328214,SRX20140867,INTS10,312
chr1,235328248,235328543,SRX5716451,SOX2,295
chr1,235328536,235328797,SRX20140867,INTS10,261
chr1,235328560,235328823,SRX20140881,CPSF3L,263
chr1,235328606,235328914,SRX20140895,INTS13,308
chr1,235328712,235329156,SRX5075170,SMARCA4,444
chr1,235328724,235328911,SRX5054309,FOSL2,187
chr1,235328826,235329013,SRX5075174,SMARCA4,187
chr1,235328908,235329111,SRX5075168,SMARCA4,203
chr1,235367135,235367806,SRX5075174,SMARCA4,671
chr1,235367141,235367620,SRX5075170,SMARCA4,479
chr1,235367142,235367650,SRX5075168,SMARCA4,508
chr1,235367149,235367403,SRX5054309,FOSL2,254
chr1,235367154,235367590,SRX5075176,SMARCA4,436
chr1,235367158,235367764,SRX5075169,SMARCA4,606
chr1,235367181,235367438,SRX5716463,SMARCA4,257
chr1,235367216,235367468,SRX5716464,SMARCA4,252
chr1,235367229,235367900,SRX20140895,INTS13,671
chr1,235367251,235367608,SRX5054308,FOSL2,357
chr1,235367284,235367755,SRX20140869,INTS10,471
chr1,235367294,235367771,SRX20140897,INTS13,477
chr1,235367359,235367621,SRX20140879,CPSF3L,262
chr1,235367398,235367640,SRX20140867,INTS10,242
chr1,235367399,235367795,SRX5075175,SMARCA4,396
chr1,235367587,235367851,SRX5716470,SMARCA4,264
chr1,235391899,235392166,SRX5054309,FOSL2,267
chr1,235397638,235398097,SRX5075169,SMARCA4,459
chr1,235397684,235397994,SRX5020214,SMARCA2,310
chr1,235397696,235398119,SRX5716469,SMARCA4,423
chr1,235397717,235398115,SRX5075175,SMARCA4,398
chr1,235397717,235398118,SRX5075170,SMARCA4,401
chr1,235397728,235398117,SRX5054309,FOSL2,389
chr1,235397748,235398095,SRX5075176,SMARCA4,347
chr1,235397768,235398007,SRX5075182,SMARCA2,239
chr1,235397772,235398087,SRX5716467,SMARCA2,315
chr1,235397780,235398183,SRX5716470,SMARCA4,403
chr1,235397781,235398132,SRX5054308,FOSL2,351
chr1,235415312,235415675,SRX16500061,CTCF,363
chr1,235415316,235415779,SRX16500059,CTCF,463
chr1,235415329,235415597,SRX5075168,SMARCA4,268
chr1,235415333,235415562,SRX5075174,SMARCA4,229
chr1,235415340,235415719,SRX16500062,CTCF,379
chr1,235415342,235415715,SRX16500060,CTCF,373
chr1,235415403,235415592,SRX5075176,SMARCA4,189
chr1,235415406,235415601,SRX5075170,SMARCA4,195
chr1,235417025,235417494,SRX16500060,CTCF,469
chr1,235417067,235417564,SRX16500062,CTCF,497
chr1,235417071,235417502,SRX16500059,CTCF,431
chr1,235417089,235417518,SRX16500061,CTCF,429
chr1,235417125,235417417,SRX5075176,SMARCA4,292
chr1,235417130,235417364,SRX4174629,CTCF,234
chr1,235417147,235417481,SRX5075174,SMARCA4,334
chr1,235417153,235417424,SRX5075168,SMARCA4,271
chr1,235417164,235417410,SRX5075170,SMARCA4,246
chr1,235442729,235443188,SRX5075175,SMARCA4,459
chr1,235442770,235443196,SRX5075169,SMARCA4,426
chr1,235442782,235443108,SRX5054309,FOSL2,326
chr1,235442801,235443162,SRX5075176,SMARCA4,361
chr1,235442809,235443071,SRX5054308,FOSL2,262
chr1,235442810,235443131,SRX5075170,SMARCA4,321
chr1,235442847,235443107,SRX5716469,SMARCA4,260
chr1,235469012,235469328,SRX5054309,FOSL2,316
chr1,235469044,235469267,SRX5716470,SMARCA4,223
chr1,235469068,235469321,SRX5054308,FOSL2,253
chr1,235504011,235505527,SRX20140895,INTS13,1516
chr1,235504059,235504637,SRX20140868,INTS10,578
chr1,235504198,235504468,SRX20140867,INTS10,270
chr1,235504232,235504443,SRX5075169,SMARCA4,211
chr1,235504232,235504899,SRX5075176,SMARCA4,667
chr1,235504303,235505007,SRX5075174,SMARCA4,704
chr1,235504364,235504930,SRX16500062,CTCF,566
chr1,235504367,235504987,SRX16500059,CTCF,620
chr1,235504379,235504961,SRX5075168,SMARCA4,582
chr1,235504383,235505004,SRX16500060,CTCF,621
chr1,235504389,235504702,SRX5716469,SMARCA4,313
chr1,235504421,235504893,SRX5716463,SMARCA4,472
chr1,235504432,235505010,SRX16500061,CTCF,578
chr1,235504474,235505042,SRX5075170,SMARCA4,568
chr1,235504512,235505115,SRX5054309,FOSL2,603
chr1,235504530,235504746,SRX5075169,SMARCA4,216
chr1,235504531,235504711,SRX5054308,FOSL2,180
chr1,235504531,235504973,SRX20140867,INTS10,442
chr1,235504546,235504743,SRX5075181,SMARCA2,197
chr1,235504554,235504923,SRX5716470,SMARCA4,369
chr1,235504591,235504801,SRX4174629,CTCF,210
chr1,235504722,235505215,SRX20140868,INTS10,493
chr1,235504725,235505206,SRX20140897,INTS13,481
chr1,235504780,235505077,SRX5054308,FOSL2,297
chr1,235504792,235505090,SRX5075175,SMARCA4,298
chr1,235513699,235514256,SRX16500059,CTCF,557
chr1,235513732,235514246,SRX16500062,CTCF,514
chr1,235513735,235514200,SRX16500061,CTCF,465
chr1,235513751,235514246,SRX16500060,CTCF,495
chr1,235513769,235514120,SRX5075168,SMARCA4,351
chr1,235513783,235514114,SRX5075175,SMARCA4,331
chr1,235513783,235514126,SRX5075174,SMARCA4,343
chr1,235513796,235514099,SRX5075170,SMARCA4,303
chr1,235513811,235514074,SRX5716469,SMARCA4,263
chr1,235513815,235514126,SRX5075176,SMARCA4,311
chr1,235513823,235514106,SRX5716463,SMARCA4,283
chr1,235513829,235514118,SRX5075169,SMARCA4,289
chr1,235513838,235514115,SRX5716470,SMARCA4,277
chr1,235513852,235514131,SRX5716464,SMARCA4,279
chr1,235532403,235532640,SRX5075169,SMARCA4,237
chr1,235546815,235547164,SRX20140867,INTS10,349
chr1,235566111,235566435,SRX5075168,SMARCA4,324
chr1,235566127,235566427,SRX5075174,SMARCA4,300
chr1,235598197,235598512,SRX5054309,FOSL2,315
chr1,235598250,235598462,SRX5054308,FOSL2,212
chr1,235601167,235601416,SRX16500062,CTCF,249
chr1,235601170,235601449,SRX16500061,CTCF,279
chr1,235601179,235601441,SRX16500059,CTCF,262
chr1,235601213,235601459,SRX16500060,CTCF,246
chr1,235617904,235618115,SRX5716470,SMARCA4,211
chr1,235617911,235618135,SRX5075169,SMARCA4,224
chr1,235617924,235618164,SRX5075175,SMARCA4,240
chr1,235617929,235618175,SRX5054309,FOSL2,246
chr1,235624603,235625160,SRX5716470,SMARCA4,557
chr1,235624640,235625104,SRX5020211,SMARCA2,464
chr1,235624648,235625197,SRX5075176,SMARCA4,549
chr1,235624666,235625195,SRX5075169,SMARCA4,529
chr1,235624669,235625080,SRX5075170,SMARCA4,411
chr1,235624760,235625237,SRX5716469,SMARCA4,477
chr1,235624877,235625206,SRX5716467,SMARCA2,329
chr1,235624919,235625128,SRX5075175,SMARCA4,209
chr1,235632567,235632878,SRX5075175,SMARCA4,311
chr1,235632572,235632955,SRX5075174,SMARCA4,383
chr1,235632580,235632924,SRX5075170,SMARCA4,344
chr1,235632639,235632906,SRX5075169,SMARCA4,267
chr1,235632639,235633016,SRX5075168,SMARCA4,377
chr1,235632663,235632874,SRX5716470,SMARCA4,211
chr1,235632702,235633077,SRX5716469,SMARCA4,375
chr1,235633011,235633230,SRX5075175,SMARCA4,219
chr1,235642365,235642643,SRX5075176,SMARCA4,278
chr1,235642383,235642710,SRX5716469,SMARCA4,327
chr1,235642407,235642665,SRX5075174,SMARCA4,258
chr1,235642412,235642669,SRX5075170,SMARCA4,257
chr1,235642434,235642614,SRX5054308,FOSL2,180
chr1,235642437,235642620,SRX5054309,FOSL2,183
chr1,235642442,235642621,SRX5075168,SMARCA4,179
chr1,235648922,235649276,SRX5075169,SMARCA4,354
chr1,235648941,235649256,SRX5716470,SMARCA4,315
chr1,235648962,235649237,SRX5075176,SMARCA4,275
chr1,235648980,235649255,SRX5075175,SMARCA4,275
chr1,235648981,235649315,SRX5716469,SMARCA4,334
chr1,235648997,235649220,SRX5075170,SMARCA4,223
chr1,235649002,235649218,SRX5075174,SMARCA4,216
chr1,235649183,235649985,SRX20140895,INTS13,802
chr1,235649665,235649983,SRX5075174,SMARCA4,318
chr1,235703585,235703814,SRX5054308,FOSL2,229
chr1,235703600,235703802,SRX5075169,SMARCA4,202
chr1,235703668,235703869,SRX5054309,FOSL2,201
chr1,235708573,235708908,SRX5075170,SMARCA4,335
chr1,235708578,235708894,SRX5075176,SMARCA4,316
chr1,235708685,235708896,SRX5054309,FOSL2,211
chr1,235725351,235725793,SRX5075170,SMARCA4,442
chr1,235725433,235725818,SRX5716470,SMARCA4,385
chr1,235725473,235725854,SRX5075169,SMARCA4,381
chr1,235725483,235725822,SRX5075176,SMARCA4,339
chr1,235725484,235725748,SRX5020211,SMARCA2,264
chr1,235725484,235725811,SRX5075175,SMARCA4,327
chr1,235725487,235725892,SRX5716469,SMARCA4,405
chr1,235725519,235725819,SRX5716467,SMARCA2,300
chr1,235725522,235725777,SRX5716468,SMARCA2,255
chr1,235725531,235725748,SRX5054309,FOSL2,217
chr1,235725538,235725804,SRX5075181,SMARCA2,266
chr1,235725544,235725769,SRX5054308,FOSL2,225
chr1,235731649,235732060,SRX16500060,CTCF,411
chr1,235731668,235732081,SRX16500059,CTCF,413
chr1,235731718,235732072,SRX16500062,CTCF,354
chr1,235731729,235732018,SRX16500061,CTCF,289
chr1,235741346,235741562,SRX5054308,FOSL2,216
chr1,235741353,235741624,SRX5054309,FOSL2,271
chr1,235741358,235741661,SRX5075169,SMARCA4,303
chr1,235741377,235741626,SRX5716469,SMARCA4,249
chr1,235741386,235741640,SRX5075175,SMARCA4,254
chr1,235745420,235745851,SRX5716469,SMARCA4,431
chr1,235745441,235745864,SRX5075176,SMARCA4,423
chr1,235745467,235745821,SRX5716467,SMARCA2,354
chr1,235745484,235745702,SRX5716468,SMARCA2,218
chr1,235745490,235745903,SRX5075170,SMARCA4,413
chr1,235745494,235745859,SRX5075175,SMARCA4,365
chr1,235745499,235745819,SRX5075169,SMARCA4,320
chr1,235745520,235745912,SRX5716470,SMARCA4,392
chr1,235776478,235776700,SRX5054309,FOSL2,222
chr1,235783053,235783556,SRX16500062,CTCF,503
chr1,235783110,235783582,SRX16500059,CTCF,472
chr1,235783160,235783574,SRX16500060,CTCF,414
chr1,235783175,235783576,SRX16500061,CTCF,401
chr1,235783207,235783455,SRX5075169,SMARCA4,248
chr1,235783239,235783480,SRX5075168,SMARCA4,241
chr1,235783263,235783438,SRX5075176,SMARCA4,175
chr1,235783266,235783485,SRX5075174,SMARCA4,219
chr1,235783279,235783507,SRX5075175,SMARCA4,228
chr1,235783316,235783487,SRX5075170,SMARCA4,171
chr1,235831110,235831472,SRX5075170,SMARCA4,362
chr1,235831194,235831430,SRX5075176,SMARCA4,236
chr1,235843362,235843686,SRX16500062,CTCF,324
chr1,235843379,235843729,SRX16500061,CTCF,350
chr1,235843385,235843727,SRX16500060,CTCF,342
chr1,235843401,235843811,SRX16500059,CTCF,410
chr1,235843408,235843696,SRX5716470,SMARCA4,288
chr1,235843419,235843722,SRX5075176,SMARCA4,303
chr1,235843421,235843663,SRX5075175,SMARCA4,242
chr1,235843429,235843679,SRX5716469,SMARCA4,250
chr1,235843433,235843710,SRX5075168,SMARCA4,277
chr1,235843435,235843718,SRX5075170,SMARCA4,283
chr1,235843450,235843702,SRX5075174,SMARCA4,252
chr1,235843483,235843718,SRX5075169,SMARCA4,235
chr1,235843537,235843741,SRX5716463,SMARCA4,204
chr1,235866143,235866434,SRX16500061,CTCF,291
chr1,235866556,235867479,SRX20140895,INTS13,923
chr1,235866651,235867396,SRX5075170,SMARCA4,745
chr1,235866735,235867330,SRX5075174,SMARCA4,595
chr1,235866737,235867428,SRX5075168,SMARCA4,691
chr1,235866830,235867181,SRX5716463,SMARCA4,351
chr1,235866838,235867284,SRX5716464,SMARCA4,446
chr1,235866977,235867455,SRX20140868,INTS10,478
chr1,235866982,235867222,SRX5054307,FOSL2,240
chr1,235867014,235867424,SRX5075176,SMARCA4,410
chr1,235867023,235867325,SRX20140867,INTS10,302
chr1,235867078,235867289,SRX5716470,SMARCA4,211
chr1,235867101,235867297,SRX5075169,SMARCA4,196
chr1,235867140,235867427,SRX20140879,CPSF3L,287
chr1,235867187,235867453,SRX20140881,CPSF3L,266
chr1,235883297,235883588,SRX5054309,FOSL2,291
chr1,235883363,235883947,SRX5075169,SMARCA4,584
chr1,235883532,235883854,SRX5716467,SMARCA2,322
chr1,235883585,235883984,SRX5054308,FOSL2,399
chr1,235883599,235883866,SRX5075176,SMARCA4,267
chr1,235883612,235883824,SRX5716469,SMARCA4,212
chr1,235883620,235883912,SRX5075175,SMARCA4,292
chr1,235883627,235883888,SRX5020211,SMARCA2,261
chr1,235883668,235883946,SRX5075170,SMARCA4,278
chr1,235883682,235883940,SRX5054309,FOSL2,258
chr1,235901614,235901868,SRX5054309,FOSL2,254
chr1,235903029,235903351,SRX5054308,FOSL2,322
chr1,235903030,235903360,SRX5054309,FOSL2,330
chr1,235903051,235903375,SRX5075176,SMARCA4,324
chr1,235903056,235903334,SRX5075169,SMARCA4,278
chr1,235903059,235903371,SRX5075170,SMARCA4,312
chr1,235903092,235903324,SRX5075175,SMARCA4,232
chr1,235908761,235909095,SRX5075170,SMARCA4,334
chr1,235908806,235909069,SRX5075176,SMARCA4,263
chr1,235908847,235909137,SRX5075169,SMARCA4,290
chr1,235908868,235909188,SRX5075175,SMARCA4,320
chr1,235908883,235909173,SRX5716469,SMARCA4,290
chr1,235910315,235911038,SRX5075168,SMARCA4,723
chr1,235910335,235911047,SRX5075174,SMARCA4,712
chr1,235910378,235911014,SRX5075170,SMARCA4,636
chr1,235910394,235910778,SRX20140867,INTS10,384
chr1,235910419,235911069,SRX5075169,SMARCA4,650
chr1,235910428,235910763,SRX20140881,CPSF3L,335
chr1,235910433,235911046,SRX5075176,SMARCA4,613
chr1,235910441,235910939,SRX5716469,SMARCA4,498
chr1,235910458,235911064,SRX5075175,SMARCA4,606
chr1,235910459,235910887,SRX5716470,SMARCA4,428
chr1,235910462,235911053,SRX5054309,FOSL2,591
chr1,235910500,235910783,SRX5716463,SMARCA4,283
chr1,235910626,235910903,SRX5054307,FOSL2,277
chr1,235910636,235911006,SRX5054308,FOSL2,370
chr1,235910703,235910960,SRX5020214,SMARCA2,257
chr1,235910722,235910958,SRX5716467,SMARCA2,236
chr1,235910839,235911163,SRX5716460,Epitope tags,324
chr1,235917371,235917841,SRX5075176,SMARCA4,470
chr1,235917388,235917835,SRX5075170,SMARCA4,447
chr1,235917420,235917767,SRX5716470,SMARCA4,347
chr1,235917426,235917768,SRX5054308,FOSL2,342
chr1,235917430,235917827,SRX5075169,SMARCA4,397
chr1,235917432,235917795,SRX5054309,FOSL2,363
chr1,235917446,235917853,SRX5075175,SMARCA4,407
chr1,235917454,235917807,SRX5716469,SMARCA4,353
chr1,235917507,235917778,SRX5716468,SMARCA2,271
chr1,235917511,235917727,SRX5020211,SMARCA2,216
chr1,235920110,235920482,SRX5075176,SMARCA4,372
chr1,235920183,235920406,SRX5075170,SMARCA4,223
chr1,235923464,235923749,SRX5054308,FOSL2,285
chr1,235923499,235923773,SRX5075170,SMARCA4,274
chr1,235923545,235923764,SRX5075176,SMARCA4,219
chr1,235929303,235929550,SRX5075175,SMARCA4,247
chr1,235929304,235929652,SRX5075170,SMARCA4,348
chr1,235929312,235929612,SRX5075169,SMARCA4,300
chr1,235929323,235929574,SRX5075176,SMARCA4,251
chr1,235943503,235943785,SRX5716469,SMARCA4,282
chr1,235943514,235943791,SRX5075169,SMARCA4,277
chr1,235943528,235943708,SRX5054308,FOSL2,180
chr1,235943529,235943813,SRX5075176,SMARCA4,284
chr1,235943530,235943795,SRX5075175,SMARCA4,265
chr1,235943532,235943839,SRX5075170,SMARCA4,307
chr1,235946745,235946981,SRX5716470,SMARCA4,236
chr1,235953817,235954141,SRX5054309,FOSL2,324
chr1,235953864,235954086,SRX5054308,FOSL2,222
chr1,235953895,235954085,SRX5075169,SMARCA4,190
chr1,235971615,235972171,SRX16500061,CTCF,556
chr1,235971648,235972128,SRX5075176,SMARCA4,480
chr1,235971660,235972184,SRX16500060,CTCF,524
chr1,235971677,235972195,SRX5075168,SMARCA4,518
chr1,235971678,235972209,SRX16500059,CTCF,531
chr1,235971689,235972036,SRX4174629,CTCF,347
chr1,235971700,235972172,SRX5075174,SMARCA4,472
chr1,235971731,235972170,SRX5075170,SMARCA4,439
chr1,235971731,235972226,SRX20140895,INTS13,495
chr1,235971732,235972133,SRX16500062,CTCF,401
chr1,235971756,235972084,SRX5075175,SMARCA4,328
chr1,235971756,235972206,SRX5075169,SMARCA4,450
chr1,235971806,235972116,SRX5716464,SMARCA4,310
chr1,235971908,235972184,SRX5716469,SMARCA4,276
chr1,235972014,235972388,SRX5716470,SMARCA4,374
chr1,235972401,235972696,SRX5075175,SMARCA4,295
chr1,235972491,235972737,SRX5054309,FOSL2,246
chr1,235983899,235984770,SRX5075175,SMARCA4,871
chr1,235983924,235984716,SRX5716470,SMARCA4,792
chr1,235983927,235984794,SRX5075170,SMARCA4,867
chr1,235983945,235984771,SRX5075176,SMARCA4,826
chr1,235983950,235984774,SRX5075169,SMARCA4,824
chr1,235983978,235984740,SRX5716469,SMARCA4,762
chr1,235983992,235984309,SRX5716467,SMARCA2,317
chr1,235984010,235984498,SRX5716468,SMARCA2,488
chr1,235984037,235984244,SRX5020214,SMARCA2,207
chr1,235984047,235984415,SRX20140869,INTS10,368
chr1,235984124,235984375,SRX5020211,SMARCA2,251
chr1,235984403,235984731,SRX5054308,FOSL2,328
chr1,235984440,235984776,SRX5716467,SMARCA2,336
chr1,235984488,235984801,SRX5054309,FOSL2,313
chr1,235999351,235999723,SRX5075170,SMARCA4,372
chr1,235999407,235999763,SRX5054309,FOSL2,356
chr1,235999410,235999778,SRX5075176,SMARCA4,368
chr1,235999417,235999761,SRX5075175,SMARCA4,344
chr1,235999430,235999769,SRX5075169,SMARCA4,339
chr1,235999463,235999731,SRX5054308,FOSL2,268
chr1,236009769,236010264,SRX5075175,SMARCA4,495
chr1,236009779,236010232,SRX5716470,SMARCA4,453
chr1,236009780,236010303,SRX5075176,SMARCA4,523
chr1,236009815,236010278,SRX5075170,SMARCA4,463
chr1,236009860,236010236,SRX5716469,SMARCA4,376
chr1,236009882,236010270,SRX5075169,SMARCA4,388
chr1,236009895,236010304,SRX5716467,SMARCA2,409
chr1,236009914,236010216,SRX5054308,FOSL2,302
chr1,236009924,236010201,SRX5020211,SMARCA2,277
chr1,236009938,236010252,SRX5054309,FOSL2,314
chr1,236009974,236010206,SRX5716468,SMARCA2,232
chr1,236016118,236016402,SRX5075176,SMARCA4,284
chr1,236021475,236021886,SRX5716470,SMARCA4,411
chr1,236021497,236021843,SRX5075170,SMARCA4,346
chr1,236021561,236021858,SRX5075176,SMARCA4,297
chr1,236021592,236021809,SRX5075175,SMARCA4,217
chr1,236021592,236021838,SRX5716468,SMARCA2,246
chr1,236021605,236021894,SRX5716467,SMARCA2,289
chr1,236039723,236040059,SRX5075176,SMARCA4,336
chr1,236039743,236040013,SRX5075170,SMARCA4,270
chr1,236039744,236040045,SRX5716468,SMARCA2,301
chr1,236039770,236040005,SRX5716470,SMARCA4,235
chr1,236039799,236040016,SRX5075169,SMARCA4,217
chr1,236039813,236040025,SRX5716469,SMARCA4,212
chr1,236058108,236058652,SRX5075174,SMARCA4,544
chr1,236058192,236058789,SRX5075176,SMARCA4,597
chr1,236058222,236058606,SRX5075168,SMARCA4,384
chr1,236058256,236058540,SRX5075169,SMARCA4,284
chr1,236058257,236058623,SRX5075170,SMARCA4,366
chr1,236058302,236058750,SRX5716470,SMARCA4,448
chr1,236058352,236058623,SRX5075175,SMARCA4,271
chr1,236058358,236058577,SRX5716469,SMARCA4,219
chr1,236064820,236065424,SRX20140895,INTS13,604
chr1,236064845,236065412,SRX5075176,SMARCA4,567
chr1,236064894,236065467,SRX5075174,SMARCA4,573
chr1,236064924,236065148,SRX5716469,SMARCA4,224
chr1,236064983,236065528,SRX5075169,SMARCA4,545
chr1,236065012,236065442,SRX5075170,SMARCA4,430
chr1,236065045,236065408,SRX16500059,CTCF,363
chr1,236065051,236065483,SRX5075168,SMARCA4,432
chr1,236065054,236065416,SRX5075175,SMARCA4,362
chr1,236065074,236065372,SRX5716470,SMARCA4,298
chr1,236065151,236065407,SRX5716464,SMARCA4,256
chr1,236065178,236065416,SRX16500062,CTCF,238
chr1,236065180,236065442,SRX16500060,CTCF,262
chr1,236065203,236065448,SRX16500061,CTCF,245
chr1,236096980,236097405,SRX20140870,INTS10,425
chr1,236096994,236097425,SRX20140868,INTS10,431
chr1,236096996,236097473,SRX20140869,INTS10,477
chr1,236097005,236097444,SRX5716460,Epitope tags,439
chr1,236097010,236097491,SRX5054308,FOSL2,481
chr1,236097011,236097506,SRX5054309,FOSL2,495
chr1,236097015,236097385,SRX20140879,CPSF3L,370
chr1,236097015,236097394,SRX5020214,SMARCA2,379
chr1,236097017,236097393,SRX20140880,CPSF3L,376
chr1,236097017,236097455,SRX20140897,INTS13,438
chr1,236097019,236097410,SRX20140894,INTS13,391
chr1,236097020,236097412,SRX20140881,CPSF3L,392
chr1,236097023,236097407,SRX20140895,INTS13,384
chr1,236097026,236097469,SRX5075175,SMARCA4,443
chr1,236097029,236097491,SRX5054307,FOSL2,462
chr1,236097030,236097467,SRX5075168,SMARCA4,437
chr1,236097034,236097378,SRX20140861,SOX2,344
chr1,236097039,236097393,SRX20140860,SOX2,354
chr1,236097040,236097398,SRX20140892,SOX2,358
chr1,236097042,236097373,SRX20140867,INTS10,331
chr1,236097042,236097451,SRX5075169,SMARCA4,409
chr1,236097044,236097403,SRX20140896,INTS13,359
chr1,236097044,236097439,SRX5075174,SMARCA4,395
chr1,236097051,236097410,SRX5075170,SMARCA4,359
chr1,236097056,236097372,SRX20140891,SOX2,316
chr1,236097056,236097403,SRX5716463,SMARCA4,347
chr1,236097059,236097436,SRX5075176,SMARCA4,377
chr1,236097060,236097419,SRX20140882,CPSF3L,359
chr1,236097063,236097417,SRX5716469,SMARCA4,354
chr1,236097065,236097361,SRX20140862,SOX2,296
chr1,236097079,236097422,SRX5020211,SMARCA2,343
chr1,236097080,236097386,SRX9989504,GFP,306
chr1,236097090,236097408,SRX9989505,GFP,318
chr1,236097096,236097451,SRX5716470,SMARCA4,355
chr1,236097110,236097389,SRX20140890,SOX2,279
chr1,236097115,236097453,SRX5716467,SMARCA2,338
chr1,236097120,236097368,SRX16500059,CTCF,248
chr1,236097122,236097401,SRX5716451,SOX2,279
chr1,236097122,236097407,SRX5716459,Epitope tags,285
chr1,236097124,236097403,SRX5075182,SMARCA2,279
chr1,236097125,236097421,SRX5075181,SMARCA2,296
chr1,236097127,236097392,SRX1424894,POU3F2,265
chr1,236097128,236097399,SRX1424891,POU3F2,271
chr1,236097139,236097398,SRX5716468,SMARCA2,259
chr1,236097150,236097371,SRX5716454,SOX3,221
chr1,236097156,236097367,SRX5716464,SMARCA4,211
chr1,236097168,236097387,SRX16500061,CTCF,219
chr1,236097178,236097440,SRX16500062,CTCF,262
chr1,236097202,236097397,SRX1424893,POU3F2,195
chr1,236097273,236097393,SRX1424892,POU3F2,120
chr1,236103542,236104029,SRX16500059,CTCF,487
chr1,236103551,236104007,SRX16500062,CTCF,456
chr1,236103565,236104040,SRX16500061,CTCF,475
chr1,236103585,236104039,SRX16500060,CTCF,454
chr1,236103686,236103962,SRX5075174,SMARCA4,276
chr1,236103692,236103933,SRX5075176,SMARCA4,241
chr1,236103695,236103921,SRX4174629,CTCF,226
chr1,236103708,236103986,SRX5075175,SMARCA4,278
chr1,236103718,236103978,SRX5075170,SMARCA4,260
chr1,236103732,236104022,SRX5075168,SMARCA4,290
chr1,236103733,236103949,SRX5075169,SMARCA4,216
chr1,236109289,236109821,SRX16500059,CTCF,532
chr1,236109320,236109813,SRX16500061,CTCF,493
chr1,236109330,236109803,SRX16500062,CTCF,473
chr1,236109330,236109837,SRX16500060,CTCF,507
chr1,236109369,236109764,SRX4174629,CTCF,395
chr1,236109380,236109608,SRX5075176,SMARCA4,228
chr1,236109437,236109799,SRX5075170,SMARCA4,362
chr1,236109466,236109696,SRX5075168,SMARCA4,230
chr1,236129398,236129653,SRX5075168,SMARCA4,255
chr1,236129455,236129735,SRX5075174,SMARCA4,280
chr1,236142519,236142788,SRX5075175,SMARCA4,269
chr1,236142539,236142742,SRX5075176,SMARCA4,203
chr1,236142550,236142754,SRX5075174,SMARCA4,204
chr1,236142552,236142958,SRX20140895,INTS13,406
chr1,236142578,236142772,SRX5075169,SMARCA4,194
chr1,236172108,236172435,SRX5716468,SMARCA2,327
chr1,236172127,236172425,SRX5020211,SMARCA2,298
chr1,236172128,236172431,SRX5075176,SMARCA4,303
chr1,236172130,236172386,SRX5075175,SMARCA4,256
chr1,236172132,236172581,SRX5716470,SMARCA4,449
chr1,236172152,236172426,SRX5075170,SMARCA4,274
chr1,236172152,236172482,SRX5075181,SMARCA2,330
chr1,236172164,236172426,SRX5075169,SMARCA4,262
chr1,236172178,236172485,SRX5716469,SMARCA4,307
chr1,236172186,236172618,SRX5716467,SMARCA2,432
chr1,236181154,236181383,SRX5054309,FOSL2,229
chr1,236281595,236282177,SRX20140881,CPSF3L,582
chr1,236281610,236282267,SRX20140895,INTS13,657
chr1,236281643,236282064,SRX20140897,INTS13,421
chr1,236281676,236281850,SRX5075170,SMARCA4,174
chr1,236281701,236282265,SRX20140868,INTS10,564
chr1,236281703,236282085,SRX20140879,CPSF3L,382
chr1,236281749,236282342,SRX20140867,INTS10,593
chr1,236281767,236281978,SRX5716470,SMARCA4,211
chr1,236281780,236281980,SRX5075169,SMARCA4,200
chr1,236281790,236282346,SRX5075168,SMARCA4,556
chr1,236281805,236282342,SRX5075176,SMARCA4,537
chr1,236281811,236282064,SRX20140894,INTS13,253
chr1,236281836,236282371,SRX5075174,SMARCA4,535
chr1,236281944,236282406,SRX5075170,SMARCA4,462
chr1,236282025,236282204,SRX5054307,FOSL2,179
chr1,236282098,236282305,SRX5716463,SMARCA4,207
chr1,236282131,236282487,SRX5716469,SMARCA4,356
chr1,236282185,236282393,SRX5075169,SMARCA4,208
chr1,236307486,236307732,SRX5075168,SMARCA4,246
chr1,236307535,236307773,SRX5075170,SMARCA4,238
chr1,236307544,236307803,SRX5075174,SMARCA4,259
chr1,236307549,236307827,SRX5075176,SMARCA4,278
chr1,236307619,236307802,SRX5054309,FOSL2,183
chr1,236307744,236307957,SRX5054308,FOSL2,213
chr1,236338199,236338404,SRX5054309,FOSL2,205
chr1,236345785,236346019,SRX16500060,CTCF,234
chr1,236395111,236395471,SRX5075174,SMARCA4,360
chr1,236395120,236395379,SRX5075168,SMARCA4,259
chr1,236395334,236395514,SRX5075169,SMARCA4,180
chr1,236489826,236490394,SRX16500060,CTCF,568
chr1,236489842,236490306,SRX16500059,CTCF,464
chr1,236489857,236490290,SRX4174629,CTCF,433
chr1,236489861,236490332,SRX16500062,CTCF,471
chr1,236489875,236490297,SRX16500061,CTCF,422
chr1,236489918,236490107,SRX5075168,SMARCA4,189
chr1,236490005,236490174,SRX5075170,SMARCA4,169
chr1,236503110,236503493,SRX5716470,SMARCA4,383
chr1,236503131,236503549,SRX5075168,SMARCA4,418
chr1,236503135,236503562,SRX5075169,SMARCA4,427
chr1,236503136,236503624,SRX5075170,SMARCA4,488
chr1,236503154,236503536,SRX5075176,SMARCA4,382
chr1,236503159,236503383,SRX5020211,SMARCA2,224
chr1,236503163,236503575,SRX5075175,SMARCA4,412
chr1,236503176,236503531,SRX5075174,SMARCA4,355
chr1,236503209,236503517,SRX5716467,SMARCA2,308
chr1,236503284,236503498,SRX5716469,SMARCA4,214
chr1,236503284,236503515,SRX5716463,SMARCA4,231
chr1,236517257,236517540,SRX5716467,SMARCA2,283
chr1,236517263,236517573,SRX5075169,SMARCA4,310
chr1,236517271,236517526,SRX5716470,SMARCA4,255
chr1,236517277,236517498,SRX5075175,SMARCA4,221
chr1,236517281,236517631,SRX5716469,SMARCA4,350
chr1,236517284,236517604,SRX5075170,SMARCA4,320
chr1,236517294,236517521,SRX5716468,SMARCA2,227
chr1,236517310,236517502,SRX5054308,FOSL2,192
chr1,236517327,236517548,SRX5020211,SMARCA2,221
chr1,236518450,236518680,SRX5054309,FOSL2,230
chr1,236518466,236518666,SRX5020211,SMARCA2,200
chr1,236518485,236518670,SRX5075169,SMARCA4,185
chr1,236524456,236524734,SRX20140895,INTS13,278
chr1,236524530,236524729,SRX5075169,SMARCA4,199
chr1,236524568,236524783,SRX5075170,SMARCA4,215
chr1,236524634,236524849,SRX5075176,SMARCA4,215
chr1,236531705,236531964,SRX5054309,FOSL2,259
chr1,236531710,236532004,SRX5054308,FOSL2,294
chr1,236531759,236532027,SRX5075176,SMARCA4,268
chr1,236531766,236531970,SRX5075170,SMARCA4,204
chr1,236531848,236532142,SRX16500060,CTCF,294
chr1,236534344,236534677,SRX5054308,FOSL2,333
chr1,236534370,236534703,SRX5054309,FOSL2,333
chr1,236534393,236534649,SRX5075169,SMARCA4,256
chr1,236534430,236534642,SRX5716469,SMARCA4,212
chr1,236534439,236534631,SRX5075175,SMARCA4,192
chr1,236535619,236535824,SRX5075174,SMARCA4,205
chr1,236543090,236543382,SRX16500060,CTCF,292
chr1,236565577,236565807,SRX5075174,SMARCA4,230
chr1,236565608,236565838,SRX5075168,SMARCA4,230
chr1,236604302,236604885,SRX5716470,SMARCA4,583
chr1,236604342,236604883,SRX5075170,SMARCA4,541
chr1,236604356,236604845,SRX5075174,SMARCA4,489
chr1,236604370,236604781,SRX5075168,SMARCA4,411
chr1,236604392,236605056,SRX20140895,INTS13,664
chr1,236604417,236604711,SRX5716463,SMARCA4,294
chr1,236604445,236604798,SRX5716464,SMARCA4,353
chr1,236604447,236604734,SRX5054309,FOSL2,287
chr1,236604504,236604818,SRX5075176,SMARCA4,314
chr1,236604550,236604805,SRX20140879,CPSF3L,255
chr1,236604573,236604787,SRX20140867,INTS10,214
chr1,236604613,236604930,SRX20140897,INTS13,317
chr1,236604680,236604883,SRX5075169,SMARCA4,203
chr1,236609079,236609516,SRX16500061,CTCF,437
chr1,236609081,236609560,SRX16500059,CTCF,479
chr1,236609107,236609562,SRX16500062,CTCF,455
chr1,236609110,236609550,SRX16500060,CTCF,440
chr1,236609229,236609442,SRX4174629,CTCF,213
chr1,236686121,236686752,SRX20140895,INTS13,631
chr1,236686168,236686555,SRX5075168,SMARCA4,387
chr1,236686200,236686549,SRX5075174,SMARCA4,349
chr1,236686293,236686748,SRX20140897,INTS13,455
chr1,236686352,236686666,SRX20140867,INTS10,314
chr1,236699473,236699649,SRX5075174,SMARCA4,176
chr1,236705799,236706059,SRX5075174,SMARCA4,260
chr1,236713729,236714452,SRX20140895,INTS13,723
chr1,236713843,236714176,SRX20140896,INTS13,333
chr1,236713861,236714176,SRX20140880,CPSF3L,315
chr1,236713988,236714255,SRX20140868,INTS10,267
chr1,236714027,236714280,SRX20140867,INTS10,253
chr1,236714028,236714364,SRX20140881,CPSF3L,336
chr1,236714053,236714377,SRX20140897,INTS13,324
chr1,236714156,236714477,SRX20140869,INTS10,321
chr1,236714172,236714641,SRX20140860,SOX2,469
chr1,236714214,236714484,SRX20140879,CPSF3L,270
chr1,236714312,236714768,SRX20140896,INTS13,456
chr1,236714513,236714896,SRX20140890,SOX2,383
chr1,236734408,236734637,SRX5054309,FOSL2,229
chr1,236734476,236734733,SRX5054308,FOSL2,257
chr1,236753605,236753843,SRX16500059,CTCF,238
chr1,236759187,236759670,SRX16500059,CTCF,483
chr1,236759209,236759638,SRX16500061,CTCF,429
chr1,236759234,236759689,SRX16500060,CTCF,455
chr1,236759260,236759625,SRX16500062,CTCF,365
chr1,236759307,236759549,SRX5075168,SMARCA4,242
chr1,236759386,236759594,SRX5075174,SMARCA4,208
chr1,236794876,236795194,SRX5075170,SMARCA4,318
chr1,236794892,236795109,SRX5716470,SMARCA4,217
chr1,236794893,236795382,SRX5075174,SMARCA4,489
chr1,236794896,236795451,SRX5075168,SMARCA4,555
chr1,236794921,236795118,SRX5075176,SMARCA4,197
chr1,236794972,236795295,SRX5716464,SMARCA4,323
chr1,236794987,236795634,SRX20140895,INTS13,647
chr1,236794992,236795580,SRX20140881,CPSF3L,588
chr1,236795109,236795507,SRX20140897,INTS13,398
chr1,236795112,236795609,SRX20140869,INTS10,497
chr1,236795167,236795548,SRX20140867,INTS10,381
chr1,236795177,236795381,SRX5716463,SMARCA4,204
chr1,236795267,236795558,SRX20140868,INTS10,291
chr1,236795290,236795478,SRX5075176,SMARCA4,188
chr1,236795302,236795590,SRX20140879,CPSF3L,288
chr1,236795310,236795528,SRX5716469,SMARCA4,218
chr1,236795492,236795703,SRX5075175,SMARCA4,211
chr1,236844556,236844837,SRX20140867,INTS10,281
chr1,236844663,236844863,SRX5020211,SMARCA2,200
chr1,236844694,236844954,SRX5075170,SMARCA4,260
chr1,236844718,236844931,SRX5075169,SMARCA4,213
chr1,236850421,236850625,SRX5075170,SMARCA4,204
chr1,236854308,236854619,SRX5054309,FOSL2,311
chr1,236854316,236854887,SRX5075175,SMARCA4,571
chr1,236854318,236854919,SRX5075174,SMARCA4,601
chr1,236854345,236854638,SRX5075168,SMARCA4,293
chr1,236854346,236854586,SRX5716469,SMARCA4,240
chr1,236854348,236854674,SRX20140869,INTS10,326
chr1,236854373,236855035,SRX5075169,SMARCA4,662
chr1,236854382,236855001,SRX20140881,CPSF3L,619
chr1,236854417,236854852,SRX20140867,INTS10,435
chr1,236854566,236854991,SRX5075176,SMARCA4,425
chr1,236854689,236855018,SRX5054309,FOSL2,329
chr1,236854706,236855082,SRX5075170,SMARCA4,376
chr1,236854770,236854988,SRX5716470,SMARCA4,218
chr1,236860055,236860098,SRX1424891,POU3F2,43
chr1,236860057,236860099,SRX1424894,POU3F2,42
chr1,236860058,236860100,SRX1424893,POU3F2,42
chr1,236868802,236869253,SRX16500062,CTCF,451
chr1,236868854,236869282,SRX16500061,CTCF,428
chr1,236868861,236869270,SRX16500060,CTCF,409
chr1,236868861,236869271,SRX16500059,CTCF,410
chr1,236868905,236869143,SRX5075174,SMARCA4,238
chr1,236868916,236869166,SRX5075168,SMARCA4,250
chr1,236876101,236876302,SRX5054308,FOSL2,201
chr1,236905129,236905540,SRX5054309,FOSL2,411
chr1,236905175,236905452,SRX5054308,FOSL2,277
chr1,236905203,236905405,SRX5075169,SMARCA4,202
chr1,237012943,237013310,SRX20140869,INTS10,367
chr1,237012945,237013267,SRX5054309,FOSL2,322
chr1,237012994,237013352,SRX5075176,SMARCA4,358
chr1,237013006,237013252,SRX5054308,FOSL2,246
chr1,237013039,237013399,SRX5075170,SMARCA4,360
chr1,237013146,237013422,SRX5075174,SMARCA4,276
chr1,237013233,237013431,SRX5075168,SMARCA4,198
chr1,237032115,237032403,SRX5054309,FOSL2,288
chr1,237032127,237032418,SRX5075168,SMARCA4,291
chr1,237032142,237032332,SRX5075174,SMARCA4,190
chr1,237041722,237042169,SRX16500062,CTCF,447
chr1,237041761,237042198,SRX16500059,CTCF,437
chr1,237041814,237042207,SRX16500061,CTCF,393
chr1,237041865,237042210,SRX16500060,CTCF,345
chr1,237041938,237042192,SRX5075168,SMARCA4,254
chr1,237041951,237042193,SRX5075174,SMARCA4,242
chr1,237042020,237042264,SRX20140897,INTS13,244
chr1,237098508,237098746,SRX5054309,FOSL2,238
chr1,237117681,237117747,SRX1424892,POU3F2,66
chr1,237117691,237117743,SRX1424894,POU3F2,52
chr1,237124923,237125150,SRX5075174,SMARCA4,227
chr1,237124943,237125206,SRX16500061,CTCF,263
chr1,237124957,237125189,SRX16500062,CTCF,232
chr1,237166503,237166751,SRX5054309,FOSL2,248
chr1,237353897,237354503,SRX5075174,SMARCA4,606
chr1,237353930,237354193,SRX5075168,SMARCA4,263
chr1,237353937,237354211,SRX5716463,SMARCA4,274
chr1,237383811,237384070,SRX5054309,FOSL2,259
chr1,237383830,237384071,SRX5716469,SMARCA4,241
chr1,237383851,237384146,SRX5075176,SMARCA4,295
chr1,237383857,237384108,SRX5075169,SMARCA4,251
chr1,237383864,237384077,SRX5020211,SMARCA2,213
chr1,237383905,237384176,SRX5075170,SMARCA4,271
chr1,237383957,237384202,SRX5075175,SMARCA4,245
chr1,237386392,237386767,SRX4174629,CTCF,375
chr1,237386487,237386986,SRX16500059,CTCF,499
chr1,237386590,237387022,SRX16500061,CTCF,432
chr1,237386597,237386979,SRX16500060,CTCF,382
chr1,237386611,237386958,SRX16500062,CTCF,347
chr1,237386616,237386860,SRX5075170,SMARCA4,244
chr1,237386625,237386877,SRX5075168,SMARCA4,252
chr1,237386628,237386863,SRX5075174,SMARCA4,235
chr1,237386633,237386824,SRX5075175,SMARCA4,191
chr1,237386643,237386882,SRX5075176,SMARCA4,239
chr1,237396415,237396818,SRX5075176,SMARCA4,403
chr1,237396490,237396781,SRX5075170,SMARCA4,291
chr1,237401621,237402017,SRX5075174,SMARCA4,396
chr1,237401809,237402029,SRX5075168,SMARCA4,220
chr1,237411565,237411909,SRX5075174,SMARCA4,344
chr1,237411660,237411934,SRX5075168,SMARCA4,274
chr1,237562120,237562662,SRX16500059,CTCF,542
chr1,237562122,237562701,SRX16500060,CTCF,579
chr1,237562162,237562692,SRX16500061,CTCF,530
chr1,237562199,237562651,SRX16500062,CTCF,452
chr1,237562276,237562623,SRX4174629,CTCF,347
chr1,237562292,237562541,SRX5075168,SMARCA4,249
chr1,237562313,237562488,SRX5075176,SMARCA4,175
chr1,237562313,237562549,SRX5075174,SMARCA4,236
chr1,237562315,237562529,SRX5075170,SMARCA4,214
chr1,237570566,237570882,SRX16500059,CTCF,316
chr1,237570649,237570894,SRX16500060,CTCF,245
chr1,237603048,237603125,SRX1424894,POU3F2,77
chr1,237603173,237603286,SRX1424894,POU3F2,113
chr1,237603176,237603224,SRX1424892,POU3F2,48
chr1,237603176,237603287,SRX1424893,POU3F2,111
chr1,237677934,237678381,SRX5075176,SMARCA4,447
chr1,237677994,237678395,SRX5075169,SMARCA4,401
chr1,237678001,237678407,SRX5054308,FOSL2,406
chr1,237678009,237678285,SRX5075174,SMARCA4,276
chr1,237678009,237678452,SRX5716470,SMARCA4,443
chr1,237678043,237678371,SRX5075175,SMARCA4,328
chr1,237678052,237678372,SRX5716469,SMARCA4,320
chr1,237678062,237678435,SRX5054309,FOSL2,373
chr1,237678135,237678358,SRX5075170,SMARCA4,223
chr1,237711953,237712143,SRX5075168,SMARCA4,190
chr1,237736630,237736875,SRX16500059,CTCF,245
chr1,237736661,237736938,SRX16500060,CTCF,277
chr1,237736689,237736901,SRX5075168,SMARCA4,212
chr1,237753044,237753244,SRX5075174,SMARCA4,200
chr1,237753064,237753243,SRX5075168,SMARCA4,179
chr1,237766563,237767052,SRX5075168,SMARCA4,489
chr1,237766693,237767016,SRX5075174,SMARCA4,323
chr1,237766815,237767023,SRX5716463,SMARCA4,208
chr1,237799859,237800152,SRX5075168,SMARCA4,293
chr1,237799893,237800295,SRX16500059,CTCF,402
chr1,237799909,237800119,SRX16500062,CTCF,210
chr1,237799917,237800266,SRX16500060,CTCF,349
chr1,237799933,237800188,SRX5075174,SMARCA4,255
chr1,237799952,237800211,SRX16500061,CTCF,259
chr1,237806661,237807173,SRX16500061,CTCF,512
chr1,237806680,237807183,SRX16500060,CTCF,503
chr1,237806697,237807190,SRX16500062,CTCF,493
chr1,237806708,237807208,SRX16500059,CTCF,500
chr1,237806780,237807058,SRX4174629,CTCF,278
chr1,237806795,237807098,SRX5075174,SMARCA4,303
chr1,237806815,237807152,SRX5075168,SMARCA4,337
chr1,237806841,237807083,SRX5075176,SMARCA4,242
chr1,237806856,237807089,SRX5075170,SMARCA4,233
chr1,237806881,237807086,SRX5716464,SMARCA4,205
chr1,237806885,237807076,SRX5075175,SMARCA4,191
chr1,237814311,237814710,SRX16500062,CTCF,399
chr1,237814315,237814745,SRX16500059,CTCF,430
chr1,237814321,237814731,SRX16500060,CTCF,410
chr1,237814331,237814753,SRX16500061,CTCF,422
chr1,237814363,237814639,SRX5075174,SMARCA4,276
chr1,237814372,237814659,SRX5075168,SMARCA4,287
chr1,237814452,237814639,SRX5075176,SMARCA4,187
chr1,237851198,237851625,SRX16500060,CTCF,427
chr1,237851212,237851599,SRX16500059,CTCF,387
chr1,237851234,237851583,SRX16500061,CTCF,349
chr1,237851278,237851587,SRX16500062,CTCF,309
chr1,237851356,237851605,SRX4174629,CTCF,249
chr1,237851372,237851582,SRX5075174,SMARCA4,210
chr1,237864159,237864641,SRX16500060,CTCF,482
chr1,237864171,237864659,SRX16500061,CTCF,488
chr1,237864176,237864677,SRX16500059,CTCF,501
chr1,237864208,237864657,SRX16500062,CTCF,449
chr1,237864311,237864572,SRX4174629,CTCF,261
chr1,237864336,237864643,SRX5075168,SMARCA4,307
chr1,237864340,237864611,SRX5075174,SMARCA4,271
chr1,237864354,237864604,SRX5075170,SMARCA4,250
chr1,237864356,237864658,SRX20140895,INTS13,302
chr1,237864378,237864637,SRX5075176,SMARCA4,259
chr1,237864385,237864585,SRX5075169,SMARCA4,200
chr1,237864385,237864608,SRX5716469,SMARCA4,223
chr1,237864406,237864594,SRX5075175,SMARCA4,188
chr1,237873321,237873919,SRX5075168,SMARCA4,598
chr1,237873332,237873920,SRX5075174,SMARCA4,588
chr1,237873389,237873825,SRX5075169,SMARCA4,436
chr1,237873391,237873820,SRX5075176,SMARCA4,429
chr1,237873401,237873782,SRX5075175,SMARCA4,381
chr1,237873405,237873864,SRX5054309,FOSL2,459
chr1,237873407,237873750,SRX5716463,SMARCA4,343
chr1,237873429,237873756,SRX5054308,FOSL2,327
chr1,237873446,237873843,SRX5075170,SMARCA4,397
chr1,237873453,237873800,SRX5020214,SMARCA2,347
chr1,237873476,237873743,SRX5716469,SMARCA4,267
chr1,237873523,237873708,SRX5054307,FOSL2,185
chr1,237877651,237877891,SRX16500060,CTCF,240
chr1,237879247,237879501,SRX5075176,SMARCA4,254
chr1,237879277,237879494,SRX5075175,SMARCA4,217
chr1,237879288,237879460,SRX5075170,SMARCA4,172
chr1,237879288,237879549,SRX5054309,FOSL2,261
chr1,237879293,237879555,SRX5054308,FOSL2,262
chr1,237901266,237901662,SRX16500060,CTCF,396
chr1,237901316,237901591,SRX16500061,CTCF,275
chr1,237901349,237901664,SRX16500059,CTCF,315
chr1,237901353,237901624,SRX16500062,CTCF,271
chr1,237973481,237973807,SRX5075170,SMARCA4,326
chr1,237973512,237973831,SRX5075174,SMARCA4,319
chr1,237973546,237973748,SRX5054309,FOSL2,202
chr1,237973548,237973904,SRX5075168,SMARCA4,356
chr1,237983500,237983807,SRX5075174,SMARCA4,307
chr1,237983594,237983811,SRX5075168,SMARCA4,217
chr1,238001871,238002174,SRX5075176,SMARCA4,303
chr1,238001893,238002233,SRX5075168,SMARCA4,340
chr1,238001934,238002148,SRX5075170,SMARCA4,214
chr1,238002001,238002301,SRX5075174,SMARCA4,300
chr1,238053010,238053201,SRX5054309,FOSL2,191
chr1,238060116,238060486,SRX5075168,SMARCA4,370
chr1,238060144,238060525,SRX5075174,SMARCA4,381
chr1,238060176,238060424,SRX5716470,SMARCA4,248
chr1,238060201,238060443,SRX5075176,SMARCA4,242
chr1,238062248,238062548,SRX5075170,SMARCA4,300
chr1,238062248,238062561,SRX5075176,SMARCA4,313
chr1,238062258,238062549,SRX5054309,FOSL2,291
chr1,238062260,238062600,SRX5075174,SMARCA4,340
chr1,238062273,238062612,SRX5075168,SMARCA4,339
chr1,238062326,238062577,SRX5075175,SMARCA4,251
chr1,238062369,238062549,SRX5054308,FOSL2,180
chr1,238063515,238063832,SRX5075170,SMARCA4,317
chr1,238063520,238063809,SRX5075176,SMARCA4,289
chr1,238063533,238063779,SRX5075175,SMARCA4,246
chr1,238063560,238063780,SRX5075169,SMARCA4,220
chr1,238088541,238089366,SRX5075168,SMARCA4,825
chr1,238088543,238089326,SRX5716463,SMARCA4,783
chr1,238088546,238089348,SRX5075174,SMARCA4,802
chr1,238088817,238089261,SRX5716464,SMARCA4,444
chr1,238088917,238089293,SRX5716470,SMARCA4,376
chr1,238088957,238089232,SRX5075176,SMARCA4,275
chr1,238088965,238089177,SRX5716469,SMARCA4,212
chr1,238088992,238089303,SRX5075170,SMARCA4,311
chr1,238088995,238089241,SRX5075169,SMARCA4,246
chr1,238141311,238141511,SRX5075176,SMARCA4,200
chr1,238141369,238141669,SRX5075170,SMARCA4,300
chr1,238176575,238176757,SRX5075174,SMARCA4,182
chr1,238176622,238176817,SRX5075168,SMARCA4,195
chr1,238177932,238178352,SRX5075168,SMARCA4,420
chr1,238177942,238178423,SRX5075174,SMARCA4,481
chr1,238177972,238178314,SRX5716463,SMARCA4,342
chr1,238178029,238178444,SRX5075170,SMARCA4,415
chr1,238178057,238178475,SRX5716460,Epitope tags,418
chr1,238178065,238178592,SRX5075176,SMARCA4,527
chr1,238178075,238178355,SRX5716469,SMARCA4,280
chr1,238178082,238178377,SRX5054309,FOSL2,295
chr1,238178094,238178380,SRX5075169,SMARCA4,286
chr1,238178121,238178372,SRX5716470,SMARCA4,251
chr1,238223301,238223544,SRX5075170,SMARCA4,243
chr1,238223316,238223508,SRX5075169,SMARCA4,192
chr1,238223385,238223568,SRX5054309,FOSL2,183
chr1,238252173,238252686,SRX16500059,CTCF,513
chr1,238252182,238252683,SRX16500060,CTCF,501
chr1,238252302,238252743,SRX16500061,CTCF,441
chr1,238252313,238252711,SRX16500062,CTCF,398
chr1,238252368,238252548,SRX5075174,SMARCA4,180
chr1,238252418,238252640,SRX5075170,SMARCA4,222
chr1,238255039,238255239,SRX5075174,SMARCA4,200
chr1,238255546,238255742,SRX5075174,SMARCA4,196
chr1,238266073,238266253,SRX5054308,FOSL2,180
chr1,238281466,238281754,SRX5054309,FOSL2,288
chr1,238281474,238281767,SRX5054308,FOSL2,293
chr1,238377340,238377660,SRX5075174,SMARCA4,320
chr1,238377371,238377675,SRX5075168,SMARCA4,304
chr1,238382969,238383589,SRX5075174,SMARCA4,620
chr1,238382998,238383633,SRX5075168,SMARCA4,635
chr1,238383325,238383566,SRX5716463,SMARCA4,241
chr1,238384418,238384700,SRX5075176,SMARCA4,282
chr1,238384423,238384691,SRX5054309,FOSL2,268
chr1,238384439,238384650,SRX5075170,SMARCA4,211
chr1,238409103,238409606,SRX5716460,Epitope tags,503
chr1,238409135,238409861,SRX5075175,SMARCA4,726
chr1,238409139,238410425,SRX5075170,SMARCA4,1286
chr1,238409149,238409693,SRX5075169,SMARCA4,544
chr1,238409155,238409779,SRX5054309,FOSL2,624
chr1,238409162,238409812,SRX5075176,SMARCA4,650
chr1,238409170,238409767,SRX5054308,FOSL2,597
chr1,238409201,238409513,SRX5716467,SMARCA2,312
chr1,238409222,238409512,SRX5020214,SMARCA2,290
chr1,238409239,238410213,SRX5716469,SMARCA4,974
chr1,238409264,238409569,SRX5020211,SMARCA2,305
chr1,238409292,238409595,SRX5716470,SMARCA4,303
chr1,238409767,238410291,SRX5075169,SMARCA4,524
chr1,238409864,238410414,SRX5075176,SMARCA4,550
chr1,238409925,238410246,SRX5716468,SMARCA2,321
chr1,238409945,238410289,SRX5716470,SMARCA4,344
chr1,238409955,238410208,SRX5716467,SMARCA2,253
chr1,238410039,238410348,SRX5075175,SMARCA4,309
chr1,238425391,238425607,SRX5075169,SMARCA4,216
chr1,238451085,238451269,SRX5075169,SMARCA4,184
chr1,238451106,238451388,SRX5054309,FOSL2,282
chr1,238458807,238459331,SRX5075168,SMARCA4,524
chr1,238458813,238459395,SRX5075170,SMARCA4,582
chr1,238458827,238459380,SRX5075176,SMARCA4,553
chr1,238458838,238459353,SRX5075174,SMARCA4,515
chr1,238458974,238459200,SRX5716470,SMARCA4,226
chr1,238458974,238459257,SRX5716463,SMARCA4,283
chr1,238465427,238465775,SRX5075170,SMARCA4,348
chr1,238465458,238465867,SRX5075176,SMARCA4,409
chr1,238465527,238465708,SRX5075169,SMARCA4,181
chr1,238466500,238466843,SRX5054309,FOSL2,343
chr1,238466528,238466795,SRX5054308,FOSL2,267
chr1,238466541,238466792,SRX5075169,SMARCA4,251
chr1,238466544,238466778,SRX5075170,SMARCA4,234
chr1,238469210,238469512,SRX5075170,SMARCA4,302
chr1,238469212,238469392,SRX5075176,SMARCA4,180
chr1,238469369,238469657,SRX5075175,SMARCA4,288
chr1,238489062,238489451,SRX5075170,SMARCA4,389
chr1,238489076,238489337,SRX5075169,SMARCA4,261
chr1,238489116,238489378,SRX5054308,FOSL2,262
chr1,238489148,238489403,SRX5075176,SMARCA4,255
chr1,238489158,238489396,SRX5075175,SMARCA4,238
chr1,238537667,238538005,SRX5075168,SMARCA4,338
chr1,238537752,238538023,SRX5075174,SMARCA4,271
chr1,238558199,238558538,SRX5054309,FOSL2,339
chr1,238558211,238558518,SRX5020211,SMARCA2,307
chr1,238558216,238558525,SRX5075175,SMARCA4,309
chr1,238558217,238558482,SRX5075170,SMARCA4,265
chr1,238558233,238558562,SRX5075169,SMARCA4,329
chr1,238558237,238558514,SRX5054308,FOSL2,277
chr1,238558251,238558530,SRX5716469,SMARCA4,279
chr1,238558252,238558471,SRX5075176,SMARCA4,219
chr1,238589957,238590363,SRX5716469,SMARCA4,406
chr1,238589959,238590462,SRX5075176,SMARCA4,503
chr1,238589989,238590546,SRX5075170,SMARCA4,557
chr1,238589992,238590371,SRX5054308,FOSL2,379
chr1,238590008,238590359,SRX5020211,SMARCA2,351
chr1,238590015,238590475,SRX5075169,SMARCA4,460
chr1,238590023,238590390,SRX5054309,FOSL2,367
chr1,238590044,238590403,SRX5716467,SMARCA2,359
chr1,238590066,238590502,SRX5716470,SMARCA4,436
chr1,238590077,238590532,SRX5075175,SMARCA4,455
chr1,238601791,238601991,SRX5075176,SMARCA4,200
chr1,238601792,238601988,SRX5075170,SMARCA4,196
chr1,238606876,238607196,SRX5075169,SMARCA4,320
chr1,238606986,238607240,SRX5075170,SMARCA4,254
chr1,238607002,238607246,SRX5075176,SMARCA4,244
chr1,238607018,238607317,SRX5054308,FOSL2,299
chr1,238607028,238607251,SRX5075175,SMARCA4,223
chr1,238607033,238607262,SRX5054309,FOSL2,229
chr1,238624802,238625106,SRX5075170,SMARCA4,304
chr1,238624828,238625131,SRX5075176,SMARCA4,303
chr1,238624863,238625099,SRX5075169,SMARCA4,236
chr1,238624885,238625142,SRX5054308,FOSL2,257
chr1,238628218,238628414,SRX5054309,FOSL2,196
chr1,238642229,238642514,SRX5054309,FOSL2,285
chr1,238642273,238642474,SRX5075175,SMARCA4,201
chr1,238642283,238642502,SRX5054308,FOSL2,219
chr1,238647820,238648351,SRX5075169,SMARCA4,531
chr1,238647833,238648330,SRX5054309,FOSL2,497
chr1,238647846,238648324,SRX5075176,SMARCA4,478
chr1,238647869,238648445,SRX5075168,SMARCA4,576
chr1,238647877,238648324,SRX5054308,FOSL2,447
chr1,238647879,238648287,SRX5716463,SMARCA4,408
chr1,238647879,238648401,SRX5075170,SMARCA4,522
chr1,238647888,238648362,SRX5075174,SMARCA4,474
chr1,238647902,238648322,SRX5716469,SMARCA4,420
chr1,238647911,238648289,SRX5716470,SMARCA4,378
chr1,238647912,238648254,SRX20140869,INTS10,342
chr1,238647921,238648246,SRX5054307,FOSL2,325
chr1,238647927,238648347,SRX5075175,SMARCA4,420
chr1,238647939,238648315,SRX5020211,SMARCA2,376
chr1,238647953,238648191,SRX5075181,SMARCA2,238
chr1,238647962,238648267,SRX5020214,SMARCA2,305
chr1,238647982,238648311,SRX5716451,SOX2,329
chr1,238647990,238648265,SRX5716467,SMARCA2,275
chr1,238652683,238652888,SRX5075176,SMARCA4,205
chr1,238652685,238652920,SRX5075175,SMARCA4,235
chr1,238652742,238652911,SRX5075170,SMARCA4,169
chr1,238653720,238653943,SRX5054309,FOSL2,223
chr1,238653753,238654355,SRX5075169,SMARCA4,602
chr1,238654085,238654384,SRX5054309,FOSL2,299
chr1,238654114,238654333,SRX5054308,FOSL2,219
chr1,238658850,238659120,SRX5075169,SMARCA4,270
chr1,238658857,238659081,SRX5075175,SMARCA4,224
chr1,238658895,238659122,SRX5054309,FOSL2,227
chr1,238681146,238681334,SRX5054309,FOSL2,188
chr1,238777582,238777889,SRX5054309,FOSL2,307
chr1,238777701,238777881,SRX5054308,FOSL2,180
chr1,238806812,238807016,SRX5075168,SMARCA4,204
chr1,238806855,238807035,SRX5075174,SMARCA4,180
chr1,238811541,238811776,SRX5075170,SMARCA4,235
chr1,238951828,238952160,SRX16500062,CTCF,332
chr1,238951830,238952105,SRX16500059,CTCF,275
chr1,238951836,238952206,SRX16500060,CTCF,370
chr1,238951857,238952059,SRX5075176,SMARCA4,202
chr1,238951869,238952071,SRX5075169,SMARCA4,202
chr1,238951905,238952169,SRX16500061,CTCF,264
chr1,238954914,238955169,SRX5075174,SMARCA4,255
chr1,238960135,238960496,SRX5075169,SMARCA4,361
chr1,238960228,238960404,SRX5075170,SMARCA4,176
chr1,238960240,238960421,SRX5054308,FOSL2,181
chr1,238991969,238992364,SRX5075170,SMARCA4,395
chr1,238992080,238992410,SRX5075169,SMARCA4,330
chr1,238992114,238992339,SRX5075176,SMARCA4,225
chr1,238992118,238992387,SRX5716469,SMARCA4,269
chr1,238992137,238992378,SRX5716467,SMARCA2,241
chr1,238992143,238992335,SRX5054308,FOSL2,192
chr1,239008614,239008857,SRX16500060,CTCF,243
chr1,239125143,239125316,SRX5075174,SMARCA4,173
chr1,239125998,239126197,SRX5075168,SMARCA4,199
chr1,239126867,239127304,SRX5075174,SMARCA4,437
chr1,239126904,239127296,SRX5075176,SMARCA4,392
chr1,239126906,239127330,SRX5075168,SMARCA4,424
chr1,239126917,239127283,SRX5075170,SMARCA4,366
chr1,239126929,239127250,SRX5716469,SMARCA4,321
chr1,239126963,239127237,SRX5054307,FOSL2,274
chr1,239126968,239127235,SRX5054308,FOSL2,267
chr1,239126996,239127270,SRX5054309,FOSL2,274
chr1,239167873,239167928,SRX1424893,POU3F2,55
chr1,239167878,239167930,SRX1424891,POU3F2,52
chr1,239167880,239167929,SRX1424892,POU3F2,49
chr1,239167885,239167930,SRX1424894,POU3F2,45
chr1,239184538,239184979,SRX5075176,SMARCA4,441
chr1,239184567,239184946,SRX5075170,SMARCA4,379
chr1,239184598,239184875,SRX5020211,SMARCA2,277
chr1,239184641,239184868,SRX5716468,SMARCA2,227
chr1,239184647,239184951,SRX5716470,SMARCA4,304
chr1,239184660,239184925,SRX5075169,SMARCA4,265
chr1,239184660,239184928,SRX5716469,SMARCA4,268
chr1,239184669,239184940,SRX5075175,SMARCA4,271
chr1,239184674,239184879,SRX5054308,FOSL2,205
chr1,239184674,239184896,SRX5716467,SMARCA2,222
chr1,239253144,239253486,SRX5075168,SMARCA4,342
chr1,239253264,239253557,SRX5075174,SMARCA4,293
chr1,239289172,239289401,SRX5054309,FOSL2,229
chr1,239308663,239309115,SRX16500060,CTCF,452
chr1,239308678,239309021,SRX16500061,CTCF,343
chr1,239308686,239309052,SRX16500059,CTCF,366
chr1,239308703,239309057,SRX16500062,CTCF,354
chr1,239308783,239309023,SRX5075174,SMARCA4,240
chr1,239308791,239308995,SRX5716463,SMARCA4,204
chr1,239308797,239309069,SRX5075168,SMARCA4,272
chr1,239308808,239309029,SRX5075176,SMARCA4,221
chr1,239317176,239317513,SRX5716469,SMARCA4,337
chr1,239317236,239317433,SRX5054308,FOSL2,197
chr1,239317242,239317487,SRX5075175,SMARCA4,245
chr1,239317269,239317529,SRX5716468,SMARCA2,260
chr1,239317282,239317580,SRX5716470,SMARCA4,298
chr1,239343395,239343600,SRX5075175,SMARCA4,205
chr1,239343484,239343726,SRX5716470,SMARCA4,242
chr1,239343516,239343791,SRX5075176,SMARCA4,275
chr1,239343518,239343723,SRX5054308,FOSL2,205
chr1,239354255,239354504,SRX5075175,SMARCA4,249
chr1,239354296,239354606,SRX5054308,FOSL2,310
chr1,239354324,239354538,SRX5075176,SMARCA4,214
chr1,239361185,239361888,SRX5075169,SMARCA4,703
chr1,239361343,239361839,SRX5075175,SMARCA4,496
chr1,239361373,239361921,SRX5075170,SMARCA4,548
chr1,239361397,239361893,SRX5716469,SMARCA4,496
chr1,239361411,239361844,SRX5054308,FOSL2,433
chr1,239361415,239361759,SRX5020211,SMARCA2,344
chr1,239361418,239361897,SRX5075176,SMARCA4,479
chr1,239361421,239361827,SRX5716467,SMARCA2,406
chr1,239361422,239361797,SRX5716470,SMARCA4,375
chr1,239361427,239361667,SRX5716468,SMARCA2,240
chr1,239361464,239361911,SRX5054309,FOSL2,447
chr1,239361472,239361781,SRX5020214,SMARCA2,309
chr1,239361603,239361863,SRX5716460,Epitope tags,260
chr1,239361782,239362030,SRX5716459,Epitope tags,248
chr1,239386349,239386693,SRX5075168,SMARCA4,344
chr1,239386420,239386756,SRX5075174,SMARCA4,336
chr1,239386446,239386735,SRX16500059,CTCF,289
chr1,239386534,239386773,SRX16500061,CTCF,239
chr1,239386536,239386746,SRX16500062,CTCF,210
chr1,239386557,239386778,SRX16500060,CTCF,221
chr1,239386713,239387010,SRX20140895,INTS13,297
chr1,239405370,239405924,SRX16500061,CTCF,554
chr1,239405427,239405893,SRX16500059,CTCF,466
chr1,239405445,239405897,SRX16500062,CTCF,452
chr1,239405476,239405891,SRX16500060,CTCF,415
chr1,239405565,239405811,SRX5075168,SMARCA4,246
chr1,239421811,239422022,SRX5716470,SMARCA4,211
chr1,239421886,239422066,SRX5075169,SMARCA4,180
chr1,239428341,239428543,SRX5075174,SMARCA4,202
chr1,239428378,239428589,SRX5716470,SMARCA4,211
chr1,239428414,239428615,SRX5075175,SMARCA4,201
chr1,239428428,239428663,SRX5054308,FOSL2,235
chr1,239450493,239450755,SRX5716470,SMARCA4,262
chr1,239450538,239450793,SRX5075170,SMARCA4,255
chr1,239450563,239450882,SRX5075176,SMARCA4,319
chr1,239450565,239450799,SRX5075169,SMARCA4,234
chr1,239450568,239450807,SRX5716467,SMARCA2,239
chr1,239450584,239450807,SRX5716469,SMARCA4,223
chr1,239450594,239450876,SRX5075175,SMARCA4,282
chr1,239511906,239512113,SRX5075168,SMARCA4,207
chr1,239511987,239512194,SRX5075174,SMARCA4,207
chr1,239538299,239538542,SRX5075168,SMARCA4,243
chr1,239545550,239545818,SRX5054309,FOSL2,268
chr1,239545569,239545788,SRX5054308,FOSL2,219
chr1,239555334,239555732,SRX5075174,SMARCA4,398
chr1,239555456,239555708,SRX5075168,SMARCA4,252
chr1,239555464,239555654,SRX5716451,SOX2,190
chr1,239682038,239682486,SRX5075174,SMARCA4,448
chr1,239682054,239682405,SRX5075168,SMARCA4,351
chr1,239682089,239682336,SRX5075170,SMARCA4,247
chr1,239682176,239682402,SRX5716470,SMARCA4,226
chr1,239682195,239682413,SRX5716463,SMARCA4,218
chr1,239725971,239726342,SRX5075174,SMARCA4,371
chr1,239726021,239726310,SRX5075168,SMARCA4,289
chr1,239726070,239726274,SRX5716463,SMARCA4,204
chr1,239734051,239734275,SRX5075170,SMARCA4,224
chr1,239734264,239734452,SRX5075176,SMARCA4,188
chr1,239768457,239768734,SRX5075176,SMARCA4,277
chr1,239768606,239768788,SRX5075170,SMARCA4,182
chr1,239811152,239811567,SRX20140867,INTS10,415
chr1,239811203,239811445,SRX20140860,SOX2,242
chr1,239811259,239811621,SRX5075168,SMARCA4,362
chr1,239811298,239811765,SRX5075174,SMARCA4,467
chr1,239814228,239814580,SRX5054309,FOSL2,352
chr1,239814228,239814671,SRX5075169,SMARCA4,443
chr1,239814234,239814589,SRX5075175,SMARCA4,355
chr1,239814264,239814528,SRX5075170,SMARCA4,264
chr1,239814267,239814589,SRX5075176,SMARCA4,322
chr1,239814278,239814685,SRX5716469,SMARCA4,407
chr1,239814293,239814578,SRX5054308,FOSL2,285
chr1,239814315,239814601,SRX5716467,SMARCA2,286
chr1,239814327,239814561,SRX5716470,SMARCA4,234
chr1,239814337,239814519,SRX5075174,SMARCA4,182
chr1,239816130,239816398,SRX5054309,FOSL2,268
chr1,239816132,239816311,SRX5075168,SMARCA4,179
chr1,239816138,239816388,SRX5075174,SMARCA4,250
chr1,239816139,239816371,SRX5054308,FOSL2,232
chr1,239816148,239816381,SRX5075169,SMARCA4,233
chr1,239816170,239816365,SRX5075175,SMARCA4,195
chr1,239819130,239819355,SRX16500060,CTCF,225
chr1,239839272,239839457,SRX5054309,FOSL2,185
chr1,239840842,239841035,SRX5075174,SMARCA4,193
chr1,239854955,239855466,SRX5075170,SMARCA4,511
chr1,239854993,239855538,SRX5075176,SMARCA4,545
chr1,239855070,239855393,SRX5716468,SMARCA2,323
chr1,239855072,239855359,SRX5075175,SMARCA4,287
chr1,239855073,239855466,SRX5075169,SMARCA4,393
chr1,239855088,239855348,SRX5716469,SMARCA4,260
chr1,239855098,239855425,SRX5716470,SMARCA4,327
chr1,239855146,239855326,SRX5054308,FOSL2,180
chr1,239857968,239858502,SRX5075174,SMARCA4,534
chr1,239858016,239858521,SRX5075168,SMARCA4,505
chr1,239858074,239858474,SRX5716451,SOX2,400
chr1,239858128,239858333,SRX5716464,SMARCA4,205
chr1,239858144,239858380,SRX5054307,FOSL2,236
chr1,239858159,239858363,SRX5054309,FOSL2,204
chr1,239858159,239858464,SRX5716463,SMARCA4,305
chr1,239858175,239858381,SRX5075170,SMARCA4,206
chr1,239858178,239858380,SRX5075176,SMARCA4,202
chr1,239858187,239858380,SRX5075169,SMARCA4,193
chr1,239872643,239872970,SRX5075176,SMARCA4,327
chr1,239898069,239898564,SRX16500060,CTCF,495
chr1,239898085,239898420,SRX5075168,SMARCA4,335
chr1,239898085,239898610,SRX16500061,CTCF,525
chr1,239898095,239898563,SRX16500062,CTCF,468
chr1,239898106,239898449,SRX4174629,CTCF,343
chr1,239898107,239898451,SRX5075174,SMARCA4,344
chr1,239898113,239898577,SRX16500059,CTCF,464
chr1,239898155,239898411,SRX20140895,INTS13,256
chr1,239898156,239898362,SRX5075175,SMARCA4,206
chr1,239898160,239898403,SRX5075170,SMARCA4,243
chr1,239898182,239898408,SRX5075169,SMARCA4,226
chr1,239898235,239898427,SRX5075176,SMARCA4,192
chr1,239914781,239915395,SRX5075170,SMARCA4,614
chr1,239914793,239915304,SRX5075176,SMARCA4,511
chr1,239914810,239915399,SRX5075169,SMARCA4,589
chr1,239914822,239915278,SRX5716467,SMARCA2,456
chr1,239914838,239915255,SRX5716470,SMARCA4,417
chr1,239914883,239915290,SRX5054309,FOSL2,407
chr1,239914895,239915143,SRX5716459,Epitope tags,248
chr1,239914896,239915275,SRX5054308,FOSL2,379
chr1,239914898,239915305,SRX5075175,SMARCA4,407
chr1,239914903,239915317,SRX5716469,SMARCA4,414
chr1,239914943,239915214,SRX5075174,SMARCA4,271
chr1,239914950,239915268,SRX5020214,SMARCA2,318
chr1,239914971,239915265,SRX5716468,SMARCA2,294
chr1,239914996,239915235,SRX5020211,SMARCA2,239
chr1,239915022,239915201,SRX5075168,SMARCA4,179
chr1,239922859,239923097,SRX5054309,FOSL2,238
chr1,239939008,239939225,SRX5075169,SMARCA4,217
chr1,239947892,239948088,SRX5054308,FOSL2,196
chr1,239947963,239948150,SRX5054309,FOSL2,187
chr1,239951448,239951974,SRX16500061,CTCF,526
chr1,239951459,239951986,SRX16500059,CTCF,527
chr1,239951472,239951948,SRX16500062,CTCF,476
chr1,239951493,239951940,SRX16500060,CTCF,447
chr1,239951559,239951812,SRX4174629,CTCF,253
chr1,239951570,239951878,SRX5075168,SMARCA4,308
chr1,239951601,239951832,SRX5075174,SMARCA4,231
chr1,239951615,239951850,SRX5075176,SMARCA4,235
chr1,239951658,239951886,SRX5075170,SMARCA4,228
chr1,239976260,239976776,SRX16500060,CTCF,516
chr1,239976272,239976775,SRX16500059,CTCF,503
chr1,239976290,239976758,SRX16500061,CTCF,468
chr1,239976297,239976752,SRX16500062,CTCF,455
chr1,239976378,239976680,SRX5075168,SMARCA4,302
chr1,239976439,239976874,SRX4174629,CTCF,435
chr1,239987055,239987585,SRX16500059,CTCF,530
chr1,239987103,239987540,SRX16500060,CTCF,437
chr1,239987113,239987530,SRX16500061,CTCF,417
chr1,239987155,239987544,SRX16500062,CTCF,389
chr1,239987180,239987470,SRX5075174,SMARCA4,290
chr1,239987232,239987473,SRX5075168,SMARCA4,241
chr1,239987236,239987437,SRX5075170,SMARCA4,201
chr1,239997731,239998100,SRX16500059,CTCF,369
chr1,239997748,239998079,SRX16500061,CTCF,331
chr1,239997804,239998077,SRX16500062,CTCF,273
chr1,239997821,239998085,SRX16500060,CTCF,264
chr1,239997887,239998244,SRX5075174,SMARCA4,357
chr1,239998006,239998232,SRX5075168,SMARCA4,226
chr1,240000658,240000965,SRX5075169,SMARCA4,307
chr1,240000669,240001000,SRX5054309,FOSL2,331
chr1,240000698,240000952,SRX5054308,FOSL2,254
chr1,240000703,240000900,SRX5075175,SMARCA4,197
chr1,240000705,240000929,SRX5075176,SMARCA4,224
chr1,240000717,240000918,SRX5075170,SMARCA4,201
chr1,240004098,240004562,SRX16500059,CTCF,464
chr1,240004104,240004561,SRX16500062,CTCF,457
chr1,240004126,240004564,SRX16500061,CTCF,438
chr1,240004143,240004683,SRX16500060,CTCF,540
chr1,240004172,240004349,SRX5075174,SMARCA4,177
chr1,240004226,240004436,SRX4174629,CTCF,210
chr1,240026858,240027422,SRX16500059,CTCF,564
chr1,240026904,240027433,SRX16500060,CTCF,529
chr1,240026965,240027429,SRX16500061,CTCF,464
chr1,240026974,240027400,SRX16500062,CTCF,426
chr1,240026994,240027307,SRX4174629,CTCF,313
chr1,240027010,240027329,SRX5075174,SMARCA4,319
chr1,240027066,240027279,SRX5075168,SMARCA4,213
chr1,240031051,240031487,SRX5075175,SMARCA4,436
chr1,240031053,240031362,SRX5075170,SMARCA4,309
chr1,240031055,240031441,SRX5075169,SMARCA4,386
chr1,240031060,240031718,SRX5054309,FOSL2,658
chr1,240031080,240031418,SRX5716470,SMARCA4,338
chr1,240031082,240031430,SRX5054308,FOSL2,348
chr1,240031086,240031340,SRX5716468,SMARCA2,254
chr1,240031090,240031445,SRX5075176,SMARCA4,355
chr1,240031119,240031470,SRX5716469,SMARCA4,351
chr1,240031146,240031344,SRX5075182,SMARCA2,198
chr1,240031154,240031440,SRX5716467,SMARCA2,286
chr1,240044607,240044910,SRX5054308,FOSL2,303
chr1,240066559,240066605,SRX1424891,POU3F2,46
chr1,240066563,240066605,SRX1424892,POU3F2,42
chr1,240075007,240075181,SRX5075174,SMARCA4,174
chr1,240075019,240075244,SRX5075168,SMARCA4,225
chr1,240090058,240090381,SRX5075174,SMARCA4,323
chr1,240090104,240090481,SRX5075168,SMARCA4,377
chr1,240091670,240092061,SRX5075168,SMARCA4,391
chr1,240091673,240092199,SRX20140895,INTS13,526
chr1,240091689,240092029,SRX5075170,SMARCA4,340
chr1,240091691,240091968,SRX5075174,SMARCA4,277
chr1,240100412,240100642,SRX5054308,FOSL2,230
chr1,240100414,240100624,SRX5054309,FOSL2,210
chr1,240107086,240107474,SRX5075175,SMARCA4,388
chr1,240107095,240107478,SRX5075169,SMARCA4,383
chr1,240107099,240107485,SRX5075170,SMARCA4,386
chr1,240107127,240107507,SRX5054308,FOSL2,380
chr1,240107158,240107446,SRX5075176,SMARCA4,288
chr1,240107159,240107535,SRX5054309,FOSL2,376
chr1,240107168,240107435,SRX5716470,SMARCA4,267
chr1,240107183,240107432,SRX5075174,SMARCA4,249
chr1,240107186,240107466,SRX5716469,SMARCA4,280
chr1,240107199,240107481,SRX5020211,SMARCA2,282
chr1,240107222,240107436,SRX5075168,SMARCA4,214
chr1,240149354,240150050,SRX16500060,CTCF,696
chr1,240149389,240149917,SRX16500061,CTCF,528
chr1,240149409,240149965,SRX16500059,CTCF,556
chr1,240149455,240149915,SRX16500062,CTCF,460
chr1,240149504,240149786,SRX5075174,SMARCA4,282
chr1,240149591,240149862,SRX5075168,SMARCA4,271
chr1,240169269,240169496,SRX16500060,CTCF,227
chr1,240189264,240189819,SRX16500059,CTCF,555
chr1,240189305,240189755,SRX16500061,CTCF,450
chr1,240189326,240189790,SRX16500062,CTCF,464
chr1,240189345,240189761,SRX16500060,CTCF,416
chr1,240189422,240189627,SRX5075168,SMARCA4,205
chr1,240189429,240189647,SRX5075174,SMARCA4,218
chr1,240190814,240191060,SRX16500062,CTCF,246
chr1,240190818,240191092,SRX16500059,CTCF,274
chr1,240190826,240191125,SRX16500060,CTCF,299
chr1,240190830,240191118,SRX16500061,CTCF,288
chr1,240190898,240191442,SRX5075170,SMARCA4,544
chr1,240190903,240191398,SRX5075176,SMARCA4,495
chr1,240190912,240191453,SRX5716470,SMARCA4,541
chr1,240190928,240191422,SRX5054309,FOSL2,494
chr1,240190933,240191412,SRX5075169,SMARCA4,479
chr1,240190934,240191448,SRX5075175,SMARCA4,514
chr1,240190938,240191404,SRX5716469,SMARCA4,466
chr1,240190950,240191451,SRX5054308,FOSL2,501
chr1,240190953,240191244,SRX5716467,SMARCA2,291
chr1,240190963,240191313,SRX5020211,SMARCA2,350
chr1,240190997,240191222,SRX5075182,SMARCA2,225
chr1,240191062,240191390,SRX5020214,SMARCA2,328
chr1,240232625,240232847,SRX5054309,FOSL2,222
chr1,240234454,240234817,SRX5075170,SMARCA4,363
chr1,240234495,240235007,SRX5075169,SMARCA4,512
chr1,240234515,240234874,SRX5075175,SMARCA4,359
chr1,240234531,240234972,SRX5075176,SMARCA4,441
chr1,240234549,240235107,SRX5054308,FOSL2,558
chr1,240234556,240234838,SRX5054309,FOSL2,282
chr1,240242633,240243112,SRX5075169,SMARCA4,479
chr1,240258833,240259371,SRX5075169,SMARCA4,538
chr1,240258980,240259240,SRX5075176,SMARCA4,260
chr1,240259013,240259232,SRX5075170,SMARCA4,219
chr1,240293714,240293883,SRX5075170,SMARCA4,169
chr1,240294570,240294927,SRX5716470,SMARCA4,357
chr1,240294637,240294934,SRX5075170,SMARCA4,297
chr1,240294675,240294945,SRX5075175,SMARCA4,270
chr1,240294703,240295057,SRX5075169,SMARCA4,354
chr1,240294748,240295024,SRX5075176,SMARCA4,276
chr1,240294786,240294966,SRX5054308,FOSL2,180
chr1,240310245,240310540,SRX5075170,SMARCA4,295
chr1,240310298,240310483,SRX5075176,SMARCA4,185
chr1,240312915,240313268,SRX5075169,SMARCA4,353
chr1,240312940,240313289,SRX5075175,SMARCA4,349
chr1,240312957,240313316,SRX5075176,SMARCA4,359
chr1,240312962,240313334,SRX5054309,FOSL2,372
chr1,240312966,240313275,SRX5075170,SMARCA4,309
chr1,240312970,240313185,SRX5020214,SMARCA2,215
chr1,240312984,240313296,SRX5054308,FOSL2,312
chr1,240312988,240313201,SRX5075168,SMARCA4,213
chr1,240312989,240313279,SRX5716469,SMARCA4,290
chr1,240313005,240313304,SRX5075174,SMARCA4,299
chr1,240315380,240315764,SRX5075176,SMARCA4,384
chr1,240315386,240315778,SRX5075170,SMARCA4,392
chr1,240315414,240315657,SRX5716467,SMARCA2,243
chr1,240315459,240315657,SRX5075175,SMARCA4,198
chr1,240315472,240315703,SRX5716469,SMARCA4,231
chr1,240315509,240315739,SRX5075169,SMARCA4,230
chr1,240315521,240315734,SRX5716470,SMARCA4,213
chr1,240337844,240338240,SRX5075169,SMARCA4,396
chr1,240337889,240338097,SRX5075170,SMARCA4,208
chr1,240337993,240338198,SRX5075176,SMARCA4,205
chr1,240350984,240351263,SRX5075169,SMARCA4,279
chr1,240351000,240351207,SRX5054308,FOSL2,207
chr1,240351024,240351340,SRX5054309,FOSL2,316
chr1,240351062,240351315,SRX5075175,SMARCA4,253
chr1,240386265,240386719,SRX5054309,FOSL2,454
chr1,240386335,240386716,SRX5075169,SMARCA4,381
chr1,240386336,240386618,SRX5075170,SMARCA4,282
chr1,240386387,240386668,SRX5075176,SMARCA4,281
chr1,240386406,240386763,SRX5075175,SMARCA4,357
chr1,240386417,240386701,SRX5716470,SMARCA4,284
chr1,240386444,240386628,SRX5054308,FOSL2,184
chr1,240399405,240399689,SRX5020211,SMARCA2,284
chr1,240399424,240399787,SRX5075169,SMARCA4,363
chr1,240399435,240399690,SRX5075176,SMARCA4,255
chr1,240399438,240399730,SRX5075175,SMARCA4,292
chr1,240399451,240399753,SRX5054309,FOSL2,302
chr1,240399460,240399704,SRX5054308,FOSL2,244
chr1,240399464,240399748,SRX5716469,SMARCA4,284
chr1,240399466,240399689,SRX5075170,SMARCA4,223
chr1,240455260,240455553,SRX16500062,CTCF,293
chr1,240455266,240455608,SRX16500060,CTCF,342
chr1,240455294,240455563,SRX16500059,CTCF,269
chr1,240462849,240463036,SRX5075175,SMARCA4,187
chr1,240464222,240464402,SRX5054308,FOSL2,180
chr1,240474049,240474270,SRX5054308,FOSL2,221
chr1,240474064,240474326,SRX5075174,SMARCA4,262
chr1,240474088,240474293,SRX5054309,FOSL2,205
chr1,240491243,240491608,SRX5054309,FOSL2,365
chr1,240491247,240491589,SRX5075168,SMARCA4,342
chr1,240491254,240491622,SRX5075175,SMARCA4,368
chr1,240491273,240491579,SRX5054308,FOSL2,306
chr1,240491278,240491457,SRX5054307,FOSL2,179
chr1,240491290,240491555,SRX5075170,SMARCA4,265
chr1,240491306,240491592,SRX5075169,SMARCA4,286
chr1,240491330,240491635,SRX5075174,SMARCA4,305
chr1,240491346,240491633,SRX5716470,SMARCA4,287
chr1,240492962,240493273,SRX16500062,CTCF,311
chr1,240493208,240493429,SRX16500060,CTCF,221
chr1,240499038,240499329,SRX5075174,SMARCA4,291
chr1,240499067,240499274,SRX5075168,SMARCA4,207
chr1,240501140,240501394,SRX5054309,FOSL2,254
chr1,240509070,240509284,SRX5075170,SMARCA4,214
chr1,240515409,240515889,SRX5075169,SMARCA4,480
chr1,240515452,240516017,SRX5054309,FOSL2,565
chr1,240515475,240515815,SRX5075175,SMARCA4,340
chr1,240515476,240515743,SRX5020214,SMARCA2,267
chr1,240515530,240515885,SRX5054308,FOSL2,355
chr1,240555537,240555979,SRX5075176,SMARCA4,442
chr1,240555583,240555993,SRX5075170,SMARCA4,410
chr1,240555613,240555992,SRX5075175,SMARCA4,379
chr1,240555620,240555900,SRX5054309,FOSL2,280
chr1,240555637,240555909,SRX5716470,SMARCA4,272
chr1,240555656,240555964,SRX5075169,SMARCA4,308
chr1,240555660,240555933,SRX5716467,SMARCA2,273
chr1,240555671,240555983,SRX5020211,SMARCA2,312
chr1,240555718,240555956,SRX5716468,SMARCA2,238
chr1,240555719,240555939,SRX5716469,SMARCA4,220
chr1,240596189,240596373,SRX5075176,SMARCA4,184
chr1,240598630,240598809,SRX5075168,SMARCA4,179
chr1,240608736,240609112,SRX16500059,CTCF,376
chr1,240608743,240609106,SRX16500060,CTCF,363
chr1,240608822,240609100,SRX16500061,CTCF,278
chr1,240611796,240612358,SRX5716470,SMARCA4,562
chr1,240611814,240612337,SRX5716469,SMARCA4,523
chr1,240611862,240612183,SRX5075175,SMARCA4,321
chr1,240611927,240612275,SRX5075170,SMARCA4,348
chr1,240611931,240612310,SRX5075169,SMARCA4,379
chr1,240611937,240612299,SRX5075176,SMARCA4,362
chr1,240611988,240612350,SRX5075174,SMARCA4,362
chr1,240612026,240612231,SRX5075168,SMARCA4,205
chr1,240646975,240647222,SRX5075176,SMARCA4,247
chr1,240658592,240658902,SRX5075169,SMARCA4,310
chr1,240663486,240663721,SRX5054309,FOSL2,235
chr1,240692031,240692464,SRX4174629,CTCF,433
chr1,240692065,240692463,SRX16500059,CTCF,398
chr1,240692081,240692491,SRX16500060,CTCF,410
chr1,240692126,240692480,SRX16500061,CTCF,354
chr1,240692135,240692450,SRX16500062,CTCF,315
chr1,240701490,240701695,SRX5075175,SMARCA4,205
chr1,240701518,240701727,SRX5075176,SMARCA4,209
chr1,240706223,240706398,SRX5075176,SMARCA4,175
chr1,240706410,240706669,SRX5054309,FOSL2,259
chr1,240720271,240720663,SRX5075176,SMARCA4,392
chr1,240720280,240720774,SRX5075170,SMARCA4,494
chr1,240720375,240720564,SRX5075175,SMARCA4,189
chr1,240732247,240732734,SRX16500059,CTCF,487
chr1,240732251,240732794,SRX16500061,CTCF,543
chr1,240732288,240732751,SRX16500060,CTCF,463
chr1,240732312,240732538,SRX5075168,SMARCA4,226
chr1,240732314,240732743,SRX16500062,CTCF,429
chr1,240732387,240732640,SRX5075174,SMARCA4,253
chr1,240732494,240732793,SRX4174629,CTCF,299
chr1,240739268,240739451,SRX5054309,FOSL2,183
chr1,240765786,240766022,SRX5075174,SMARCA4,236
chr1,240765786,240766039,SRX5054309,FOSL2,253
chr1,240765787,240765999,SRX5716469,SMARCA4,212
chr1,240765792,240766090,SRX5075168,SMARCA4,298
chr1,240765806,240765998,SRX5054308,FOSL2,192
chr1,240765811,240766114,SRX5716470,SMARCA4,303
chr1,240792966,240793154,SRX5075176,SMARCA4,188
chr1,240813834,240814029,SRX5075168,SMARCA4,195
chr1,240887964,240888459,SRX16500061,CTCF,495
chr1,240887971,240888466,SRX16500059,CTCF,495
chr1,240887996,240888471,SRX16500060,CTCF,475
chr1,240888015,240888430,SRX16500062,CTCF,415
chr1,240888041,240888420,SRX4174629,CTCF,379
chr1,240888140,240888330,SRX5075174,SMARCA4,190
chr1,240888160,240888356,SRX5075168,SMARCA4,196
chr1,240965752,240965995,SRX5075176,SMARCA4,243
chr1,240967012,240967333,SRX16500059,CTCF,321
chr1,240967032,240967382,SRX16500061,CTCF,350
chr1,240967068,240967445,SRX16500060,CTCF,377
chr1,240967093,240967341,SRX16500062,CTCF,248
chr1,241034213,241034475,SRX5075174,SMARCA4,262
chr1,241101847,241102154,SRX5054309,FOSL2,307
chr1,241101882,241102112,SRX5054308,FOSL2,230
chr1,241166709,241166981,SRX5075174,SMARCA4,272
chr1,241172550,241172827,SRX5054309,FOSL2,277
chr1,241235240,241235640,SRX5075168,SMARCA4,400
chr1,241235246,241235597,SRX5075174,SMARCA4,351
chr1,241235379,241235573,SRX5716451,SOX2,194
chr1,241307993,241308242,SRX5075168,SMARCA4,249
chr1,241308024,241308295,SRX5716463,SMARCA4,271
chr1,241308034,241308326,SRX5716464,SMARCA4,292
chr1,241308070,241308375,SRX5075174,SMARCA4,305
chr1,241323509,241323817,SRX5716464,SMARCA4,308
chr1,241323514,241323845,SRX5075174,SMARCA4,331
chr1,241323533,241323843,SRX5075168,SMARCA4,310
chr1,241323576,241323792,SRX5075176,SMARCA4,216
chr1,241323592,241323793,SRX5075170,SMARCA4,201
chr1,241323606,241323809,SRX5075169,SMARCA4,203
chr1,241356574,241356931,SRX5075175,SMARCA4,357
chr1,241356590,241356911,SRX5716469,SMARCA4,321
chr1,241356591,241356863,SRX5075176,SMARCA4,272
chr1,241356599,241356826,SRX5075174,SMARCA4,227
chr1,241356618,241356912,SRX5075169,SMARCA4,294
chr1,241356644,241356957,SRX5075170,SMARCA4,313
chr1,241356670,241356934,SRX5716470,SMARCA4,264
chr1,241356811,241357502,SRX20140895,INTS13,691
chr1,241356888,241357533,SRX5075168,SMARCA4,645
chr1,241357024,241357508,SRX5075174,SMARCA4,484
chr1,241357048,241357244,SRX5075169,SMARCA4,196
chr1,241423827,241424401,SRX20140895,INTS13,574
chr1,241423955,241424296,SRX5075174,SMARCA4,341
chr1,241482805,241483075,SRX5075175,SMARCA4,270
chr1,241482840,241483080,SRX5075176,SMARCA4,240
chr1,241482853,241483253,SRX5075169,SMARCA4,400
chr1,241482878,241483270,SRX5054309,FOSL2,392
chr1,241482900,241483149,SRX5054308,FOSL2,249
chr1,241482923,241483115,SRX5075170,SMARCA4,192
chr1,241499853,241500298,SRX16500060,CTCF,445
chr1,241499861,241500262,SRX16500059,CTCF,401
chr1,241499883,241500229,SRX16500062,CTCF,346
chr1,241499890,241500249,SRX16500061,CTCF,359
chr1,241519143,241519410,SRX5075175,SMARCA4,267
chr1,241519144,241519664,SRX5075169,SMARCA4,520
chr1,241519338,241520059,SRX20140895,INTS13,721
chr1,241519531,241520109,SRX5716470,SMARCA4,578
chr1,241519557,241520140,SRX5075170,SMARCA4,583
chr1,241519610,241520115,SRX5075168,SMARCA4,505
chr1,241519724,241520115,SRX5716464,SMARCA4,391
chr1,241519749,241520097,SRX5075176,SMARCA4,348
chr1,241519754,241519953,SRX5054307,FOSL2,199
chr1,241519755,241520096,SRX5716463,SMARCA4,341
chr1,241519756,241520136,SRX5075174,SMARCA4,380
chr1,241519765,241520002,SRX5716454,SOX3,237
chr1,241519773,241520002,SRX5716451,SOX2,229
chr1,241519781,241520011,SRX5054309,FOSL2,230
chr1,241519784,241519967,SRX5054308,FOSL2,183
chr1,241519838,241520028,SRX5075169,SMARCA4,190
chr1,241531219,241531841,SRX16500062,CTCF,622
chr1,241531226,241531798,SRX16500060,CTCF,572
chr1,241531226,241531807,SRX16500059,CTCF,581
chr1,241531262,241531707,SRX16500061,CTCF,445
chr1,241531353,241531639,SRX5075174,SMARCA4,286
chr1,241531362,241531760,SRX5075170,SMARCA4,398
chr1,241531366,241531677,SRX5075168,SMARCA4,311
chr1,241531380,241531671,SRX5075169,SMARCA4,291
chr1,241531389,241531836,SRX5716470,SMARCA4,447
chr1,241531391,241531762,SRX5075176,SMARCA4,371
chr1,241531407,241531756,SRX5075175,SMARCA4,349
chr1,241531417,241531629,SRX5716469,SMARCA4,212
chr1,241531434,241531638,SRX5716463,SMARCA4,204
chr1,241592249,241592516,SRX5075170,SMARCA4,267
chr1,241592259,241592507,SRX5075175,SMARCA4,248
chr1,241592266,241592538,SRX5075169,SMARCA4,272
chr1,241592281,241592584,SRX5075176,SMARCA4,303
chr1,241603977,241604172,SRX5054309,FOSL2,195
chr1,241604017,241604223,SRX5054308,FOSL2,206
chr1,241605183,241605445,SRX16500059,CTCF,262
chr1,241605234,241605521,SRX16500062,CTCF,287
chr1,241605314,241605559,SRX16500060,CTCF,245
chr1,241610887,241611419,SRX16500059,CTCF,532
chr1,241610920,241611411,SRX16500061,CTCF,491
chr1,241610956,241611386,SRX16500062,CTCF,430
chr1,241610978,241611432,SRX16500060,CTCF,454
chr1,241611270,241611480,SRX4174629,CTCF,210
chr1,241612519,241612942,SRX5716469,SMARCA4,423
chr1,241612560,241612933,SRX5075170,SMARCA4,373
chr1,241612589,241612861,SRX5716470,SMARCA4,272
chr1,241612592,241612930,SRX5075176,SMARCA4,338
chr1,241612605,241612979,SRX5054309,FOSL2,374
chr1,241612638,241612950,SRX5075169,SMARCA4,312
chr1,241612639,241612989,SRX5054308,FOSL2,350
chr1,241612640,241612948,SRX5075175,SMARCA4,308
chr1,241612708,241612943,SRX5716467,SMARCA2,235
chr1,241627487,241627771,SRX16500059,CTCF,284
chr1,241627488,241627761,SRX5054309,FOSL2,273
chr1,241627491,241627744,SRX5075168,SMARCA4,253
chr1,241627512,241627748,SRX5075174,SMARCA4,236
chr1,241627518,241627740,SRX5054308,FOSL2,222
chr1,241627529,241627759,SRX5075176,SMARCA4,230
chr1,241627553,241627787,SRX5716470,SMARCA4,234
chr1,241627584,241627773,SRX5075175,SMARCA4,189
chr1,241627603,241627794,SRX5075170,SMARCA4,191
chr1,241627606,241627842,SRX16500060,CTCF,236
chr1,241639954,241640638,SRX20140895,INTS13,684
chr1,241640021,241640619,SRX20140868,INTS10,598
chr1,241640059,241640532,SRX20140867,INTS10,473
chr1,241640064,241640493,SRX20140881,CPSF3L,429
chr1,241640088,241640646,SRX5075175,SMARCA4,558
chr1,241640096,241640609,SRX5075169,SMARCA4,513
chr1,241640100,241640715,SRX5075176,SMARCA4,615
chr1,241640107,241640508,SRX20140869,INTS10,401
chr1,241640108,241640571,SRX20140896,INTS13,463
chr1,241640129,241640666,SRX5075170,SMARCA4,537
chr1,241640157,241640648,SRX5716470,SMARCA4,491
chr1,241640178,241640580,SRX20140897,INTS13,402
chr1,241640185,241640708,SRX5075168,SMARCA4,523
chr1,241640204,241640765,SRX5075174,SMARCA4,561
chr1,241640347,241640542,SRX5054307,FOSL2,195
chr1,241640354,241640681,SRX5716463,SMARCA4,327
chr1,241640398,241640656,SRX5716464,SMARCA4,258
chr1,241641806,241641986,SRX5054308,FOSL2,180
chr1,241723027,241723255,SRX5075174,SMARCA4,228
chr1,241834687,241835195,SRX16500060,CTCF,508
chr1,241834705,241835141,SRX16500059,CTCF,436
chr1,241834708,241835309,SRX16500062,CTCF,601
chr1,241834734,241835184,SRX16500061,CTCF,450
chr1,241834817,241835015,SRX5075170,SMARCA4,198
chr1,241834837,241835089,SRX5075168,SMARCA4,252
chr1,241834848,241835026,SRX5075176,SMARCA4,178
chr1,241834887,241835126,SRX5075174,SMARCA4,239
chr1,241837985,241838253,SRX5054309,FOSL2,268
chr1,241842578,241842859,SRX5075168,SMARCA4,281
chr1,241847564,241848047,SRX5075169,SMARCA4,483
chr1,241847595,241848084,SRX5075170,SMARCA4,489
chr1,241847631,241848116,SRX5075168,SMARCA4,485
chr1,241847638,241847850,SRX5716469,SMARCA4,212
chr1,241847661,241848141,SRX5075176,SMARCA4,480
chr1,241847673,241848143,SRX5075174,SMARCA4,470
chr1,241847688,241847999,SRX16500059,CTCF,311
chr1,241847792,241848281,SRX20140895,INTS13,489
chr1,241847793,241848181,SRX20140867,INTS10,388
chr1,241847810,241848327,SRX20140868,INTS10,517
chr1,241847831,241848159,SRX20140869,INTS10,328
chr1,241847887,241848091,SRX5716463,SMARCA4,204
chr1,241896286,241896921,SRX16500059,CTCF,635
chr1,241896321,241896897,SRX16500060,CTCF,576
chr1,241896340,241896798,SRX16500062,CTCF,458
chr1,241896350,241896837,SRX16500061,CTCF,487
chr1,241896382,241896654,SRX4174629,CTCF,272
chr1,241896455,241896681,SRX5075168,SMARCA4,226
chr1,241896467,241896643,SRX5075170,SMARCA4,176
chr1,241896470,241896668,SRX5075176,SMARCA4,198
chr1,241896500,241896690,SRX5075174,SMARCA4,190
chr1,241902245,241902854,SRX5716470,SMARCA4,609
chr1,241902284,241903008,SRX5075170,SMARCA4,724
chr1,241902320,241903020,SRX5075176,SMARCA4,700
chr1,241902331,241902847,SRX5716469,SMARCA4,516
chr1,241902335,241902684,SRX5075169,SMARCA4,349
chr1,241902374,241902759,SRX5716467,SMARCA2,385
chr1,241902383,241902773,SRX5075175,SMARCA4,390
chr1,241902429,241902663,SRX5054308,FOSL2,234
chr1,241902430,241902675,SRX5716468,SMARCA2,245
chr1,241902460,241902728,SRX5020211,SMARCA2,268
chr1,241918845,241919056,SRX5716470,SMARCA4,211
chr1,241918849,241919226,SRX5075176,SMARCA4,377
chr1,241918907,241919231,SRX5075175,SMARCA4,324
chr1,241918915,241919229,SRX5075170,SMARCA4,314
chr1,241918926,241919238,SRX5075169,SMARCA4,312
chr1,241918927,241919219,SRX5054308,FOSL2,292
chr1,241918934,241919117,SRX5075168,SMARCA4,183
chr1,241918942,241919201,SRX5054309,FOSL2,259
chr1,241933920,241934590,SRX5075174,SMARCA4,670
chr1,241934006,241934561,SRX5075168,SMARCA4,555
chr1,241934031,241934524,SRX5716463,SMARCA4,493
chr1,241934073,241934546,SRX5716464,SMARCA4,473
chr1,241934108,241934661,SRX5075170,SMARCA4,553
chr1,241934141,241934568,SRX5716470,SMARCA4,427
chr1,241934145,241934453,SRX20140895,INTS13,308
chr1,241934153,241934475,SRX5716469,SMARCA4,322
chr1,241934171,241934595,SRX5075175,SMARCA4,424
chr1,241934192,241934683,SRX5075176,SMARCA4,491
chr1,241934205,241934647,SRX5075169,SMARCA4,442
chr1,241934264,241934545,SRX5054308,FOSL2,281
chr1,241934265,241934654,SRX5716467,SMARCA2,389
chr1,241947342,241947710,SRX5075176,SMARCA4,368
chr1,241947365,241947741,SRX5075170,SMARCA4,376
chr1,241947388,241947642,SRX5054308,FOSL2,254
chr1,241950397,241950636,SRX5716469,SMARCA4,239
chr1,241950401,241950772,SRX5075176,SMARCA4,371
chr1,241950418,241950745,SRX5075169,SMARCA4,327
chr1,241950425,241950697,SRX5054309,FOSL2,272
chr1,241950430,241950777,SRX5075170,SMARCA4,347
chr1,241950462,241950759,SRX5075175,SMARCA4,297
chr1,241950489,241950669,SRX5054308,FOSL2,180
chr1,241963839,241964116,SRX20140867,INTS10,277
chr1,241972545,241973165,SRX5075168,SMARCA4,620
chr1,241972589,241973108,SRX5075174,SMARCA4,519
chr1,241972602,241973292,SRX5716469,SMARCA4,690
chr1,241972632,241972850,SRX5716451,SOX2,218
chr1,241972637,241973433,SRX5075176,SMARCA4,796
chr1,241972642,241973395,SRX5075170,SMARCA4,753
chr1,241972650,241973040,SRX5716464,SMARCA4,390
chr1,241972652,241973191,SRX20140895,INTS13,539
chr1,241972657,241973352,SRX5716470,SMARCA4,695
chr1,241972660,241972881,SRX5075181,SMARCA2,221
chr1,241972662,241972944,SRX5020211,SMARCA2,282
chr1,241972666,241973064,SRX5716463,SMARCA4,398
chr1,241972670,241972991,SRX5716468,SMARCA2,321
chr1,241972696,241973295,SRX5075169,SMARCA4,599
chr1,241972704,241973208,SRX5716467,SMARCA2,504
chr1,241972720,241972953,SRX5716454,SOX3,233
chr1,241972724,241973113,SRX20140867,INTS10,389
chr1,241972736,241973388,SRX5075175,SMARCA4,652
chr1,241972788,241973036,SRX20140897,INTS13,248
chr1,241972809,241973273,SRX5054309,FOSL2,464
chr1,241973023,241973344,SRX5054308,FOSL2,321
chr1,241985673,241986230,SRX16500061,CTCF,557
chr1,241985786,241986233,SRX16500062,CTCF,447
chr1,241985796,241986185,SRX16500060,CTCF,389
chr1,241985830,241986183,SRX16500059,CTCF,353
chr1,241988907,241989559,SRX5075170,SMARCA4,652
chr1,241988910,241989264,SRX5716470,SMARCA4,354
chr1,241988919,241989600,SRX5075176,SMARCA4,681
chr1,241988927,241989139,SRX5716469,SMARCA4,212
chr1,241988964,241989455,SRX5075169,SMARCA4,491
chr1,241989115,241989512,SRX5075175,SMARCA4,397
chr1,241989157,241989474,SRX5054308,FOSL2,317
chr1,241990086,241990403,SRX5075176,SMARCA4,317
chr1,241990112,241990411,SRX5054308,FOSL2,299
chr1,241990136,241990423,SRX5075169,SMARCA4,287
chr1,241990137,241990355,SRX5716469,SMARCA4,218
chr1,241990143,241990409,SRX5075175,SMARCA4,266
chr1,241990146,241990437,SRX5075170,SMARCA4,291
chr1,241990160,241990384,SRX5054309,FOSL2,224
chr1,241992795,241993004,SRX5075169,SMARCA4,209
chr1,241992796,241993032,SRX5054309,FOSL2,236
chr1,241998305,241998958,SRX16500061,CTCF,653
chr1,241998344,241998873,SRX4174629,CTCF,529
chr1,241998352,241998911,SRX16500062,CTCF,559
chr1,241998359,241998916,SRX16500059,CTCF,557
chr1,241998367,241998987,SRX16500060,CTCF,620
chr1,241998427,241998838,SRX5075176,SMARCA4,411
chr1,241998434,241998838,SRX5075174,SMARCA4,404
chr1,241998439,241998856,SRX5075169,SMARCA4,417
chr1,241998447,241999317,SRX5075170,SMARCA4,870
chr1,241998477,241998863,SRX5075175,SMARCA4,386
chr1,241998489,241998710,SRX5716467,SMARCA2,221
chr1,241998502,241998784,SRX5716470,SMARCA4,282
chr1,241998523,241998897,SRX5716469,SMARCA4,374
chr1,241998541,241998721,SRX5054308,FOSL2,180
chr1,241998591,241998774,SRX5054309,FOSL2,183
chr1,241998594,241998927,SRX5075168,SMARCA4,333
chr1,241999055,241999237,SRX5075168,SMARCA4,182
chr1,241999117,241999330,SRX5075176,SMARCA4,213
chr1,242005205,242005409,SRX5716463,SMARCA4,204
chr1,242011856,242012484,SRX5075176,SMARCA4,628
chr1,242011907,242012259,SRX5075169,SMARCA4,352
chr1,242011907,242012279,SRX5075170,SMARCA4,372
chr1,242011930,242012142,SRX5716469,SMARCA4,212
chr1,242011976,242012194,SRX5075175,SMARCA4,218
chr1,242012000,242012209,SRX5054308,FOSL2,209
chr1,242017587,242018023,SRX16500059,CTCF,436
chr1,242017604,242018060,SRX16500060,CTCF,456
chr1,242017621,242018040,SRX16500061,CTCF,419
chr1,242017646,242018050,SRX16500062,CTCF,404
chr1,242017667,242017935,SRX5075174,SMARCA4,268
chr1,242017677,242017950,SRX5075168,SMARCA4,273
chr1,242017691,242017908,SRX5075170,SMARCA4,217
chr1,242017704,242017884,SRX5075169,SMARCA4,180
chr1,242017704,242017925,SRX5716463,SMARCA4,221
chr1,242017711,242017892,SRX5075176,SMARCA4,181
chr1,242019818,242020278,SRX16500059,CTCF,460
chr1,242019851,242020225,SRX16500061,CTCF,374
chr1,242019851,242020265,SRX16500060,CTCF,414
chr1,242019877,242020231,SRX16500062,CTCF,354
chr1,242019922,242020165,SRX5075168,SMARCA4,243
chr1,242019951,242020190,SRX5075176,SMARCA4,239
chr1,242019999,242020189,SRX5075174,SMARCA4,190
chr1,242129142,242129475,SRX16500061,CTCF,333
chr1,242129166,242129561,SRX16500060,CTCF,395
chr1,242146634,242146961,SRX5075168,SMARCA4,327
chr1,242146705,242146955,SRX5075174,SMARCA4,250
chr1,242147130,242147340,SRX5075174,SMARCA4,210
chr1,242147167,242147428,SRX5075168,SMARCA4,261
chr1,242147189,242147421,SRX5075176,SMARCA4,232
chr1,242147251,242147626,SRX5716460,Epitope tags,375
chr1,242162271,242162482,SRX5075174,SMARCA4,211
chr1,242185746,242185988,SRX5075174,SMARCA4,242
chr1,242185748,242186039,SRX5075170,SMARCA4,291
chr1,242211307,242211605,SRX20140881,CPSF3L,298
chr1,242224452,242224796,SRX5075168,SMARCA4,344
chr1,242224467,242225558,SRX5075174,SMARCA4,1091
chr1,242224509,242224699,SRX5716451,SOX2,190
chr1,242224591,242225502,SRX5716463,SMARCA4,911
chr1,242224867,242225520,SRX5075168,SMARCA4,653
chr1,242224919,242225314,SRX5716451,SOX2,395
chr1,242224950,242225169,SRX5716464,SMARCA4,219
chr1,242224995,242225343,SRX5716454,SOX3,348
chr1,242245318,242245537,SRX5075168,SMARCA4,219
chr1,242454585,242455136,SRX16500061,CTCF,551
chr1,242454665,242455246,SRX16500060,CTCF,581
chr1,242454703,242455200,SRX16500062,CTCF,497
chr1,242454738,242455081,SRX5716470,SMARCA4,343
chr1,242454754,242455203,SRX16500059,CTCF,449
chr1,242454764,242455095,SRX4174629,CTCF,331
chr1,242454794,242455153,SRX5075168,SMARCA4,359
chr1,242454799,242455118,SRX5075170,SMARCA4,319
chr1,242454808,242455122,SRX5075176,SMARCA4,314
chr1,242454809,242455155,SRX5075174,SMARCA4,346
chr1,242454845,242455133,SRX5716463,SMARCA4,288
chr1,242454894,242455099,SRX5075169,SMARCA4,205
chr1,242467417,242467906,SRX16500062,CTCF,489
chr1,242467461,242467937,SRX16500061,CTCF,476
chr1,242467462,242467941,SRX16500060,CTCF,479
chr1,242467472,242467999,SRX16500059,CTCF,527
chr1,242467543,242467943,SRX4174629,CTCF,400
chr1,242467608,242467849,SRX5075168,SMARCA4,241
chr1,242467627,242467897,SRX5075174,SMARCA4,270
chr1,242524196,242524429,SRX5075174,SMARCA4,233
chr1,242585944,242586674,SRX5075174,SMARCA4,730
chr1,242586006,242586688,SRX5075168,SMARCA4,682
chr1,242586100,242586741,SRX20140895,INTS13,641
chr1,242586153,242586659,SRX20140867,INTS10,506
chr1,242586173,242586514,SRX20140879,CPSF3L,341
chr1,242586230,242586496,SRX20140881,CPSF3L,266
chr1,242586234,242586623,SRX20140868,INTS10,389
chr1,242623128,242623436,SRX5075174,SMARCA4,308
chr1,242623135,242623416,SRX5075168,SMARCA4,281
chr1,242625681,242625917,SRX5075174,SMARCA4,236
chr1,242625696,242625985,SRX5075168,SMARCA4,289
chr1,242651851,242652115,SRX16500062,CTCF,264
chr1,242651911,242652193,SRX16500059,CTCF,282
chr1,242723245,242723712,SRX5075174,SMARCA4,467
chr1,242745116,242745488,SRX5075174,SMARCA4,372
chr1,242745273,242745501,SRX5075168,SMARCA4,228
chr1,242787993,242788356,SRX5075168,SMARCA4,363
chr1,242788009,242788353,SRX5075174,SMARCA4,344
chr1,242788039,242788357,SRX5075170,SMARCA4,318
chr1,242788051,242788383,SRX5054309,FOSL2,332
chr1,242788064,242788395,SRX5075176,SMARCA4,331
chr1,242788159,242788361,SRX5054308,FOSL2,202
chr1,242790469,242790968,SRX5075174,SMARCA4,499
chr1,242790498,242790910,SRX5716463,SMARCA4,412
chr1,242790678,242790916,SRX5075168,SMARCA4,238
chr1,242824403,242824819,SRX5075168,SMARCA4,416
chr1,242824419,242824811,SRX5075174,SMARCA4,392
chr1,242824424,242824739,SRX5054309,FOSL2,315
chr1,242824441,242824636,SRX5054308,FOSL2,195
chr1,242824479,242824648,SRX5075170,SMARCA4,169
chr1,242824499,242824750,SRX5054307,FOSL2,251
chr1,242824525,242824705,SRX5075169,SMARCA4,180
chr1,242828873,242829297,SRX5075174,SMARCA4,424
chr1,242828878,242829289,SRX5075168,SMARCA4,411
chr1,242828940,242829183,SRX5716463,SMARCA4,243
chr1,242847432,242847624,SRX5075170,SMARCA4,192
chr1,242847435,242847738,SRX5075174,SMARCA4,303
chr1,242847452,242847645,SRX5075176,SMARCA4,193
chr1,242847465,242847705,SRX5075168,SMARCA4,240
chr1,242890082,242890301,SRX5054309,FOSL2,219
chr1,242890149,242890614,SRX5075174,SMARCA4,465
chr1,242890185,242890389,SRX5075170,SMARCA4,204
chr1,242890195,242890447,SRX5075176,SMARCA4,252
chr1,242890229,242890434,SRX5075169,SMARCA4,205
chr1,242890245,242890656,SRX5075168,SMARCA4,411
chr1,242924697,242925034,SRX5075170,SMARCA4,337
chr1,243010840,243011146,SRX16500059,CTCF,306
chr1,243010847,243011122,SRX16500060,CTCF,275
chr1,243010902,243011113,SRX4174629,CTCF,211
chr1,243019038,243019394,SRX5716470,SMARCA4,356
chr1,243019062,243019369,SRX5075168,SMARCA4,307
chr1,243019063,243019362,SRX5075174,SMARCA4,299
chr1,243019065,243019350,SRX5075175,SMARCA4,285
chr1,243019065,243019368,SRX5075170,SMARCA4,303
chr1,243019069,243019327,SRX5075176,SMARCA4,258
chr1,243019071,243019361,SRX5075169,SMARCA4,290
chr1,243023612,243023912,SRX16500059,CTCF,300
chr1,243023657,243023878,SRX16500060,CTCF,221
chr1,243086678,243086854,SRX5075176,SMARCA4,176
chr1,243086740,243086917,SRX5075170,SMARCA4,177
chr1,243113892,243114470,SRX5075170,SMARCA4,578
chr1,243113913,243114546,SRX5716470,SMARCA4,633
chr1,243113922,243114581,SRX5075176,SMARCA4,659
chr1,243113933,243114633,SRX5075169,SMARCA4,700
chr1,243113945,243114435,SRX5054308,FOSL2,490
chr1,243113958,243114387,SRX5716467,SMARCA2,429
chr1,243113961,243114554,SRX5716469,SMARCA4,593
chr1,243113968,243114411,SRX5716468,SMARCA2,443
chr1,243113971,243114268,SRX5075181,SMARCA2,297
chr1,243113972,243114600,SRX5075175,SMARCA4,628
chr1,243113987,243114296,SRX5020211,SMARCA2,309
chr1,243114048,243114380,SRX5054309,FOSL2,332
chr1,243114058,243114403,SRX5020214,SMARCA2,345
chr1,243114116,243114403,SRX5075174,SMARCA4,287
chr1,243114249,243114428,SRX5075168,SMARCA4,179
chr1,243140474,243140814,SRX16500059,CTCF,340
chr1,243140524,243140768,SRX16500062,CTCF,244
chr1,243140540,243140810,SRX16500060,CTCF,270
chr1,243173933,243174327,SRX5075168,SMARCA4,394
chr1,243174007,243174278,SRX5075174,SMARCA4,271
chr1,243205286,243205347,SRX1424891,POU3F2,61
chr1,243217409,243217654,SRX5075170,SMARCA4,245
chr1,243217544,243217719,SRX5075176,SMARCA4,175
chr1,243233957,243234130,SRX5075170,SMARCA4,173
chr1,243233966,243234171,SRX5054308,FOSL2,205
chr1,243234019,243234214,SRX5075176,SMARCA4,195
chr1,243235149,243235576,SRX5075176,SMARCA4,427
chr1,243235159,243235623,SRX5075169,SMARCA4,464
chr1,243235216,243235533,SRX5075170,SMARCA4,317
chr1,243235253,243235615,SRX5075175,SMARCA4,362
chr1,243235268,243235646,SRX5716470,SMARCA4,378
chr1,243235327,243235578,SRX5020211,SMARCA2,251
chr1,243254489,243255362,SRX20140895,INTS13,873
chr1,243254889,243255168,SRX20140868,INTS10,279
chr1,243255200,243255290,SRX1424893,POU3F2,90
chr1,243255233,243255526,SRX5075168,SMARCA4,293
chr1,243255241,243255559,SRX5716451,SOX2,318
chr1,243255257,243255577,SRX5716454,SOX3,320
chr1,243255310,243255607,SRX5075174,SMARCA4,297
chr1,243255845,243256069,SRX5075174,SMARCA4,224
chr1,243255861,243256151,SRX5075176,SMARCA4,290
chr1,243264724,243265061,SRX5075176,SMARCA4,337
chr1,243264737,243265102,SRX5075170,SMARCA4,365
chr1,243264824,243265033,SRX5075169,SMARCA4,209
chr1,243268261,243268668,SRX5054309,FOSL2,407
chr1,243268282,243268629,SRX5075175,SMARCA4,347
chr1,243268296,243268654,SRX5054308,FOSL2,358
chr1,243268312,243268598,SRX5075169,SMARCA4,286
chr1,243268348,243268561,SRX5075176,SMARCA4,213
chr1,243268365,243268584,SRX5075170,SMARCA4,219
chr1,243268380,243268658,SRX5020214,SMARCA2,278
chr1,243287690,243288001,SRX5075169,SMARCA4,311
chr1,243287692,243288038,SRX5075176,SMARCA4,346
chr1,243287699,243288040,SRX5075175,SMARCA4,341
chr1,243287708,243288023,SRX5054308,FOSL2,315
chr1,243287713,243288015,SRX5054309,FOSL2,302
chr1,243287717,243288027,SRX5075170,SMARCA4,310
chr1,243294749,243294993,SRX5075169,SMARCA4,244
chr1,243294788,243295076,SRX5054309,FOSL2,288
chr1,243315657,243315826,SRX5075170,SMARCA4,169
chr1,243316334,243316754,SRX20140895,INTS13,420
chr1,243316337,243316881,SRX5075174,SMARCA4,544
chr1,243316373,243316775,SRX5075176,SMARCA4,402
chr1,243316389,243316828,SRX5075168,SMARCA4,439
chr1,243325259,243325727,SRX16500059,CTCF,468
chr1,243325267,243325732,SRX16500062,CTCF,465
chr1,243325268,243325773,SRX16500060,CTCF,505
chr1,243325271,243325718,SRX16500061,CTCF,447
chr1,243325361,243325646,SRX5075174,SMARCA4,285
chr1,243325367,243325566,SRX5075176,SMARCA4,199
chr1,243325394,243325570,SRX5075170,SMARCA4,176
chr1,243325430,243325650,SRX5075168,SMARCA4,220
chr1,243329263,243329507,SRX5075176,SMARCA4,244
chr1,243329274,243329516,SRX5075170,SMARCA4,242
chr1,243343875,243344407,SRX16500062,CTCF,532
chr1,243343903,243344426,SRX16500059,CTCF,523
chr1,243343932,243344411,SRX16500061,CTCF,479
chr1,243343954,243344417,SRX16500060,CTCF,463
chr1,243343988,243344290,SRX5075176,SMARCA4,302
chr1,243344048,243344255,SRX5075170,SMARCA4,207
chr1,243344049,243344286,SRX5075169,SMARCA4,237
chr1,243344057,243344249,SRX5075174,SMARCA4,192
chr1,243344092,243344403,SRX4174629,CTCF,311
chr1,243345874,243346403,SRX5075174,SMARCA4,529
chr1,243345908,243346899,SRX5075168,SMARCA4,991
chr1,243345924,243346831,SRX20140895,INTS13,907
chr1,243346002,243346275,SRX5716463,SMARCA4,273
chr1,243346177,243346778,SRX20140868,INTS10,601
chr1,243346487,243346959,SRX5075174,SMARCA4,472
chr1,243346525,243346817,SRX5716451,SOX2,292
chr1,243346534,243346821,SRX5716463,SMARCA4,287
chr1,243346583,243346792,SRX5716464,SMARCA4,209
chr1,243354571,243354886,SRX5716469,SMARCA4,315
chr1,243354658,243354835,SRX5075170,SMARCA4,177
chr1,243354683,243354943,SRX5075169,SMARCA4,260
chr1,243407528,243408006,SRX5075176,SMARCA4,478
chr1,243407587,243407955,SRX5075169,SMARCA4,368
chr1,243407590,243407900,SRX5054309,FOSL2,310
chr1,243407594,243407905,SRX5716469,SMARCA4,311
chr1,243407622,243407943,SRX5054308,FOSL2,321
chr1,243407648,243407957,SRX5075175,SMARCA4,309
chr1,243407657,243407903,SRX5020211,SMARCA2,246
chr1,243407707,243407942,SRX5075170,SMARCA4,235
chr1,243421788,243422117,SRX5075175,SMARCA4,329
chr1,243421800,243422058,SRX5716469,SMARCA4,258
chr1,243421813,243422067,SRX5054308,FOSL2,254
chr1,243421816,243422104,SRX5075169,SMARCA4,288
chr1,243421824,243422011,SRX5054309,FOSL2,187
chr1,243421833,243422144,SRX5716470,SMARCA4,311
chr1,243421835,243422091,SRX5075170,SMARCA4,256
chr1,243421856,243422112,SRX5075176,SMARCA4,256
chr1,243434100,243434342,SRX5075169,SMARCA4,242
chr1,243434107,243434329,SRX5075175,SMARCA4,222
chr1,243434122,243434364,SRX5054309,FOSL2,242
chr1,243434153,243434370,SRX5075176,SMARCA4,217
chr1,243440324,243440794,SRX20140895,INTS13,470
chr1,243440352,243440890,SRX5075168,SMARCA4,538
chr1,243440392,243440831,SRX5075174,SMARCA4,439
chr1,243440473,243440768,SRX5716463,SMARCA4,295
chr1,243470428,243470784,SRX5075174,SMARCA4,356
chr1,243470499,243470762,SRX5075168,SMARCA4,263
chr1,243473477,243473801,SRX5075170,SMARCA4,324
chr1,243475939,243476290,SRX5054309,FOSL2,351
chr1,243475957,243476400,SRX5075168,SMARCA4,443
chr1,243475959,243476437,SRX5075174,SMARCA4,478
chr1,243475965,243476345,SRX5075170,SMARCA4,380
chr1,243475975,243476278,SRX5075175,SMARCA4,303
chr1,243475980,243476332,SRX5075176,SMARCA4,352
chr1,243475987,243476289,SRX5075169,SMARCA4,302
chr1,243475994,243476223,SRX5716470,SMARCA4,229
chr1,243476044,243476233,SRX5054308,FOSL2,189
chr1,243476066,243476270,SRX5054307,FOSL2,204
chr1,243476077,243476282,SRX5716463,SMARCA4,205
chr1,243476091,243476406,SRX5716464,SMARCA4,315
chr1,243476123,243476353,SRX16500062,CTCF,230
chr1,243482318,243482525,SRX5075168,SMARCA4,207
chr1,243503225,243503394,SRX5075170,SMARCA4,169
chr1,243507404,243507609,SRX5075174,SMARCA4,205
chr1,243507407,243507653,SRX5075168,SMARCA4,246
chr1,243513956,243514257,SRX5716469,SMARCA4,301
chr1,243515788,243515831,SRX1424891,POU3F2,43
chr1,243525122,243525511,SRX5075175,SMARCA4,389
chr1,243525132,243525513,SRX5075169,SMARCA4,381
chr1,243525134,243525510,SRX5075170,SMARCA4,376
chr1,243525148,243525498,SRX5075176,SMARCA4,350
chr1,243525180,243525500,SRX5054309,FOSL2,320
chr1,243525278,243525581,SRX5716469,SMARCA4,303
chr1,243539693,243539877,SRX5054309,FOSL2,184
chr1,243539731,243539975,SRX5054308,FOSL2,244
chr1,243549186,243549482,SRX5054309,FOSL2,296
chr1,243596328,243596779,SRX5075175,SMARCA4,451
chr1,243596339,243596651,SRX5054309,FOSL2,312
chr1,243596342,243596557,SRX5020214,SMARCA2,215
chr1,243596360,243596735,SRX5075169,SMARCA4,375
chr1,243596366,243596667,SRX5054308,FOSL2,301
chr1,243596385,243596693,SRX5020211,SMARCA2,308
chr1,243596386,243596690,SRX5075170,SMARCA4,304
chr1,243596391,243596625,SRX5716470,SMARCA4,234
chr1,243596397,243596773,SRX5716469,SMARCA4,376
chr1,243642975,243643167,SRX5075174,SMARCA4,192
chr1,243643003,243643220,SRX5054308,FOSL2,217
chr1,243643047,243643261,SRX5075170,SMARCA4,214
chr1,243643071,243643292,SRX5075168,SMARCA4,221
chr1,243708248,243708529,SRX16500059,CTCF,281
chr1,243708263,243708566,SRX16500062,CTCF,303
chr1,243708280,243708606,SRX16500060,CTCF,326
chr1,243712893,243713218,SRX16500061,CTCF,325
chr1,243712904,243713221,SRX16500059,CTCF,317
chr1,243713440,243714137,SRX5075174,SMARCA4,697
chr1,243713452,243714116,SRX5075168,SMARCA4,664
chr1,243713481,243713738,SRX5075170,SMARCA4,257
chr1,243713491,243713942,SRX20140895,INTS13,451
chr1,243713537,243713951,SRX5075176,SMARCA4,414
chr1,243713730,243714024,SRX5075169,SMARCA4,294
chr1,243713775,243713965,SRX5716451,SOX2,190
chr1,243713828,243714038,SRX5716463,SMARCA4,210
chr1,243713829,243714097,SRX5716469,SMARCA4,268
chr1,243718856,243719281,SRX5054309,FOSL2,425
chr1,243718888,243719246,SRX5075169,SMARCA4,358
chr1,243718890,243719278,SRX5716470,SMARCA4,388
chr1,243718891,243719264,SRX5054308,FOSL2,373
chr1,243718929,243719253,SRX5075175,SMARCA4,324
chr1,243718946,243719227,SRX5716469,SMARCA4,281
chr1,243718954,243719179,SRX5075170,SMARCA4,225
chr1,243718976,243719241,SRX5020214,SMARCA2,265
chr1,243718991,243719290,SRX5075176,SMARCA4,299
chr1,243719012,243719196,SRX5054307,FOSL2,184
chr1,243719030,243719208,SRX5075174,SMARCA4,178
chr1,243723668,243723875,SRX5075170,SMARCA4,207
chr1,243731361,243731536,SRX5075176,SMARCA4,175
chr1,243737937,243738505,SRX5075168,SMARCA4,568
chr1,243737962,243738527,SRX5075174,SMARCA4,565
chr1,243737974,243738360,SRX20140895,INTS13,386
chr1,243738033,243738489,SRX5716463,SMARCA4,456
chr1,243738079,243738317,SRX5716454,SOX3,238
chr1,243738081,243738343,SRX20140868,INTS10,262
chr1,243738083,243738362,SRX5716451,SOX2,279
chr1,243738088,243738369,SRX5716464,SMARCA4,281
chr1,243738190,243738281,SRX1424894,POU3F2,91
chr1,243738222,243738327,SRX1424893,POU3F2,105
chr1,243740441,243740624,SRX5075174,SMARCA4,183
chr1,243745565,243745845,SRX5075174,SMARCA4,280
chr1,243746793,243747099,SRX5075168,SMARCA4,306
chr1,243746843,243747042,SRX5075174,SMARCA4,199
chr1,243748596,243749138,SRX16500059,CTCF,542
chr1,243748598,243749103,SRX16500060,CTCF,505
chr1,243748613,243749098,SRX16500061,CTCF,485
chr1,243748685,243749083,SRX16500062,CTCF,398
chr1,243748725,243748927,SRX5075176,SMARCA4,202
chr1,243748763,243748999,SRX5075168,SMARCA4,236
chr1,243748763,243749013,SRX5075174,SMARCA4,250
chr1,243766746,243767341,SRX5075168,SMARCA4,595
chr1,243766852,243767412,SRX5075174,SMARCA4,560
chr1,243766929,243767315,SRX5716463,SMARCA4,386
chr1,243766962,243767171,SRX5716451,SOX2,209
chr1,243767067,243767272,SRX5716464,SMARCA4,205
chr1,243768929,243769174,SRX5054308,FOSL2,245
chr1,243781093,243781308,SRX5716467,SMARCA2,215
chr1,243781127,243781333,SRX5054308,FOSL2,206
chr1,243781152,243781407,SRX5020211,SMARCA2,255
chr1,243781168,243781355,SRX5054309,FOSL2,187
chr1,243781178,243781379,SRX5075169,SMARCA4,201
chr1,243841557,243841775,SRX5075169,SMARCA4,218
chr1,243841565,243841768,SRX5075175,SMARCA4,203
chr1,243843061,243843480,SRX5054309,FOSL2,419
chr1,243843073,243843496,SRX5075175,SMARCA4,423
chr1,243843079,243843514,SRX5716469,SMARCA4,435
chr1,243843079,243843522,SRX5075176,SMARCA4,443
chr1,243843081,243843394,SRX5075168,SMARCA4,313
chr1,243843082,243843483,SRX5075174,SMARCA4,401
chr1,243843097,243843466,SRX5054308,FOSL2,369
chr1,243843113,243843545,SRX5075170,SMARCA4,432
chr1,243843124,243843475,SRX5075169,SMARCA4,351
chr1,243843129,243843481,SRX5716470,SMARCA4,352
chr1,243843181,243843448,SRX5020214,SMARCA2,267
chr1,243843203,243843440,SRX5716467,SMARCA2,237
chr1,243850299,243851049,SRX20140867,INTS10,750
chr1,243850369,243851133,SRX20140895,INTS13,764
chr1,243850376,243850594,SRX5075174,SMARCA4,218
chr1,243850408,243850588,SRX5075168,SMARCA4,180
chr1,243850452,243850680,SRX5075175,SMARCA4,228
chr1,243850487,243851086,SRX20140868,INTS10,599
chr1,243850771,243851070,SRX5075170,SMARCA4,299
chr1,243850807,243851155,SRX5075169,SMARCA4,348
chr1,243850847,243851050,SRX5075175,SMARCA4,203
chr1,243850911,243851141,SRX5716469,SMARCA4,230
chr1,243850946,243851133,SRX5075174,SMARCA4,187
chr1,243883629,243883918,SRX5054309,FOSL2,289
chr1,243883642,243883944,SRX5075176,SMARCA4,302
chr1,243883651,243883968,SRX5075169,SMARCA4,317
chr1,243883658,243884005,SRX5075175,SMARCA4,347
chr1,243883667,243883913,SRX5075170,SMARCA4,246
chr1,243883693,243883919,SRX5054308,FOSL2,226
chr1,243883701,243883917,SRX5716470,SMARCA4,216
chr1,243890523,243891017,SRX5075170,SMARCA4,494
chr1,243890547,243891000,SRX5075169,SMARCA4,453
chr1,243890548,243891117,SRX5075176,SMARCA4,569
chr1,243890568,243890945,SRX5054309,FOSL2,377
chr1,243890599,243890926,SRX5054308,FOSL2,327
chr1,243890610,243890939,SRX5075175,SMARCA4,329
chr1,243890618,243890903,SRX5716467,SMARCA2,285
chr1,243890628,243890840,SRX5716469,SMARCA4,212
chr1,243890652,243890908,SRX5020214,SMARCA2,256
chr1,243890661,243890907,SRX5716470,SMARCA4,246
chr1,243903908,243904259,SRX5075176,SMARCA4,351
chr1,243903926,243904236,SRX5075175,SMARCA4,310
chr1,243903928,243904243,SRX5075170,SMARCA4,315
chr1,243903928,243904260,SRX5716470,SMARCA4,332
chr1,243903931,243904256,SRX5075169,SMARCA4,325
chr1,243903941,243904248,SRX5716469,SMARCA4,307
chr1,243903955,243904158,SRX5075181,SMARCA2,203
chr1,243903968,243904229,SRX5075168,SMARCA4,261
chr1,243904041,243904246,SRX5020214,SMARCA2,205
chr1,243917188,243917412,SRX5075170,SMARCA4,224
chr1,243917191,243917878,SRX5075168,SMARCA4,687
chr1,243917192,243917950,SRX20140895,INTS13,758
chr1,243917218,243917928,SRX5075176,SMARCA4,710
chr1,243917230,243917931,SRX5716470,SMARCA4,701
chr1,243917231,243917863,SRX5716469,SMARCA4,632
chr1,243917235,243917816,SRX20140868,INTS10,581
chr1,243917257,243917870,SRX5075174,SMARCA4,613
chr1,243917287,243917854,SRX5075175,SMARCA4,567
chr1,243917305,243917777,SRX5716463,SMARCA4,472
chr1,243917335,243917916,SRX5075169,SMARCA4,581
chr1,243917520,243917903,SRX5075170,SMARCA4,383
chr1,243926705,243927254,SRX5020211,SMARCA2,549
chr1,243926722,243927348,SRX5075175,SMARCA4,626
chr1,243926733,243927326,SRX5075169,SMARCA4,593
chr1,243926777,243927328,SRX5054309,FOSL2,551
chr1,243926780,243927179,SRX5716468,SMARCA2,399
chr1,243926795,243927325,SRX5716467,SMARCA2,530
chr1,243926799,243927135,SRX5075181,SMARCA2,336
chr1,243926799,243927402,SRX5075170,SMARCA4,603
chr1,243926800,243927326,SRX5075176,SMARCA4,526
chr1,243926806,243927284,SRX5054308,FOSL2,478
chr1,243926811,243927254,SRX5020214,SMARCA2,443
chr1,243926812,243927209,SRX5075182,SMARCA2,397
chr1,243926812,243927320,SRX5716469,SMARCA4,508
chr1,243926831,243927434,SRX5075174,SMARCA4,603
chr1,243926833,243927300,SRX5716463,SMARCA4,467
chr1,243926850,243927605,SRX5075168,SMARCA4,755
chr1,243926873,243927136,SRX5054307,FOSL2,263
chr1,243926889,243927348,SRX5716470,SMARCA4,459
chr1,243926990,243927253,SRX5716451,SOX2,263
chr1,243927050,243927289,SRX5716454,SOX3,239
chr1,243939259,243939469,SRX5054309,FOSL2,210
chr1,243939322,243939505,SRX5075169,SMARCA4,183
chr1,243944354,243944680,SRX5716470,SMARCA4,326
chr1,243944385,243944601,SRX5075176,SMARCA4,216
chr1,243944418,243944630,SRX5075169,SMARCA4,212
chr1,243944447,243944659,SRX5716469,SMARCA4,212
chr1,243944454,243944650,SRX5075170,SMARCA4,196
chr1,243947014,243947396,SRX16500059,CTCF,382
chr1,243947131,243947387,SRX16500061,CTCF,256
chr1,243947135,243947356,SRX16500060,CTCF,221
chr1,243956459,243956773,SRX5054309,FOSL2,314
chr1,243968381,243968810,SRX5075176,SMARCA4,429
chr1,243968439,243968845,SRX5075169,SMARCA4,406
chr1,243968441,243968739,SRX5716470,SMARCA4,298
chr1,243968507,243968711,SRX5716463,SMARCA4,204
chr1,243968517,243968735,SRX5054309,FOSL2,218
chr1,243968524,243968770,SRX5075174,SMARCA4,246
chr1,243968536,243968723,SRX5075168,SMARCA4,187
chr1,243974737,243974965,SRX5716470,SMARCA4,228
chr1,243977039,243977322,SRX5075175,SMARCA4,283
chr1,243977053,243977330,SRX5020211,SMARCA2,277
chr1,243977059,243977341,SRX5716470,SMARCA4,282
chr1,243977068,243977419,SRX5075170,SMARCA4,351
chr1,243977069,243977403,SRX5075169,SMARCA4,334
chr1,243977087,243977453,SRX5075181,SMARCA2,366
chr1,243977107,243977330,SRX5075176,SMARCA4,223
chr1,243977118,243977351,SRX5054308,FOSL2,233
chr1,243977141,243977352,SRX5716468,SMARCA2,211
chr1,243977175,243977378,SRX5054309,FOSL2,203
chr1,243994809,243995206,SRX5075174,SMARCA4,397
chr1,243994845,243995106,SRX5075168,SMARCA4,261
chr1,244011209,244011469,SRX5075170,SMARCA4,260
chr1,244011216,244011557,SRX5075176,SMARCA4,341
chr1,244011285,244011498,SRX5075175,SMARCA4,213
chr1,244011746,244012627,SRX5075174,SMARCA4,881
chr1,244011792,244012017,SRX5716463,SMARCA4,225
chr1,244011814,244012641,SRX5075168,SMARCA4,827
chr1,244012072,244012531,SRX5716463,SMARCA4,459
chr1,244012092,244012511,SRX5716464,SMARCA4,419
chr1,244012117,244012405,SRX5716451,SOX2,288
chr1,244012177,244012466,SRX20140895,INTS13,289
chr1,244012378,244012559,SRX5075176,SMARCA4,181
chr1,244012434,244012614,SRX5054308,FOSL2,180
chr1,244021513,244021762,SRX20140867,INTS10,249
chr1,244046926,244047141,SRX5054309,FOSL2,215
chr1,244047798,244048327,SRX20140895,INTS13,529
chr1,244047890,244048266,SRX20140867,INTS10,376
chr1,244047901,244048269,SRX20140897,INTS13,368
chr1,244047916,244048272,SRX20140868,INTS10,356
chr1,244048020,244048277,SRX5075174,SMARCA4,257
chr1,244048182,244048517,SRX5054307,FOSL2,335
chr1,244051126,244051320,SRX5075170,SMARCA4,194
chr1,244051174,244051349,SRX5075176,SMARCA4,175
chr1,244053757,244054164,SRX5075168,SMARCA4,407
chr1,244053848,244054206,SRX20140895,INTS13,358
chr1,244053907,244054114,SRX5075174,SMARCA4,207
chr1,244056489,244056908,SRX5075174,SMARCA4,419
chr1,244056579,244056894,SRX5075168,SMARCA4,315
chr1,244065802,244066405,SRX5075175,SMARCA4,603
chr1,244065855,244066217,SRX5054309,FOSL2,362
chr1,244065884,244066223,SRX5716467,SMARCA2,339
chr1,244065893,244066320,SRX5075170,SMARCA4,427
chr1,244065912,244066394,SRX5075169,SMARCA4,482
chr1,244065922,244066255,SRX5054308,FOSL2,333
chr1,244065936,244066311,SRX5716469,SMARCA4,375
chr1,244065937,244066305,SRX5020214,SMARCA2,368
chr1,244065971,244066320,SRX5075176,SMARCA4,349
chr1,244092267,244092659,SRX5075176,SMARCA4,392
chr1,244092283,244092641,SRX5075170,SMARCA4,358
chr1,244092290,244092536,SRX5075169,SMARCA4,246
chr1,244092305,244092549,SRX5075175,SMARCA4,244
chr1,244092376,244092559,SRX5054309,FOSL2,183
chr1,244092607,244093341,SRX20140869,INTS10,734
chr1,244092823,244093165,SRX20140881,CPSF3L,342
chr1,244093027,244093208,SRX5075174,SMARCA4,181
chr1,244100544,244101004,SRX5075168,SMARCA4,460
chr1,244100608,244100950,SRX5075174,SMARCA4,342
chr1,244100630,244101032,SRX5075176,SMARCA4,402
chr1,244100661,244100865,SRX5075169,SMARCA4,204
chr1,244100692,244100958,SRX5075175,SMARCA4,266
chr1,244100695,244100929,SRX5716470,SMARCA4,234
chr1,244100719,244101029,SRX5075170,SMARCA4,310
chr1,244104323,244104717,SRX5054309,FOSL2,394
chr1,244104338,244104729,SRX5075170,SMARCA4,391
chr1,244104348,244104803,SRX5075169,SMARCA4,455
chr1,244104382,244104759,SRX5716469,SMARCA4,377
chr1,244104389,244104781,SRX5075175,SMARCA4,392
chr1,244104400,244104710,SRX5716470,SMARCA4,310
chr1,244104409,244104653,SRX5716467,SMARCA2,244
chr1,244104416,244104722,SRX5054308,FOSL2,306
chr1,244104417,244104667,SRX5020214,SMARCA2,250
chr1,244104438,244104776,SRX5075176,SMARCA4,338
chr1,244112517,244113022,SRX5075175,SMARCA4,505
chr1,244112560,244112969,SRX5075176,SMARCA4,409
chr1,244112576,244112947,SRX5716470,SMARCA4,371
chr1,244112581,244112944,SRX5075169,SMARCA4,363
chr1,244112582,244113051,SRX5075170,SMARCA4,469
chr1,244112583,244112915,SRX5075181,SMARCA2,332
chr1,244112596,244112990,SRX5716469,SMARCA4,394
chr1,244112635,244112891,SRX5054308,FOSL2,256
chr1,244112635,244112915,SRX5716468,SMARCA2,280
chr1,244112648,244112975,SRX5054309,FOSL2,327
chr1,244112660,244112939,SRX5716467,SMARCA2,279
chr1,244112666,244112922,SRX5020211,SMARCA2,256
chr1,244113508,244113872,SRX5054309,FOSL2,364
chr1,244113586,244113794,SRX5054308,FOSL2,208
chr1,244113606,244113786,SRX5075169,SMARCA4,180
chr1,244118421,244119028,SRX20140881,CPSF3L,607
chr1,244118821,244119084,SRX5075174,SMARCA4,263
chr1,244118851,244119176,SRX5075168,SMARCA4,325
chr1,244118884,244119132,SRX20140867,INTS10,248
chr1,244128489,244128658,SRX5075170,SMARCA4,169
chr1,244128524,244128790,SRX5075176,SMARCA4,266
chr1,244139733,244139949,SRX5075170,SMARCA4,216
chr1,244139740,244140020,SRX5075176,SMARCA4,280
chr1,244150007,244150566,SRX5075176,SMARCA4,559
chr1,244150024,244150471,SRX5075169,SMARCA4,447
chr1,244150037,244150654,SRX5075170,SMARCA4,617
chr1,244150143,244150532,SRX5716470,SMARCA4,389
chr1,244150149,244150557,SRX5716467,SMARCA2,408
chr1,244150171,244150416,SRX5075175,SMARCA4,245
chr1,244150172,244150452,SRX5054309,FOSL2,280
chr1,244150182,244150483,SRX5716468,SMARCA2,301
chr1,244150205,244150425,SRX5716469,SMARCA4,220
chr1,244150252,244150446,SRX5054308,FOSL2,194
chr1,244150328,244150546,SRX5020214,SMARCA2,218
chr1,244163776,244164453,SRX5075170,SMARCA4,677
chr1,244163789,244164461,SRX5075176,SMARCA4,672
chr1,244163817,244164397,SRX5075175,SMARCA4,580
chr1,244163829,244164459,SRX5075169,SMARCA4,630
chr1,244163869,244164316,SRX5716460,Epitope tags,447
chr1,244163871,244164478,SRX5716470,SMARCA4,607
chr1,244163891,244164428,SRX5716469,SMARCA4,537
chr1,244163899,244164372,SRX5075168,SMARCA4,473
chr1,244163933,244164370,SRX5716467,SMARCA2,437
chr1,244163939,244164369,SRX5716459,Epitope tags,430
chr1,244163940,244164358,SRX5020211,SMARCA2,418
chr1,244163942,244164401,SRX5075174,SMARCA4,459
chr1,244163994,244164386,SRX5054308,FOSL2,392
chr1,244164001,244164404,SRX5054309,FOSL2,403
chr1,244164003,244164337,SRX5716468,SMARCA2,334
chr1,244164065,244164378,SRX5020214,SMARCA2,313
chr1,244164073,244164304,SRX5075182,SMARCA2,231
chr1,244164081,244164287,SRX5054307,FOSL2,206
chr1,244164179,244164465,SRX5075181,SMARCA2,286
chr1,244211104,244211453,SRX16500061,CTCF,349
chr1,244211137,244211518,SRX16500060,CTCF,381
chr1,244211175,244211562,SRX16500059,CTCF,387
chr1,244211212,244211455,SRX16500062,CTCF,243
chr1,244214173,244214681,SRX5716469,SMARCA4,508
chr1,244214178,244214711,SRX5075176,SMARCA4,533
chr1,244214228,244214877,SRX5075169,SMARCA4,649
chr1,244214272,244214754,SRX5054308,FOSL2,482
chr1,244214296,244214756,SRX5054309,FOSL2,460
chr1,244214310,244214731,SRX5075182,SMARCA2,421
chr1,244214347,244214728,SRX5075175,SMARCA4,381
chr1,244214357,244214740,SRX5020211,SMARCA2,383
chr1,244214363,244214719,SRX5716470,SMARCA4,356
chr1,244214405,244214649,SRX5075174,SMARCA4,244
chr1,244214411,244214696,SRX5075170,SMARCA4,285
chr1,244214447,244214743,SRX5020214,SMARCA2,296
chr1,244236291,244236493,SRX5054308,FOSL2,202
chr1,244236294,244236477,SRX5054309,FOSL2,183
chr1,244272827,244273452,SRX4174629,CTCF,625
chr1,244272862,244273438,SRX16500060,CTCF,576
chr1,244272894,244273426,SRX16500062,CTCF,532
chr1,244272909,244273299,SRX5716463,SMARCA4,390
chr1,244272932,244273466,SRX16500059,CTCF,534
chr1,244272974,244273426,SRX16500061,CTCF,452
chr1,244272999,244273319,SRX5075168,SMARCA4,320
chr1,244273022,244273330,SRX5075174,SMARCA4,308
chr1,244273030,244273328,SRX20140895,INTS13,298
chr1,244273070,244273262,SRX5075170,SMARCA4,192
chr1,244273633,244274603,SRX5075170,SMARCA4,970
chr1,244273639,244274307,SRX5075169,SMARCA4,668
chr1,244273652,244274122,SRX5716470,SMARCA4,470
chr1,244273653,244274136,SRX5716469,SMARCA4,483
chr1,244273664,244274394,SRX5054309,FOSL2,730
chr1,244273667,244274450,SRX5075175,SMARCA4,783
chr1,244273688,244274540,SRX5075176,SMARCA4,852
chr1,244273690,244274228,SRX5054308,FOSL2,538
chr1,244273711,244274080,SRX5020214,SMARCA2,369
chr1,244273714,244274161,SRX5716467,SMARCA2,447
chr1,244273722,244273997,SRX5075181,SMARCA2,275
chr1,244273748,244274000,SRX5716468,SMARCA2,252
chr1,244273759,244274243,SRX5020211,SMARCA2,484
chr1,244273765,244274158,SRX5075174,SMARCA4,393
chr1,244273794,244274126,SRX5075168,SMARCA4,332
chr1,244273812,244273991,SRX5075182,SMARCA2,179
chr1,244273825,244274264,SRX5716459,Epitope tags,439
chr1,244273935,244274114,SRX5054307,FOSL2,179
chr1,244299363,244299845,SRX16500062,CTCF,482
chr1,244299372,244299880,SRX16500059,CTCF,508
chr1,244299375,244299870,SRX16500060,CTCF,495
chr1,244299381,244299765,SRX5075169,SMARCA4,384
chr1,244299382,244299819,SRX16500061,CTCF,437
chr1,244299390,244299771,SRX5075176,SMARCA4,381
chr1,244299395,244299802,SRX5075174,SMARCA4,407
chr1,244299417,244299778,SRX5075170,SMARCA4,361
chr1,244299419,244299792,SRX5075168,SMARCA4,373
chr1,244299427,244299731,SRX5075175,SMARCA4,304
chr1,244299430,244299722,SRX5716469,SMARCA4,292
chr1,244299468,244299797,SRX5716470,SMARCA4,329
chr1,244299483,244299713,SRX5716464,SMARCA4,230
chr1,244299497,244299745,SRX5716463,SMARCA4,248
chr1,244299503,244299780,SRX4174629,CTCF,277
chr1,244322729,244323334,SRX5716460,Epitope tags,605
chr1,244322774,244323423,SRX5075176,SMARCA4,649
chr1,244322787,244323315,SRX5716470,SMARCA4,528
chr1,244322806,244323438,SRX5075170,SMARCA4,632
chr1,244322828,244323408,SRX5075174,SMARCA4,580
chr1,244322833,244323366,SRX5716469,SMARCA4,533
chr1,244322849,244323366,SRX5054309,FOSL2,517
chr1,244322853,244323403,SRX5075175,SMARCA4,550
chr1,244322860,244323343,SRX5716467,SMARCA2,483
chr1,244322888,244323351,SRX5075169,SMARCA4,463
chr1,244322908,244323382,SRX5075168,SMARCA4,474
chr1,244322921,244323343,SRX5054308,FOSL2,422
chr1,244322974,244323340,SRX5020211,SMARCA2,366
chr1,244323001,244323276,SRX5020214,SMARCA2,275
chr1,244323002,244323213,SRX5716468,SMARCA2,211
chr1,244323036,244323295,SRX5054307,FOSL2,259
chr1,244323087,244323351,SRX5716459,Epitope tags,264
chr1,244339247,244339461,SRX5075174,SMARCA4,214
chr1,244341461,244341866,SRX5075175,SMARCA4,405
chr1,244341466,244342113,SRX5075170,SMARCA4,647
chr1,244341494,244342029,SRX5075174,SMARCA4,535
chr1,244341548,244341835,SRX5075169,SMARCA4,287
chr1,244341590,244342002,SRX5075176,SMARCA4,412
chr1,244341750,244342056,SRX5075168,SMARCA4,306
chr1,244347952,244348203,SRX5054309,FOSL2,251
chr1,244347970,244348235,SRX5054308,FOSL2,265
chr1,244348016,244348210,SRX5075169,SMARCA4,194
chr1,244349625,244349818,SRX5054308,FOSL2,193
chr1,244349632,244349895,SRX5075170,SMARCA4,263
chr1,244349645,244349870,SRX5054309,FOSL2,225
chr1,244349662,244349886,SRX5075168,SMARCA4,224
chr1,244349696,244349879,SRX5075176,SMARCA4,183
chr1,244353596,244354088,SRX5075174,SMARCA4,492
chr1,244353657,244354194,SRX5075170,SMARCA4,537
chr1,244353689,244354162,SRX5075175,SMARCA4,473
chr1,244353713,244354224,SRX5075169,SMARCA4,511
chr1,244353720,244354154,SRX5075176,SMARCA4,434
chr1,244353726,244353986,SRX5716460,Epitope tags,260
chr1,244353729,244354155,SRX5716470,SMARCA4,426
chr1,244353748,244354085,SRX5075168,SMARCA4,337
chr1,244353765,244354103,SRX5054309,FOSL2,338
chr1,244353766,244354110,SRX5716469,SMARCA4,344
chr1,244353811,244354098,SRX5054308,FOSL2,287
chr1,244353812,244354064,SRX5716467,SMARCA2,252
chr1,244353919,244354157,SRX5020211,SMARCA2,238
chr1,244361603,244362376,SRX5075174,SMARCA4,773
chr1,244361608,244362346,SRX5075168,SMARCA4,738
chr1,244361646,244362043,SRX5716463,SMARCA4,397
chr1,244361743,244362049,SRX5716464,SMARCA4,306
chr1,244361782,244362356,SRX5075176,SMARCA4,574
chr1,244361836,244362031,SRX5075175,SMARCA4,195
chr1,244361938,244362433,SRX5075169,SMARCA4,495
chr1,244362080,244362300,SRX5054309,FOSL2,220
chr1,244362118,244362355,SRX5075170,SMARCA4,237
chr1,244362126,244362467,SRX5716470,SMARCA4,341
chr1,244362164,244362387,SRX5716469,SMARCA4,223
chr1,244382125,244382463,SRX5075169,SMARCA4,338
chr1,244382174,244382521,SRX5075176,SMARCA4,347
chr1,244382199,244382440,SRX5075175,SMARCA4,241
chr1,244382199,244382509,SRX5075170,SMARCA4,310
chr1,244382201,244382508,SRX5054309,FOSL2,307
chr1,244382214,244382482,SRX5054308,FOSL2,268
chr1,244435827,244436019,SRX5075170,SMARCA4,192
chr1,244435911,244436209,SRX5075175,SMARCA4,298
chr1,244437169,244437532,SRX5054309,FOSL2,363
chr1,244437187,244437522,SRX5075169,SMARCA4,335
chr1,244437193,244437520,SRX5054308,FOSL2,327
chr1,244437217,244437507,SRX5075170,SMARCA4,290
chr1,244437249,244437543,SRX5716469,SMARCA4,294
chr1,244437266,244437453,SRX5075175,SMARCA4,187
chr1,244445006,244445243,SRX5075170,SMARCA4,237
chr1,244445357,244445587,SRX5075169,SMARCA4,230
chr1,244445422,244445705,SRX5075170,SMARCA4,283
chr1,244445437,244445717,SRX5054309,FOSL2,280
chr1,244445475,244445715,SRX5075175,SMARCA4,240
chr1,244451466,244452289,SRX20140895,INTS13,823
chr1,244451602,244451910,SRX20140879,CPSF3L,308
chr1,244451622,244452073,SRX20140868,INTS10,451
chr1,244451644,244452084,SRX20140867,INTS10,440
chr1,244451667,244452121,SRX20140897,INTS13,454
chr1,244451699,244452471,SRX5075174,SMARCA4,772
chr1,244451720,244452119,SRX5075169,SMARCA4,399
chr1,244451741,244452462,SRX5075168,SMARCA4,721
chr1,244451746,244452158,SRX5075175,SMARCA4,412
chr1,244451786,244452252,SRX16500060,CTCF,466
chr1,244451802,244452581,SRX16500059,CTCF,779
chr1,244451821,244452311,SRX16500062,CTCF,490
chr1,244451830,244452415,SRX5075176,SMARCA4,585
chr1,244451840,244452388,SRX5716463,SMARCA4,548
chr1,244451852,244452311,SRX5716464,SMARCA4,459
chr1,244451876,244452117,SRX5054309,FOSL2,241
chr1,244451884,244452347,SRX16500061,CTCF,463
chr1,244451898,244452431,SRX5075170,SMARCA4,533
chr1,244451905,244452136,SRX5716470,SMARCA4,231
chr1,244451917,244452228,SRX5054307,FOSL2,311
chr1,244452004,244452219,SRX5716451,SOX2,215
chr1,244461283,244461581,SRX20140895,INTS13,298
chr1,244496306,244496536,SRX5075168,SMARCA4,230
chr1,244544341,244544738,SRX5075170,SMARCA4,397
chr1,244544408,244544728,SRX5075176,SMARCA4,320
chr1,244544432,244544655,SRX5075169,SMARCA4,223
chr1,244599795,244600194,SRX5716460,Epitope tags,399
chr1,244599807,244600241,SRX5054309,FOSL2,434
chr1,244599839,244600341,SRX5075169,SMARCA4,502
chr1,244599844,244600196,SRX5054308,FOSL2,352
chr1,244599860,244600243,SRX5716469,SMARCA4,383
chr1,244599882,244600267,SRX5075176,SMARCA4,385
chr1,244599894,244600293,SRX5075170,SMARCA4,399
chr1,244599925,244600139,SRX5716470,SMARCA4,214
chr1,244599932,244600289,SRX5075175,SMARCA4,357
chr1,244599941,244600171,SRX5020214,SMARCA2,230
chr1,244603344,244603840,SRX16500060,CTCF,496
chr1,244603354,244603839,SRX16500061,CTCF,485
chr1,244603360,244603868,SRX16500059,CTCF,508
chr1,244603382,244603856,SRX16500062,CTCF,474
chr1,244603471,244603747,SRX5075168,SMARCA4,276
chr1,244603502,244603732,SRX5075170,SMARCA4,230
chr1,244603514,244603750,SRX5075176,SMARCA4,236
chr1,244603532,244603906,SRX4174629,CTCF,374
chr1,244614861,244615202,SRX5075174,SMARCA4,341
chr1,244614881,244615218,SRX5716463,SMARCA4,337
chr1,244614918,244615230,SRX5075168,SMARCA4,312
chr1,244614932,244615218,SRX5716464,SMARCA4,286
chr1,244652579,244653360,SRX5075174,SMARCA4,781
chr1,244652582,244653330,SRX5075168,SMARCA4,748
chr1,244652624,244653428,SRX5075170,SMARCA4,804
chr1,244652656,244652967,SRX5716464,SMARCA4,311
chr1,244652659,244653374,SRX5075176,SMARCA4,715
chr1,244652711,244653511,SRX20140895,INTS13,800
chr1,244652718,244653301,SRX5716463,SMARCA4,583
chr1,244652736,244652946,SRX5716451,SOX2,210
chr1,244652884,244653352,SRX20140896,INTS13,468
chr1,244652884,244653440,SRX20140897,INTS13,556
chr1,244652910,244653429,SRX20140868,INTS10,519
chr1,244652942,244653432,SRX20140881,CPSF3L,490
chr1,244652947,244653438,SRX20140879,CPSF3L,491
chr1,244652952,244653409,SRX20140867,INTS10,457
chr1,244653008,244653575,SRX16500059,CTCF,567
chr1,244653031,244653367,SRX20140869,INTS10,336
chr1,244653040,244653550,SRX16500060,CTCF,510
chr1,244653052,244653535,SRX16500061,CTCF,483
chr1,244653058,244653422,SRX5716469,SMARCA4,364
chr1,244653060,244653436,SRX5075175,SMARCA4,376
chr1,244653062,244653414,SRX5075169,SMARCA4,352
chr1,244653127,244653579,SRX16500062,CTCF,452
chr1,244653137,244653348,SRX5716470,SMARCA4,211
chr1,244665884,244666221,SRX5075175,SMARCA4,337
chr1,244665915,244666150,SRX5075170,SMARCA4,235
chr1,244665936,244666176,SRX5075169,SMARCA4,240
chr1,244673035,244673976,SRX5075176,SMARCA4,941
chr1,244673179,244673677,SRX5075170,SMARCA4,498
chr1,244673318,244673565,SRX5075169,SMARCA4,247
chr1,244673353,244673649,SRX5075175,SMARCA4,296
chr1,244673384,244673584,SRX5020211,SMARCA2,200
chr1,244673426,244673615,SRX5054308,FOSL2,189
chr1,244673458,244673936,SRX5716470,SMARCA4,478
chr1,244673488,244673745,SRX5716469,SMARCA4,257
chr1,244673647,244673920,SRX5075169,SMARCA4,273
chr1,244673727,244673939,SRX5075175,SMARCA4,212
chr1,244673750,244673919,SRX5075170,SMARCA4,169
chr1,244730388,244730648,SRX5075169,SMARCA4,260
chr1,244736120,244736386,SRX5075170,SMARCA4,266
chr1,244736157,244736469,SRX5075169,SMARCA4,312
chr1,244757483,244757859,SRX5075175,SMARCA4,376
chr1,244757483,244757971,SRX5075169,SMARCA4,488
chr1,244757494,244757856,SRX5075170,SMARCA4,362
chr1,244757514,244757806,SRX5716469,SMARCA4,292
chr1,244757522,244757737,SRX5716467,SMARCA2,215
chr1,244757526,244758020,SRX5075176,SMARCA4,494
chr1,244757534,244757805,SRX5054308,FOSL2,271
chr1,244757589,244757813,SRX5716470,SMARCA4,224
chr1,244771258,244771446,SRX5075169,SMARCA4,188
chr1,244778271,244778780,SRX5716469,SMARCA4,509
chr1,244778323,244778755,SRX5054309,FOSL2,432
chr1,244778333,244778794,SRX5075176,SMARCA4,461
chr1,244778348,244778781,SRX5054308,FOSL2,433
chr1,244778371,244778704,SRX5075175,SMARCA4,333
chr1,244778374,244778830,SRX5075169,SMARCA4,456
chr1,244778389,244778769,SRX5075170,SMARCA4,380
chr1,244778403,244778731,SRX5716467,SMARCA2,328
chr1,244778409,244778601,SRX5075182,SMARCA2,192
chr1,244778416,244778731,SRX5716470,SMARCA4,315
chr1,244778445,244778744,SRX5020211,SMARCA2,299
chr1,244796718,244797324,SRX16500060,CTCF,606
chr1,244796746,244797290,SRX16500059,CTCF,544
chr1,244796767,244797210,SRX16500062,CTCF,443
chr1,244796777,244797248,SRX16500061,CTCF,471
chr1,244796794,244796981,SRX5075176,SMARCA4,187
chr1,244796827,244797039,SRX4174629,CTCF,212
chr1,244796835,244797093,SRX5716464,SMARCA4,258
chr1,244796846,244797025,SRX5075168,SMARCA4,179
chr1,244796848,244797054,SRX5075170,SMARCA4,206
chr1,244796899,244797103,SRX5716463,SMARCA4,204
chr1,244796899,244797121,SRX5075174,SMARCA4,222
chr1,244797094,244797360,SRX4174629,CTCF,266
chr1,244833752,244834110,SRX16500062,CTCF,358
chr1,244833776,244834043,SRX16500059,CTCF,267
chr1,244833809,244834232,SRX5075170,SMARCA4,423
chr1,244834707,244835886,SRX20140895,INTS13,1179
chr1,244834740,244835719,SRX20140869,INTS10,979
chr1,244834762,244835313,SRX5075176,SMARCA4,551
chr1,244834812,244835780,SRX20140897,INTS13,968
chr1,244834818,244835728,SRX20140868,INTS10,910
chr1,244834822,244835724,SRX20140879,CPSF3L,902
chr1,244834871,244835683,SRX20140867,INTS10,812
chr1,244834874,244835129,SRX5075169,SMARCA4,255
chr1,244834894,244835579,SRX5075174,SMARCA4,685
chr1,244834895,244835644,SRX20140881,CPSF3L,749
chr1,244834914,244835543,SRX5075168,SMARCA4,629
chr1,244834928,244835652,SRX20140894,INTS13,724
chr1,244834956,244835507,SRX5716469,SMARCA4,551
chr1,244835109,244835338,SRX5075170,SMARCA4,229
chr1,244835193,244835460,SRX5716454,SOX3,267
chr1,244835255,244835644,SRX20140896,INTS13,389
chr1,244835320,244835565,SRX20140880,CPSF3L,245
chr1,244862908,244863369,SRX5075174,SMARCA4,461
chr1,244863035,244863229,SRX5716451,SOX2,194
chr1,244863073,244863522,SRX20140867,INTS10,449
chr1,244863165,244863608,SRX20140895,INTS13,443
chr1,244863199,244863570,SRX20140868,INTS10,371
chr1,244864133,244864477,SRX16500062,CTCF,344
chr1,244864177,244864565,SRX16500060,CTCF,388
chr1,244864185,244864519,SRX16500061,CTCF,334
chr1,244864267,244864972,SRX20140895,INTS13,705
chr1,244864271,244864965,SRX20140897,INTS13,694
chr1,244864352,244864894,SRX20140868,INTS10,542
chr1,244864374,244864842,SRX20140867,INTS10,468
chr1,244864396,244864823,SRX5075174,SMARCA4,427
chr1,244864408,244864881,SRX5075168,SMARCA4,473
chr1,244864418,244864836,SRX5075176,SMARCA4,418
chr1,244864456,244864822,SRX20140881,CPSF3L,366
chr1,244864500,244864925,SRX20140869,INTS10,425
chr1,244864551,244864783,SRX5075169,SMARCA4,232
chr1,244864558,244864862,SRX5075170,SMARCA4,304
chr1,244864611,244864861,SRX5716470,SMARCA4,250
chr1,244864611,244864896,SRX5716469,SMARCA4,285
chr1,244864612,244864840,SRX5075175,SMARCA4,228
chr1,244896625,244896897,SRX5075169,SMARCA4,272
chr1,244896651,244896891,SRX5075175,SMARCA4,240
chr1,244896666,244896863,SRX5075176,SMARCA4,197
chr1,244896677,244896877,SRX5054309,FOSL2,200
chr1,244918507,244918680,SRX5075174,SMARCA4,173
chr1,244918719,244919015,SRX5716469,SMARCA4,296
chr1,244918725,244918966,SRX5075170,SMARCA4,241
chr1,244918731,244919093,SRX5075176,SMARCA4,362
chr1,244918847,244919058,SRX5716470,SMARCA4,211
chr1,244918864,244919087,SRX5075174,SMARCA4,223
chr1,244918873,244919108,SRX5075175,SMARCA4,235
chr1,244959601,244959641,SRX1424894,POU3F2,40
chr1,244959601,244959648,SRX1424891,POU3F2,47
chr1,244959603,244959644,SRX1424893,POU3F2,41
chr1,244964363,244964813,SRX5075175,SMARCA4,450
chr1,244964367,244964847,SRX5716469,SMARCA4,480
chr1,244964372,244964578,SRX5075168,SMARCA4,206
chr1,244964459,244964778,SRX5075169,SMARCA4,319
chr1,244964475,244964742,SRX5075170,SMARCA4,267
chr1,244964475,244964799,SRX5075176,SMARCA4,324
chr1,244964482,244964792,SRX5054308,FOSL2,310
chr1,244964503,244964803,SRX5054309,FOSL2,300
chr1,244969419,244969815,SRX5716469,SMARCA4,396
chr1,244969450,244969925,SRX5075170,SMARCA4,475
chr1,244969480,244969853,SRX5716470,SMARCA4,373
chr1,244969481,244969911,SRX5075176,SMARCA4,430
chr1,244969562,244969751,SRX5075174,SMARCA4,189
chr1,244969625,244969886,SRX5075175,SMARCA4,261
chr1,244969695,244971392,SRX20140895,INTS13,1697
chr1,244969702,244970122,SRX20140897,INTS13,420
chr1,244969719,244970017,SRX20140881,CPSF3L,298
chr1,244969915,244970620,SRX20140868,INTS10,705
chr1,244969964,244970605,SRX20140867,INTS10,641
chr1,244970199,244970505,SRX20140869,INTS10,306
chr1,244970641,244971117,SRX20140896,INTS13,476
chr1,244970676,244971351,SRX20140868,INTS10,675
chr1,244970714,244971235,SRX20140867,INTS10,521
chr1,244970731,244971071,SRX5075170,SMARCA4,340
chr1,244970735,244970979,SRX5075168,SMARCA4,244
chr1,244970737,244971063,SRX5075174,SMARCA4,326
chr1,244970741,244971263,SRX20140897,INTS13,522
chr1,244970747,244971067,SRX16500059,CTCF,320
chr1,244970752,244971059,SRX5075176,SMARCA4,307
chr1,244970755,244971086,SRX20140879,CPSF3L,331
chr1,244970763,244971025,SRX16500060,CTCF,262
chr1,244970780,244970960,SRX5075169,SMARCA4,180
chr1,244970788,244971404,SRX20140869,INTS10,616
chr1,244970789,244971223,SRX20140881,CPSF3L,434
chr1,244970799,244971066,SRX16500062,CTCF,267
chr1,244970850,244971116,SRX16500061,CTCF,266
chr1,244971105,244971322,SRX5075168,SMARCA4,217
chr1,244971130,244971413,SRX5075170,SMARCA4,283
chr1,244971194,244971465,SRX5716470,SMARCA4,271
chr1,244971216,244971438,SRX5075169,SMARCA4,222
chr1,244971217,244971481,SRX5075176,SMARCA4,264
chr1,244989834,244990014,SRX5054308,FOSL2,180
chr1,245018494,245018749,SRX5075168,SMARCA4,255
chr1,245018508,245018861,SRX5075174,SMARCA4,353
chr1,245042587,245043123,SRX16500059,CTCF,536
chr1,245042594,245043087,SRX16500060,CTCF,493
chr1,245042606,245043073,SRX16500061,CTCF,467
chr1,245042622,245043100,SRX16500062,CTCF,478
chr1,245042684,245043050,SRX5075168,SMARCA4,366
chr1,245042689,245043037,SRX5716464,SMARCA4,348
chr1,245042691,245042927,SRX5716469,SMARCA4,236
chr1,245042691,245043037,SRX5716463,SMARCA4,346
chr1,245042695,245043015,SRX5075174,SMARCA4,320
chr1,245042696,245042974,SRX5075176,SMARCA4,278
chr1,245042708,245042991,SRX5075169,SMARCA4,283
chr1,245042721,245042995,SRX4174629,CTCF,274
chr1,245042722,245042987,SRX5075170,SMARCA4,265
chr1,245042726,245043001,SRX5716470,SMARCA4,275
chr1,245042745,245043003,SRX5075175,SMARCA4,258
chr1,245067316,245067644,SRX5075169,SMARCA4,328
chr1,245067347,245067578,SRX5075175,SMARCA4,231
chr1,245067350,245067675,SRX5054308,FOSL2,325
chr1,245067353,245067741,SRX5054309,FOSL2,388
chr1,245067372,245067613,SRX5716469,SMARCA4,241
chr1,245074464,245074730,SRX5075176,SMARCA4,266
chr1,245074477,245074660,SRX5075170,SMARCA4,183
chr1,245074482,245074739,SRX5075175,SMARCA4,257
chr1,245074512,245074733,SRX5054308,FOSL2,221
chr1,245074526,245074711,SRX5054309,FOSL2,185
chr1,245079012,245079358,SRX16500060,CTCF,346
chr1,245079033,245079398,SRX16500059,CTCF,365
chr1,245079078,245079394,SRX16500061,CTCF,316
chr1,245079108,245079347,SRX16500062,CTCF,239
chr1,245079147,245079353,SRX5075176,SMARCA4,206
chr1,245085452,245085830,SRX5716469,SMARCA4,378
chr1,245085462,245085903,SRX5075175,SMARCA4,441
chr1,245085463,245085832,SRX5075169,SMARCA4,369
chr1,245085466,245085913,SRX5075170,SMARCA4,447
chr1,245085474,245085785,SRX5075176,SMARCA4,311
chr1,245085500,245085828,SRX5054309,FOSL2,328
chr1,245085542,245085872,SRX5054308,FOSL2,330
chr1,245085580,245085818,SRX5716470,SMARCA4,238
chr1,245091746,245092320,SRX5075176,SMARCA4,574
chr1,245091780,245092382,SRX5075169,SMARCA4,602
chr1,245091792,245092234,SRX5716469,SMARCA4,442
chr1,245091808,245092330,SRX5075170,SMARCA4,522
chr1,245091820,245092278,SRX5075168,SMARCA4,458
chr1,245091828,245092259,SRX5054309,FOSL2,431
chr1,245091837,245092282,SRX5075175,SMARCA4,445
chr1,245091856,245092242,SRX5075174,SMARCA4,386
chr1,245091901,245092282,SRX5054308,FOSL2,381
chr1,245091926,245092149,SRX5075182,SMARCA2,223
chr1,245091952,245092194,SRX5716467,SMARCA2,242
chr1,245091980,245092208,SRX5716470,SMARCA4,228
chr1,245118944,245119155,SRX5075169,SMARCA4,211
chr1,245129757,245130146,SRX5075176,SMARCA4,389
chr1,245129858,245130105,SRX5716470,SMARCA4,247
chr1,245129865,245130102,SRX5075175,SMARCA4,237
chr1,245129897,245130153,SRX5075170,SMARCA4,256
chr1,245129933,245130139,SRX5075169,SMARCA4,206
chr1,245152969,245153344,SRX16500060,CTCF,375
chr1,245152986,245153391,SRX16500061,CTCF,405
chr1,245152995,245153353,SRX16500062,CTCF,358
chr1,245152997,245153397,SRX16500059,CTCF,400
chr1,245153774,245154109,SRX20140895,INTS13,335
chr1,245156415,245156883,SRX16500060,CTCF,468
chr1,245156422,245156868,SRX16500061,CTCF,446
chr1,245156427,245156877,SRX16500059,CTCF,450
chr1,245156445,245156837,SRX16500062,CTCF,392
chr1,245156545,245156795,SRX5075168,SMARCA4,250
chr1,245156547,245156791,SRX5075174,SMARCA4,244
chr1,245156596,245156788,SRX5075176,SMARCA4,192
chr1,245173935,245174210,SRX5075175,SMARCA4,275
chr1,245173974,245174188,SRX5716470,SMARCA4,214
chr1,245174005,245174260,SRX5075170,SMARCA4,255
chr1,245197767,245198143,SRX5075169,SMARCA4,376
chr1,245197889,245198165,SRX5075170,SMARCA4,276
chr1,245205441,245205692,SRX5075174,SMARCA4,251
chr1,245205492,245205757,SRX5075168,SMARCA4,265
chr1,245216899,245217131,SRX5075174,SMARCA4,232
chr1,245225321,245225631,SRX5075170,SMARCA4,310
chr1,245225325,245225605,SRX20140869,INTS10,280
chr1,245225379,245225716,SRX5075176,SMARCA4,337
chr1,245225381,245225636,SRX5075169,SMARCA4,255
chr1,245234623,245235140,SRX5075168,SMARCA4,517
chr1,245234673,245235131,SRX5075174,SMARCA4,458
chr1,245234701,245235048,SRX5075176,SMARCA4,347
chr1,245234709,245235041,SRX5075170,SMARCA4,332
chr1,245234732,245235148,SRX20140895,INTS13,416
chr1,245234744,245234984,SRX5075169,SMARCA4,240
chr1,245234752,245235058,SRX20140867,INTS10,306
chr1,245234807,245235018,SRX5716470,SMARCA4,211
chr1,245256496,245256987,SRX5075174,SMARCA4,491
chr1,245256542,245256959,SRX5075168,SMARCA4,417
chr1,245256590,245256837,SRX5716464,SMARCA4,247
chr1,245256604,245256917,SRX5716463,SMARCA4,313
chr1,245256668,245256862,SRX5716451,SOX2,194
chr1,245263844,245264053,SRX5075169,SMARCA4,209
chr1,245263888,245264095,SRX5075176,SMARCA4,207
chr1,245279486,245279708,SRX5054309,FOSL2,222
chr1,245301193,245301611,SRX5075170,SMARCA4,418
chr1,245301223,245301608,SRX5075176,SMARCA4,385
chr1,245301227,245301526,SRX5075169,SMARCA4,299
chr1,245301265,245301496,SRX5716467,SMARCA2,231
chr1,245301290,245301494,SRX5075175,SMARCA4,204
chr1,245301303,245301576,SRX5716470,SMARCA4,273
chr1,245303929,245304114,SRX5075176,SMARCA4,185
chr1,245303949,245304180,SRX5075169,SMARCA4,231
chr1,245303971,245304175,SRX5020211,SMARCA2,204
chr1,245310555,245310872,SRX5075174,SMARCA4,317
chr1,245310609,245311028,SRX5075168,SMARCA4,419
chr1,245310647,245311101,SRX5075170,SMARCA4,454
chr1,245310662,245310995,SRX5075176,SMARCA4,333
chr1,245310713,245310925,SRX5716469,SMARCA4,212
chr1,245310724,245310966,SRX5075169,SMARCA4,242
chr1,245310983,245311364,SRX5075174,SMARCA4,381
chr1,245316874,245317205,SRX5075176,SMARCA4,331
chr1,245316961,245317228,SRX5075170,SMARCA4,267
chr1,245316972,245317373,SRX5716470,SMARCA4,401
chr1,245356504,245356692,SRX5075168,SMARCA4,188
chr1,245356536,245356737,SRX5075174,SMARCA4,201
chr1,245380129,245380489,SRX5075170,SMARCA4,360
chr1,245380140,245380546,SRX5054309,FOSL2,406
chr1,245380144,245380468,SRX5075175,SMARCA4,324
chr1,245380147,245380570,SRX5075176,SMARCA4,423
chr1,245380212,245380531,SRX5054308,FOSL2,319
chr1,245380292,245380493,SRX5075169,SMARCA4,201
chr1,245380831,245381178,SRX16500062,CTCF,347
chr1,245380845,245381214,SRX16500059,CTCF,369
chr1,245380851,245381205,SRX16500060,CTCF,354
chr1,245380906,245381221,SRX16500061,CTCF,315
chr1,245389905,245390240,SRX5075176,SMARCA4,335
chr1,245389905,245390245,SRX5075170,SMARCA4,340
chr1,245389928,245390247,SRX5716469,SMARCA4,319
chr1,245389930,245390237,SRX5716467,SMARCA2,307
chr1,245389933,245390238,SRX5716470,SMARCA4,305
chr1,245389938,245390170,SRX5075169,SMARCA4,232
chr1,245389969,245390240,SRX5075175,SMARCA4,271
chr1,245389983,245390186,SRX5054309,FOSL2,203
chr1,245404514,245404758,SRX5716469,SMARCA4,244
chr1,245404650,245404870,SRX5075176,SMARCA4,220
chr1,245428662,245428874,SRX5075170,SMARCA4,212
chr1,245428666,245428865,SRX5075176,SMARCA4,199
chr1,245428668,245428925,SRX5716470,SMARCA4,257
chr1,245433653,245434001,SRX5075176,SMARCA4,348
chr1,245444435,245444788,SRX5075176,SMARCA4,353
chr1,245444437,245444835,SRX5075170,SMARCA4,398
chr1,245444477,245444692,SRX5716469,SMARCA4,215
chr1,245444487,245444722,SRX5716470,SMARCA4,235
chr1,245444517,245444745,SRX5054309,FOSL2,228
chr1,245444529,245444711,SRX5075169,SMARCA4,182
chr1,245445001,245445204,SRX5075170,SMARCA4,203
chr1,245493074,245493284,SRX16500062,CTCF,210
chr1,245493115,245493350,SRX16500059,CTCF,235
chr1,245500576,245500787,SRX5716470,SMARCA4,211
chr1,245550306,245550502,SRX5075174,SMARCA4,196
chr1,245566960,245567332,SRX5075176,SMARCA4,372
chr1,245566965,245567476,SRX5075168,SMARCA4,511
chr1,245566988,245567202,SRX5054308,FOSL2,214
chr1,245567001,245567387,SRX5716470,SMARCA4,386
chr1,245567013,245567399,SRX5075174,SMARCA4,386
chr1,245567017,245567362,SRX5075175,SMARCA4,345
chr1,245567028,245567294,SRX5075169,SMARCA4,266
chr1,245567045,245567356,SRX5020211,SMARCA2,311
chr1,245567047,245567308,SRX5716469,SMARCA4,261
chr1,245567065,245567377,SRX5075170,SMARCA4,312
chr1,245578800,245579097,SRX5075170,SMARCA4,297
chr1,245578834,245579154,SRX5716470,SMARCA4,320
chr1,245578876,245579132,SRX5020211,SMARCA2,256
chr1,245578936,245579111,SRX5075176,SMARCA4,175
chr1,245578988,245579168,SRX5075169,SMARCA4,180
chr1,245585026,245585521,SRX5075174,SMARCA4,495
chr1,245585095,245585726,SRX5075169,SMARCA4,631
chr1,245585113,245585718,SRX5075170,SMARCA4,605
chr1,245585139,245585648,SRX5075175,SMARCA4,509
chr1,245585139,245585871,SRX5054309,FOSL2,732
chr1,245585162,245585573,SRX5020211,SMARCA2,411
chr1,245585178,245585627,SRX5075176,SMARCA4,449
chr1,245585183,245585601,SRX5716470,SMARCA4,418
chr1,245585188,245585408,SRX5020214,SMARCA2,220
chr1,245585189,245585787,SRX5054308,FOSL2,598
chr1,245585190,245585962,SRX5075168,SMARCA4,772
chr1,245585260,245585562,SRX5716467,SMARCA2,302
chr1,245585287,245585640,SRX5716469,SMARCA4,353
chr1,245585339,245585538,SRX5075182,SMARCA2,199
chr1,245585582,245586002,SRX5075174,SMARCA4,420
chr1,245599295,245599682,SRX5075176,SMARCA4,387
chr1,245599296,245599860,SRX5075168,SMARCA4,564
chr1,245599297,245599724,SRX5054309,FOSL2,427
chr1,245599313,245599584,SRX5716467,SMARCA2,271
chr1,245599322,245599652,SRX5075174,SMARCA4,330
chr1,245599323,245599700,SRX5075170,SMARCA4,377
chr1,245599328,245599649,SRX5054308,FOSL2,321
chr1,245599353,245599786,SRX5716469,SMARCA4,433
chr1,245599368,245599700,SRX5075175,SMARCA4,332
chr1,245599399,245599754,SRX5075169,SMARCA4,355
chr1,245599412,245599770,SRX5716470,SMARCA4,358
chr1,245599432,245599665,SRX5020214,SMARCA2,233
chr1,245605546,245606017,SRX5075170,SMARCA4,471
chr1,245605564,245605938,SRX5716469,SMARCA4,374
chr1,245605572,245606045,SRX5075169,SMARCA4,473
chr1,245605587,245605984,SRX5075175,SMARCA4,397
chr1,245605605,245606089,SRX5075176,SMARCA4,484
chr1,245605609,245605890,SRX5716470,SMARCA4,281
chr1,245615080,245615287,SRX5075176,SMARCA4,207
chr1,245615142,245615340,SRX5075170,SMARCA4,198
chr1,245649334,245649584,SRX5075174,SMARCA4,250
chr1,245673738,245674017,SRX5716464,SMARCA4,279
chr1,245673784,245674199,SRX5075174,SMARCA4,415
chr1,245673790,245674022,SRX5075168,SMARCA4,232
chr1,245677618,245677827,SRX5054309,FOSL2,209
chr1,245683314,245683584,SRX5075176,SMARCA4,270
chr1,245704798,245705002,SRX5075170,SMARCA4,204
chr1,245704844,245705045,SRX5054309,FOSL2,201
chr1,245704854,245705069,SRX5054308,FOSL2,215
chr1,245704863,245705064,SRX5075175,SMARCA4,201
chr1,245704893,245705089,SRX5075169,SMARCA4,196
chr1,245704900,245705087,SRX5075176,SMARCA4,187
chr1,245709038,245709248,SRX5075176,SMARCA4,210
chr1,245715561,245715747,SRX5054308,FOSL2,186
chr1,245716093,245716324,SRX5054309,FOSL2,231
chr1,245716098,245716318,SRX5054308,FOSL2,220
chr1,245716150,245716337,SRX5075175,SMARCA4,187
chr1,245742744,245743389,SRX5716470,SMARCA4,645
chr1,245742783,245743363,SRX5075176,SMARCA4,580
chr1,245742790,245743361,SRX5075175,SMARCA4,571
chr1,245742826,245743388,SRX5075170,SMARCA4,562
chr1,245742833,245743289,SRX5020211,SMARCA2,456
chr1,245742878,245743354,SRX5075169,SMARCA4,476
chr1,245742890,245743117,SRX5054309,FOSL2,227
chr1,245742939,245743176,SRX5054308,FOSL2,237
chr1,245742966,245743333,SRX5716467,SMARCA2,367
chr1,245742969,245743346,SRX5716469,SMARCA4,377
chr1,245743013,245743348,SRX5716468,SMARCA2,335
chr1,245748366,245748572,SRX5716463,SMARCA4,206
chr1,245748522,245748699,SRX5075174,SMARCA4,177
chr1,245765237,245765621,SRX5054309,FOSL2,384
chr1,245765276,245765615,SRX5075175,SMARCA4,339
chr1,245765302,245765574,SRX5075169,SMARCA4,272
chr1,245765338,245765512,SRX5075170,SMARCA4,174
chr1,245765351,245765593,SRX5054308,FOSL2,242
chr1,245771658,245772092,SRX5075176,SMARCA4,434
chr1,245771722,245772078,SRX5075169,SMARCA4,356
chr1,245771817,245772083,SRX5075170,SMARCA4,266
chr1,245771818,245772257,SRX5054308,FOSL2,439
chr1,245771842,245772277,SRX5054309,FOSL2,435
chr1,245771859,245772115,SRX5075175,SMARCA4,256
chr1,245788160,245788622,SRX5716469,SMARCA4,462
chr1,245788207,245788695,SRX5075175,SMARCA4,488
chr1,245788209,245788687,SRX5716470,SMARCA4,478
chr1,245788209,245788702,SRX5075169,SMARCA4,493
chr1,245788225,245788660,SRX5075170,SMARCA4,435
chr1,245788241,245788662,SRX5075176,SMARCA4,421
chr1,245788266,245788567,SRX5716467,SMARCA2,301
chr1,245788280,245788531,SRX5020211,SMARCA2,251
chr1,245788294,245788632,SRX5054308,FOSL2,338
chr1,245788311,245788652,SRX5054309,FOSL2,341
chr1,245788325,245788606,SRX5716468,SMARCA2,281
chr1,245788362,245788661,SRX5075181,SMARCA2,299
chr1,245797621,245797956,SRX16500060,CTCF,335
chr1,245797642,245797987,SRX16500061,CTCF,345
chr1,245797650,245797935,SRX16500062,CTCF,285
chr1,245797657,245797957,SRX16500059,CTCF,300
chr1,245822943,245823380,SRX5075170,SMARCA4,437
chr1,245822945,245823361,SRX5075175,SMARCA4,416
chr1,245822985,245823314,SRX5020214,SMARCA2,329
chr1,245822994,245823348,SRX5075169,SMARCA4,354
chr1,245822995,245823378,SRX5716469,SMARCA4,383
chr1,245822997,245823282,SRX5075176,SMARCA4,285
chr1,245823002,245823379,SRX5075174,SMARCA4,377
chr1,245823007,245823369,SRX5054309,FOSL2,362
chr1,245823014,245823319,SRX5716470,SMARCA4,305
chr1,245823017,245823305,SRX5054308,FOSL2,288
chr1,245823035,245823405,SRX5075168,SMARCA4,370
chr1,245823077,245823310,SRX5716467,SMARCA2,233
chr1,245823174,245823451,SRX5716460,Epitope tags,277
chr1,245829871,245830109,SRX5054309,FOSL2,238
chr1,245837688,245838146,SRX5075176,SMARCA4,458
chr1,245837733,245838111,SRX5054309,FOSL2,378
chr1,245837746,245838143,SRX5075169,SMARCA4,397
chr1,245837760,245838159,SRX5075170,SMARCA4,399
chr1,245837783,245838180,SRX5075175,SMARCA4,397
chr1,245837784,245838129,SRX5716469,SMARCA4,345
chr1,245837823,245838087,SRX5054308,FOSL2,264
chr1,245837826,245838120,SRX5716470,SMARCA4,294
chr1,245837899,245838125,SRX5716467,SMARCA2,226
chr1,245856966,245857146,SRX5054308,FOSL2,180
chr1,245856978,245857239,SRX5716469,SMARCA4,261
chr1,245856989,245857203,SRX5075169,SMARCA4,214
chr1,245857021,245857227,SRX5054309,FOSL2,206
chr1,245860572,245861043,SRX5075176,SMARCA4,471
chr1,245860837,245861210,SRX5716470,SMARCA4,373
chr1,245860976,245861466,SRX5075170,SMARCA4,490
chr1,245871994,245872244,SRX5054309,FOSL2,250
chr1,245874920,245875290,SRX5716470,SMARCA4,370
chr1,245874964,245875376,SRX5075176,SMARCA4,412
chr1,245874976,245875416,SRX5075170,SMARCA4,440
chr1,245875021,245875283,SRX5075175,SMARCA4,262
chr1,245875055,245875367,SRX5054309,FOSL2,312
chr1,245875060,245875354,SRX5075169,SMARCA4,294
chr1,245875070,245875282,SRX5716469,SMARCA4,212
chr1,245881003,245881323,SRX5054309,FOSL2,320
chr1,245881025,245881342,SRX5716470,SMARCA4,317
chr1,245881077,245881408,SRX5075169,SMARCA4,331
chr1,245881132,245881319,SRX5075176,SMARCA4,187
chr1,245881158,245881338,SRX5054308,FOSL2,180
chr1,245881161,245881380,SRX5716468,SMARCA2,219
chr1,245881169,245881392,SRX5075175,SMARCA4,223
chr1,245946912,245947235,SRX5716469,SMARCA4,323
chr1,245946982,245947213,SRX5075169,SMARCA4,231
chr1,245947042,245947217,SRX5075176,SMARCA4,175
chr1,245961248,245961635,SRX5075170,SMARCA4,387
chr1,245961270,245961626,SRX5075176,SMARCA4,356
chr1,245961275,245961514,SRX5075175,SMARCA4,239
chr1,245961304,245961546,SRX5075169,SMARCA4,242
chr1,245961328,245961612,SRX5054308,FOSL2,284
chr1,245961384,245961567,SRX5054309,FOSL2,183
chr1,245969183,245969454,SRX5716459,Epitope tags,271
chr1,245969243,245969697,SRX5075175,SMARCA4,454
chr1,245969258,245969648,SRX5075176,SMARCA4,390
chr1,245969281,245969861,SRX5075169,SMARCA4,580
chr1,245969286,245969727,SRX5716470,SMARCA4,441
chr1,245969291,245969744,SRX5075170,SMARCA4,453
chr1,245969313,245969767,SRX5054309,FOSL2,454
chr1,245969359,245969539,SRX5054308,FOSL2,180
chr1,245969439,245969681,SRX5716469,SMARCA4,242
chr1,245986222,245987376,SRX5075176,SMARCA4,1154
chr1,245986247,245986740,SRX5075170,SMARCA4,493
chr1,245986249,245986741,SRX5075169,SMARCA4,492
chr1,245986317,245986655,SRX5054308,FOSL2,338
chr1,245986323,245986678,SRX5716470,SMARCA4,355
chr1,245986333,245986630,SRX5716469,SMARCA4,297
chr1,245986336,245986625,SRX5054309,FOSL2,289
chr1,245986340,245986590,SRX5716468,SMARCA2,250
chr1,245986340,245986692,SRX5716467,SMARCA2,352
chr1,245986359,245986678,SRX5075175,SMARCA4,319
chr1,245986413,245986672,SRX5020211,SMARCA2,259
chr1,245986539,245986771,SRX5075168,SMARCA4,232
chr1,245986558,245986734,SRX5075174,SMARCA4,176
chr1,245986802,245987205,SRX5075169,SMARCA4,403
chr1,245986844,245987180,SRX5054308,FOSL2,336
chr1,245986865,245987317,SRX5075170,SMARCA4,452
chr1,245986868,245987176,SRX5716469,SMARCA4,308
chr1,245986876,245987199,SRX5054309,FOSL2,323
chr1,245986902,245987398,SRX5075175,SMARCA4,496
chr1,245986919,245987255,SRX5075168,SMARCA4,336
chr1,245986920,245987291,SRX5075174,SMARCA4,371
chr1,245986946,245987296,SRX5716470,SMARCA4,350
chr1,245987005,245987220,SRX5716467,SMARCA2,215
chr1,246001396,246001834,SRX5075170,SMARCA4,438
chr1,246001424,246001711,SRX5716469,SMARCA4,287
chr1,246001448,246001736,SRX5075169,SMARCA4,288
chr1,246001461,246001750,SRX5075176,SMARCA4,289
chr1,246001492,246001743,SRX5075175,SMARCA4,251
chr1,246001495,246001763,SRX5054309,FOSL2,268
chr1,246001544,246001767,SRX5020211,SMARCA2,223
chr1,246001545,246001771,SRX5054308,FOSL2,226
chr1,246001554,246001759,SRX5020214,SMARCA2,205
chr1,246003034,246003447,SRX4174629,CTCF,413
chr1,246003043,246003588,SRX16500059,CTCF,545
chr1,246003105,246003529,SRX16500062,CTCF,424
chr1,246003105,246003552,SRX16500061,CTCF,447
chr1,246003121,246003632,SRX16500060,CTCF,511
chr1,246003178,246003450,SRX5075174,SMARCA4,272
chr1,246003208,246003485,SRX5075168,SMARCA4,277
chr1,246005048,246005522,SRX5075176,SMARCA4,474
chr1,246005053,246005464,SRX5075170,SMARCA4,411
chr1,246005079,246005522,SRX5075175,SMARCA4,443
chr1,246005082,246005491,SRX5075169,SMARCA4,409
chr1,246005105,246005398,SRX5716470,SMARCA4,293
chr1,246005109,246005354,SRX5020214,SMARCA2,245
chr1,246005110,246005437,SRX5716469,SMARCA4,327
chr1,246005112,246005454,SRX5054309,FOSL2,342
chr1,246005115,246005403,SRX5716467,SMARCA2,288
chr1,246005126,246005391,SRX5020211,SMARCA2,265
chr1,246005139,246005454,SRX5054308,FOSL2,315
chr1,246005143,246005467,SRX5075182,SMARCA2,324
chr1,246005151,246005403,SRX5716468,SMARCA2,252
chr1,246012198,246012685,SRX16500060,CTCF,487
chr1,246012199,246012684,SRX16500059,CTCF,485
chr1,246012223,246012658,SRX16500061,CTCF,435
chr1,246012252,246012661,SRX16500062,CTCF,409
chr1,246043468,246043878,SRX5075175,SMARCA4,410
chr1,246043472,246043976,SRX5075170,SMARCA4,504
chr1,246043479,246043822,SRX5075169,SMARCA4,343
chr1,246043502,246044008,SRX5075176,SMARCA4,506
chr1,246043584,246043853,SRX5716469,SMARCA4,269
chr1,246043590,246043902,SRX5716470,SMARCA4,312
chr1,246099547,246099773,SRX5075170,SMARCA4,226
chr1,246106442,246106622,SRX5075169,SMARCA4,180
chr1,246107475,246107923,SRX5075170,SMARCA4,448
chr1,246107480,246107852,SRX5075174,SMARCA4,372
chr1,246107484,246107896,SRX5075176,SMARCA4,412
chr1,246107494,246107909,SRX5075169,SMARCA4,415
chr1,246107552,246107875,SRX5075168,SMARCA4,323
chr1,246107561,246107885,SRX5075175,SMARCA4,324
chr1,246107567,246107823,SRX5716467,SMARCA2,256
chr1,246107572,246107848,SRX5716469,SMARCA4,276
chr1,246107574,246107833,SRX5054309,FOSL2,259
chr1,246107610,246107824,SRX5716468,SMARCA2,214
chr1,246117101,246117539,SRX16500060,CTCF,438
chr1,246117139,246117479,SRX16500059,CTCF,340
chr1,246117165,246117473,SRX5716470,SMARCA4,308
chr1,246117180,246117469,SRX16500062,CTCF,289
chr1,246117201,246117461,SRX5075176,SMARCA4,260
chr1,246117211,246117532,SRX5075174,SMARCA4,321
chr1,246117212,246117399,SRX5075175,SMARCA4,187
chr1,246117214,246117481,SRX5075168,SMARCA4,267
chr1,246117215,246117476,SRX16500061,CTCF,261
chr1,246117224,246117444,SRX5075170,SMARCA4,220
chr1,246117263,246117518,SRX5075169,SMARCA4,255
chr1,246138735,246139287,SRX5075174,SMARCA4,552
chr1,246138799,246139230,SRX5716463,SMARCA4,431
chr1,246138821,246139242,SRX5075168,SMARCA4,421
chr1,246138854,246139184,SRX5716451,SOX2,330
chr1,246139728,246140035,SRX5075176,SMARCA4,307
chr1,246139742,246140084,SRX5075169,SMARCA4,342
chr1,246139767,246140102,SRX5054309,FOSL2,335
chr1,246139803,246140026,SRX5075175,SMARCA4,223
chr1,246139833,246140013,SRX5054308,FOSL2,180
chr1,246139836,246140022,SRX5075170,SMARCA4,186
chr1,246142418,246142729,SRX5075169,SMARCA4,311
chr1,246142430,246142737,SRX5075175,SMARCA4,307
chr1,246142454,246142707,SRX5716469,SMARCA4,253
chr1,246142464,246142747,SRX5054308,FOSL2,283
chr1,246142466,246142745,SRX5075170,SMARCA4,279
chr1,246142477,246142679,SRX5075176,SMARCA4,202
chr1,246142497,246142706,SRX5054309,FOSL2,209
chr1,246142540,246142797,SRX5716470,SMARCA4,257
chr1,246152259,246152475,SRX16500062,CTCF,216
chr1,246153890,246154135,SRX5054308,FOSL2,245
chr1,246153921,246154217,SRX5054309,FOSL2,296
chr1,246153933,246154205,SRX5075169,SMARCA4,272
chr1,246153937,246154200,SRX5075174,SMARCA4,263
chr1,246153940,246154190,SRX5716469,SMARCA4,250
chr1,246153960,246154196,SRX5716470,SMARCA4,236
chr1,246153979,246154204,SRX5075170,SMARCA4,225
chr1,246153992,246154221,SRX5075168,SMARCA4,229
chr1,246156013,246156298,SRX5716467,SMARCA2,285
chr1,246156022,246156287,SRX5054308,FOSL2,265
chr1,246156036,246156330,SRX5075170,SMARCA4,294
chr1,246156042,246156283,SRX5054309,FOSL2,241
chr1,246156068,246156332,SRX5075169,SMARCA4,264
chr1,246156070,246156330,SRX5075176,SMARCA4,260
chr1,246156114,246156310,SRX5075175,SMARCA4,196
chr1,246161757,246161926,SRX5075170,SMARCA4,169
chr1,246199168,246199355,SRX5075175,SMARCA4,187
chr1,246199205,246199434,SRX5075176,SMARCA4,229
chr1,246199209,246199482,SRX5075170,SMARCA4,273
chr1,246199273,246199492,SRX5716470,SMARCA4,219
chr1,246210800,246211119,SRX5075168,SMARCA4,319
chr1,246210825,246211119,SRX5075174,SMARCA4,294
chr1,246214779,246215299,SRX5075169,SMARCA4,520
chr1,246214869,246215271,SRX5054308,FOSL2,402
chr1,246214903,246215248,SRX5054309,FOSL2,345
chr1,246214911,246215234,SRX5075168,SMARCA4,323
chr1,246214914,246215251,SRX5075170,SMARCA4,337
chr1,246214918,246215350,SRX5716469,SMARCA4,432
chr1,246214933,246215267,SRX5075176,SMARCA4,334
chr1,246214936,246215301,SRX5075175,SMARCA4,365
chr1,246214968,246215215,SRX5075174,SMARCA4,247
chr1,246219754,246219999,SRX5075170,SMARCA4,245
chr1,246244199,246244379,SRX5054308,FOSL2,180
chr1,246280601,246280817,SRX5075176,SMARCA4,216
chr1,246280607,246280911,SRX16500060,CTCF,304
chr1,246280641,246280883,SRX16500062,CTCF,242
chr1,246280643,246280885,SRX16500061,CTCF,242
chr1,246280679,246280951,SRX16500059,CTCF,272
chr1,246289998,246290248,SRX5075174,SMARCA4,250
chr1,246317732,246318065,SRX5075175,SMARCA4,333
chr1,246317740,246318029,SRX5054309,FOSL2,289
chr1,246317746,246318079,SRX5075169,SMARCA4,333
chr1,246317812,246318025,SRX5054308,FOSL2,213
chr1,246320357,246320581,SRX5075168,SMARCA4,224
chr1,246320436,246320646,SRX5075174,SMARCA4,210
chr1,246377726,246378224,SRX5075168,SMARCA4,498
chr1,246377742,246378278,SRX5075174,SMARCA4,536
chr1,246377808,246378229,SRX5716463,SMARCA4,421
chr1,246377815,246378128,SRX5716464,SMARCA4,313
chr1,246377838,246378069,SRX5716454,SOX3,231
chr1,246377842,246378150,SRX5716451,SOX2,308
chr1,246377954,246378312,SRX20140895,INTS13,358
chr1,246383952,246384142,SRX5054308,FOSL2,190
chr1,246435574,246435923,SRX5075174,SMARCA4,349
chr1,246435582,246435990,SRX5075168,SMARCA4,408
chr1,246450680,246451148,SRX16500059,CTCF,468
chr1,246450702,246451196,SRX16500060,CTCF,494
chr1,246450720,246451129,SRX16500062,CTCF,409
chr1,246450720,246451162,SRX16500061,CTCF,442
chr1,246483146,246483422,SRX5054308,FOSL2,276
chr1,246483232,246483473,SRX5054309,FOSL2,241
chr1,246492579,246492880,SRX5716469,SMARCA4,301
chr1,246492590,246492930,SRX5075170,SMARCA4,340
chr1,246492592,246492978,SRX16500060,CTCF,386
chr1,246492599,246493019,SRX16500059,CTCF,420
chr1,246492600,246492955,SRX16500062,CTCF,355
chr1,246492629,246492971,SRX5075176,SMARCA4,342
chr1,246492635,246492968,SRX5075168,SMARCA4,333
chr1,246492643,246492955,SRX5075174,SMARCA4,312
chr1,246492652,246492894,SRX5075175,SMARCA4,242
chr1,246492652,246492988,SRX16500061,CTCF,336
chr1,246492661,246492957,SRX5716470,SMARCA4,296
chr1,246492692,246492933,SRX5075169,SMARCA4,241
chr1,246492730,246492958,SRX4174629,CTCF,228
chr1,246492739,246492944,SRX5716464,SMARCA4,205
chr1,246492780,246492984,SRX5716463,SMARCA4,204
chr1,246497261,246497718,SRX16500062,CTCF,457
chr1,246497277,246497708,SRX16500060,CTCF,431
chr1,246497308,246497720,SRX16500061,CTCF,412
chr1,246497311,246497729,SRX16500059,CTCF,418
chr1,246497397,246497610,SRX5075174,SMARCA4,213
chr1,246497423,246497622,SRX5075170,SMARCA4,199
chr1,246497423,246497627,SRX5716463,SMARCA4,204
chr1,246497476,246497655,SRX5075168,SMARCA4,179
chr1,246506706,246507346,SRX5075176,SMARCA4,640
chr1,246506774,246507050,SRX5075175,SMARCA4,276
chr1,246506987,246507315,SRX20140879,CPSF3L,328
chr1,246506998,246507466,SRX20140881,CPSF3L,468
chr1,246507018,246507526,SRX5075168,SMARCA4,508
chr1,246507039,246507565,SRX5075174,SMARCA4,526
chr1,246507073,246507533,SRX5716463,SMARCA4,460
chr1,246507074,246507519,SRX5075170,SMARCA4,445
chr1,246507105,246507509,SRX5716464,SMARCA4,404
chr1,246507164,246507669,SRX20140895,INTS13,505
chr1,246566126,246566389,SRX20140897,INTS13,263
chr1,246566145,246566631,SRX5075174,SMARCA4,486
chr1,246566179,246566791,SRX20140895,INTS13,612
chr1,246566255,246566551,SRX5075168,SMARCA4,296
chr1,246566311,246566569,SRX5075170,SMARCA4,258
chr1,246566315,246566601,SRX5716463,SMARCA4,286
chr1,246566419,246566676,SRX20140867,INTS10,257
chr1,246566454,246566732,SRX20140868,INTS10,278
chr1,246567260,246567440,SRX5075169,SMARCA4,180
chr1,246583481,246583817,SRX5075170,SMARCA4,336
chr1,246583506,246583798,SRX5716470,SMARCA4,292
chr1,246583516,246583775,SRX5075176,SMARCA4,259
chr1,246583550,246583819,SRX5075168,SMARCA4,269
chr1,246583572,246583882,SRX5075174,SMARCA4,310
chr1,246583574,246583862,SRX5716469,SMARCA4,288
chr1,246583664,246583873,SRX5716463,SMARCA4,209
chr1,246592509,246593076,SRX5716470,SMARCA4,567
chr1,246592514,246593089,SRX5716469,SMARCA4,575
chr1,246592537,246593099,SRX5075176,SMARCA4,562
chr1,246592559,246593113,SRX5020211,SMARCA2,554
chr1,246592578,246593092,SRX5075175,SMARCA4,514
chr1,246592578,246593106,SRX5075170,SMARCA4,528
chr1,246592594,246593038,SRX5075181,SMARCA2,444
chr1,246592602,246593082,SRX5075169,SMARCA4,480
chr1,246592629,246593043,SRX5020214,SMARCA2,414
chr1,246592638,246593028,SRX5054308,FOSL2,390
chr1,246592664,246593065,SRX5716468,SMARCA2,401
chr1,246592679,246593058,SRX5716467,SMARCA2,379
chr1,246592692,246593051,SRX5054309,FOSL2,359
chr1,246592729,246592990,SRX5075182,SMARCA2,261
chr1,246608704,246609262,SRX5716470,SMARCA4,558
chr1,246608858,246609313,SRX5075176,SMARCA4,455
chr1,246608893,246609280,SRX5716469,SMARCA4,387
chr1,246608897,246609310,SRX5075169,SMARCA4,413
chr1,246608918,246609176,SRX5020214,SMARCA2,258
chr1,246608919,246609273,SRX5075175,SMARCA4,354
chr1,246608928,246609226,SRX5716467,SMARCA2,298
chr1,246608937,246609298,SRX5075170,SMARCA4,361
chr1,246609003,246609273,SRX5054309,FOSL2,270
chr1,246609018,246609283,SRX5054308,FOSL2,265
chr1,246631607,246631798,SRX5075175,SMARCA4,191
chr1,246632577,246633045,SRX5075174,SMARCA4,468
chr1,246632605,246633109,SRX5075176,SMARCA4,504
chr1,246632656,246633072,SRX5716470,SMARCA4,416
chr1,246632657,246632953,SRX5075168,SMARCA4,296
chr1,246632665,246633180,SRX5716469,SMARCA4,515
chr1,246632727,246633119,SRX5054309,FOSL2,392
chr1,246632738,246633131,SRX5075175,SMARCA4,393
chr1,246632750,246633135,SRX5075169,SMARCA4,385
chr1,246632754,246633084,SRX5054308,FOSL2,330
chr1,246632823,246633229,SRX5075170,SMARCA4,406
chr1,246647105,246647589,SRX5075176,SMARCA4,484
chr1,246647154,246647402,SRX16500062,CTCF,248
chr1,246647156,246647754,SRX5075169,SMARCA4,598
chr1,246647159,246647434,SRX5716469,SMARCA4,275
chr1,246647175,246647485,SRX5075170,SMARCA4,310
chr1,246647206,246647395,SRX5075174,SMARCA4,189
chr1,246647213,246647764,SRX5075175,SMARCA4,551
chr1,246647217,246647729,SRX5716470,SMARCA4,512
chr1,246674039,246674335,SRX5075174,SMARCA4,296
chr1,246674126,246674324,SRX5075168,SMARCA4,198
chr1,246680709,246681085,SRX20140895,INTS13,376
chr1,246680837,246681152,SRX20140868,INTS10,315
chr1,246689425,246689909,SRX16500060,CTCF,484
chr1,246689446,246689923,SRX16500059,CTCF,477
chr1,246689491,246689807,SRX5716469,SMARCA4,316
chr1,246689503,246689835,SRX16500062,CTCF,332
chr1,246689513,246689855,SRX5716470,SMARCA4,342
chr1,246689519,246689839,SRX5075170,SMARCA4,320
chr1,246689519,246689871,SRX5075176,SMARCA4,352
chr1,246689522,246689895,SRX16500061,CTCF,373
chr1,246689529,246689755,SRX5716468,SMARCA2,226
chr1,246689541,246689799,SRX5075174,SMARCA4,258
chr1,246689562,246689838,SRX5075169,SMARCA4,276
chr1,246689563,246689846,SRX5075168,SMARCA4,283
chr1,246689564,246689845,SRX5075175,SMARCA4,281
chr1,246689587,246689797,SRX5716463,SMARCA4,210
chr1,246691687,246691862,SRX5075174,SMARCA4,175
chr1,246696428,246696724,SRX16500060,CTCF,296
chr1,246696465,246696727,SRX16500059,CTCF,262
chr1,246696468,246696721,SRX16500062,CTCF,253
chr1,246696469,246696712,SRX16500061,CTCF,243
chr1,246696519,246696734,SRX5075168,SMARCA4,215
chr1,246698994,246699489,SRX5075169,SMARCA4,495
chr1,246699057,246699484,SRX5075170,SMARCA4,427
chr1,246699060,246699350,SRX5716469,SMARCA4,290
chr1,246699083,246699326,SRX5075181,SMARCA2,243
chr1,246699086,246699423,SRX5075175,SMARCA4,337
chr1,246699102,246699587,SRX16500061,CTCF,485
chr1,246699104,246699453,SRX5075176,SMARCA4,349
chr1,246699112,246699443,SRX5716470,SMARCA4,331
chr1,246699115,246699571,SRX16500059,CTCF,456
chr1,246699126,246699353,SRX5716467,SMARCA2,227
chr1,246699126,246699527,SRX16500062,CTCF,401
chr1,246699126,246699584,SRX16500060,CTCF,458
chr1,246699158,246699440,SRX5716464,SMARCA4,282
chr1,246699159,246699388,SRX5054308,FOSL2,229
chr1,246699162,246699503,SRX5075168,SMARCA4,341
chr1,246699168,246699517,SRX5075174,SMARCA4,349
chr1,246699180,246699481,SRX4174629,CTCF,301
chr1,246699187,246699392,SRX5054309,FOSL2,205
chr1,246699237,246699490,SRX5716463,SMARCA4,253
chr1,246705231,246705737,SRX5075175,SMARCA4,506
chr1,246705312,246705745,SRX5716469,SMARCA4,433
chr1,246705334,246705683,SRX5075170,SMARCA4,349
chr1,246705368,246705784,SRX5054309,FOSL2,416
chr1,246705372,246705649,SRX5716467,SMARCA2,277
chr1,246705377,246705748,SRX5075169,SMARCA4,371
chr1,246705382,246705690,SRX5075176,SMARCA4,308
chr1,246705382,246705788,SRX5054308,FOSL2,406
chr1,246705428,246705726,SRX5716470,SMARCA4,298
chr1,246723848,246724788,SRX20140895,INTS13,940
chr1,246723871,246724733,SRX20140868,INTS10,862
chr1,246723922,246724309,SRX5075174,SMARCA4,387
chr1,246723971,246724300,SRX5075175,SMARCA4,329
chr1,246723976,246724642,SRX5075170,SMARCA4,666
chr1,246724079,246724695,SRX20140867,INTS10,616
chr1,246724093,246724628,SRX5075176,SMARCA4,535
chr1,246724110,246724397,SRX5075169,SMARCA4,287
chr1,246724121,246724565,SRX5075168,SMARCA4,444
chr1,246724507,246724734,SRX5075175,SMARCA4,227
chr1,246753761,246754362,SRX16500060,CTCF,601
chr1,246753825,246754289,SRX16500061,CTCF,464
chr1,246753843,246754312,SRX16500059,CTCF,469
chr1,246753893,246754213,SRX5075168,SMARCA4,320
chr1,246753895,246754214,SRX5075174,SMARCA4,319
chr1,246753898,246754293,SRX16500062,CTCF,395
chr1,246753919,246754159,SRX5075176,SMARCA4,240
chr1,246753936,246754182,SRX5075175,SMARCA4,246
chr1,246753941,246754188,SRX5716463,SMARCA4,247
chr1,246753950,246754186,SRX5716470,SMARCA4,236
chr1,246753964,246754196,SRX5075170,SMARCA4,232
chr1,246753974,246754299,SRX4174629,CTCF,325
chr1,246785009,246785474,SRX5075170,SMARCA4,465
chr1,246785168,246785469,SRX5075176,SMARCA4,301
chr1,246785285,246785471,SRX5054308,FOSL2,186
chr1,246785301,246785506,SRX5075169,SMARCA4,205
chr1,246844049,246844226,SRX5075176,SMARCA4,177
chr1,246863896,246864076,SRX5075174,SMARCA4,180
chr1,246885395,246885918,SRX5075168,SMARCA4,523
chr1,246885429,246885934,SRX5075174,SMARCA4,505
chr1,246885504,246885683,SRX5054307,FOSL2,179
chr1,246885525,246885802,SRX5716463,SMARCA4,277
chr1,246907492,246907829,SRX16500059,CTCF,337
chr1,246907546,246907875,SRX16500062,CTCF,329
chr1,246907584,246907819,SRX16500061,CTCF,235
chr1,246907589,246907887,SRX16500060,CTCF,298
chr1,246931470,246932123,SRX20140867,INTS10,653
chr1,246931579,246932324,SRX20140895,INTS13,745
chr1,246931620,246932056,SRX20140896,INTS13,436
chr1,246931657,246932079,SRX20140869,INTS10,422
chr1,246931659,246932176,SRX20140868,INTS10,517
chr1,246931667,246932101,SRX20140897,INTS13,434
chr1,246931671,246932131,SRX20140881,CPSF3L,460
chr1,246931675,246932011,SRX5716470,SMARCA4,336
chr1,246931697,246932029,SRX20140879,CPSF3L,332
chr1,246931788,246932040,SRX5075169,SMARCA4,252
chr1,246931811,246932367,SRX5075174,SMARCA4,556
chr1,246931855,246932354,SRX5075168,SMARCA4,499
chr1,246931904,246932411,SRX5075170,SMARCA4,507
chr1,246931941,246932331,SRX5716463,SMARCA4,390
chr1,246932010,246932316,SRX5075176,SMARCA4,306
chr1,246971404,246971649,SRX16500059,CTCF,245
chr1,246971430,246971676,SRX16500060,CTCF,246
chr1,246971437,246971711,SRX16500061,CTCF,274
chr1,247007575,247008214,SRX20140895,INTS13,639
chr1,247007616,247007896,SRX5716469,SMARCA4,280
chr1,247007671,247008110,SRX20140868,INTS10,439
chr1,247007725,247008311,SRX5075168,SMARCA4,586
chr1,247007778,247008110,SRX5716470,SMARCA4,332
chr1,247007779,247008014,SRX20140879,CPSF3L,235
chr1,247007791,247008312,SRX5075174,SMARCA4,521
chr1,247007796,247008137,SRX20140867,INTS10,341
chr1,247007828,247008057,SRX5075175,SMARCA4,229
chr1,247007850,247008272,SRX5075176,SMARCA4,422
chr1,247007951,247008351,SRX5075170,SMARCA4,400
chr1,247007974,247008237,SRX5716451,SOX2,263
chr1,247008034,247008213,SRX5054307,FOSL2,179
chr1,247008050,247008287,SRX5716463,SMARCA4,237
chr1,247078253,247078478,SRX5716470,SMARCA4,225
chr1,247078273,247078974,SRX20140895,INTS13,701
chr1,247078429,247079007,SRX5075169,SMARCA4,578
chr1,247078463,247078810,SRX20140868,INTS10,347
chr1,247078478,247078775,SRX20140897,INTS13,297
chr1,247078491,247078703,SRX5716469,SMARCA4,212
chr1,247078501,247078772,SRX20140896,INTS13,271
chr1,247078546,247079030,SRX5075170,SMARCA4,484
chr1,247078572,247079130,SRX5075176,SMARCA4,558
chr1,247078606,247079062,SRX5075174,SMARCA4,456
chr1,247078624,247078970,SRX5075175,SMARCA4,346
chr1,247078655,247078960,SRX5716463,SMARCA4,305
chr1,247078673,247079044,SRX5075168,SMARCA4,371
chr1,247104011,247104718,SRX20140895,INTS13,707
chr1,247104030,247104548,SRX20140869,INTS10,518
chr1,247104070,247104613,SRX20140897,INTS13,543
chr1,247104095,247104627,SRX20140868,INTS10,532
chr1,247104109,247104284,SRX5075176,SMARCA4,175
chr1,247104138,247104538,SRX20140867,INTS10,400
chr1,247104194,247104661,SRX5075168,SMARCA4,467
chr1,247104257,247104663,SRX5075174,SMARCA4,406
chr1,247104303,247104600,SRX5054307,FOSL2,297
chr1,247104319,247104523,SRX5716451,SOX2,204
chr1,247104363,247104637,SRX5054309,FOSL2,274
chr1,247104370,247104598,SRX5054308,FOSL2,228
chr1,247104372,247104692,SRX5075176,SMARCA4,320
chr1,247104392,247104657,SRX5075170,SMARCA4,265
chr1,247111204,247111632,SRX5075169,SMARCA4,428
chr1,247111344,247112207,SRX20140895,INTS13,863
chr1,247111525,247112146,SRX20140868,INTS10,621
chr1,247111668,247111896,SRX5075170,SMARCA4,228
chr1,247111752,247111925,SRX5075174,SMARCA4,173
chr1,247118974,247119187,SRX16500062,CTCF,213
chr1,247119012,247119241,SRX16500061,CTCF,229
chr1,247126173,247126453,SRX5075174,SMARCA4,280
chr1,247126197,247126446,SRX5075168,SMARCA4,249
chr1,247126283,247126777,SRX20140895,INTS13,494
chr1,247126340,247126587,SRX20140897,INTS13,247
chr1,247126363,247126692,SRX20140868,INTS10,329
chr1,247126393,247126666,SRX20140867,INTS10,273
chr1,247126604,247126960,SRX5075175,SMARCA4,356
chr1,247171568,247172221,SRX20140895,INTS13,653
chr1,247171628,247171815,SRX5075175,SMARCA4,187
chr1,247171751,247172006,SRX20140879,CPSF3L,255
chr1,247171829,247172074,SRX20140867,INTS10,245
chr1,247171874,247172118,SRX20140897,INTS13,244
chr1,247171924,247172261,SRX5075176,SMARCA4,337
chr1,247172050,247172332,SRX5075168,SMARCA4,282
chr1,247172070,247172256,SRX5075174,SMARCA4,186
chr1,247210295,247210658,SRX5075175,SMARCA4,363
chr1,247210306,247210587,SRX5075170,SMARCA4,281
chr1,247210340,247210599,SRX5075176,SMARCA4,259
chr1,247210350,247210655,SRX5716470,SMARCA4,305
chr1,247210424,247211019,SRX20140895,INTS13,595
chr1,247210700,247210927,SRX20140867,INTS10,227
chr1,247210746,247211165,SRX5075168,SMARCA4,419
chr1,247210782,247211198,SRX5075174,SMARCA4,416
chr1,247210787,247211052,SRX5075176,SMARCA4,265
chr1,247210791,247211002,SRX5716470,SMARCA4,211
chr1,247210874,247211085,SRX5716464,SMARCA4,211
chr1,247210877,247211071,SRX5075170,SMARCA4,194
chr1,247294336,247294667,SRX5075169,SMARCA4,331
chr1,247294390,247294643,SRX5054308,FOSL2,253
chr1,247294397,247294666,SRX5054309,FOSL2,269
chr1,247294418,247294662,SRX5716470,SMARCA4,244
chr1,247294423,247294605,SRX5075176,SMARCA4,182
chr1,247315716,247315972,SRX5075175,SMARCA4,256
chr1,247315723,247315938,SRX5075169,SMARCA4,215
chr1,247315740,247315947,SRX5054309,FOSL2,207
chr1,247324842,247325303,SRX5075174,SMARCA4,461
chr1,247324854,247325310,SRX5075168,SMARCA4,456
chr1,247324872,247325333,SRX20140895,INTS13,461
chr1,247325049,247325291,SRX5716463,SMARCA4,242
chr1,247331060,247332463,SRX20140895,INTS13,1403
chr1,247331310,247331561,SRX20140897,INTS13,251
chr1,247331411,247332421,SRX20140868,INTS10,1010
chr1,247331556,247332272,SRX20140869,INTS10,716
chr1,247331643,247332255,SRX20140867,INTS10,612
chr1,247331815,247332188,SRX5075174,SMARCA4,373
chr1,247331874,247332125,SRX5075170,SMARCA4,251
chr1,247331881,247332101,SRX5075175,SMARCA4,220
chr1,247331893,247332158,SRX5075169,SMARCA4,265
chr1,247331897,247332213,SRX5075176,SMARCA4,316
chr1,247331947,247332243,SRX20140881,CPSF3L,296
chr1,247342687,247343250,SRX5075176,SMARCA4,563
chr1,247342707,247343251,SRX5075169,SMARCA4,544
chr1,247342713,247343192,SRX5075174,SMARCA4,479
chr1,247342717,247343263,SRX5075170,SMARCA4,546
chr1,247342729,247343162,SRX5716470,SMARCA4,433
chr1,247342744,247343233,SRX5075175,SMARCA4,489
chr1,247342797,247343183,SRX5716469,SMARCA4,386
chr1,247342829,247343264,SRX5054309,FOSL2,435
chr1,247342843,247343213,SRX5075168,SMARCA4,370
chr1,247342851,247343260,SRX5054308,FOSL2,409
chr1,247342907,247343206,SRX5716467,SMARCA2,299
chr1,247372652,247373177,SRX16500059,CTCF,525
chr1,247372663,247373140,SRX16500062,CTCF,477
chr1,247372673,247373066,SRX16500061,CTCF,393
chr1,247372676,247373151,SRX16500060,CTCF,475
chr1,247372800,247373020,SRX4174629,CTCF,220
chr1,247376617,247377194,SRX5075168,SMARCA4,577
chr1,247376621,247377165,SRX5075174,SMARCA4,544
chr1,247376643,247377121,SRX5716463,SMARCA4,478
chr1,247376658,247376973,SRX5716454,SOX3,315
chr1,247376713,247377032,SRX5716464,SMARCA4,319
chr1,247376717,247376994,SRX5716451,SOX2,277
chr1,247386756,247387025,SRX5075170,SMARCA4,269
chr1,247386787,247386999,SRX5075176,SMARCA4,212
chr1,247389984,247390498,SRX16500061,CTCF,514
chr1,247390011,247390512,SRX16500059,CTCF,501
chr1,247390020,247390542,SRX16500060,CTCF,522
chr1,247390025,247390472,SRX16500062,CTCF,447
chr1,247390058,247390514,SRX4174629,CTCF,456
chr1,247390123,247390480,SRX5075168,SMARCA4,357
chr1,247390124,247390470,SRX5075174,SMARCA4,346
chr1,247390130,247390424,SRX5716464,SMARCA4,294
chr1,247390147,247390420,SRX5716463,SMARCA4,273
chr1,247390157,247390417,SRX5075170,SMARCA4,260
chr1,247390157,247390449,SRX5075169,SMARCA4,292
chr1,247390192,247390437,SRX5075176,SMARCA4,245
chr1,247447947,247448321,SRX20140869,INTS10,374
chr1,247447980,247448356,SRX20140895,INTS13,376
chr1,247448037,247448268,SRX5075168,SMARCA4,231
chr1,247448053,247448412,SRX20140867,INTS10,359
chr1,247468490,247468918,SRX5075174,SMARCA4,428
chr1,247468494,247468894,SRX5075168,SMARCA4,400
chr1,247486967,247487419,SRX16500061,CTCF,452
chr1,247487069,247487469,SRX16500060,CTCF,400
chr1,247487080,247487478,SRX16500059,CTCF,398
chr1,247487091,247487433,SRX16500062,CTCF,342
chr1,247551784,247552040,SRX5054309,FOSL2,256
chr1,247576508,247576876,SRX16500062,CTCF,368
chr1,247576517,247576818,SRX16500059,CTCF,301
chr1,247576524,247576922,SRX16500060,CTCF,398
chr1,247576575,247576900,SRX16500061,CTCF,325
chr1,247647738,247648296,SRX5075174,SMARCA4,558
chr1,247647898,247648286,SRX5075168,SMARCA4,388
chr1,247647986,247648210,SRX5716463,SMARCA4,224
chr1,247681175,247681665,SRX16500059,CTCF,490
chr1,247681287,247681682,SRX16500062,CTCF,395
chr1,247681318,247681664,SRX16500061,CTCF,346
chr1,247681319,247681733,SRX16500060,CTCF,414
chr1,247681358,247681640,SRX5075174,SMARCA4,282
chr1,247681359,247681659,SRX5075168,SMARCA4,300
chr1,247681394,247681603,SRX5716464,SMARCA4,209
chr1,247742281,247742464,SRX5054309,FOSL2,183
chr1,247742367,247742628,SRX5075168,SMARCA4,261
chr1,247857535,247857745,SRX16500062,CTCF,210
chr1,247936826,247937378,SRX16500059,CTCF,552
chr1,247936832,247937399,SRX16500060,CTCF,567
chr1,247936852,247937378,SRX16500062,CTCF,526
chr1,247936857,247937342,SRX16500061,CTCF,485
chr1,247936904,247937303,SRX4174629,CTCF,399
chr1,247936950,247937293,SRX5075174,SMARCA4,343
chr1,247937026,247937299,SRX5075168,SMARCA4,273
chr1,247937087,247937522,SRX20140897,INTS13,435
chr1,247937111,247937372,SRX20140881,CPSF3L,261
chr1,247937277,247937566,SRX20140869,INTS10,289
chr1,248201186,248201424,SRX5075168,SMARCA4,238
chr1,248243147,248243436,SRX16500059,CTCF,289
chr1,248243157,248243451,SRX16500060,CTCF,294
chr1,248243168,248243493,SRX5075168,SMARCA4,325
chr1,248243178,248243518,SRX5075174,SMARCA4,340
chr1,248243191,248243401,SRX5716463,SMARCA4,210
chr1,248243235,248243526,SRX16500061,CTCF,291
chr1,248262994,248263167,SRX5075174,SMARCA4,173
chr1,248408574,248408888,SRX16500062,CTCF,314
chr1,248619000,248619237,SRX5075168,SMARCA4,237
chr1,248619050,248619257,SRX5075174,SMARCA4,207
chr1,248622479,248622769,SRX16500061,CTCF,290
chr1,248622486,248622847,SRX16500059,CTCF,361
chr1,248622519,248622809,SRX16500062,CTCF,290
chr1,248622537,248622854,SRX16500060,CTCF,317
chr1,248807067,248807506,SRX16500060,CTCF,439
chr1,248807101,248807478,SRX16500059,CTCF,377
chr1,248807152,248807509,SRX16500062,CTCF,357
chr1,248807194,248807509,SRX16500061,CTCF,315
chr1,248810735,248810959,SRX5075176,SMARCA4,224
chr1,248825736,248826106,SRX5075168,SMARCA4,370
chr1,248825899,248826617,SRX20140895,INTS13,718
chr1,248825930,248826444,SRX20140867,INTS10,514
chr1,248826024,248826229,SRX5716454,SOX3,205
chr1,248826024,248826333,SRX20140868,INTS10,309
chr1,248826125,248826812,SRX5075174,SMARCA4,687
chr1,248826141,248826724,SRX20140897,INTS13,583
chr1,248826168,248826426,SRX20140894,INTS13,258
chr1,248826206,248826467,SRX20140881,CPSF3L,261
chr1,248826261,248826466,SRX5075170,SMARCA4,205
chr1,248826364,248826644,SRX20140869,INTS10,280
chr1,248826405,248826814,SRX4174629,CTCF,409
chr1,248826417,248826860,SRX16500062,CTCF,443
chr1,248826430,248826961,SRX16500060,CTCF,531
chr1,248826476,248826937,SRX16500061,CTCF,461
chr1,248826484,248826940,SRX16500059,CTCF,456
chr1,248826609,248826898,SRX5075168,SMARCA4,289
chr1,248826627,248826858,SRX5075170,SMARCA4,231
chr1,248837796,248838125,SRX20140879,CPSF3L,329
chr1,248837820,248838926,SRX20140895,INTS13,1106
chr1,248837865,248838278,SRX5075168,SMARCA4,413
chr1,248837877,248838312,SRX5075174,SMARCA4,435
chr1,248837902,248838283,SRX5075170,SMARCA4,381
chr1,248837924,248838333,SRX5075176,SMARCA4,409
chr1,248837954,248838982,SRX20140867,INTS10,1028
chr1,248837961,248838190,SRX5716464,SMARCA4,229
chr1,248837971,248838350,SRX5054307,FOSL2,379
chr1,248838014,248838306,SRX5716451,SOX2,292
chr1,248838029,248838275,SRX5054309,FOSL2,246
chr1,248838038,248838788,SRX20140868,INTS10,750
chr1,248838042,248838231,SRX5054308,FOSL2,189
chr1,248838046,248838423,SRX5716463,SMARCA4,377
chr1,248838149,248838869,SRX20140881,CPSF3L,720
chr1,248838340,248838652,SRX20140869,INTS10,312
chr1,248838364,248838965,SRX20140897,INTS13,601
chr1,248841644,248842092,SRX16500059,CTCF,448
chr1,248841696,248842082,SRX16500061,CTCF,386
chr1,248841722,248842083,SRX16500060,CTCF,361
chr1,248841742,248842092,SRX16500062,CTCF,350
chr1,248841806,248842019,SRX5075174,SMARCA4,213
chr1,248841839,248842012,SRX5075170,SMARCA4,173
chr1,248858174,248858430,SRX20140895,INTS13,256
chr1,248858189,248858946,SRX16500059,CTCF,757
chr1,248858268,248858539,SRX20140867,INTS10,271
chr1,248858478,248858874,SRX4174629,CTCF,396
chr1,248858489,248858912,SRX16500060,CTCF,423
chr1,248858574,248858869,SRX16500062,CTCF,295
chr1,248858608,248858933,SRX16500061,CTCF,325
chr1,248858854,248859356,SRX5075174,SMARCA4,502
chr1,248858902,248859188,SRX20140895,INTS13,286
chr1,248858914,248859247,SRX20140868,INTS10,333
chr1,248858945,248859128,SRX5054309,FOSL2,183
chr1,248858955,248859335,SRX5075168,SMARCA4,380
chr1,248858966,248859253,SRX5716463,SMARCA4,287
chr1,248858971,248859347,SRX5075170,SMARCA4,376
chr1,248858994,248859365,SRX5075176,SMARCA4,371
chr1,248859070,248859316,SRX5075169,SMARCA4,246
chr1,248859131,248859358,SRX5716470,SMARCA4,227
chr1,248863103,248863628,SRX20140895,INTS13,525
chr1,248863155,248863491,SRX20140868,INTS10,336
chr1,248863158,248863455,SRX5075174,SMARCA4,297
chr1,248863183,248863363,SRX5075169,SMARCA4,180
chr1,248863228,248863403,SRX5075176,SMARCA4,175
chr1,248863285,248863491,SRX5075170,SMARCA4,206
chr1,248872994,248874254,SRX20140895,INTS13,1260
chr1,248873109,248873377,SRX20140897,INTS13,268
chr1,248873326,248873735,SRX20140896,INTS13,409
chr1,248873413,248874413,SRX20140869,INTS10,1000
chr1,248873508,248873958,SRX20140897,INTS13,450
chr1,248873522,248874260,SRX20140881,CPSF3L,738
chr1,248873592,248873975,SRX20140867,INTS10,383
chr1,248873593,248874341,SRX20140868,INTS10,748
chr1,248873605,248873999,SRX5075174,SMARCA4,394
chr1,248873627,248873796,SRX5075170,SMARCA4,169
chr1,248873736,248873915,SRX5075168,SMARCA4,179
chr1,248873800,248874338,SRX20140879,CPSF3L,538
chr1,248873803,248874121,SRX20140870,INTS10,318
chr1,248873990,248874331,SRX20140894,INTS13,341
chr1,248874037,248874415,SRX5054309,FOSL2,378
chr1,248874070,248874355,SRX5054308,FOSL2,285
chr1,248874080,248874469,SRX5075174,SMARCA4,389
chr1,248874137,248874352,SRX20140867,INTS10,215
chr1,248874179,248874402,SRX5075176,SMARCA4,223
chr1,248874200,248874413,SRX5716464,SMARCA4,213
chr1,248874248,248874428,SRX5075168,SMARCA4,180
chr1,248881522,248881691,SRX5075170,SMARCA4,169
chr1,248884724,248884948,SRX5075176,SMARCA4,224
chr1,248884759,248884983,SRX5075170,SMARCA4,224
chr1,248886417,248886968,SRX5075176,SMARCA4,551
chr1,248886456,248887007,SRX5075170,SMARCA4,551
chr1,248886493,248886970,SRX5716470,SMARCA4,477
chr1,248886516,248886950,SRX5075169,SMARCA4,434
chr1,248886552,248886865,SRX5716469,SMARCA4,313
chr1,248886555,248886824,SRX5716468,SMARCA2,269
chr1,248886575,248886807,SRX5054308,FOSL2,232
chr1,248886591,248887000,SRX5075175,SMARCA4,409
chr1,248886598,248886781,SRX5054309,FOSL2,183
chr1,248905932,248906538,SRX20140895,INTS13,606
chr1,248905935,248906514,SRX5075168,SMARCA4,579
chr1,248905980,248906372,SRX5716470,SMARCA4,392
chr1,248905993,248906516,SRX20140867,INTS10,523
chr1,248906007,248906556,SRX20140868,INTS10,549
chr1,248906015,248906969,SRX5075174,SMARCA4,954
chr1,248906060,248906513,SRX20140881,CPSF3L,453
chr1,248906082,248906490,SRX20140879,CPSF3L,408
chr1,248906086,248906484,SRX20140869,INTS10,398
chr1,248906113,248906497,SRX20140897,INTS13,384
chr1,248906173,248906428,SRX5075169,SMARCA4,255
chr1,248906195,248906631,SRX16500059,CTCF,436
chr1,248906203,248906662,SRX16500060,CTCF,459
chr1,248906233,248906590,SRX16500061,CTCF,357
chr1,248906251,248906469,SRX5716469,SMARCA4,218
chr1,248906258,248906615,SRX16500062,CTCF,357
chr1,248906289,248906732,SRX4174629,CTCF,443
chr1,248906316,248906551,SRX5075176,SMARCA4,235
chr1,248906362,248906552,SRX5075175,SMARCA4,190
chr1,248906570,248906963,SRX5075168,SMARCA4,393
chr1,248906576,248907010,SRX5075170,SMARCA4,434
chr1,248906610,248906789,SRX5054307,FOSL2,179
chr1,248906631,248906815,SRX5054309,FOSL2,184
chr1,248906684,248906939,SRX5075176,SMARCA4,255
chr1,248906707,248907219,SRX5716470,SMARCA4,512
chr1,248906791,248907160,SRX5075169,SMARCA4,369
chr1,248906792,248907060,SRX5075175,SMARCA4,268
chr1,248924690,248925114,SRX16500059,CTCF,424
chr1,248924695,248925110,SRX4174629,CTCF,415
chr1,248924699,248925115,SRX16500062,CTCF,416
chr1,248924712,248925190,SRX16500060,CTCF,478
chr1,248924735,248925148,SRX16500061,CTCF,413
chr1,248928275,248928531,SRX5075174,SMARCA4,256
chr1,248931359,248931547,SRX5075175,SMARCA4,188
chr1,248934218,248934456,SRX5075168,SMARCA4,238
chr1,248934315,248934570,SRX5075174,SMARCA4,255
chr1,248944132,248944779,SRX16500060,CTCF,647
chr1,248944185,248944770,SRX16500059,CTCF,585
chr1,248944246,248944777,SRX16500061,CTCF,531
chr1,248944255,248944776,SRX16500062,CTCF,521
chr1,248944267,248944860,SRX20140895,INTS13,593
chr1,248944339,248944807,SRX20140868,INTS10,468
chr1,248944389,248944650,SRX4174629,CTCF,261
chr1,248944433,248944917,SRX20140867,INTS10,484
chr1,248944443,248944804,SRX20140881,CPSF3L,361
chr1,248944481,248944773,SRX20140869,INTS10,292
chr1,248945667,248946337,SRX20140862,SOX2,670
chr1,248945691,248945731,SRX1424892,POU3F2,40
chr1,248945696,248945738,SRX1424894,POU3F2,42
chr1,248945719,248946338,SRX20140879,CPSF3L,619
chr1,248945726,248946403,SRX20140894,INTS13,677
chr1,248945769,248946337,SRX20140870,INTS10,568
chr1,248945787,248946359,SRX20140869,INTS10,572
chr1,248945788,248946384,SRX20140896,INTS13,596
chr1,248945790,248946328,SRX20140890,SOX2,538
chr1,248945791,248946285,SRX20140891,SOX2,494
chr1,248945796,248946339,SRX20140861,SOX2,543
chr1,248945810,248946384,SRX20140895,INTS13,574
chr1,248945815,248946441,SRX20140860,SOX2,626
chr1,248945819,248946338,SRX20140882,CPSF3L,519
chr1,248945834,248946387,SRX20140881,CPSF3L,553
chr1,248945835,248946330,SRX20140892,SOX2,495
chr1,248945836,248946376,SRX20140897,INTS13,540
chr1,248945836,248946385,SRX20140880,CPSF3L,549
chr1,248945869,248946240,SRX20140868,INTS10,371
chr1,248945979,248946068,SRX1424891,POU3F2,89
chr1,248946285,248946392,SRX1424893,POU3F2,107
chr1,248946356,248946397,SRX1424894,POU3F2,41
